date,new positive labs,total positive labs,new negative labs,total negative labs,total tested,new hospital admissions,cumulative hospital admissions,new hospital discharges,cumulative hospital discharges,hospital deaths,cumulative hospital deaths,currently hospitalized,icu,vented,deaths,total deaths,new people positive,total people positive,new people negative,total people negative,total people tested,date_scraped
2/27/2020,0,0,0,0,0,1,1,0,0,0,0,1,,,0,0,,,,,,5/10/2020
2/28/2020,0,0,0,0,0,0,1,0,0,0,0,1,,,0,0,,,,,,5/10/2020
2/29/2020,1,1,0,0,1,0,1,0,0,0,0,1,,,0,0,,,,,,5/10/2020
3/1/2020,1,2,0,0,2,0,1,0,0,0,0,1,,,0,0,,,,,,5/10/2020
3/2/2020,0,2,1,1,3,1,2,0,0,0,0,2,,,0,0,,,,,,5/10/2020
3/3/2020,0,2,2,3,5,0,2,0,0,0,0,2,,,0,0,,,,,,5/10/2020
3/4/2020,0,2,4,7,9,1,3,0,0,0,0,3,,,0,0,,,,,,5/10/2020
3/5/2020,1,3,5,12,15,0,3,0,0,0,0,3,,,0,0,,,,,,5/10/2020
3/6/2020,0,3,12,24,27,0,3,0,0,0,0,3,,,0,0,,,,,,5/10/2020
3/7/2020,0,3,13,37,40,0,3,0,0,0,0,3,,,0,0,,,,,,5/10/2020
3/8/2020,0,3,22,59,62,0,3,0,0,0,0,3,,,0,0,,,,,,5/10/2020
3/9/2020,2,5,12,71,76,0,3,0,0,0,0,3,,,0,0,,,,,,5/10/2020
3/10/2020,0,5,18,89,94,0,3,0,0,0,0,3,,,0,0,,,,,,5/10/2020
3/11/2020,0,5,31,120,125,1,4,0,0,0,0,4,,,0,0,,,,,,5/10/2020
3/12/2020,9,14,42,162,176,1,5,0,0,0,0,5,,,0,0,,,,,,5/10/2020
3/13/2020,6,20,49,211,231,4,9,1,1,0,0,8,,,0,0,,,,,,5/10/2020
3/14/2020,0,20,86,297,317,0,9,0,1,0,0,8,,,0,0,,,,,,5/10/2020
3/15/2020,1,21,127,424,445,1,10,0,1,0,0,9,,,0,0,,,,,,5/10/2020
3/16/2020,2,23,67,491,514,2,12,0,1,0,0,11,,,0,0,,,,,,5/10/2020
3/17/2020,10,33,126,617,650,6,18,0,1,0,0,17,,,0,0,,,,,,5/10/2020
3/18/2020,11,44,130,747,791,3,21,0,1,0,0,20,,,0,0,,,,,,5/10/2020
3/19/2020,10,54,248,995,1049,2,23,1,2,0,0,21,,,1,1,,,,,,5/10/2020
3/20/2020,12,66,191,1186,1252,5,28,0,2,0,0,26,,,0,1,,,,,,5/10/2020
3/21/2020,17,83,190,1376,1459,3,31,2,4,0,0,27,,,0,1,,,,,,5/10/2020
3/22/2020,23,106,68,1444,1550,2,33,0,4,0,0,29,,,0,1,,,,,,5/10/2020
3/23/2020,18,124,166,1610,1734,16,49,1,5,0,0,44,,,0,1,,,,,,5/10/2020
3/24/2020,8,132,166,1776,1908,7,56,0,5,0,0,51,,,0,1,,,,,,5/10/2020
3/25/2020,33,165,239,2015,2180,5,61,1,6,0,0,55,,,0,1,,,,,,5/10/2020
3/26/2020,38,203,268,2283,2486,9,70,5,11,0,0,59,,,0,1,,,,,,5/10/2020
3/27/2020,36,239,258,2541,2780,8,78,1,12,1,1,65,,,2,3,,,,,,5/10/2020
3/28/2020,54,293,299,2840,3133,13,91,2,14,1,2,75,,,1,4,,,,,,5/10/2020
3/29/2020,108,401,347,3187,3588,8,99,4,18,1,3,78,,,2,6,,,,,,5/10/2020
3/30/2020,87,488,289,3476,3964,19,118,6,24,0,3,91,,,3,9,,,,,,5/10/2020
3/31/2020,79,567,355,3831,4398,11,129,7,31,1,4,94,,,2,11,,,,,,5/10/2020
4/1/2020,91,658,581,4412,5070,18,147,7,38,0,4,105,,,1,12,,,,,,5/10/2020
4/2/2020,53,711,445,4857,5568,21,168,6,44,2,6,118,,,4,16,,,,,,5/10/2020
4/3/2020,95,806,727,5584,6390,23,191,7,51,0,6,134,,,3,19,,,,,,5/10/2020
4/4/2020,116,922,677,6261,7183,21,212,4,55,5,11,146,,,9,28,,,,,,5/10/2020
4/5/2020,160,1082,1140,7401,8483,20,232,9,64,1,12,156,,,2,30,,,,,,5/10/2020
4/6/2020,148,1230,1664,9065,10295,26,258,7,71,0,12,175,,,5,35,,,,,,5/10/2020
4/7/2020,220,1450,1619,10684,12134,19,277,4,75,2,14,188,,,5,40,,,,,,5/10/2020
4/8/2020,277,1727,1599,12283,14010,18,295,8,83,6,20,192,,,7,47,,,,,,5/10/2020
4/9/2020,285,2012,1526,13809,15821,32,327,8,91,4,24,212,,,6,53,,,,,,5/10/2020
4/10/2020,331,2343,2441,16250,18593,29,356,17,108,5,29,219,,,10,63,,,,,,5/10/2020
4/11/2020,313,2656,1827,18077,20733,29,385,11,119,2,31,235,,,11,74,,,,,,5/10/2020
4/12/2020,310,2966,1572,19649,22615,34,419,13,132,5,36,251,,,10,84,,,,,,5/10/2020
4/13/2020,270,3236,1026,20675,23911,36,455,13,145,3,39,271,,,9,93,,,,,,5/10/2020
4/14/2020,271,3507,1784,22459,25966,27,482,16,161,5,44,277,,,7,100,,,,,,5/10/2020
4/15/2020,307,3814,1767,24226,28040,30,512,19,180,3,47,285,,,17,117,,,,,,5/10/2020
4/16/2020,363,4177,2358,26584,30761,37,549,25,205,6,53,291,,,13,130,,,,,,5/10/2020
4/17/2020,302,4479,1751,28335,32814,31,580,20,225,7,60,295,,,21,151,,,,,,5/10/2020
4/18/2020,276,4755,1658,29993,34748,27,607,18,243,4,64,300,,,14,165,,,,,,5/10/2020
4/19/2020,343,5098,1997,31990,37088,24,631,25,268,1,65,298,,,11,176,,,,,,5/10/2020
4/20/2020,369,5467,1843,33833,39300,46,677,30,298,3,68,311,,,11,187,,,,,,5/10/2020
4/21/2020,378,5845,2048,35881,41726,44,721,31,329,5,73,319,,,15,202,,,,,,5/10/2020
4/22/2020,417,6262,2282,38163,44425,40,761,32,361,5,78,322,,,13,215,,,,,,5/10/2020
4/23/2020,437,6699,2395,40558,47257,31,792,28,389,5,83,320,,,12,227,,,,,,5/10/2020
4/24/2020,430,7129,3204,43762,50891,35,827,27,416,4,87,324,,,9,236,,,,,,5/10/2020
4/25/2020,310,7439,2202,45964,53403,34,861,17,433,5,92,336,,,11,247,,,,,,5/10/2020
4/26/2020,269,7708,2213,48177,55885,31,892,14,447,3,95,350,,,9,256,,,,,,5/10/2020
4/27/2020,218,7926,1590,49767,57693,29,921,21,468,4,99,354,,,8,264,,,,,,5/10/2020
4/28/2020,321,8247,2151,51918,60165,41,962,23,491,3,102,369,,,16,280,,,,,,5/10/2020
4/29/2020,374,8621,3171,55089,63710,30,992,38,529,11,113,350,,,9,289,,,,,,5/10/2020
4/30/2020,341,8962,2597,57686,66648,33,1025,36,565,5,118,342,,,17,306,,,,,,5/10/2020
5/1/2020,327,9289,2953,60639,69928,50,1075,39,604,3,121,350,,,6,312,,,,,,5/10/2020
5/2/2020,188,9477,1811,62450,71927,31,1106,37,641,5,126,339,,,22,334,,,,,,5/10/2020
5/3/2020,175,9652,2034,64484,74136,31,1137,27,668,8,134,335,,,16,350,,,,,,5/10/2020
5/4/2020,281,9933,2018,66502,76435,28,1165,30,698,5,139,328,,,16,366,,,,,,5/10/2020
5/5/2020,272,10205,2666,69168,79373,26,1191,32,730,6,145,316,,,15,381,,,,,,5/10/2020
5/6/2020,325,10530,2620,71788,82318,28,1219,42,772,9,154,293,,,15,396,,,,,,5/10/2020
5/7/2020,249,10779,2699,74487,85266,32,1251,37,809,5,159,283,,,13,409,,,,,,5/10/2020
5/8/2020,210,10989,2339,76826,87815,,,,,,,,,,9,418,,,,,,5/10/2020
5/9/2020,285,11274,3113,79939,91213,,,,,,,,,,4,422,,,,,,5/10/2020
2/27/2020,0,0,0,0,0,1,1,0,0,0,0,1,,,0,0,,,,,,5/17/2020
2/28/2020,0,0,0,0,0,0,1,0,0,0,0,1,,,0,0,,,,,,5/17/2020
2/29/2020,1,1,0,0,1,0,1,0,0,0,0,1,,,0,0,,,,,,5/17/2020
3/1/2020,1,2,0,0,2,0,1,0,0,0,0,1,,,0,0,,,,,,5/17/2020
3/2/2020,0,2,1,1,3,1,2,0,0,0,0,2,,,0,0,,,,,,5/17/2020
3/3/2020,0,2,2,3,5,0,2,0,0,0,0,2,,,0,0,,,,,,5/17/2020
3/4/2020,0,2,4,7,9,1,3,0,0,0,0,3,,,0,0,,,,,,5/17/2020
3/5/2020,1,3,5,12,15,0,3,0,0,0,0,3,,,0,0,,,,,,5/17/2020
3/6/2020,0,3,12,24,27,0,3,0,0,0,0,3,,,0,0,,,,,,5/17/2020
3/7/2020,0,3,13,37,40,0,3,0,0,0,0,3,,,0,0,,,,,,5/17/2020
3/8/2020,0,3,22,59,62,0,3,0,0,0,0,3,,,0,0,,,,,,5/17/2020
3/9/2020,2,5,12,71,76,0,3,0,0,0,0,3,,,0,0,,,,,,5/17/2020
3/10/2020,0,5,18,89,94,0,3,0,0,0,0,3,,,0,0,,,,,,5/17/2020
3/11/2020,0,5,31,120,125,1,4,0,0,0,0,4,,,0,0,,,,,,5/17/2020
3/12/2020,9,14,42,162,176,1,5,0,0,0,0,5,,,0,0,,,,,,5/17/2020
3/13/2020,6,20,49,211,231,4,9,1,1,0,0,8,,,0,0,,,,,,5/17/2020
3/14/2020,0,20,86,297,317,0,9,0,1,0,0,8,,,0,0,,,,,,5/17/2020
3/15/2020,1,21,127,424,445,1,10,0,1,0,0,9,,,0,0,,,,,,5/17/2020
3/16/2020,2,23,67,491,514,2,12,0,1,0,0,11,,,0,0,,,,,,5/17/2020
3/17/2020,10,33,126,617,650,6,18,0,1,0,0,17,,,0,0,,,,,,5/17/2020
3/18/2020,11,44,130,747,791,3,21,0,1,0,0,20,,,0,0,,,,,,5/17/2020
3/19/2020,10,54,248,995,1049,2,23,1,2,0,0,21,,,1,1,,,,,,5/17/2020
3/20/2020,12,66,191,1186,1252,5,28,0,2,0,0,26,,,0,1,,,,,,5/17/2020
3/21/2020,17,83,190,1376,1459,3,31,2,4,0,0,27,,,0,1,,,,,,5/17/2020
3/22/2020,23,106,68,1444,1550,2,33,0,4,0,0,29,,,0,1,,,,,,5/17/2020
3/23/2020,18,124,166,1610,1734,16,49,1,5,0,0,44,,,0,1,,,,,,5/17/2020
3/24/2020,8,132,166,1776,1908,7,56,0,5,0,0,51,,,0,1,,,,,,5/17/2020
3/25/2020,33,165,239,2015,2180,5,61,1,6,0,0,55,,,0,1,,,,,,5/17/2020
3/26/2020,38,203,268,2283,2486,9,70,5,11,0,0,59,,,0,1,,,,,,5/17/2020
3/27/2020,36,239,258,2541,2780,8,78,1,12,1,1,65,,,2,3,,,,,,5/17/2020
3/28/2020,54,293,299,2840,3133,13,91,2,14,1,2,75,,,1,4,,,,,,5/17/2020
3/29/2020,108,401,347,3187,3588,8,99,4,18,1,3,78,,,2,6,,,,,,5/17/2020
3/30/2020,87,488,289,3476,3964,19,118,6,24,0,3,91,,,3,9,,,,,,5/17/2020
3/31/2020,79,567,355,3831,4398,11,129,7,31,1,4,94,,,2,11,,,,,,5/17/2020
4/1/2020,91,658,581,4412,5070,18,147,7,38,0,4,105,,,1,12,,,,,,5/17/2020
4/2/2020,53,711,445,4857,5568,21,168,6,44,2,6,118,,,4,16,,,,,,5/17/2020
4/3/2020,95,806,727,5584,6390,23,191,7,51,0,6,134,,,3,19,,,,,,5/17/2020
4/4/2020,116,922,677,6261,7183,21,212,4,55,5,11,146,,,9,28,,,,,,5/17/2020
4/5/2020,160,1082,1140,7401,8483,20,232,9,64,1,12,156,,,2,30,,,,,,5/17/2020
4/6/2020,148,1230,1664,9065,10295,26,258,7,71,0,12,175,,,5,35,,,,,,5/17/2020
4/7/2020,220,1450,1619,10684,12134,20,278,4,75,2,14,189,,,5,40,,,,,,5/17/2020
4/8/2020,277,1727,1599,12283,14010,18,296,8,83,6,20,193,,,7,47,,,,,,5/17/2020
4/9/2020,285,2012,1526,13809,15821,32,328,8,91,4,24,213,,,6,53,,,,,,5/17/2020
4/10/2020,331,2343,2441,16250,18593,29,357,17,108,5,29,220,,,10,63,,,,,,5/17/2020
4/11/2020,313,2656,1827,18077,20733,29,386,11,119,2,31,236,,,11,74,,,,,,5/17/2020
4/12/2020,310,2966,1572,19649,22615,34,420,13,132,5,36,252,,,10,84,,,,,,5/17/2020
4/13/2020,270,3236,1026,20675,23911,36,456,13,145,3,39,272,,,9,93,,,,,,5/17/2020
4/14/2020,271,3507,1784,22459,25966,27,483,16,161,5,44,278,,,7,100,,,,,,5/17/2020
4/15/2020,307,3814,1767,24226,28040,30,513,19,180,3,47,286,,,17,117,,,,,,5/17/2020
4/16/2020,363,4177,2358,26584,30761,37,550,25,205,6,53,292,,,13,130,,,,,,5/17/2020
4/17/2020,302,4479,1751,28335,32814,31,581,20,225,7,60,296,,,21,151,,,,,,5/17/2020
4/18/2020,276,4755,1658,29993,34748,27,608,18,243,4,64,301,,,14,165,,,,,,5/17/2020
4/19/2020,343,5098,1997,31990,37088,24,632,26,269,1,65,298,,,11,176,,,,,,5/17/2020
4/20/2020,369,5467,1843,33833,39300,46,678,30,299,3,68,311,,,11,187,,,,,,5/17/2020
4/21/2020,378,5845,2048,35881,41726,45,723,31,330,5,73,320,,,15,202,,,,,,5/17/2020
4/22/2020,417,6262,2282,38163,44425,41,764,32,362,5,78,324,,,13,215,,,,,,5/17/2020
4/23/2020,437,6699,2395,40558,47257,31,795,28,390,5,83,322,,,12,227,,,,,,5/17/2020
4/24/2020,430,7129,3204,43762,50891,35,830,27,417,4,87,326,,,9,236,,,,,,5/17/2020
4/25/2020,310,7439,2202,45964,53403,34,864,17,434,5,92,338,,,11,247,,,,,,5/17/2020
4/26/2020,269,7708,2213,48177,55885,33,897,15,449,3,95,353,,,9,256,,,,,,5/17/2020
4/27/2020,218,7926,1590,49767,57693,29,926,21,470,4,99,357,,,8,264,,,,,,5/17/2020
4/28/2020,321,8247,2151,51918,60165,43,969,24,494,3,102,373,,,16,280,,,,,,5/17/2020
4/29/2020,374,8621,3171,55089,63710,32,1001,38,532,11,113,356,,,10,290,,,,,,5/17/2020
4/30/2020,341,8962,2597,57686,66648,33,1034,37,569,5,118,347,,,17,307,,,,,,5/17/2020
5/1/2020,327,9289,2953,60639,69928,51,1085,39,608,3,121,356,,,7,314,,,,,,5/17/2020
5/2/2020,188,9477,1811,62450,71927,33,1118,39,647,5,126,345,,,23,337,,,,,,5/17/2020
5/3/2020,175,9652,2034,64484,74136,31,1149,27,674,8,134,341,,,16,353,,,,,,5/17/2020
5/4/2020,281,9933,2018,66502,76435,29,1178,31,705,5,139,334,,,16,369,,,,,,5/17/2020
5/5/2020,272,10205,2666,69168,79373,27,1205,32,737,6,145,323,,,15,384,,,,,,5/17/2020
5/6/2020,325,10530,2620,71788,82318,28,1233,43,780,9,154,299,,,16,400,,,,,,5/17/2020
5/7/2020,249,10779,2699,74487,85266,35,1268,39,819,5,159,290,,,14,414,,,,,,5/17/2020
5/8/2020,210,10989,2339,76826,87815,28,1296,29,848,4,163,285,,,11,425,,,,,,5/17/2020
5/9/2020,285,11274,3113,79939,91213,22,1318,21,869,4,167,282,,,11,436,,,,,,5/17/2020
5/10/2020,176,11450,1943,81882,93332,19,1337,22,891,6,173,273,,,9,445,,,,,,5/17/2020
5/11/2020,164,11614,1743,83625,95239,28,1365,16,907,5,178,280,,,10,455,,,,,,5/17/2020
5/12/2020,221,11835,2462,86087,97922,21,1386,17,924,4,182,280,,,16,471,,,,,,5/17/2020
5/13/2020,181,12016,3498,89585,101601,18,1404,23,947,1,183,274,,,6,477,,,,,,5/17/2020
5/14/2020,203,12219,3174,92759,104978,14,1418,25,972,3,186,260,,,9,486,,,,,,5/17/2020
5/15/2020,215,12434,3287,96046,108480,,,,,,,,,,10,496,,,,,,5/17/2020
5/16/2020,240,12674,3830,99876,112550,,,,,,,,,,3,499,,,,,,5/17/2020
2/27/2020,0,0,0,0,0,1,1,0,0,0,0,1,,,0,0,,,,,,5/21/2020
2/28/2020,0,0,0,0,0,0,1,0,0,0,0,1,,,0,0,,,,,,5/21/2020
2/29/2020,1,1,0,0,1,0,1,0,0,0,0,1,,,0,0,,,,,,5/21/2020
3/1/2020,1,2,0,0,2,0,1,0,0,0,0,1,,,0,0,,,,,,5/21/2020
3/2/2020,0,2,1,1,3,1,2,0,0,0,0,2,,,0,0,,,,,,5/21/2020
3/3/2020,0,2,2,3,5,0,2,0,0,0,0,2,,,0,0,,,,,,5/21/2020
3/4/2020,0,2,4,7,9,1,3,0,0,0,0,3,,,0,0,,,,,,5/21/2020
3/5/2020,1,3,5,12,15,0,3,0,0,0,0,3,,,0,0,,,,,,5/21/2020
3/6/2020,0,3,12,24,27,0,3,0,0,0,0,3,,,0,0,,,,,,5/21/2020
3/7/2020,0,3,13,37,40,0,3,0,0,0,0,3,,,0,0,,,,,,5/21/2020
3/8/2020,0,3,22,59,62,0,3,0,0,0,0,3,,,0,0,,,,,,5/21/2020
3/9/2020,2,5,12,71,76,0,3,0,0,0,0,3,,,0,0,,,,,,5/21/2020
3/10/2020,0,5,18,89,94,0,3,0,0,0,0,3,,,0,0,,,,,,5/21/2020
3/11/2020,0,5,31,120,125,1,4,0,0,0,0,4,,,0,0,,,,,,5/21/2020
3/12/2020,9,14,42,162,176,1,5,0,0,0,0,5,,,0,0,,,,,,5/21/2020
3/13/2020,6,20,49,211,231,4,9,1,1,0,0,8,,,0,0,,,,,,5/21/2020
3/14/2020,0,20,86,297,317,0,9,0,1,0,0,8,,,0,0,,,,,,5/21/2020
3/15/2020,1,21,127,424,445,1,10,0,1,0,0,9,,,0,0,,,,,,5/21/2020
3/16/2020,2,23,67,491,514,2,12,0,1,0,0,11,,,0,0,,,,,,5/21/2020
3/17/2020,11,34,126,617,651,6,18,0,1,0,0,17,,,0,0,,,,,,5/21/2020
3/18/2020,13,47,130,747,794,3,21,0,1,0,0,20,,,0,0,,,,,,5/21/2020
3/19/2020,12,59,248,995,1054,2,23,1,2,0,0,21,,,1,1,,,,,,5/21/2020
3/20/2020,14,73,191,1186,1259,5,28,0,2,0,0,26,,,0,1,,,,,,5/21/2020
3/21/2020,17,90,190,1376,1466,3,31,2,4,0,0,27,,,0,1,,,,,,5/21/2020
3/22/2020,24,114,68,1444,1558,2,33,0,4,0,0,29,,,0,1,,,,,,5/21/2020
3/23/2020,18,132,166,1610,1742,16,49,1,5,0,0,44,,,0,1,,,,,,5/21/2020
3/24/2020,18,150,166,1776,1926,7,56,0,5,0,0,51,,,0,1,,,,,,5/21/2020
3/25/2020,33,183,239,2015,2198,5,61,1,6,0,0,55,,,0,1,,,,,,5/21/2020
3/26/2020,37,220,268,2283,2503,9,70,5,11,0,0,59,,,0,1,,,,,,5/21/2020
3/27/2020,36,256,258,2541,2797,8,78,1,12,1,1,65,,,2,3,,,,,,5/21/2020
3/28/2020,59,315,299,2840,3155,13,91,2,14,1,2,75,,,1,4,,,,,,5/21/2020
3/29/2020,110,425,347,3187,3612,8,99,4,18,1,3,78,,,2,6,,,,,,5/21/2020
3/30/2020,85,510,289,3476,3986,19,118,6,24,0,3,91,,,3,9,,,,,,5/21/2020
3/31/2020,75,585,355,3831,4416,11,129,7,31,1,4,94,,,2,11,,,,,,5/21/2020
4/1/2020,104,689,581,4412,5101,18,147,7,38,0,4,105,,,1,12,,,,,,5/21/2020
4/2/2020,44,733,445,4857,5590,21,168,6,44,2,6,118,,,4,16,,,,,,5/21/2020
4/3/2020,121,854,727,5584,6438,23,191,7,51,0,6,134,,,3,19,,,,,,5/21/2020
4/4/2020,150,1004,677,6261,7265,21,212,4,55,5,11,146,,,9,28,,,,,,5/21/2020
4/5/2020,166,1170,1140,7401,8571,20,232,9,64,1,12,156,,,2,30,,,,,,5/21/2020
4/6/2020,181,1351,1664,9065,10416,26,258,7,71,0,12,175,,,5,35,,,,,,5/21/2020
4/7/2020,256,1607,1619,10684,12291,20,278,4,75,2,14,189,,,5,40,,,,,,5/21/2020
4/8/2020,286,1893,1599,12283,14176,18,296,8,83,6,20,193,,,7,47,,,,,,5/21/2020
4/9/2020,266,2159,1526,13809,15968,32,328,8,91,4,24,213,,,6,53,,,,,,5/21/2020
4/10/2020,410,2569,2441,16250,18819,29,357,17,108,5,29,220,,,10,63,,,,,,5/21/2020
4/11/2020,298,2867,1827,18077,20944,29,386,11,119,2,31,236,,,11,74,,,,,,5/21/2020
4/12/2020,293,3160,1572,19649,22809,34,420,13,132,5,36,252,,,10,84,,,,,,5/21/2020
4/13/2020,177,3337,1026,20675,24012,36,456,13,145,3,39,272,,,9,93,,,,,,5/21/2020
4/14/2020,270,3607,1784,22459,26066,27,483,16,161,5,44,278,,,8,101,,,,,,5/21/2020
4/15/2020,297,3904,1767,24226,28130,31,514,19,180,3,47,287,,,17,118,,,,,,5/21/2020
4/16/2020,395,4299,2358,26584,30883,37,551,25,205,6,53,293,,,13,131,,,,,,5/21/2020
4/17/2020,296,4595,1751,28335,32930,31,582,20,225,7,60,297,,,21,152,,,,,,5/21/2020
4/18/2020,273,4868,1658,29993,34861,27,609,18,243,4,64,302,,,14,166,,,,,,5/21/2020
4/19/2020,337,5205,1997,31990,37195,24,633,26,269,1,65,299,,,11,177,,,,,,5/21/2020
4/20/2020,369,5574,1843,33833,39407,46,679,30,299,3,68,312,,,11,188,,,,,,5/21/2020
4/21/2020,368,5942,2048,35881,41823,45,724,31,330,5,73,321,,,15,203,,,,,,5/21/2020
4/22/2020,412,6354,2282,38163,44517,41,765,32,362,5,78,325,,,13,216,,,,,,5/21/2020
4/23/2020,427,6781,2395,40558,47339,31,796,28,390,5,83,323,,,12,228,,,,,,5/21/2020
4/24/2020,407,7188,3204,43762,50950,35,831,27,417,4,87,327,,,9,237,,,,,,5/21/2020
4/25/2020,287,7475,2202,45964,53439,34,865,17,434,5,92,339,,,11,248,,,,,,5/21/2020
4/26/2020,285,7760,2213,48177,55937,33,898,15,449,3,95,354,,,9,257,,,,,,5/21/2020
4/27/2020,205,7965,1590,49767,57732,29,927,21,470,4,99,358,,,8,265,,,,,,5/21/2020
4/28/2020,318,8283,2151,51918,60201,43,970,24,494,3,102,374,,,16,281,,,,,,5/21/2020
4/29/2020,376,8659,3171,55089,63748,33,1003,38,532,11,113,358,,,11,292,,,,,,5/21/2020
4/30/2020,346,9005,2597,57686,66691,33,1036,37,569,5,118,349,,,17,309,,,,,,5/21/2020
5/1/2020,318,9323,2953,60639,69962,51,1087,39,608,3,121,358,,,7,316,,,,,,5/21/2020
5/2/2020,188,9511,1811,62450,71961,34,1121,39,647,5,126,348,,,23,339,,,,,,5/21/2020
5/3/2020,181,9692,2034,64484,74176,31,1152,27,674,8,134,344,,,16,355,,,,,,5/21/2020
5/4/2020,288,9980,2018,66502,76482,29,1181,31,705,5,139,337,,,16,371,,,,,,5/21/2020
5/5/2020,303,10283,2666,69168,79451,27,1208,32,737,6,145,326,,,15,386,,,,,,5/21/2020
5/6/2020,343,10626,2620,71788,82414,28,1236,43,780,9,154,302,,,16,402,,,,,,5/21/2020
5/7/2020,258,10884,2699,74487,85371,35,1271,40,820,5,159,292,,,15,417,,,,,,5/21/2020
5/8/2020,231,11115,2339,76826,87941,28,1299,29,849,4,163,287,,,11,428,,,,,,5/21/2020
5/9/2020,285,11400,3113,79939,91339,22,1321,21,870,4,167,284,,,11,439,,,,,,5/21/2020
5/10/2020,189,11589,1943,81882,93471,19,1340,22,892,6,173,275,,,10,449,,,,,,5/21/2020
5/11/2020,172,11761,1743,83625,95386,30,1370,16,908,5,178,284,,,10,459,,,,,,5/21/2020
5/12/2020,216,11977,2462,86087,98064,22,1392,18,926,4,182,284,,,16,475,,,,,,5/21/2020
5/13/2020,195,12172,3498,89585,101757,19,1411,23,949,1,183,279,,,10,485,,,,,,5/21/2020
5/14/2020,223,12395,3174,92759,105154,15,1426,26,975,3,186,265,,,10,495,,,,,,5/21/2020
5/15/2020,226,12621,3288,96047,108668,23,1449,40,1015,4,190,244,,,11,506,,,,,,5/21/2020
5/16/2020,261,12882,3830,99877,112759,24,1473,11,1026,5,195,252,,,10,516,,,,,,5/21/2020
5/17/2020,128,13010,2713,102590,115600,17,1490,6,1032,5,200,258,,,8,524,,,,,,5/21/2020
5/18/2020,132,13142,1708,104298,117440,16,1506,15,1047,5,205,254,,,17,541,,,,,,5/21/2020
5/19/2020,240,13382,2950,107248,120630,,,,,,,,,,6,547,,,,,,5/21/2020
5/20/2020,189,13571,2548,109796,123367,,,,,,,,,,9,556,,,,,,5/21/2020
2/27/2020,0,0,0,0,0,1,1,0,0,0,0,1,--,--,0,0,,,,,,5/30/2020
2/28/2020,0,0,0,0,0,0,1,0,0,0,0,1,--,--,0,0,,,,,,5/30/2020
2/29/2020,0,0,0,0,0,0,1,0,0,0,0,1,--,--,0,0,,,,,,5/30/2020
3/1/2020,2,2,0,0,2,0,1,0,0,0,0,1,--,--,0,0,,,,,,5/30/2020
3/2/2020,0,2,1,1,3,1,2,0,0,0,0,2,--,--,0,0,,,,,,5/30/2020
3/3/2020,0,2,2,3,5,0,2,0,0,0,0,2,--,--,0,0,,,,,,5/30/2020
3/4/2020,0,2,4,7,9,1,3,0,0,0,0,3,--,--,0,0,,,,,,5/30/2020
3/5/2020,1,3,5,12,15,0,3,0,0,0,0,3,--,--,0,0,,,,,,5/30/2020
3/6/2020,0,3,12,24,27,0,3,0,0,0,0,3,--,--,0,0,,,,,,5/30/2020
3/7/2020,0,3,13,37,40,0,3,0,0,0,0,3,--,--,0,0,,,,,,5/30/2020
3/8/2020,0,3,22,59,62,0,3,0,0,0,0,3,--,--,0,0,,,,,,5/30/2020
3/9/2020,1,4,12,71,75,0,3,0,0,0,0,3,--,--,0,0,,,,,,5/30/2020
3/10/2020,1,5,18,89,94,0,3,0,0,0,0,3,--,--,0,0,,,,,,5/30/2020
3/11/2020,0,5,31,120,125,1,4,0,0,0,0,4,--,--,0,0,,,,,,5/30/2020
3/12/2020,8,13,42,162,175,1,5,0,0,0,0,5,--,--,0,0,,,,,,5/30/2020
3/13/2020,6,19,49,211,230,4,9,1,1,0,0,8,--,--,0,0,,,,,,5/30/2020
3/14/2020,0,19,86,297,316,0,9,0,1,0,0,8,--,--,0,0,,,,,,5/30/2020
3/15/2020,1,20,127,424,444,1,10,0,1,0,0,9,--,--,0,0,,,,,,5/30/2020
3/16/2020,2,22,67,491,513,2,12,0,1,0,0,11,--,--,0,0,,,,,,5/30/2020
3/17/2020,12,34,126,617,651,6,18,0,1,0,0,17,--,--,0,0,,,,,,5/30/2020
3/18/2020,11,45,130,747,792,3,21,0,1,0,0,20,--,--,0,0,,,,,,5/30/2020
3/19/2020,16,61,248,995,1056,2,23,1,2,0,0,21,--,--,1,1,,,,,,5/30/2020
3/20/2020,13,74,191,1186,1260,5,28,0,2,0,0,26,--,--,0,1,,,,,,5/30/2020
3/21/2020,14,88,190,1376,1464,3,31,2,4,0,0,27,--,--,0,1,,,,,,5/30/2020
3/22/2020,25,113,68,1444,1557,2,33,0,4,0,0,29,--,--,0,1,,,,,,5/30/2020
3/23/2020,16,129,166,1610,1739,16,49,1,5,0,0,44,--,--,0,1,,,,,,5/30/2020
3/24/2020,19,148,166,1776,1924,7,56,0,5,0,0,51,--,--,0,1,,,,,,5/30/2020
3/25/2020,28,176,239,2015,2191,5,61,1,6,0,0,55,--,--,0,1,,,,,,5/30/2020
3/26/2020,41,217,268,2283,2500,10,71,5,11,0,0,60,--,--,0,1,,,,,,5/30/2020
3/27/2020,31,248,258,2541,2789,8,79,1,12,1,1,66,--,--,2,3,,,,,,5/30/2020
3/28/2020,63,311,299,2840,3151,13,92,3,15,1,2,75,--,--,1,4,,,,,,5/30/2020
3/29/2020,105,416,347,3187,3603,8,100,4,19,1,3,78,--,--,2,6,,,,,,5/30/2020
3/30/2020,77,493,289,3476,3969,20,120,5,24,0,3,93,--,--,3,9,,,,,,5/30/2020
3/31/2020,73,566,355,3831,4397,11,131,7,31,1,4,96,--,--,2,11,,,,,,5/30/2020
4/1/2020,101,667,581,4412,5079,18,149,7,38,0,4,107,--,--,1,12,,,,,,5/30/2020
4/2/2020,62,729,445,4857,5586,21,170,6,44,2,6,120,--,--,4,16,,,,,,5/30/2020
4/3/2020,99,828,727,5584,6412,23,193,7,51,0,6,136,--,--,3,19,,,,,,5/30/2020
4/4/2020,137,965,677,6261,7226,21,214,4,55,5,11,148,--,--,9,28,,,,,,5/30/2020
4/5/2020,183,1148,1140,7401,8549,20,234,9,64,1,12,158,45,37,2,30,,,,,,5/30/2020
4/6/2020,207,1355,1664,9065,10420,26,260,7,71,0,12,177,45,38,5,35,,,,,,5/30/2020
4/7/2020,260,1615,1619,10684,12299,20,280,3,74,2,14,192,45,35,5,40,,,,,,5/30/2020
4/8/2020,274,1889,1599,12283,14172,19,299,8,82,6,20,197,50,36,9,49,,,,,,5/30/2020
4/9/2020,278,2167,1526,13809,15976,32,331,9,91,4,24,216,50,38,8,57,,,,,,5/30/2020
4/10/2020,406,2573,2441,16250,18823,29,360,17,108,5,29,223,48,36,10,67,,,,,,5/30/2020
4/11/2020,280,2853,1827,18077,20930,29,389,11,119,2,31,239,49,40,11,78,,,,,,5/30/2020
4/12/2020,288,3141,1572,19649,22790,34,423,13,132,5,36,255,54,44,10,88,,,,,,5/30/2020
4/13/2020,186,3327,1026,20675,24002,36,459,13,145,3,39,275,61,43,9,97,,,,,,5/30/2020
4/14/2020,267,3594,1784,22459,26053,27,486,16,161,5,44,281,62,43,8,105,,,,,,5/30/2020
4/15/2020,307,3901,1767,24226,28127,31,517,19,180,3,47,290,67,43,17,122,,,,,,5/30/2020
4/16/2020,392,4293,2358,26584,30877,37,554,25,205,6,53,296,70,43,13,135,,,,,,5/30/2020
4/17/2020,290,4583,1751,28335,32918,31,585,20,225,7,60,300,62,45,21,156,,,,,,5/30/2020
4/18/2020,283,4866,1658,29993,34859,26,611,18,243,4,64,304,67,43,14,170,,,,,,5/30/2020
4/19/2020,337,5203,1997,31990,37193,24,635,26,269,1,65,301,71,44,11,181,,,,,,5/30/2020
4/20/2020,380,5583,1843,33833,39416,46,681,29,298,2,67,316,72,45,10,191,,,,,,5/30/2020
4/21/2020,389,5972,2048,35881,41853,45,726,31,329,5,72,325,77,48,16,207,,,,,,5/30/2020
4/22/2020,383,6355,2282,38163,44518,41,767,32,361,5,77,329,77,52,13,220,,,,,,5/30/2020
4/23/2020,421,6776,2395,40558,47334,31,798,28,389,5,82,327,78,53,12,232,,,,,,5/30/2020
4/24/2020,415,7191,3204,43762,50953,35,833,27,416,4,86,331,81,56,11,243,,,,,,5/30/2020
4/25/2020,305,7496,2202,45964,53460,34,867,17,433,5,91,343,84,55,12,255,,,,,,5/30/2020
4/26/2020,275,7771,2213,48177,55948,33,900,15,448,3,94,358,80,55,11,266,,,,,,5/30/2020
4/27/2020,205,7976,1590,49767,57743,29,929,21,469,4,98,362,98,62,9,275,,,,,,5/30/2020
4/28/2020,329,8305,2151,51918,60223,43,972,24,493,3,101,378,76,51,20,295,,,,,,5/30/2020
4/29/2020,374,8679,3171,55089,63768,34,1006,38,531,11,112,363,80,54,15,310,,,,,,5/30/2020
4/30/2020,350,9029,2597,57686,66715,33,1039,38,569,6,118,352,83,59,21,331,,,,,,5/30/2020
5/1/2020,315,9344,3073,60759,70103,51,1090,39,608,3,121,361,84,61,10,341,,,,,,5/30/2020
5/2/2020,189,9533,1915,62674,72207,35,1125,39,647,5,126,352,89,62,22,363,,,,,,5/30/2020
5/3/2020,182,9715,2153,64827,74542,31,1156,27,674,8,134,348,86,60,16,379,,,,,,5/30/2020
5/4/2020,291,10006,2079,66906,76912,30,1186,31,705,5,139,342,82,56,17,396,,,,,,5/30/2020
5/5/2020,304,10310,2851,69757,80067,28,1214,32,737,6,145,332,71,52,15,411,,,,,,5/30/2020
5/6/2020,348,10658,2827,72584,83242,28,1242,44,781,9,154,307,77,56,19,430,,,,,,5/30/2020
5/7/2020,269,10927,2886,75470,86397,35,1277,41,822,5,159,296,70,52,17,447,,,,,,5/30/2020
5/8/2020,236,11163,2482,77952,89115,28,1305,29,851,4,163,291,73,52,17,464,,,,,,5/30/2020
5/9/2020,283,11446,3280,81232,92678,22,1327,21,872,4,167,288,72,53,12,476,,,,,,5/30/2020
5/10/2020,188,11634,2077,83309,94943,20,1347,22,894,6,173,280,68,48,13,489,,,,,,5/30/2020
5/11/2020,173,11807,1791,85100,96907,30,1377,16,910,5,178,289,65,42,11,500,,,,,,5/30/2020
5/12/2020,218,12025,2421,87521,99546,23,1400,18,928,4,182,290,63,41,18,518,,,,,,5/30/2020
5/13/2020,195,12220,3509,91030,103250,22,1422,24,952,1,183,287,66,44,11,529,,,,,,5/30/2020
5/14/2020,221,12441,3269,94299,106740,18,1440,27,979,3,186,275,64,45,12,541,,,,,,5/30/2020
5/15/2020,226,12667,3432,97731,110398,24,1464,41,1020,5,191,253,62,46,12,553,,,,,,5/30/2020
5/16/2020,255,12922,4001,101732,114654,25,1489,11,1031,5,196,262,59,44,12,565,,,,,,5/30/2020
5/17/2020,130,13052,2779,104511,117563,17,1506,7,1038,5,201,267,58,45,10,575,,,,,,5/30/2020
5/18/2020,137,13189,1890,106401,119590,18,1524,15,1053,5,206,265,56,41,17,592,,,,,,5/30/2020
5/19/2020,213,13402,3082,109483,122885,22,1546,31,1084,5,211,251,56,40,9,601,,,,,,5/30/2020
5/20/2020,184,13586,2734,112217,125803,19,1565,23,1107,7,218,240,51,34,20,621,,,,,,5/30/2020
5/21/2020,175,13761,3795,116012,129773,23,1588,15,1122,3,221,245,49,32,19,640,,,,,,5/30/2020
5/22/2020,207,13968,2942,118954,132922,19,1607,29,1151,5,226,230,--,--,7,647,,,,,,5/30/2020
5/23/2020,108,14076,2703,121657,135733,16,1623,11,1162,3,229,232,50,36,10,657,,,,,,5/30/2020
5/24/2020,89,14165,1333,122990,137155,11,1634,14,1176,2,231,227,49,35,8,665,,,,,,5/30/2020
5/25/2020,70,14235,1330,124320,138555,10,1644,12,1188,0,231,225,53,36,8,673,,,,,,5/30/2020
5/26/2020,153,14388,2489,126809,141197,21,1665,20,1208,4,235,222,47,33,15,688,,,,,,5/30/2020
5/27/2020,132,14520,1944,128753,143273,17,1682,17,1225,3,238,219,50,32,9,697,,,,,,5/30/2020
5/28/2020,128,14648,3188,131941,146589,,,,,,,,,,6,703,,,,,,5/30/2020
5/29/2020,171,14819,3557,135498,150317,,,,,,,,,,8,711,,,,,,5/30/2020
2/27/2020,0,0,0,0,0,1,1,0,0,0,0,1,--,--,0,0,,,,,,6/9/2020
2/28/2020,0,0,0,0,0,0,1,0,0,0,0,1,--,--,0,0,,,,,,6/9/2020
2/29/2020,0,0,0,0,0,0,1,0,0,0,0,1,--,--,0,0,,,,,,6/9/2020
3/1/2020,2,2,0,0,2,0,1,0,0,0,0,1,--,--,0,0,,,,,,6/9/2020
3/2/2020,0,2,1,1,3,1,2,0,0,0,0,2,--,--,0,0,,,,,,6/9/2020
3/3/2020,0,2,2,3,5,0,2,0,0,0,0,2,--,--,0,0,,,,,,6/9/2020
3/4/2020,0,2,4,7,9,1,3,0,0,0,0,3,--,--,0,0,,,,,,6/9/2020
3/5/2020,1,3,5,12,15,0,3,0,0,0,0,3,--,--,0,0,,,,,,6/9/2020
3/6/2020,0,3,12,24,27,0,3,0,0,0,0,3,--,--,0,0,,,,,,6/9/2020
3/7/2020,0,3,13,37,40,0,3,0,0,0,0,3,--,--,0,0,,,,,,6/9/2020
3/8/2020,0,3,22,59,62,0,3,0,0,0,0,3,--,--,0,0,,,,,,6/9/2020
3/9/2020,1,4,12,71,75,0,3,0,0,0,0,3,--,--,0,0,,,,,,6/9/2020
3/10/2020,1,5,18,89,94,0,3,0,0,0,0,3,--,--,0,0,,,,,,6/9/2020
3/11/2020,0,5,31,120,125,1,4,0,0,0,0,4,--,--,0,0,,,,,,6/9/2020
3/12/2020,8,13,42,162,175,1,5,0,0,0,0,5,--,--,0,0,,,,,,6/9/2020
3/13/2020,6,19,49,211,230,4,9,1,1,0,0,8,--,--,0,0,,,,,,6/9/2020
3/14/2020,0,19,86,297,316,0,9,0,1,0,0,8,--,--,0,0,,,,,,6/9/2020
3/15/2020,1,20,127,424,444,1,10,0,1,0,0,9,--,--,0,0,,,,,,6/9/2020
3/16/2020,2,22,67,491,513,2,12,0,1,0,0,11,--,--,0,0,,,,,,6/9/2020
3/17/2020,12,34,126,617,651,6,18,0,1,0,0,17,--,--,0,0,,,,,,6/9/2020
3/18/2020,11,45,130,747,792,3,21,0,1,0,0,20,--,--,0,0,,,,,,6/9/2020
3/19/2020,16,61,248,995,1056,2,23,1,2,0,0,21,--,--,1,1,,,,,,6/9/2020
3/20/2020,13,74,191,1186,1260,5,28,0,2,0,0,26,--,--,0,1,,,,,,6/9/2020
3/21/2020,14,88,190,1376,1464,3,31,2,4,0,0,27,--,--,0,1,,,,,,6/9/2020
3/22/2020,25,113,68,1444,1557,2,33,0,4,0,0,29,--,--,0,1,,,,,,6/9/2020
3/23/2020,16,129,166,1610,1739,16,49,1,5,0,0,44,--,--,0,1,,,,,,6/9/2020
3/24/2020,19,148,166,1776,1924,7,56,0,5,0,0,51,--,--,0,1,,,,,,6/9/2020
3/25/2020,28,176,239,2015,2191,5,61,1,6,0,0,55,--,--,0,1,,,,,,6/9/2020
3/26/2020,41,217,268,2283,2500,10,71,5,11,0,0,60,--,--,0,1,,,,,,6/9/2020
3/27/2020,31,248,258,2541,2789,9,80,1,12,1,1,67,--,--,2,3,,,,,,6/9/2020
3/28/2020,64,312,299,2840,3152,13,93,3,15,2,3,75,--,--,1,4,,,,,,6/9/2020
3/29/2020,105,417,347,3187,3604,8,101,4,19,1,4,78,--,--,2,6,,,,,,6/9/2020
3/30/2020,78,495,289,3476,3971,20,121,5,24,0,4,93,--,--,3,9,,,,,,6/9/2020
3/31/2020,73,568,355,3831,4399,11,132,7,31,1,5,96,--,--,2,11,,,,,,6/9/2020
4/1/2020,101,669,581,4412,5081,18,150,7,38,0,5,107,--,--,1,12,,,,,,6/9/2020
4/2/2020,63,732,445,4857,5589,21,171,6,44,2,7,120,--,--,4,16,,,,,,6/9/2020
4/3/2020,100,832,727,5584,6416,23,194,7,51,0,7,136,--,--,3,19,,,,,,6/9/2020
4/4/2020,138,970,677,6261,7231,21,215,4,55,5,12,148,--,--,9,28,,,,,,6/9/2020
4/5/2020,183,1153,1140,7401,8554,20,235,9,64,1,13,158,45,37,2,30,,,,,,6/9/2020
4/6/2020,207,1360,1664,9065,10425,26,261,7,71,0,13,177,45,38,7,37,,,,,,6/9/2020
4/7/2020,261,1621,1619,10684,12305,20,281,3,74,2,15,192,45,35,5,42,,,,,,6/9/2020
4/8/2020,274,1895,1599,12283,14178,19,300,8,82,6,21,197,50,36,9,51,,,,,,6/9/2020
4/9/2020,278,2173,1526,13809,15982,32,332,9,91,4,25,216,50,38,7,58,,,,,,6/9/2020
4/10/2020,405,2578,2441,16250,18828,29,361,17,108,5,30,223,48,36,10,68,,,,,,6/9/2020
4/11/2020,279,2857,1827,18077,20934,29,390,11,119,2,32,239,49,40,11,79,,,,,,6/9/2020
4/12/2020,288,3145,1572,19649,22794,35,425,13,132,5,37,256,54,44,10,89,,,,,,6/9/2020
4/13/2020,186,3331,1026,20675,24006,35,460,13,145,3,40,275,61,43,9,98,,,,,,6/9/2020
4/14/2020,267,3598,1784,22459,26057,27,487,16,161,5,45,281,62,43,8,106,,,,,,6/9/2020
4/15/2020,307,3905,1767,24226,28131,31,518,19,180,3,48,290,67,43,17,123,,,,,,6/9/2020
4/16/2020,392,4297,2358,26584,30881,37,555,25,205,6,54,296,70,43,13,136,,,,,,6/9/2020
4/17/2020,290,4587,1751,28335,32922,31,586,20,225,7,61,300,62,45,21,157,,,,,,6/9/2020
4/18/2020,283,4870,1658,29993,34863,26,612,18,243,4,65,304,67,43,14,171,,,,,,6/9/2020
4/19/2020,339,5209,1997,31990,37199,24,636,26,269,1,66,301,71,44,11,182,,,,,,6/9/2020
4/20/2020,381,5590,1843,33833,39423,46,682,29,298,2,68,316,72,45,10,192,,,,,,6/9/2020
4/21/2020,388,5978,2048,35881,41859,45,727,31,329,5,73,325,77,48,16,208,,,,,,6/9/2020
4/22/2020,383,6361,2282,38163,44524,41,768,32,361,5,78,329,77,52,14,222,,,,,,6/9/2020
4/23/2020,422,6783,2395,40558,47341,31,799,28,389,5,83,327,78,53,13,235,,,,,,6/9/2020
4/24/2020,415,7198,3204,43762,50960,35,834,27,416,4,87,331,81,56,12,247,,,,,,6/9/2020
4/25/2020,306,7504,2202,45964,53468,34,868,17,433,5,92,343,84,55,12,259,,,,,,6/9/2020
4/26/2020,276,7780,2213,48177,55957,33,901,15,448,3,95,358,80,55,12,271,,,,,,6/9/2020
4/27/2020,204,7984,1590,49767,57751,29,930,21,469,4,99,362,98,62,9,280,,,,,,6/9/2020
4/28/2020,328,8312,2151,51918,60230,43,973,24,493,3,102,378,76,51,21,301,,,,,,6/9/2020
4/29/2020,373,8685,3171,55089,63774,35,1008,38,531,11,113,364,80,54,18,319,,,,,,6/9/2020
4/30/2020,350,9035,2597,57686,66721,33,1041,38,569,6,119,353,83,59,22,341,,,,,,6/9/2020
5/1/2020,315,9350,3073,60759,70109,51,1092,40,609,3,122,361,84,61,11,352,,,,,,6/9/2020
5/2/2020,188,9538,1915,62674,72212,36,1128,38,647,5,127,354,89,62,24,376,,,,,,6/9/2020
5/3/2020,182,9720,2153,64827,74547,31,1159,27,674,8,135,350,86,60,17,393,,,,,,6/9/2020
5/4/2020,291,10011,2079,66906,76917,30,1189,31,705,5,140,344,82,56,17,410,,,,,,6/9/2020
5/5/2020,302,10313,2851,69757,80070,28,1217,32,737,6,146,334,71,52,16,426,,,,,,6/9/2020
5/6/2020,343,10656,2827,72584,83240,28,1245,44,781,9,155,309,77,56,19,445,,,,,,6/9/2020
5/7/2020,271,10927,2886,75470,86397,35,1280,42,823,5,160,297,70,52,18,463,,,,,,6/9/2020
5/8/2020,233,11160,2482,77952,89112,29,1309,29,852,4,164,293,73,52,19,482,,,,,,6/9/2020
5/9/2020,288,11448,3280,81232,92680,22,1331,21,873,4,168,290,72,53,13,495,,,,,,6/9/2020
5/10/2020,186,11634,2077,83309,94943,20,1351,23,896,6,174,281,68,48,13,508,,,,,,6/9/2020
5/11/2020,174,11808,1791,85100,96908,31,1382,16,912,5,179,291,65,42,13,521,,,,,,6/9/2020
5/12/2020,220,12028,2421,87521,99549,23,1405,18,930,4,183,292,63,41,21,542,,,,,,6/9/2020
5/13/2020,198,12226,3509,91030,103256,22,1427,24,954,1,184,289,66,44,12,554,,,,,,6/9/2020
5/14/2020,218,12444,3269,94299,106743,19,1446,27,981,3,187,278,64,45,14,568,,,,,,6/9/2020
5/15/2020,225,12669,3432,97731,110400,24,1470,41,1022,5,192,256,62,46,13,581,,,,,,6/9/2020
5/16/2020,251,12920,4001,101732,114652,25,1495,13,1035,5,197,263,59,44,12,593,,,,,,6/9/2020
5/17/2020,128,13048,2779,104511,117559,17,1512,7,1042,5,202,268,58,45,10,603,,,,,,6/9/2020
5/18/2020,138,13186,1890,106401,119587,19,1531,15,1057,5,207,267,56,41,18,621,,,,,,6/9/2020
5/19/2020,215,13401,3082,109483,122884,22,1553,31,1088,5,212,253,56,40,10,631,,,,,,6/9/2020
5/20/2020,190,13591,2734,112217,125808,19,1572,23,1111,7,219,242,51,34,21,652,,,,,,6/9/2020
5/21/2020,169,13760,3795,116012,129772,26,1598,15,1126,3,222,250,49,32,19,671,,,,,,6/9/2020
5/22/2020,205,13965,2942,118954,132919,19,1617,29,1155,5,227,235,--,--,7,678,,,,,,6/9/2020
5/23/2020,109,14074,2703,121657,135731,19,1636,11,1166,3,230,240,50,36,12,690,,,,,,6/9/2020
5/24/2020,89,14163,1333,122990,137153,12,1648,14,1180,2,232,236,49,35,8,698,,,,,,6/9/2020
5/25/2020,70,14233,1330,124320,138553,11,1659,13,1193,0,232,234,53,36,8,706,,,,,,6/9/2020
5/26/2020,157,14390,2489,126809,141199,23,1682,22,1215,5,237,230,47,33,15,721,,,,,,6/9/2020
5/27/2020,135,14525,2090,128899,143424,20,1702,17,1232,3,240,230,50,32,9,730,,,,,,6/9/2020
5/28/2020,133,14658,3232,132131,146789,16,1718,28,1260,4,244,214,46,29,7,737,,,,,,6/9/2020
5/29/2020,173,14831,3859,135990,150821,18,1736,27,1287,5,249,200,46,29,11,748,,,,,,6/9/2020
5/30/2020,103,14934,4104,140094,155028,15,1751,19,1306,4,253,192,48,31,9,757,,,,,,6/9/2020
5/31/2020,73,15007,2207,142301,157308,10,1761,9,1315,0,253,193,44,30,3,760,,,,,,6/9/2020
6/1/2020,99,15106,2625,144926,160032,8,1769,12,1327,1,254,188,42,29,3,763,,,,,,6/9/2020
6/2/2020,105,15211,2904,147830,163041,8,1777,9,1336,3,257,184,37,23,10,773,,,,,,6/9/2020
6/3/2020,101,15312,3343,151173,166485,13,1790,18,1354,6,263,173,--,--,10,783,,,,,,6/9/2020
6/4/2020,114,15426,4456,155629,171055,6,1796,25,1379,3,266,151,--,--,10,793,,,,,,6/9/2020
6/5/2020,99,15525,3794,159423,174948,12,1808,12,1391,5,271,146,28,20,5,798,,,,,,6/9/2020
6/6/2020,63,15588,2569,161992,177580,7,1815,7,1398,2,273,144,31,19,4,802,,,,,,6/9/2020
6/7/2020,48,15636,1539,163531,179167,,,,,,,,,,4,806,,,,,,6/9/2020
6/8/2020,55,15691,1665,165196,180887,,,,,,,,,,2,808,,,,,,6/9/2020
2/27/2020,0,0,0,0,0,1,1,0,0,0,0,1,--,--,0,0,,,,,,6/12/2020
2/28/2020,0,0,0,0,0,0,1,0,0,0,0,1,--,--,0,0,,,,,,6/12/2020
2/29/2020,0,0,0,0,0,0,1,0,0,0,0,1,--,--,0,0,,,,,,6/12/2020
3/1/2020,2,2,0,0,2,0,1,0,0,0,0,1,--,--,0,0,,,,,,6/12/2020
3/2/2020,0,2,1,1,3,1,2,0,0,0,0,2,--,--,0,0,,,,,,6/12/2020
3/3/2020,0,2,2,3,5,0,2,0,0,0,0,2,--,--,0,0,,,,,,6/12/2020
3/4/2020,0,2,4,7,9,1,3,0,0,0,0,3,--,--,0,0,,,,,,6/12/2020
3/5/2020,1,3,5,12,15,0,3,0,0,0,0,3,--,--,0,0,,,,,,6/12/2020
3/6/2020,0,3,12,24,27,0,3,0,0,0,0,3,--,--,0,0,,,,,,6/12/2020
3/7/2020,0,3,13,37,40,0,3,0,0,0,0,3,--,--,0,0,,,,,,6/12/2020
3/8/2020,0,3,22,59,62,0,3,0,0,0,0,3,--,--,0,0,,,,,,6/12/2020
3/9/2020,1,4,12,71,75,0,3,0,0,0,0,3,--,--,0,0,,,,,,6/12/2020
3/10/2020,1,5,18,89,94,0,3,0,0,0,0,3,--,--,0,0,,,,,,6/12/2020
3/11/2020,0,5,31,120,125,1,4,0,0,0,0,4,--,--,0,0,,,,,,6/12/2020
3/12/2020,8,13,42,162,175,1,5,0,0,0,0,5,--,--,0,0,,,,,,6/12/2020
3/13/2020,6,19,49,211,230,4,9,1,1,0,0,8,--,--,0,0,,,,,,6/12/2020
3/14/2020,0,19,86,297,316,0,9,0,1,0,0,8,--,--,0,0,,,,,,6/12/2020
3/15/2020,1,20,127,424,444,1,10,0,1,0,0,9,--,--,0,0,,,,,,6/12/2020
3/16/2020,2,22,67,491,513,2,12,0,1,0,0,11,--,--,0,0,,,,,,6/12/2020
3/17/2020,12,34,126,617,651,6,18,0,1,0,0,17,--,--,0,0,,,,,,6/12/2020
3/18/2020,11,45,130,747,792,3,21,0,1,0,0,20,--,--,0,0,,,,,,6/12/2020
3/19/2020,16,61,248,995,1056,2,23,1,2,0,0,21,--,--,1,1,,,,,,6/12/2020
3/20/2020,13,74,191,1186,1260,5,28,0,2,0,0,26,--,--,0,1,,,,,,6/12/2020
3/21/2020,14,88,190,1376,1464,3,31,2,4,0,0,27,--,--,0,1,,,,,,6/12/2020
3/22/2020,25,113,68,1444,1557,2,33,0,4,0,0,29,--,--,0,1,,,,,,6/12/2020
3/23/2020,16,129,166,1610,1739,16,49,1,5,0,0,44,--,--,0,1,,,,,,6/12/2020
3/24/2020,19,148,166,1776,1924,7,56,0,5,0,0,51,--,--,0,1,,,,,,6/12/2020
3/25/2020,28,176,239,2015,2191,5,61,1,6,0,0,55,--,--,0,1,,,,,,6/12/2020
3/26/2020,41,217,268,2283,2500,10,71,5,11,0,0,60,--,--,0,1,,,,,,6/12/2020
3/27/2020,31,248,258,2541,2789,9,80,1,12,1,1,67,--,--,2,3,,,,,,6/12/2020
3/28/2020,64,312,299,2840,3152,13,93,3,15,2,3,75,--,--,1,4,,,,,,6/12/2020
3/29/2020,105,417,347,3187,3604,8,101,4,19,1,4,78,--,--,2,6,,,,,,6/12/2020
3/30/2020,78,495,289,3476,3971,20,121,5,24,0,4,93,--,--,3,9,,,,,,6/12/2020
3/31/2020,73,568,355,3831,4399,11,132,7,31,1,5,96,--,--,2,11,,,,,,6/12/2020
4/1/2020,101,669,581,4412,5081,18,150,7,38,0,5,107,--,--,1,12,,,,,,6/12/2020
4/2/2020,63,732,445,4857,5589,21,171,6,44,2,7,120,--,--,4,16,,,,,,6/12/2020
4/3/2020,100,832,727,5584,6416,23,194,7,51,0,7,136,--,--,3,19,,,,,,6/12/2020
4/4/2020,138,970,677,6261,7231,21,215,4,55,5,12,148,--,--,9,28,,,,,,6/12/2020
4/5/2020,183,1153,1140,7401,8554,20,235,9,64,1,13,158,45,37,2,30,,,,,,6/12/2020
4/6/2020,207,1360,1664,9065,10425,26,261,7,71,0,13,177,45,38,7,37,,,,,,6/12/2020
4/7/2020,261,1621,1619,10684,12305,20,281,3,74,2,15,192,45,35,5,42,,,,,,6/12/2020
4/8/2020,274,1895,1599,12283,14178,19,300,8,82,6,21,197,50,36,9,51,,,,,,6/12/2020
4/9/2020,278,2173,1526,13809,15982,32,332,9,91,4,25,216,50,38,7,58,,,,,,6/12/2020
4/10/2020,405,2578,2441,16250,18828,29,361,17,108,5,30,223,48,36,10,68,,,,,,6/12/2020
4/11/2020,279,2857,1827,18077,20934,29,390,11,119,2,32,239,49,40,11,79,,,,,,6/12/2020
4/12/2020,288,3145,1572,19649,22794,35,425,13,132,5,37,256,54,44,10,89,,,,,,6/12/2020
4/13/2020,186,3331,1026,20675,24006,35,460,13,145,3,40,275,61,43,9,98,,,,,,6/12/2020
4/14/2020,267,3598,1784,22459,26057,27,487,16,161,5,45,281,62,43,8,106,,,,,,6/12/2020
4/15/2020,307,3905,1767,24226,28131,31,518,19,180,3,48,290,67,43,17,123,,,,,,6/12/2020
4/16/2020,392,4297,2358,26584,30881,37,555,25,205,6,54,296,70,43,13,136,,,,,,6/12/2020
4/17/2020,290,4587,1751,28335,32922,31,586,21,226,7,61,299,62,45,21,157,,,,,,6/12/2020
4/18/2020,284,4871,1658,29993,34864,26,612,18,244,4,65,303,67,43,14,171,,,,,,6/12/2020
4/19/2020,339,5210,1997,31990,37200,24,636,26,270,1,66,300,71,44,11,182,,,,,,6/12/2020
4/20/2020,381,5591,1843,33833,39424,46,682,29,299,2,68,315,72,45,10,192,,,,,,6/12/2020
4/21/2020,388,5979,2048,35881,41860,45,727,31,330,5,73,324,77,48,16,208,,,,,,6/12/2020
4/22/2020,383,6362,2282,38163,44525,41,768,32,362,5,78,328,77,52,14,222,,,,,,6/12/2020
4/23/2020,422,6784,2395,40558,47342,31,799,28,390,5,83,326,78,53,13,235,,,,,,6/12/2020
4/24/2020,416,7200,3204,43762,50962,35,834,27,417,4,87,330,81,56,12,247,,,,,,6/12/2020
4/25/2020,306,7506,2202,45964,53470,34,868,17,434,5,92,342,84,55,13,260,,,,,,6/12/2020
4/26/2020,276,7782,2213,48177,55959,33,901,15,449,3,95,357,80,55,12,272,,,,,,6/12/2020
4/27/2020,204,7986,1590,49767,57753,29,930,21,470,4,99,361,98,62,9,281,,,,,,6/12/2020
4/28/2020,328,8314,2151,51918,60232,43,973,24,494,3,102,377,76,51,21,302,,,,,,6/12/2020
4/29/2020,373,8687,3171,55089,63776,35,1008,38,532,11,113,363,80,54,18,320,,,,,,6/12/2020
4/30/2020,350,9037,2597,57686,66723,33,1041,38,570,6,119,352,83,59,22,342,,,,,,6/12/2020
5/1/2020,315,9352,3073,60759,70111,51,1092,40,610,3,122,360,84,61,11,353,,,,,,6/12/2020
5/2/2020,189,9541,1915,62674,72215,36,1128,38,648,5,127,353,89,62,24,377,,,,,,6/12/2020
5/3/2020,182,9723,2153,64827,74550,31,1159,27,675,8,135,349,86,60,17,394,,,,,,6/12/2020
5/4/2020,291,10014,2079,66906,76920,30,1189,31,706,5,140,343,82,56,17,411,,,,,,6/12/2020
5/5/2020,303,10317,2851,69757,80074,28,1217,32,738,6,146,333,71,52,16,427,,,,,,6/12/2020
5/6/2020,343,10660,2827,72584,83244,28,1245,44,782,9,155,308,77,56,19,446,,,,,,6/12/2020
5/7/2020,271,10931,2886,75470,86401,35,1280,42,824,5,160,296,70,52,18,464,,,,,,6/12/2020
5/8/2020,234,11165,2482,77952,89117,29,1309,29,853,4,164,292,73,52,19,483,,,,,,6/12/2020
5/9/2020,288,11453,3280,81232,92685,22,1331,21,874,4,168,289,72,53,13,496,,,,,,6/12/2020
5/10/2020,188,11641,2077,83309,94950,20,1351,23,897,6,174,280,68,48,13,509,,,,,,6/12/2020
5/11/2020,174,11815,1791,85100,96915,31,1382,16,913,5,179,290,65,42,13,522,,,,,,6/12/2020
5/12/2020,220,12035,2421,87521,99556,23,1405,18,931,4,183,291,63,41,21,543,,,,,,6/12/2020
5/13/2020,198,12233,3509,91030,103263,22,1427,24,955,1,184,288,66,44,12,555,,,,,,6/12/2020
5/14/2020,218,12451,3269,94299,106750,19,1446,27,982,3,187,277,64,45,14,569,,,,,,6/12/2020
5/15/2020,226,12677,3432,97731,110408,24,1470,41,1023,5,192,255,62,46,13,582,,,,,,6/12/2020
5/16/2020,251,12928,4001,101732,114660,25,1495,13,1036,5,197,262,59,44,12,594,,,,,,6/12/2020
5/17/2020,127,13055,2779,104511,117566,17,1512,7,1043,5,202,267,58,45,10,604,,,,,,6/12/2020
5/18/2020,138,13193,1890,106401,119594,19,1531,15,1058,5,207,266,56,41,18,622,,,,,,6/12/2020
5/19/2020,215,13408,3082,109483,122891,22,1553,31,1089,5,212,252,56,40,10,632,,,,,,6/12/2020
5/20/2020,190,13598,2734,112217,125815,19,1572,23,1112,7,219,241,51,34,21,653,,,,,,6/12/2020
5/21/2020,169,13767,3795,116012,129779,26,1598,15,1127,3,222,249,49,32,19,672,,,,,,6/12/2020
5/22/2020,200,13967,2942,118954,132921,19,1617,29,1156,5,227,234,--,--,7,679,,,,,,6/12/2020
5/23/2020,107,14074,2703,121657,135731,19,1636,11,1167,3,230,239,50,36,12,691,,,,,,6/12/2020
5/24/2020,87,14161,1333,122990,137151,12,1648,14,1181,2,232,235,49,35,8,699,,,,,,6/12/2020
5/25/2020,68,14229,1330,124320,138549,12,1660,13,1194,0,232,234,53,36,8,707,,,,,,6/12/2020
5/26/2020,156,14385,2489,126809,141194,23,1683,22,1216,5,237,230,47,33,15,722,,,,,,6/12/2020
5/27/2020,135,14520,2090,128899,143419,20,1703,17,1233,3,240,230,50,32,9,731,,,,,,6/12/2020
5/28/2020,132,14652,3232,132131,146783,16,1719,29,1262,4,244,213,46,29,7,738,,,,,,6/12/2020
5/29/2020,177,14829,3859,135990,150819,18,1737,27,1289,5,249,199,46,29,11,749,,,,,,6/12/2020
5/30/2020,104,14933,4104,140094,155027,15,1752,19,1308,4,253,191,48,31,10,759,,,,,,6/12/2020
5/31/2020,75,15008,2273,142367,157375,10,1762,9,1317,0,253,192,44,30,3,762,,,,,,6/12/2020
6/1/2020,99,15107,2663,145030,160137,8,1770,12,1329,1,254,187,42,29,3,765,,,,,,6/12/2020
6/2/2020,111,15218,2974,148004,163222,8,1778,9,1338,3,257,183,37,23,10,775,,,,,,6/12/2020
6/3/2020,101,15319,3366,151370,166689,13,1791,18,1356,6,263,172,--,--,10,785,,,,,,6/12/2020
6/4/2020,114,15433,4456,155826,171259,6,1797,25,1381,3,266,150,--,--,10,795,,,,,,6/12/2020
6/5/2020,103,15536,3794,159620,175156,13,1810,12,1393,5,271,146,28,20,6,801,,,,,,6/12/2020
6/6/2020,66,15602,2569,162189,177791,8,1818,7,1400,2,273,145,31,19,4,805,,,,,,6/12/2020
6/7/2020,49,15651,1539,163728,179379,10,1828,6,1406,1,274,148,27,16,4,809,,,,,,6/12/2020
6/8/2020,39,15690,1665,165393,181083,,,,,,,,,,3,812,,,,,,6/12/2020
6/9/2020,66,15756,2473,167866,183622,,,,,,,,,,0,812,,,,,,6/12/2020
2/27/2020,0,0,0,0,0,1,1,0,0,0,0,1,--,--,0,0,,,,,,6/14/2020
2/28/2020,0,0,0,0,0,0,1,0,0,0,0,1,--,--,0,0,,,,,,6/14/2020
2/29/2020,0,0,0,0,0,0,1,0,0,0,0,1,--,--,0,0,,,,,,6/14/2020
3/1/2020,2,2,0,0,2,0,1,0,0,0,0,1,--,--,0,0,,,,,,6/14/2020
3/2/2020,0,2,1,1,3,1,2,0,0,0,0,2,--,--,0,0,,,,,,6/14/2020
3/3/2020,0,2,2,3,5,0,2,0,0,0,0,2,--,--,0,0,,,,,,6/14/2020
3/4/2020,0,2,4,7,9,1,3,0,0,0,0,3,--,--,0,0,,,,,,6/14/2020
3/5/2020,1,3,5,12,15,0,3,0,0,0,0,3,--,--,0,0,,,,,,6/14/2020
3/6/2020,0,3,12,24,27,0,3,0,0,0,0,3,--,--,0,0,,,,,,6/14/2020
3/7/2020,0,3,13,37,40,0,3,0,0,0,0,3,--,--,0,0,,,,,,6/14/2020
3/8/2020,0,3,22,59,62,0,3,0,0,0,0,3,--,--,0,0,,,,,,6/14/2020
3/9/2020,1,4,12,71,75,0,3,0,0,0,0,3,--,--,0,0,,,,,,6/14/2020
3/10/2020,1,5,18,89,94,0,3,0,0,0,0,3,--,--,0,0,,,,,,6/14/2020
3/11/2020,0,5,31,120,125,1,4,0,0,0,0,4,--,--,0,0,,,,,,6/14/2020
3/12/2020,8,13,42,162,175,1,5,0,0,0,0,5,--,--,0,0,,,,,,6/14/2020
3/13/2020,6,19,49,211,230,4,9,1,1,0,0,8,--,--,0,0,,,,,,6/14/2020
3/14/2020,0,19,86,297,316,0,9,0,1,0,0,8,--,--,0,0,,,,,,6/14/2020
3/15/2020,1,20,127,424,444,1,10,0,1,0,0,9,--,--,0,0,,,,,,6/14/2020
3/16/2020,2,22,67,491,513,2,12,0,1,0,0,11,--,--,0,0,,,,,,6/14/2020
3/17/2020,12,34,126,617,651,6,18,0,1,0,0,17,--,--,0,0,,,,,,6/14/2020
3/18/2020,11,45,130,747,792,3,21,0,1,0,0,20,--,--,0,0,,,,,,6/14/2020
3/19/2020,16,61,248,995,1056,2,23,1,2,0,0,21,--,--,1,1,,,,,,6/14/2020
3/20/2020,13,74,191,1186,1260,5,28,0,2,0,0,26,--,--,0,1,,,,,,6/14/2020
3/21/2020,14,88,190,1376,1464,3,31,2,4,0,0,27,--,--,0,1,,,,,,6/14/2020
3/22/2020,25,113,68,1444,1557,2,33,0,4,0,0,29,--,--,0,1,,,,,,6/14/2020
3/23/2020,16,129,166,1610,1739,16,49,1,5,0,0,44,--,--,0,1,,,,,,6/14/2020
3/24/2020,19,148,166,1776,1924,7,56,0,5,0,0,51,--,--,0,1,,,,,,6/14/2020
3/25/2020,28,176,239,2015,2191,5,61,1,6,0,0,55,--,--,0,1,,,,,,6/14/2020
3/26/2020,41,217,268,2283,2500,10,71,5,11,0,0,60,--,--,0,1,,,,,,6/14/2020
3/27/2020,31,248,258,2541,2789,9,80,1,12,1,1,67,--,--,2,3,,,,,,6/14/2020
3/28/2020,64,312,299,2840,3152,13,93,3,15,2,3,75,--,--,1,4,,,,,,6/14/2020
3/29/2020,105,417,347,3187,3604,8,101,4,19,1,4,78,--,--,2,6,,,,,,6/14/2020
3/30/2020,78,495,289,3476,3971,20,121,5,24,0,4,93,--,--,3,9,,,,,,6/14/2020
3/31/2020,73,568,355,3831,4399,11,132,7,31,1,5,96,--,--,2,11,,,,,,6/14/2020
4/1/2020,101,669,581,4412,5081,18,150,7,38,0,5,107,--,--,1,12,,,,,,6/14/2020
4/2/2020,63,732,445,4857,5589,21,171,6,44,2,7,120,--,--,4,16,,,,,,6/14/2020
4/3/2020,100,832,727,5584,6416,23,194,7,51,0,7,136,--,--,3,19,,,,,,6/14/2020
4/4/2020,138,970,677,6261,7231,21,215,4,55,5,12,148,--,--,9,28,,,,,,6/14/2020
4/5/2020,183,1153,1140,7401,8554,20,235,9,64,1,13,158,45,37,2,30,,,,,,6/14/2020
4/6/2020,207,1360,1664,9065,10425,26,261,7,71,0,13,177,45,38,7,37,,,,,,6/14/2020
4/7/2020,261,1621,1619,10684,12305,20,281,3,74,2,15,192,45,35,5,42,,,,,,6/14/2020
4/8/2020,274,1895,1599,12283,14178,19,300,8,82,6,21,197,50,36,9,51,,,,,,6/14/2020
4/9/2020,279,2174,1526,13809,15983,32,332,9,91,4,25,216,50,38,7,58,,,,,,6/14/2020
4/10/2020,405,2579,2441,16250,18829,29,361,17,108,5,30,223,48,36,11,69,,,,,,6/14/2020
4/11/2020,279,2858,1827,18077,20935,29,390,11,119,2,32,239,49,40,11,80,,,,,,6/14/2020
4/12/2020,287,3145,1572,19649,22794,35,425,13,132,5,37,256,54,44,10,90,,,,,,6/14/2020
4/13/2020,186,3331,1026,20675,24006,35,460,13,145,3,40,275,61,43,9,99,,,,,,6/14/2020
4/14/2020,268,3599,1784,22459,26058,27,487,16,161,5,45,281,62,43,8,107,,,,,,6/14/2020
4/15/2020,307,3906,1767,24226,28132,31,518,19,180,3,48,290,67,43,17,124,,,,,,6/14/2020
4/16/2020,392,4298,2358,26584,30882,37,555,25,205,6,54,296,70,43,14,138,,,,,,6/14/2020
4/17/2020,290,4588,1751,28335,32923,31,586,21,226,7,61,299,62,45,21,159,,,,,,6/14/2020
4/18/2020,284,4872,1658,29993,34865,26,612,18,244,4,65,303,67,43,15,174,,,,,,6/14/2020
4/19/2020,340,5212,1997,31990,37202,24,636,26,270,1,66,300,71,44,11,185,,,,,,6/14/2020
4/20/2020,381,5593,1843,33833,39426,46,682,29,299,2,68,315,72,45,10,195,,,,,,6/14/2020
4/21/2020,388,5981,2048,35881,41862,45,727,31,330,5,73,324,77,48,18,213,,,,,,6/14/2020
4/22/2020,383,6364,2282,38163,44527,41,768,32,362,5,78,328,77,52,16,229,,,,,,6/14/2020
4/23/2020,421,6785,2395,40558,47343,31,799,28,390,5,83,326,78,53,14,243,,,,,,6/14/2020
4/24/2020,416,7201,3204,43762,50963,35,834,27,417,4,87,330,81,56,15,258,,,,,,6/14/2020
4/25/2020,306,7507,2202,45964,53471,34,868,17,434,5,92,342,84,55,14,272,,,,,,6/14/2020
4/26/2020,276,7783,2213,48177,55960,33,901,15,449,3,95,357,80,55,12,284,,,,,,6/14/2020
4/27/2020,204,7987,1590,49767,57754,29,930,21,470,4,99,361,98,62,9,293,,,,,,6/14/2020
4/28/2020,329,8316,2151,51918,60234,43,973,24,494,3,102,377,76,51,21,314,,,,,,6/14/2020
4/29/2020,373,8689,3171,55089,63778,35,1008,38,532,11,113,363,80,54,18,332,,,,,,6/14/2020
4/30/2020,350,9039,2597,57686,66725,33,1041,38,570,6,119,352,83,59,22,354,,,,,,6/14/2020
5/1/2020,316,9355,3098,60784,70139,51,1092,39,609,3,122,361,84,61,12,366,,,,,,6/14/2020
5/2/2020,189,9544,1934,62718,72262,36,1128,39,648,5,127,353,89,62,24,390,,,,,,6/14/2020
5/3/2020,182,9726,2172,64890,74616,31,1159,27,675,8,135,349,86,60,17,407,,,,,,6/14/2020
5/4/2020,291,10017,2106,66996,77013,30,1189,31,706,5,140,343,82,56,17,424,,,,,,6/14/2020
5/5/2020,303,10320,2885,69881,80201,28,1217,32,738,6,146,333,71,52,16,440,,,,,,6/14/2020
5/6/2020,342,10662,2848,72729,83391,28,1245,44,782,9,155,308,77,56,19,459,,,,,,6/14/2020
5/7/2020,271,10933,2909,75638,86571,36,1281,42,824,5,160,297,70,52,18,477,,,,,,6/14/2020
5/8/2020,231,11164,2501,78139,89303,29,1310,29,853,4,164,293,73,52,19,496,,,,,,6/14/2020
5/9/2020,288,11452,3292,81431,92883,22,1332,21,874,4,168,290,72,53,13,509,,,,,,6/14/2020
5/10/2020,188,11640,2094,83525,95165,20,1352,23,897,6,174,281,68,48,13,522,,,,,,6/14/2020
5/11/2020,173,11813,1810,85335,97148,31,1383,16,913,6,180,290,65,42,13,535,,,,,,6/14/2020
5/12/2020,219,12032,2449,87784,99816,23,1406,18,931,4,184,291,63,41,21,556,,,,,,6/14/2020
5/13/2020,194,12226,3528,91312,103538,22,1428,24,955,1,185,288,66,44,12,568,,,,,,6/14/2020
5/14/2020,218,12444,3306,94618,107062,19,1447,27,982,3,188,277,64,45,14,582,,,,,,6/14/2020
5/15/2020,227,12671,3462,98080,110751,24,1471,41,1023,5,193,255,62,46,13,595,,,,,,6/14/2020
5/16/2020,251,12922,4024,102104,115026,25,1496,13,1036,5,198,262,59,44,12,607,,,,,,6/14/2020
5/17/2020,127,13049,2790,104894,117943,17,1513,7,1043,5,203,267,58,45,10,617,,,,,,6/14/2020
5/18/2020,139,13188,1921,106815,120003,19,1532,15,1058,5,208,266,56,41,18,635,,,,,,6/14/2020
5/19/2020,211,13399,3116,109931,123330,23,1555,31,1089,5,213,253,56,40,10,645,,,,,,6/14/2020
5/20/2020,187,13586,2789,112720,126306,19,1574,23,1112,7,220,242,51,34,21,666,,,,,,6/14/2020
5/21/2020,170,13756,3830,116550,130306,26,1600,15,1127,3,223,250,49,32,19,685,,,,,,6/14/2020
5/22/2020,201,13957,2984,119534,133491,19,1619,29,1156,5,228,235,--,--,7,692,,,,,,6/14/2020
5/23/2020,109,14066,2734,122268,136334,19,1638,11,1167,3,231,240,50,36,12,704,,,,,,6/14/2020
5/24/2020,84,14150,1359,123627,137777,12,1650,14,1181,2,233,236,49,35,8,712,,,,,,6/14/2020
5/25/2020,69,14219,1366,124993,139212,12,1662,14,1195,0,233,234,53,36,8,720,,,,,,6/14/2020
5/26/2020,151,14370,2562,127555,141925,23,1685,22,1217,5,238,230,47,33,15,735,,,,,,6/14/2020
5/27/2020,135,14505,2065,129620,144125,20,1705,17,1234,3,241,230,50,32,9,744,,,,,,6/14/2020
5/28/2020,133,14638,3289,132909,147547,16,1721,29,1263,4,245,213,46,29,7,751,,,,,,6/14/2020
5/29/2020,175,14813,3902,136811,151624,18,1739,27,1290,5,250,199,46,29,11,762,,,,,,6/14/2020
5/30/2020,104,14917,4134,140945,155862,15,1754,19,1309,4,254,191,48,31,10,772,,,,,,6/14/2020
5/31/2020,76,14993,2306,143251,158244,10,1764,9,1318,0,254,192,44,30,3,775,,,,,,6/14/2020
6/1/2020,100,15093,2722,145973,161066,8,1772,12,1330,1,255,187,42,29,3,778,,,,,,6/14/2020
6/2/2020,114,15207,3022,148995,164202,8,1780,9,1339,3,258,183,37,23,10,788,,,,,,6/14/2020
6/3/2020,104,15311,3407,152402,167713,12,1792,18,1357,6,264,171,--,--,10,798,,,,,,6/14/2020
6/4/2020,115,15426,4505,156907,172333,6,1798,25,1382,3,267,149,--,--,10,808,,,,,,6/14/2020
6/5/2020,106,15532,3841,160748,176280,13,1811,12,1394,5,272,145,28,20,7,815,,,,,,6/14/2020
6/6/2020,68,15600,2602,163350,178950,9,1820,7,1401,2,274,145,31,19,4,819,,,,,,6/14/2020
6/7/2020,48,15648,1567,164917,180565,10,1830,6,1407,1,275,148,27,16,4,823,,,,,,6/14/2020
6/8/2020,43,15691,1720,166637,182328,14,1844,12,1419,2,277,148,26,16,3,826,,,,,,6/14/2020
6/9/2020,70,15761,2506,169143,184904,9,1853,16,1435,0,277,141,28,17,1,827,,,,,,6/14/2020
6/10/2020,102,15863,2873,172016,187879,,,,,,,,,,3,830,,,,,,6/14/2020
6/11/2020,84,15947,3555,175571,191518,,,,,,,,,,3,833,,,,,,6/14/2020
2/27/2020,0,0,0,0,0,1,1,0,0,0,0,1,--,--,0,0,,,,,,6/15/2020
2/28/2020,0,0,0,0,0,0,1,0,0,0,0,1,--,--,0,0,,,,,,6/15/2020
2/29/2020,0,0,0,0,0,0,1,0,0,0,0,1,--,--,0,0,,,,,,6/15/2020
3/1/2020,2,2,0,0,2,0,1,0,0,0,0,1,--,--,0,0,,,,,,6/15/2020
3/2/2020,0,2,1,1,3,1,2,0,0,0,0,2,--,--,0,0,,,,,,6/15/2020
3/3/2020,0,2,2,3,5,0,2,0,0,0,0,2,--,--,0,0,,,,,,6/15/2020
3/4/2020,0,2,4,7,9,1,3,0,0,0,0,3,--,--,0,0,,,,,,6/15/2020
3/5/2020,1,3,5,12,15,0,3,0,0,0,0,3,--,--,0,0,,,,,,6/15/2020
3/6/2020,0,3,12,24,27,0,3,0,0,0,0,3,--,--,0,0,,,,,,6/15/2020
3/7/2020,0,3,13,37,40,0,3,0,0,0,0,3,--,--,0,0,,,,,,6/15/2020
3/8/2020,0,3,22,59,62,0,3,0,0,0,0,3,--,--,0,0,,,,,,6/15/2020
3/9/2020,1,4,12,71,75,0,3,0,0,0,0,3,--,--,0,0,,,,,,6/15/2020
3/10/2020,1,5,18,89,94,0,3,0,0,0,0,3,--,--,0,0,,,,,,6/15/2020
3/11/2020,0,5,31,120,125,1,4,0,0,0,0,4,--,--,0,0,,,,,,6/15/2020
3/12/2020,8,13,42,162,175,1,5,0,0,0,0,5,--,--,0,0,,,,,,6/15/2020
3/13/2020,6,19,49,211,230,4,9,1,1,0,0,8,--,--,0,0,,,,,,6/15/2020
3/14/2020,0,19,86,297,316,0,9,0,1,0,0,8,--,--,0,0,,,,,,6/15/2020
3/15/2020,1,20,127,424,444,1,10,0,1,0,0,9,--,--,0,0,,,,,,6/15/2020
3/16/2020,2,22,67,491,513,2,12,0,1,0,0,11,--,--,0,0,,,,,,6/15/2020
3/17/2020,12,34,126,617,651,6,18,0,1,0,0,17,--,--,0,0,,,,,,6/15/2020
3/18/2020,11,45,130,747,792,3,21,0,1,0,0,20,--,--,0,0,,,,,,6/15/2020
3/19/2020,16,61,248,995,1056,2,23,1,2,0,0,21,--,--,1,1,,,,,,6/15/2020
3/20/2020,13,74,191,1186,1260,5,28,0,2,0,0,26,--,--,0,1,,,,,,6/15/2020
3/21/2020,14,88,190,1376,1464,3,31,2,4,0,0,27,--,--,0,1,,,,,,6/15/2020
3/22/2020,25,113,68,1444,1557,2,33,0,4,0,0,29,--,--,0,1,,,,,,6/15/2020
3/23/2020,16,129,166,1610,1739,16,49,1,5,0,0,44,--,--,0,1,,,,,,6/15/2020
3/24/2020,19,148,166,1776,1924,7,56,0,5,0,0,51,--,--,0,1,,,,,,6/15/2020
3/25/2020,28,176,239,2015,2191,5,61,1,6,0,0,55,--,--,0,1,,,,,,6/15/2020
3/26/2020,41,217,268,2283,2500,10,71,5,11,0,0,60,--,--,0,1,,,,,,6/15/2020
3/27/2020,31,248,258,2541,2789,9,80,1,12,1,1,67,--,--,2,3,,,,,,6/15/2020
3/28/2020,64,312,299,2840,3152,13,93,3,15,2,3,75,--,--,1,4,,,,,,6/15/2020
3/29/2020,105,417,347,3187,3604,8,101,4,19,1,4,78,--,--,2,6,,,,,,6/15/2020
3/30/2020,78,495,289,3476,3971,20,121,5,24,0,4,93,--,--,3,9,,,,,,6/15/2020
3/31/2020,73,568,355,3831,4399,11,132,7,31,1,5,96,--,--,2,11,,,,,,6/15/2020
4/1/2020,101,669,581,4412,5081,18,150,7,38,0,5,107,--,--,1,12,,,,,,6/15/2020
4/2/2020,63,732,445,4857,5589,21,171,6,44,2,7,120,--,--,4,16,,,,,,6/15/2020
4/3/2020,100,832,727,5584,6416,23,194,7,51,0,7,136,--,--,3,19,,,,,,6/15/2020
4/4/2020,138,970,677,6261,7231,21,215,4,55,5,12,148,--,--,9,28,,,,,,6/15/2020
4/5/2020,183,1153,1140,7401,8554,20,235,9,64,1,13,158,45,37,2,30,,,,,,6/15/2020
4/6/2020,207,1360,1664,9065,10425,26,261,7,71,0,13,177,45,38,7,37,,,,,,6/15/2020
4/7/2020,261,1621,1619,10684,12305,20,281,3,74,2,15,192,45,35,5,42,,,,,,6/15/2020
4/8/2020,274,1895,1599,12283,14178,19,300,8,82,6,21,197,50,36,9,51,,,,,,6/15/2020
4/9/2020,279,2174,1526,13809,15983,32,332,9,91,4,25,216,50,38,7,58,,,,,,6/15/2020
4/10/2020,405,2579,2441,16250,18829,29,361,17,108,5,30,223,48,36,11,69,,,,,,6/15/2020
4/11/2020,279,2858,1827,18077,20935,29,390,11,119,2,32,239,49,40,11,80,,,,,,6/15/2020
4/12/2020,287,3145,1572,19649,22794,35,425,13,132,5,37,256,54,44,10,90,,,,,,6/15/2020
4/13/2020,186,3331,1026,20675,24006,35,460,13,145,3,40,275,61,43,9,99,,,,,,6/15/2020
4/14/2020,268,3599,1784,22459,26058,27,487,16,161,5,45,281,62,43,8,107,,,,,,6/15/2020
4/15/2020,307,3906,1767,24226,28132,31,518,19,180,3,48,290,67,43,17,124,,,,,,6/15/2020
4/16/2020,392,4298,2358,26584,30882,37,555,25,205,6,54,296,70,43,14,138,,,,,,6/15/2020
4/17/2020,290,4588,1751,28335,32923,31,586,21,226,7,61,299,62,45,21,159,,,,,,6/15/2020
4/18/2020,284,4872,1658,29993,34865,26,612,18,244,4,65,303,67,43,15,174,,,,,,6/15/2020
4/19/2020,340,5212,1997,31990,37202,24,636,26,270,1,66,300,71,44,11,185,,,,,,6/15/2020
4/20/2020,380,5592,1843,33833,39425,46,682,29,299,2,68,315,72,45,10,195,,,,,,6/15/2020
4/21/2020,388,5980,2048,35881,41861,45,727,31,330,5,73,324,77,48,18,213,,,,,,6/15/2020
4/22/2020,383,6363,2282,38163,44526,41,768,32,362,5,78,328,77,52,16,229,,,,,,6/15/2020
4/23/2020,420,6783,2395,40558,47341,31,799,28,390,5,83,326,78,53,14,243,,,,,,6/15/2020
4/24/2020,416,7199,3204,43762,50961,35,834,27,417,4,87,330,81,56,15,258,,,,,,6/15/2020
4/25/2020,306,7505,2202,45964,53469,34,868,17,434,5,92,342,84,55,14,272,,,,,,6/15/2020
4/26/2020,276,7781,2213,48177,55958,33,901,15,449,3,95,357,80,55,14,286,,,,,,6/15/2020
4/27/2020,204,7985,1590,49767,57752,29,930,21,470,4,99,361,98,62,10,296,,,,,,6/15/2020
4/28/2020,329,8314,2151,51918,60232,43,973,24,494,3,102,377,76,51,22,318,,,,,,6/15/2020
4/29/2020,372,8686,3171,55089,63775,35,1008,38,532,11,113,363,80,54,18,336,,,,,,6/15/2020
4/30/2020,350,9036,2597,57686,66722,33,1041,38,570,6,119,352,83,59,24,360,,,,,,6/15/2020
5/1/2020,316,9352,3098,60784,70136,51,1092,39,609,3,122,361,84,61,14,374,,,,,,6/15/2020
5/2/2020,189,9541,1934,62718,72259,36,1128,39,648,5,127,353,89,62,24,398,,,,,,6/15/2020
5/3/2020,182,9723,2172,64890,74613,31,1159,27,675,8,135,349,86,60,20,418,,,,,,6/15/2020
5/4/2020,291,10014,2106,66996,77010,30,1189,31,706,5,140,343,82,56,18,436,,,,,,6/15/2020
5/5/2020,304,10318,2885,69881,80199,28,1217,32,738,6,146,333,71,52,16,452,,,,,,6/15/2020
5/6/2020,342,10660,2848,72729,83389,28,1245,44,782,9,155,308,77,56,19,471,,,,,,6/15/2020
5/7/2020,271,10931,2909,75638,86569,36,1281,42,824,5,160,297,70,52,18,489,,,,,,6/15/2020
5/8/2020,231,11162,2501,78139,89301,29,1310,29,853,4,164,293,73,52,19,508,,,,,,6/15/2020
5/9/2020,288,11450,3292,81431,92881,22,1332,21,874,4,168,290,72,53,14,522,,,,,,6/15/2020
5/10/2020,188,11638,2094,83525,95163,20,1352,23,897,6,174,281,68,48,13,535,,,,,,6/15/2020
5/11/2020,173,11811,1810,85335,97146,31,1383,16,913,6,180,290,65,42,13,548,,,,,,6/15/2020
5/12/2020,221,12032,2449,87784,99816,23,1406,18,931,4,184,291,63,41,21,569,,,,,,6/15/2020
5/13/2020,194,12226,3528,91312,103538,22,1428,24,955,1,185,288,66,44,12,581,,,,,,6/15/2020
5/14/2020,218,12444,3306,94618,107062,19,1447,27,982,3,188,277,64,45,14,595,,,,,,6/15/2020
5/15/2020,227,12671,3462,98080,110751,24,1471,41,1023,5,193,255,62,46,13,608,,,,,,6/15/2020
5/16/2020,251,12922,4024,102104,115026,25,1496,13,1036,5,198,262,59,44,12,620,,,,,,6/15/2020
5/17/2020,127,13049,2790,104894,117943,17,1513,7,1043,5,203,267,58,45,10,630,,,,,,6/15/2020
5/18/2020,139,13188,1921,106815,120003,19,1532,15,1058,5,208,266,56,41,18,648,,,,,,6/15/2020
5/19/2020,212,13400,3116,109931,123331,23,1555,31,1089,5,213,253,56,40,10,658,,,,,,6/15/2020
5/20/2020,186,13586,2789,112720,126306,19,1574,23,1112,7,220,242,51,34,21,679,,,,,,6/15/2020
5/21/2020,169,13755,3830,116550,130305,26,1600,15,1127,3,223,250,49,32,19,698,,,,,,6/15/2020
5/22/2020,204,13959,2984,119534,133493,19,1619,29,1156,5,228,235,--,--,7,705,,,,,,6/15/2020
5/23/2020,108,14067,2734,122268,136335,19,1638,11,1167,3,231,240,50,36,12,717,,,,,,6/15/2020
5/24/2020,84,14151,1359,123627,137778,12,1650,14,1181,2,233,236,49,35,8,725,,,,,,6/15/2020
5/25/2020,69,14220,1366,124993,139213,12,1662,14,1195,0,233,234,53,36,8,733,,,,,,6/15/2020
5/26/2020,152,14372,2562,127555,141927,23,1685,22,1217,5,238,230,47,33,15,748,,,,,,6/15/2020
5/27/2020,132,14504,2065,129620,144124,20,1705,17,1234,3,241,230,50,32,9,757,,,,,,6/15/2020
5/28/2020,132,14636,3289,132909,147545,17,1722,29,1263,4,245,214,46,29,7,764,,,,,,6/15/2020
5/29/2020,177,14813,3902,136811,151624,18,1740,27,1290,5,250,200,46,29,11,775,,,,,,6/15/2020
5/30/2020,104,14917,4134,140945,155862,15,1755,19,1309,4,254,192,48,31,10,785,,,,,,6/15/2020
5/31/2020,76,14993,2306,143251,158244,10,1765,10,1319,0,254,192,44,30,3,788,,,,,,6/15/2020
6/1/2020,100,15093,2722,145973,161066,8,1773,12,1331,1,255,187,42,29,3,791,,,,,,6/15/2020
6/2/2020,110,15203,3022,148995,164198,8,1781,9,1340,3,258,183,37,23,10,801,,,,,,6/15/2020
6/3/2020,103,15306,3407,152402,167708,12,1793,18,1358,6,264,171,--,--,10,811,,,,,,6/15/2020
6/4/2020,115,15421,4505,156907,172328,7,1800,25,1383,3,267,150,--,--,11,822,,,,,,6/15/2020
6/5/2020,106,15527,3841,160748,176275,13,1813,12,1395,5,272,146,28,20,7,829,,,,,,6/15/2020
6/6/2020,67,15594,2602,163350,178944,9,1822,7,1402,2,274,146,31,19,4,833,,,,,,6/15/2020
6/7/2020,48,15642,1567,164917,180559,11,1833,6,1408,1,275,150,27,16,4,837,,,,,,6/15/2020
6/8/2020,41,15683,1720,166637,182320,14,1847,12,1420,2,277,150,26,16,3,840,,,,,,6/15/2020
6/9/2020,67,15750,2506,169143,184893,9,1856,16,1436,0,277,143,28,17,1,841,,,,,,6/15/2020
6/10/2020,103,15853,2873,172016,187869,12,1868,12,1448,2,279,141,--,--,3,844,,,,,,6/15/2020
6/11/2020,89,15942,3610,175626,191568,6,1874,13,1461,1,280,133,--,--,4,848,,,,,,6/15/2020
6/12/2020,73,16015,4311,179937,195952,8,1882,13,1474,1,281,127,21,14,2,850,,,,,,6/15/2020
6/13/2020,46,16061,2634,182571,198632,,,,,,,,,,1,851,,,,,,6/15/2020
6/14/2020,32,16093,1781,184352,200445,,,,,,,,,,0,851,,,,,,6/15/2020
2/27/2020,0,0,0,0,0,1,1,0,0,0,0,1,--,--,0,0,,,,,,6/16/2020
2/28/2020,0,0,0,0,0,0,1,0,0,0,0,1,--,--,0,0,,,,,,6/16/2020
2/29/2020,0,0,0,0,0,0,1,0,0,0,0,1,--,--,0,0,,,,,,6/16/2020
3/1/2020,2,2,0,0,2,0,1,0,0,0,0,1,--,--,0,0,,,,,,6/16/2020
3/2/2020,0,2,1,1,3,1,2,0,0,0,0,2,--,--,0,0,,,,,,6/16/2020
3/3/2020,0,2,2,3,5,0,2,0,0,0,0,2,--,--,0,0,,,,,,6/16/2020
3/4/2020,0,2,4,7,9,1,3,0,0,0,0,3,--,--,0,0,,,,,,6/16/2020
3/5/2020,1,3,5,12,15,0,3,0,0,0,0,3,--,--,0,0,,,,,,6/16/2020
3/6/2020,0,3,12,24,27,0,3,0,0,0,0,3,--,--,0,0,,,,,,6/16/2020
3/7/2020,0,3,13,37,40,0,3,0,0,0,0,3,--,--,0,0,,,,,,6/16/2020
3/8/2020,0,3,22,59,62,0,3,0,0,0,0,3,--,--,0,0,,,,,,6/16/2020
3/9/2020,1,4,12,71,75,0,3,0,0,0,0,3,--,--,0,0,,,,,,6/16/2020
3/10/2020,1,5,18,89,94,0,3,0,0,0,0,3,--,--,0,0,,,,,,6/16/2020
3/11/2020,0,5,31,120,125,1,4,0,0,0,0,4,--,--,0,0,,,,,,6/16/2020
3/12/2020,8,13,42,162,175,1,5,0,0,0,0,5,--,--,0,0,,,,,,6/16/2020
3/13/2020,6,19,49,211,230,4,9,1,1,0,0,8,--,--,0,0,,,,,,6/16/2020
3/14/2020,0,19,86,297,316,0,9,0,1,0,0,8,--,--,0,0,,,,,,6/16/2020
3/15/2020,1,20,127,424,444,1,10,0,1,0,0,9,--,--,0,0,,,,,,6/16/2020
3/16/2020,2,22,67,491,513,2,12,0,1,0,0,11,--,--,0,0,,,,,,6/16/2020
3/17/2020,12,34,126,617,651,6,18,0,1,0,0,17,--,--,0,0,,,,,,6/16/2020
3/18/2020,11,45,130,747,792,3,21,0,1,0,0,20,--,--,0,0,,,,,,6/16/2020
3/19/2020,16,61,248,995,1056,2,23,1,2,0,0,21,--,--,1,1,,,,,,6/16/2020
3/20/2020,13,74,191,1186,1260,5,28,0,2,0,0,26,--,--,0,1,,,,,,6/16/2020
3/21/2020,14,88,190,1376,1464,3,31,2,4,0,0,27,--,--,0,1,,,,,,6/16/2020
3/22/2020,25,113,68,1444,1557,2,33,0,4,0,0,29,--,--,0,1,,,,,,6/16/2020
3/23/2020,16,129,166,1610,1739,16,49,1,5,0,0,44,--,--,0,1,,,,,,6/16/2020
3/24/2020,19,148,166,1776,1924,7,56,0,5,0,0,51,--,--,0,1,,,,,,6/16/2020
3/25/2020,28,176,239,2015,2191,5,61,1,6,0,0,55,--,--,0,1,,,,,,6/16/2020
3/26/2020,41,217,268,2283,2500,10,71,5,11,0,0,60,--,--,0,1,,,,,,6/16/2020
3/27/2020,31,248,258,2541,2789,9,80,1,12,1,1,67,--,--,2,3,,,,,,6/16/2020
3/28/2020,64,312,299,2840,3152,13,93,3,15,2,3,75,--,--,1,4,,,,,,6/16/2020
3/29/2020,105,417,347,3187,3604,8,101,4,19,1,4,78,--,--,2,6,,,,,,6/16/2020
3/30/2020,78,495,289,3476,3971,20,121,5,24,0,4,93,--,--,3,9,,,,,,6/16/2020
3/31/2020,73,568,355,3831,4399,11,132,7,31,1,5,96,--,--,2,11,,,,,,6/16/2020
4/1/2020,101,669,581,4412,5081,18,150,7,38,0,5,107,--,--,1,12,,,,,,6/16/2020
4/2/2020,63,732,445,4857,5589,21,171,6,44,2,7,120,--,--,4,16,,,,,,6/16/2020
4/3/2020,100,832,727,5584,6416,23,194,7,51,0,7,136,--,--,3,19,,,,,,6/16/2020
4/4/2020,138,970,677,6261,7231,21,215,4,55,5,12,148,--,--,9,28,,,,,,6/16/2020
4/5/2020,183,1153,1140,7401,8554,20,235,9,64,1,13,158,45,37,2,30,,,,,,6/16/2020
4/6/2020,207,1360,1664,9065,10425,26,261,7,71,0,13,177,45,38,7,37,,,,,,6/16/2020
4/7/2020,261,1621,1619,10684,12305,20,281,3,74,2,15,192,45,35,5,42,,,,,,6/16/2020
4/8/2020,274,1895,1599,12283,14178,19,300,8,82,6,21,197,50,36,9,51,,,,,,6/16/2020
4/9/2020,279,2174,1526,13809,15983,32,332,9,91,4,25,216,50,38,7,58,,,,,,6/16/2020
4/10/2020,404,2578,2441,16250,18828,29,361,17,108,5,30,223,48,36,11,69,,,,,,6/16/2020
4/11/2020,279,2857,1827,18077,20934,29,390,11,119,2,32,239,49,40,11,80,,,,,,6/16/2020
4/12/2020,287,3144,1572,19649,22793,35,425,13,132,5,37,256,54,44,10,90,,,,,,6/16/2020
4/13/2020,186,3330,1026,20675,24005,35,460,13,145,3,40,275,61,43,9,99,,,,,,6/16/2020
4/14/2020,268,3598,1784,22459,26057,27,487,16,161,5,45,281,62,43,8,107,,,,,,6/16/2020
4/15/2020,307,3905,1767,24226,28131,31,518,19,180,3,48,290,67,43,17,124,,,,,,6/16/2020
4/16/2020,392,4297,2358,26584,30881,36,554,25,205,6,54,295,70,43,14,138,,,,,,6/16/2020
4/17/2020,290,4587,1751,28335,32922,31,585,21,226,7,61,298,62,45,21,159,,,,,,6/16/2020
4/18/2020,284,4871,1658,29993,34864,26,611,18,244,4,65,302,67,43,15,174,,,,,,6/16/2020
4/19/2020,339,5210,1997,31990,37200,23,634,26,270,1,66,298,71,44,11,185,,,,,,6/16/2020
4/20/2020,380,5590,1843,33833,39423,46,680,29,299,2,68,313,72,45,10,195,,,,,,6/16/2020
4/21/2020,388,5978,2048,35881,41859,45,725,31,330,5,73,322,77,48,18,213,,,,,,6/16/2020
4/22/2020,383,6361,2282,38163,44524,41,766,32,362,5,78,326,77,52,17,230,,,,,,6/16/2020
4/23/2020,419,6780,2395,40558,47338,31,797,28,390,5,83,324,78,53,14,244,,,,,,6/16/2020
4/24/2020,416,7196,3204,43762,50958,35,832,27,417,4,87,328,81,56,15,259,,,,,,6/16/2020
4/25/2020,306,7502,2202,45964,53466,34,866,17,434,5,92,340,84,55,14,273,,,,,,6/16/2020
4/26/2020,276,7778,2213,48177,55955,33,899,15,449,3,95,355,80,55,14,287,,,,,,6/16/2020
4/27/2020,204,7982,1590,49767,57749,29,928,21,470,4,99,359,98,62,10,297,,,,,,6/16/2020
4/28/2020,329,8311,2151,51918,60229,44,972,24,494,3,102,376,76,51,22,319,,,,,,6/16/2020
4/29/2020,372,8683,3171,55089,63772,36,1008,38,532,11,113,363,80,54,18,337,,,,,,6/16/2020
4/30/2020,349,9032,2597,57686,66718,33,1041,38,570,6,119,352,83,59,24,361,,,,,,6/16/2020
5/1/2020,317,9349,3098,60784,70133,51,1092,40,610,3,122,360,84,61,14,375,,,,,,6/16/2020
5/2/2020,189,9538,1934,62718,72256,36,1128,38,648,5,127,353,89,62,24,399,,,,,,6/16/2020
5/3/2020,182,9720,2172,64890,74610,31,1159,27,675,8,135,349,86,60,20,419,,,,,,6/16/2020
5/4/2020,291,10011,2106,66996,77007,30,1189,31,706,5,140,343,82,56,18,437,,,,,,6/16/2020
5/5/2020,304,10315,2885,69881,80196,28,1217,32,738,6,146,333,71,52,16,453,,,,,,6/16/2020
5/6/2020,342,10657,2848,72729,83386,28,1245,44,782,9,155,308,77,56,19,472,,,,,,6/16/2020
5/7/2020,271,10928,2909,75638,86566,36,1281,42,824,5,160,297,70,52,20,492,,,,,,6/16/2020
5/8/2020,231,11159,2501,78139,89298,29,1310,29,853,4,164,293,73,52,20,512,,,,,,6/16/2020
5/9/2020,288,11447,3292,81431,92878,22,1332,21,874,4,168,290,72,53,14,526,,,,,,6/16/2020
5/10/2020,188,11635,2094,83525,95160,20,1352,23,897,6,174,281,68,48,13,539,,,,,,6/16/2020
5/11/2020,173,11808,1810,85335,97143,31,1383,16,913,6,180,290,65,42,13,552,,,,,,6/16/2020
5/12/2020,221,12029,2449,87784,99813,23,1406,18,931,4,184,291,63,41,21,573,,,,,,6/16/2020
5/13/2020,194,12223,3528,91312,103535,22,1428,24,955,1,185,288,66,44,12,585,,,,,,6/16/2020
5/14/2020,219,12442,3306,94618,107060,19,1447,27,982,3,188,277,64,45,14,599,,,,,,6/16/2020
5/15/2020,227,12669,3462,98080,110749,24,1471,41,1023,5,193,255,62,46,13,612,,,,,,6/16/2020
5/16/2020,251,12920,4024,102104,115024,25,1496,13,1036,5,198,262,59,44,12,624,,,,,,6/16/2020
5/17/2020,127,13047,2790,104894,117941,17,1513,7,1043,5,203,267,58,45,10,634,,,,,,6/16/2020
5/18/2020,139,13186,1921,106815,120001,19,1532,15,1058,5,208,266,56,41,18,652,,,,,,6/16/2020
5/19/2020,212,13398,3116,109931,123329,23,1555,31,1089,5,213,253,56,40,10,662,,,,,,6/16/2020
5/20/2020,186,13584,2789,112720,126304,19,1574,23,1112,7,220,242,51,34,21,683,,,,,,6/16/2020
5/21/2020,170,13754,3830,116550,130304,26,1600,15,1127,3,223,250,49,32,19,702,,,,,,6/16/2020
5/22/2020,204,13958,2984,119534,133492,19,1619,29,1156,5,228,235,--,--,7,709,,,,,,6/16/2020
5/23/2020,108,14066,2734,122268,136334,19,1638,11,1167,3,231,240,50,36,12,721,,,,,,6/16/2020
5/24/2020,84,14150,1359,123627,137777,12,1650,14,1181,2,233,236,49,35,8,729,,,,,,6/16/2020
5/25/2020,70,14220,1366,124993,139213,12,1662,14,1195,0,233,234,53,36,8,737,,,,,,6/16/2020
5/26/2020,152,14372,2562,127555,141927,23,1685,22,1217,5,238,230,47,33,15,752,,,,,,6/16/2020
5/27/2020,132,14504,2065,129620,144124,20,1705,17,1234,3,241,230,50,32,9,761,,,,,,6/16/2020
5/28/2020,132,14636,3289,132909,147545,17,1722,29,1263,4,245,214,46,29,7,768,,,,,,6/16/2020
5/29/2020,178,14814,3902,136811,151625,18,1740,27,1290,5,250,200,46,29,11,779,,,,,,6/16/2020
5/30/2020,104,14918,4134,140945,155863,15,1755,19,1309,4,254,192,48,31,10,789,,,,,,6/16/2020
5/31/2020,77,14995,2306,143251,158246,10,1765,10,1319,0,254,192,44,30,3,792,,,,,,6/16/2020
6/1/2020,100,15095,2722,145973,161068,8,1773,12,1331,1,255,187,42,29,4,796,,,,,,6/16/2020
6/2/2020,109,15204,3022,148995,164199,8,1781,9,1340,3,258,183,37,23,10,806,,,,,,6/16/2020
6/3/2020,103,15307,3407,152402,167709,13,1794,18,1358,6,264,172,--,--,10,816,,,,,,6/16/2020
6/4/2020,115,15422,4505,156907,172329,7,1801,25,1383,3,267,151,--,--,11,827,,,,,,6/16/2020
6/5/2020,106,15528,3841,160748,176276,13,1814,12,1395,5,272,147,28,20,9,836,,,,,,6/16/2020
6/6/2020,67,15595,2602,163350,178945,9,1823,7,1402,2,274,147,31,19,6,842,,,,,,6/16/2020
6/7/2020,48,15643,1567,164917,180560,11,1834,6,1408,1,275,151,27,16,4,846,,,,,,6/16/2020
6/8/2020,41,15684,1720,166637,182321,14,1848,12,1420,2,277,151,26,16,3,849,,,,,,6/16/2020
6/9/2020,66,15750,2506,169143,184893,9,1857,16,1436,0,277,144,28,17,1,850,,,,,,6/16/2020
6/10/2020,102,15852,2873,172016,187868,12,1869,12,1448,2,279,142,--,--,3,853,,,,,,6/16/2020
6/11/2020,87,15939,3628,175644,191583,6,1875,13,1461,1,280,134,--,--,4,857,,,,,,6/16/2020
6/12/2020,76,16015,4311,179955,195970,8,1883,14,1475,1,281,127,21,14,2,859,,,,,,6/16/2020
6/13/2020,46,16061,2727,182682,198743,6,1889,4,1479,0,281,129,16,13,2,861,,,,,,6/16/2020
6/14/2020,31,16092,1828,184510,200602,,,,,,,,,,2,863,,,,,,6/16/2020
6/15/2020,72,16164,2944,187454,203618,,,,,,,,,,2,865,,,,,,6/16/2020
2/27/2020,0,0,0,0,0,1,1,0,0,0,0,1,--,--,0,0,,,,,,6/17/2020
2/28/2020,0,0,0,0,0,0,1,0,0,0,0,1,--,--,0,0,,,,,,6/17/2020
2/29/2020,0,0,0,0,0,0,1,0,0,0,0,1,--,--,0,0,,,,,,6/17/2020
3/1/2020,2,2,0,0,2,0,1,0,0,0,0,1,--,--,0,0,,,,,,6/17/2020
3/2/2020,0,2,1,1,3,1,2,0,0,0,0,2,--,--,0,0,,,,,,6/17/2020
3/3/2020,0,2,2,3,5,0,2,0,0,0,0,2,--,--,0,0,,,,,,6/17/2020
3/4/2020,0,2,4,7,9,1,3,0,0,0,0,3,--,--,0,0,,,,,,6/17/2020
3/5/2020,1,3,5,12,15,0,3,0,0,0,0,3,--,--,0,0,,,,,,6/17/2020
3/6/2020,0,3,12,24,27,0,3,0,0,0,0,3,--,--,0,0,,,,,,6/17/2020
3/7/2020,0,3,13,37,40,0,3,0,0,0,0,3,--,--,0,0,,,,,,6/17/2020
3/8/2020,0,3,22,59,62,0,3,0,0,0,0,3,--,--,0,0,,,,,,6/17/2020
3/9/2020,1,4,12,71,75,0,3,0,0,0,0,3,--,--,0,0,,,,,,6/17/2020
3/10/2020,1,5,18,89,94,0,3,0,0,0,0,3,--,--,0,0,,,,,,6/17/2020
3/11/2020,0,5,31,120,125,1,4,0,0,0,0,4,--,--,0,0,,,,,,6/17/2020
3/12/2020,8,13,42,162,175,1,5,0,0,0,0,5,--,--,0,0,,,,,,6/17/2020
3/13/2020,6,19,49,211,230,4,9,1,1,0,0,8,--,--,0,0,,,,,,6/17/2020
3/14/2020,0,19,86,297,316,0,9,0,1,0,0,8,--,--,0,0,,,,,,6/17/2020
3/15/2020,1,20,127,424,444,1,10,0,1,0,0,9,--,--,0,0,,,,,,6/17/2020
3/16/2020,2,22,67,491,513,2,12,0,1,0,0,11,--,--,0,0,,,,,,6/17/2020
3/17/2020,12,34,126,617,651,6,18,0,1,0,0,17,--,--,0,0,,,,,,6/17/2020
3/18/2020,11,45,130,747,792,3,21,0,1,0,0,20,--,--,0,0,,,,,,6/17/2020
3/19/2020,16,61,248,995,1056,2,23,1,2,0,0,21,--,--,1,1,,,,,,6/17/2020
3/20/2020,13,74,191,1186,1260,5,28,0,2,0,0,26,--,--,0,1,,,,,,6/17/2020
3/21/2020,14,88,190,1376,1464,3,31,2,4,0,0,27,--,--,0,1,,,,,,6/17/2020
3/22/2020,25,113,68,1444,1557,2,33,0,4,0,0,29,--,--,0,1,,,,,,6/17/2020
3/23/2020,16,129,166,1610,1739,16,49,1,5,0,0,44,--,--,0,1,,,,,,6/17/2020
3/24/2020,19,148,166,1776,1924,7,56,0,5,0,0,51,--,--,0,1,,,,,,6/17/2020
3/25/2020,28,176,239,2015,2191,5,61,1,6,0,0,55,--,--,0,1,,,,,,6/17/2020
3/26/2020,41,217,268,2283,2500,10,71,5,11,0,0,60,--,--,0,1,,,,,,6/17/2020
3/27/2020,31,248,258,2541,2789,9,80,1,12,1,1,67,--,--,2,3,,,,,,6/17/2020
3/28/2020,64,312,299,2840,3152,13,93,3,15,2,3,75,--,--,1,4,,,,,,6/17/2020
3/29/2020,105,417,347,3187,3604,8,101,4,19,1,4,78,--,--,2,6,,,,,,6/17/2020
3/30/2020,78,495,289,3476,3971,20,121,5,24,0,4,93,--,--,3,9,,,,,,6/17/2020
3/31/2020,73,568,355,3831,4399,11,132,7,31,1,5,96,--,--,2,11,,,,,,6/17/2020
4/1/2020,101,669,581,4412,5081,18,150,7,38,0,5,107,--,--,1,12,,,,,,6/17/2020
4/2/2020,63,732,445,4857,5589,21,171,6,44,2,7,120,--,--,4,16,,,,,,6/17/2020
4/3/2020,100,832,727,5584,6416,23,194,7,51,0,7,136,--,--,3,19,,,,,,6/17/2020
4/4/2020,138,970,677,6261,7231,21,215,4,55,5,12,148,--,--,9,28,,,,,,6/17/2020
4/5/2020,183,1153,1140,7401,8554,20,235,9,64,1,13,158,45,37,2,30,,,,,,6/17/2020
4/6/2020,205,1358,1664,9065,10423,26,261,7,71,0,13,177,45,38,7,37,,,,,,6/17/2020
4/7/2020,261,1619,1619,10684,12303,20,281,3,74,2,15,192,45,35,5,42,,,,,,6/17/2020
4/8/2020,274,1893,1599,12283,14176,19,300,8,82,6,21,197,50,36,9,51,,,,,,6/17/2020
4/9/2020,279,2172,1526,13809,15981,32,332,9,91,4,25,216,50,38,7,58,,,,,,6/17/2020
4/10/2020,404,2576,2441,16250,18826,29,361,17,108,5,30,223,48,36,11,69,,,,,,6/17/2020
4/11/2020,279,2855,1827,18077,20932,29,390,11,119,2,32,239,49,40,11,80,,,,,,6/17/2020
4/12/2020,287,3142,1572,19649,22791,35,425,13,132,5,37,256,54,44,10,90,,,,,,6/17/2020
4/13/2020,186,3328,1026,20675,24003,35,460,13,145,3,40,275,61,43,9,99,,,,,,6/17/2020
4/14/2020,268,3596,1784,22459,26055,27,487,16,161,5,45,281,62,43,8,107,,,,,,6/17/2020
4/15/2020,307,3903,1767,24226,28129,31,518,19,180,3,48,290,67,43,17,124,,,,,,6/17/2020
4/16/2020,392,4295,2358,26584,30879,36,554,25,205,6,54,295,70,43,14,138,,,,,,6/17/2020
4/17/2020,290,4585,1751,28335,32920,31,585,21,226,7,61,298,62,45,21,159,,,,,,6/17/2020
4/18/2020,284,4869,1658,29993,34862,26,611,18,244,4,65,302,67,43,15,174,,,,,,6/17/2020
4/19/2020,339,5208,1997,31990,37198,23,634,26,270,1,66,298,71,44,11,185,,,,,,6/17/2020
4/20/2020,380,5588,1843,33833,39421,46,680,29,299,2,68,313,72,45,10,195,,,,,,6/17/2020
4/21/2020,388,5976,2048,35881,41857,45,725,31,330,5,73,322,77,48,18,213,,,,,,6/17/2020
4/22/2020,383,6359,2282,38163,44522,41,766,32,362,5,78,326,77,52,17,230,,,,,,6/17/2020
4/23/2020,419,6778,2395,40558,47336,31,797,28,390,5,83,324,78,53,14,244,,,,,,6/17/2020
4/24/2020,416,7194,3204,43762,50956,35,832,27,417,4,87,328,81,56,15,259,,,,,,6/17/2020
4/25/2020,305,7499,2202,45964,53463,34,866,17,434,5,92,340,84,55,14,273,,,,,,6/17/2020
4/26/2020,275,7774,2213,48177,55951,33,899,15,449,3,95,355,80,55,14,287,,,,,,6/17/2020
4/27/2020,202,7976,1590,49767,57743,29,928,21,470,4,99,359,98,62,10,297,,,,,,6/17/2020
4/28/2020,325,8301,2151,51918,60219,44,972,24,494,3,102,376,76,51,22,319,,,,,,6/17/2020
4/29/2020,371,8672,3171,55089,63761,36,1008,38,532,11,113,363,80,54,18,337,,,,,,6/17/2020
4/30/2020,349,9021,2597,57686,66707,33,1041,38,570,6,119,352,83,59,24,361,,,,,,6/17/2020
5/1/2020,317,9338,3098,60784,70122,51,1092,40,610,3,122,360,84,61,14,375,,,,,,6/17/2020
5/2/2020,189,9527,1934,62718,72245,36,1128,38,648,5,127,353,89,62,24,399,,,,,,6/17/2020
5/3/2020,182,9709,2172,64890,74599,31,1159,26,674,8,135,350,86,60,20,419,,,,,,6/17/2020
5/4/2020,291,10000,2106,66996,76996,30,1189,31,705,6,141,343,82,56,18,437,,,,,,6/17/2020
5/5/2020,303,10303,2885,69881,80184,28,1217,32,737,6,147,333,71,52,16,453,,,,,,6/17/2020
5/6/2020,343,10646,2848,72729,83375,28,1245,44,781,9,156,308,77,56,19,472,,,,,,6/17/2020
5/7/2020,271,10917,2909,75638,86555,36,1281,42,823,5,161,297,70,52,20,492,,,,,,6/17/2020
5/8/2020,231,11148,2501,78139,89287,29,1310,29,852,4,165,293,73,52,22,514,,,,,,6/17/2020
5/9/2020,288,11436,3292,81431,92867,22,1332,21,873,4,169,290,72,53,14,528,,,,,,6/17/2020
5/10/2020,187,11623,2094,83525,95148,20,1352,23,896,6,175,281,68,48,13,541,,,,,,6/17/2020
5/11/2020,173,11796,1810,85335,97131,31,1383,16,912,6,181,290,65,42,13,554,,,,,,6/17/2020
5/12/2020,221,12017,2449,87784,99801,23,1406,18,930,4,185,291,63,41,22,576,,,,,,6/17/2020
5/13/2020,195,12212,3528,91312,103524,22,1428,24,954,1,186,288,66,44,12,588,,,,,,6/17/2020
5/14/2020,219,12431,3306,94618,107049,19,1447,27,981,3,189,277,64,45,14,602,,,,,,6/17/2020
5/15/2020,227,12658,3462,98080,110738,24,1471,41,1022,5,194,255,62,46,13,615,,,,,,6/17/2020
5/16/2020,251,12909,4024,102104,115013,25,1496,13,1035,5,199,262,59,44,13,628,,,,,,6/17/2020
5/17/2020,128,13037,2790,104894,117931,17,1513,7,1042,5,204,267,58,45,10,638,,,,,,6/17/2020
5/18/2020,139,13176,1921,106815,119991,19,1532,15,1057,5,209,266,56,41,18,656,,,,,,6/17/2020
5/19/2020,212,13388,3116,109931,123319,23,1555,31,1088,5,214,253,56,40,10,666,,,,,,6/17/2020
5/20/2020,186,13574,2789,112720,126294,19,1574,23,1111,7,221,242,51,34,21,687,,,,,,6/17/2020
5/21/2020,170,13744,3830,116550,130294,26,1600,15,1126,3,224,250,49,32,19,706,,,,,,6/17/2020
5/22/2020,204,13948,2984,119534,133482,19,1619,29,1155,5,229,235,--,--,7,713,,,,,,6/17/2020
5/23/2020,108,14056,2734,122268,136324,19,1638,11,1166,3,232,240,50,36,12,725,,,,,,6/17/2020
5/24/2020,84,14140,1359,123627,137767,12,1650,14,1180,2,234,236,49,35,8,733,,,,,,6/17/2020
5/25/2020,70,14210,1366,124993,139203,12,1662,14,1194,0,234,234,53,36,8,741,,,,,,6/17/2020
5/26/2020,152,14362,2562,127555,141917,23,1685,22,1216,5,239,230,47,33,15,756,,,,,,6/17/2020
5/27/2020,132,14494,2065,129620,144114,20,1705,17,1233,3,242,230,50,32,9,765,,,,,,6/17/2020
5/28/2020,132,14626,3289,132909,147535,17,1722,29,1262,4,246,214,46,29,7,772,,,,,,6/17/2020
5/29/2020,178,14804,3902,136811,151615,18,1740,27,1289,5,251,200,46,29,11,783,,,,,,6/17/2020
5/30/2020,104,14908,4134,140945,155853,15,1755,19,1308,4,255,192,48,31,10,793,,,,,,6/17/2020
5/31/2020,77,14985,2306,143251,158236,10,1765,10,1318,0,255,192,44,30,3,796,,,,,,6/17/2020
6/1/2020,100,15085,2722,145973,161058,8,1773,12,1330,1,256,187,42,29,4,800,,,,,,6/17/2020
6/2/2020,109,15194,3022,148995,164189,8,1781,9,1339,3,259,183,37,23,10,810,,,,,,6/17/2020
6/3/2020,103,15297,3407,152402,167699,13,1794,18,1357,6,265,172,--,--,10,820,,,,,,6/17/2020
6/4/2020,117,15414,4505,156907,172321,7,1801,25,1382,3,268,151,--,--,11,831,,,,,,6/17/2020
6/5/2020,107,15521,3841,160748,176269,14,1815,12,1394,5,273,148,28,20,9,840,,,,,,6/17/2020
6/6/2020,69,15590,2602,163350,178940,10,1825,7,1401,2,275,149,31,19,6,846,,,,,,6/17/2020
6/7/2020,48,15638,1567,164917,180555,11,1836,7,1408,1,276,152,27,16,4,850,,,,,,6/17/2020
6/8/2020,44,15682,1720,166637,182319,15,1851,12,1420,2,278,153,26,16,3,853,,,,,,6/17/2020
6/9/2020,67,15749,2506,169143,184892,10,1861,18,1438,0,278,145,28,17,1,854,,,,,,6/17/2020
6/10/2020,100,15849,2873,172016,187865,13,1874,12,1450,2,280,144,--,--,3,857,,,,,,6/17/2020
6/11/2020,87,15936,3628,175644,191580,6,1880,14,1464,1,281,135,--,--,5,862,,,,,,6/17/2020
6/12/2020,76,16012,4311,179955,195967,8,1888,14,1478,1,282,128,21,14,2,864,,,,,,6/17/2020
6/13/2020,47,16059,2727,182682,198741,6,1894,4,1482,0,282,130,16,13,2,866,,,,,,6/17/2020
6/14/2020,29,16088,1828,184510,200598,4,1898,7,1489,1,283,126,17,13,3,869,,,,,,6/17/2020
6/15/2020,76,16164,2944,187454,203618,,,,,,,,,,3,872,,,,,,6/17/2020
6/16/2020,49,16213,2803,190257,206470,,,,,,,,,,4,876,,,,,,6/17/2020
2/27/2020,0,0,0,0,0,1,1,0,0,0,0,1,--,--,0,0,,,,,,6/18/2020
2/28/2020,0,0,0,0,0,0,1,0,0,0,0,1,--,--,0,0,,,,,,6/18/2020
2/29/2020,0,0,0,0,0,0,1,0,0,0,0,1,--,--,0,0,,,,,,6/18/2020
3/1/2020,2,2,3,3,5,0,1,0,0,0,0,1,--,--,0,0,,,,,,6/18/2020
3/2/2020,0,2,4,7,9,1,2,0,0,0,0,2,--,--,0,0,,,,,,6/18/2020
3/3/2020,0,2,2,9,11,0,2,0,0,0,0,2,--,--,0,0,,,,,,6/18/2020
3/4/2020,0,2,12,21,23,1,3,0,0,0,0,3,--,--,0,0,,,,,,6/18/2020
3/5/2020,1,3,5,26,29,0,3,0,0,0,0,3,--,--,0,0,,,,,,6/18/2020
3/6/2020,0,3,12,38,41,0,3,0,0,0,0,3,--,--,0,0,,,,,,6/18/2020
3/7/2020,0,3,19,57,60,0,3,0,0,0,0,3,--,--,0,0,,,,,,6/18/2020
3/8/2020,0,3,19,76,79,0,3,0,0,0,0,3,--,--,0,0,,,,,,6/18/2020
3/9/2020,1,4,27,103,107,0,3,0,0,0,0,3,--,--,0,0,,,,,,6/18/2020
3/10/2020,1,5,25,128,133,0,3,0,0,0,0,3,--,--,0,0,,,,,,6/18/2020
3/11/2020,0,5,34,162,167,1,4,0,0,0,0,4,--,--,0,0,,,,,,6/18/2020
3/12/2020,8,13,42,204,217,1,5,0,0,0,0,5,--,--,0,0,,,,,,6/18/2020
3/13/2020,6,19,50,254,273,4,9,1,1,0,0,8,--,--,0,0,,,,,,6/18/2020
3/14/2020,0,19,90,344,363,0,9,0,1,0,0,8,--,--,0,0,,,,,,6/18/2020
3/15/2020,1,20,54,398,418,1,10,0,1,0,0,9,--,--,0,0,,,,,,6/18/2020
3/16/2020,2,22,95,493,515,2,12,0,1,0,0,11,--,--,0,0,,,,,,6/18/2020
3/17/2020,12,34,162,655,689,6,18,0,1,0,0,17,--,--,0,0,,,,,,6/18/2020
3/18/2020,11,45,116,771,816,3,21,0,1,0,0,20,--,--,0,0,,,,,,6/18/2020
3/19/2020,16,61,263,1034,1095,2,23,1,2,0,0,21,--,--,1,1,,,,,,6/18/2020
3/20/2020,13,74,197,1231,1305,5,28,0,2,0,0,26,--,--,0,1,,,,,,6/18/2020
3/21/2020,14,88,126,1357,1445,3,31,2,4,0,0,27,--,--,0,1,,,,,,6/18/2020
3/22/2020,25,113,283,1640,1753,2,33,0,4,0,0,29,--,--,0,1,,,,,,6/18/2020
3/23/2020,16,129,177,1817,1946,16,49,1,5,0,0,44,--,--,0,1,,,,,,6/18/2020
3/24/2020,19,148,245,2062,2210,7,56,0,5,0,0,51,--,--,0,1,,,,,,6/18/2020
3/25/2020,28,176,186,2248,2424,5,61,1,6,0,0,55,--,--,0,1,,,,,,6/18/2020
3/26/2020,41,217,185,2433,2650,10,71,5,11,0,0,60,--,--,0,1,,,,,,6/18/2020
3/27/2020,31,248,219,2652,2900,9,80,1,12,1,1,67,--,--,2,3,,,,,,6/18/2020
3/28/2020,64,312,263,2915,3227,13,93,3,15,2,3,75,--,--,1,4,,,,,,6/18/2020
3/29/2020,105,417,360,3275,3692,8,101,4,19,1,4,78,--,--,2,6,,,,,,6/18/2020
3/30/2020,78,495,225,3500,3995,20,121,5,24,0,4,93,--,--,3,9,,,,,,6/18/2020
3/31/2020,73,568,372,3872,4440,11,132,7,31,1,5,96,--,--,2,11,,,,,,6/18/2020
4/1/2020,101,669,706,4578,5247,18,150,7,38,0,5,107,--,--,1,12,,,,,,6/18/2020
4/2/2020,63,732,483,5061,5793,21,171,6,44,2,7,120,--,--,4,16,,,,,,6/18/2020
4/3/2020,100,832,793,5854,6686,23,194,7,51,0,7,136,--,--,3,19,,,,,,6/18/2020
4/4/2020,138,970,662,6516,7486,21,215,4,55,5,12,148,--,--,9,28,,,,,,6/18/2020
4/5/2020,183,1153,1161,7677,8830,20,235,9,64,1,13,158,45,37,2,30,,,,,,6/18/2020
4/6/2020,206,1359,1711,9388,10747,26,261,7,71,0,13,177,45,38,7,37,,,,,,6/18/2020
4/7/2020,260,1619,1646,11034,12653,20,281,3,74,2,15,192,45,35,5,42,,,,,,6/18/2020
4/8/2020,274,1893,1727,12761,14654,19,300,8,82,6,21,197,50,36,9,51,,,,,,6/18/2020
4/9/2020,279,2172,1531,14292,16464,32,332,9,91,4,25,216,50,38,7,58,,,,,,6/18/2020
4/10/2020,404,2576,2581,16873,19449,29,361,17,108,5,30,223,48,36,11,69,,,,,,6/18/2020
4/11/2020,279,2855,1918,18791,21646,29,390,11,119,2,32,239,49,40,11,80,,,,,,6/18/2020
4/12/2020,287,3142,1681,20472,23614,35,425,13,132,5,37,256,54,44,10,90,,,,,,6/18/2020
4/13/2020,186,3328,943,21415,24743,35,460,13,145,3,40,275,61,43,9,99,,,,,,6/18/2020
4/14/2020,268,3596,1811,23226,26822,27,487,16,161,5,45,281,62,43,8,107,,,,,,6/18/2020
4/15/2020,307,3903,1808,25034,28937,31,518,19,180,3,48,290,67,43,17,124,,,,,,6/18/2020
4/16/2020,392,4295,2505,27539,31834,36,554,25,205,6,54,295,70,43,14,138,,,,,,6/18/2020
4/17/2020,290,4585,1830,29369,33954,31,585,21,226,7,61,298,62,45,21,159,,,,,,6/18/2020
4/18/2020,284,4869,1733,31102,35971,26,611,18,244,4,65,302,67,43,15,174,,,,,,6/18/2020
4/19/2020,339,5208,2067,33169,38377,23,634,26,270,1,66,298,71,44,11,185,,,,,,6/18/2020
4/20/2020,380,5588,1913,35082,40670,46,680,29,299,2,68,313,72,45,10,195,,,,,,6/18/2020
4/21/2020,388,5976,2127,37209,43185,45,725,31,330,5,73,322,77,48,18,213,,,,,,6/18/2020
4/22/2020,383,6359,2408,39617,45976,41,766,32,362,5,78,326,77,52,17,230,,,,,,6/18/2020
4/23/2020,419,6778,2478,42095,48873,31,797,28,390,5,83,324,78,53,14,244,,,,,,6/18/2020
4/24/2020,416,7194,3298,45393,52587,35,832,27,417,4,87,328,81,56,15,259,,,,,,6/18/2020
4/25/2020,305,7499,2218,47611,55110,34,866,17,434,5,92,340,84,55,14,273,,,,,,6/18/2020
4/26/2020,274,7773,2318,49929,57702,33,899,15,449,3,95,355,80,55,14,287,,,,,,6/18/2020
4/27/2020,203,7976,1632,51561,59537,29,928,21,470,4,99,359,98,62,10,297,,,,,,6/18/2020
4/28/2020,324,8300,2275,53836,62136,44,972,24,494,3,102,376,76,51,22,319,,,,,,6/18/2020
4/29/2020,371,8671,3365,57201,65872,36,1008,38,532,11,113,363,80,54,18,337,,,,,,6/18/2020
4/30/2020,349,9020,2776,59977,68997,33,1041,38,570,6,119,352,83,59,24,361,,,,,,6/18/2020
5/1/2020,317,9337,3098,63075,72412,51,1092,39,609,3,122,361,84,61,14,375,,,,,,6/18/2020
5/2/2020,189,9526,1934,65009,74535,36,1128,39,648,5,127,353,89,62,24,399,,,,,,6/18/2020
5/3/2020,182,9708,2172,67181,76889,31,1159,26,674,8,135,350,86,60,20,419,,,,,,6/18/2020
5/4/2020,291,9999,2106,69287,79286,30,1189,31,705,6,141,343,82,56,18,437,,,,,,6/18/2020
5/5/2020,304,10303,2885,72172,82475,28,1217,32,737,6,147,333,71,52,16,453,,,,,,6/18/2020
5/6/2020,343,10646,2848,75020,85666,28,1245,44,781,9,156,308,77,56,20,473,,,,,,6/18/2020
5/7/2020,271,10917,2909,77929,88846,36,1281,42,823,5,161,297,70,52,21,494,,,,,,6/18/2020
5/8/2020,231,11148,2501,80430,91578,29,1310,29,852,4,165,293,73,52,22,516,,,,,,6/18/2020
5/9/2020,288,11436,3292,83722,95158,22,1332,21,873,4,169,290,72,53,14,530,,,,,,6/18/2020
5/10/2020,188,11624,2094,85816,97440,20,1352,23,896,6,175,281,68,48,13,543,,,,,,6/18/2020
5/11/2020,173,11797,1810,87626,99423,31,1383,16,912,6,181,290,65,42,13,556,,,,,,6/18/2020
5/12/2020,221,12018,2449,90075,102093,23,1406,18,930,4,185,291,63,41,22,578,,,,,,6/18/2020
5/13/2020,195,12213,3528,93603,105816,22,1428,24,954,1,186,288,66,44,12,590,,,,,,6/18/2020
5/14/2020,219,12432,3306,96909,109341,19,1447,27,981,3,189,277,64,45,14,604,,,,,,6/18/2020
5/15/2020,227,12659,3462,100371,113030,24,1471,41,1022,5,194,255,62,46,13,617,,,,,,6/18/2020
5/16/2020,251,12910,4024,104395,117305,25,1496,13,1035,5,199,262,59,44,13,630,,,,,,6/18/2020
5/17/2020,128,13038,2790,107185,120223,17,1513,7,1042,5,204,267,58,45,10,640,,,,,,6/18/2020
5/18/2020,139,13177,1921,109106,122283,19,1532,15,1057,5,209,266,56,41,18,658,,,,,,6/18/2020
5/19/2020,212,13389,3116,112222,125611,23,1555,31,1088,5,214,253,56,40,10,668,,,,,,6/18/2020
5/20/2020,186,13575,2789,115011,128586,19,1574,23,1111,7,221,242,51,34,22,690,,,,,,6/18/2020
5/21/2020,170,13745,3830,118841,132586,26,1600,15,1126,3,224,250,49,32,19,709,,,,,,6/18/2020
5/22/2020,203,13948,2984,121825,135773,19,1619,29,1155,5,229,235,--,--,7,716,,,,,,6/18/2020
5/23/2020,108,14056,2734,124559,138615,19,1638,11,1166,3,232,240,50,36,13,729,,,,,,6/18/2020
5/24/2020,84,14140,1359,125918,140058,12,1650,14,1180,2,234,236,49,35,8,737,,,,,,6/18/2020
5/25/2020,70,14210,1366,127284,141494,12,1662,14,1194,0,234,234,53,36,9,746,,,,,,6/18/2020
5/26/2020,152,14362,2562,129846,144208,23,1685,22,1216,5,239,230,47,33,15,761,,,,,,6/18/2020
5/27/2020,132,14494,2065,131911,146405,20,1705,17,1233,3,242,230,50,32,9,770,,,,,,6/18/2020
5/28/2020,132,14626,3289,135200,149826,17,1722,29,1262,4,246,214,46,29,7,777,,,,,,6/18/2020
5/29/2020,178,14804,3902,139102,153906,18,1740,27,1289,5,251,200,46,29,11,788,,,,,,6/18/2020
5/30/2020,104,14908,4134,143236,158144,15,1755,19,1308,4,255,192,48,31,10,798,,,,,,6/18/2020
5/31/2020,76,14984,2306,145542,160526,10,1765,10,1318,0,255,192,44,30,3,801,,,,,,6/18/2020
6/1/2020,100,15084,2722,148264,163348,8,1773,12,1330,1,256,187,42,29,4,805,,,,,,6/18/2020
6/2/2020,109,15193,3022,151286,166479,8,1781,9,1339,3,259,183,37,23,10,815,,,,,,6/18/2020
6/3/2020,103,15296,3407,154693,169989,13,1794,18,1357,6,265,172,--,--,10,825,,,,,,6/18/2020
6/4/2020,117,15413,4505,159198,174611,7,1801,25,1382,3,268,151,--,--,11,836,,,,,,6/18/2020
6/5/2020,107,15520,3841,163039,178559,14,1815,12,1394,5,273,148,28,20,9,845,,,,,,6/18/2020
6/6/2020,69,15589,2602,165641,181230,10,1825,7,1401,2,275,149,31,19,6,851,,,,,,6/18/2020
6/7/2020,48,15637,1567,167208,182845,11,1836,7,1408,1,276,152,27,16,4,855,,,,,,6/18/2020
6/8/2020,44,15681,1720,168928,184609,15,1851,12,1420,2,278,153,26,16,3,858,,,,,,6/18/2020
6/9/2020,67,15748,2506,171434,187182,10,1861,18,1438,0,278,145,28,17,1,859,,,,,,6/18/2020
6/10/2020,102,15850,2873,174307,190157,13,1874,12,1450,2,280,144,--,--,3,862,,,,,,6/18/2020
6/11/2020,87,15937,3628,177935,193872,6,1880,14,1464,1,281,135,--,--,5,867,,,,,,6/18/2020
6/12/2020,79,16016,4311,182246,198262,8,1888,14,1478,1,282,128,21,14,2,869,,,,,,6/18/2020
6/13/2020,47,16063,2727,184973,201036,6,1894,4,1482,0,282,130,16,13,2,871,,,,,,6/18/2020
6/14/2020,32,16095,1828,186801,202896,4,1898,7,1489,1,283,126,17,13,3,874,,,,,,6/18/2020
6/15/2020,75,16170,2944,189745,205915,13,1911,13,1502,0,283,126,23,13,3,877,,,,,,6/18/2020
6/16/2020,49,16219,2803,192548,208767,,,,,,,,,,6,883,,,,,,6/18/2020
6/17/2020,50,16269,2776,195324,211593,,,,,,,,,,2,885,,,,,,6/18/2020
2/27/2020,0,0,0,0,0,1,1,0,0,0,0,1,--,--,0,0,,,,,,6/19/2020
2/28/2020,0,0,0,0,0,0,1,0,0,0,0,1,--,--,0,0,,,,,,6/19/2020
2/29/2020,0,0,0,0,0,0,1,0,0,0,0,1,--,--,0,0,,,,,,6/19/2020
3/1/2020,2,2,3,3,5,0,1,0,0,0,0,1,--,--,0,0,,,,,,6/19/2020
3/2/2020,0,2,4,7,9,1,2,0,0,0,0,2,--,--,0,0,,,,,,6/19/2020
3/3/2020,0,2,2,9,11,0,2,0,0,0,0,2,--,--,0,0,,,,,,6/19/2020
3/4/2020,0,2,12,21,23,1,3,0,0,0,0,3,--,--,0,0,,,,,,6/19/2020
3/5/2020,1,3,5,26,29,0,3,0,0,0,0,3,--,--,0,0,,,,,,6/19/2020
3/6/2020,0,3,12,38,41,0,3,0,0,0,0,3,--,--,0,0,,,,,,6/19/2020
3/7/2020,0,3,19,57,60,0,3,0,0,0,0,3,--,--,0,0,,,,,,6/19/2020
3/8/2020,0,3,19,76,79,0,3,0,0,0,0,3,--,--,0,0,,,,,,6/19/2020
3/9/2020,1,4,27,103,107,0,3,0,0,0,0,3,--,--,0,0,,,,,,6/19/2020
3/10/2020,1,5,25,128,133,0,3,0,0,0,0,3,--,--,0,0,,,,,,6/19/2020
3/11/2020,0,5,34,162,167,1,4,0,0,0,0,4,--,--,0,0,,,,,,6/19/2020
3/12/2020,8,13,42,204,217,1,5,0,0,0,0,5,--,--,0,0,,,,,,6/19/2020
3/13/2020,6,19,50,254,273,4,9,1,1,0,0,8,--,--,0,0,,,,,,6/19/2020
3/14/2020,0,19,90,344,363,0,9,0,1,0,0,8,--,--,0,0,,,,,,6/19/2020
3/15/2020,1,20,54,398,418,1,10,0,1,0,0,9,--,--,0,0,,,,,,6/19/2020
3/16/2020,2,22,95,493,515,2,12,0,1,0,0,11,--,--,0,0,,,,,,6/19/2020
3/17/2020,12,34,162,655,689,6,18,0,1,0,0,17,--,--,0,0,,,,,,6/19/2020
3/18/2020,11,45,116,771,816,3,21,0,1,0,0,20,--,--,0,0,,,,,,6/19/2020
3/19/2020,16,61,263,1034,1095,2,23,1,2,0,0,21,--,--,1,1,,,,,,6/19/2020
3/20/2020,13,74,197,1231,1305,5,28,0,2,0,0,26,--,--,0,1,,,,,,6/19/2020
3/21/2020,14,88,126,1357,1445,3,31,2,4,0,0,27,--,--,0,1,,,,,,6/19/2020
3/22/2020,25,113,283,1640,1753,2,33,0,4,0,0,29,--,--,0,1,,,,,,6/19/2020
3/23/2020,16,129,177,1817,1946,16,49,1,5,0,0,44,--,--,0,1,,,,,,6/19/2020
3/24/2020,19,148,245,2062,2210,7,56,0,5,0,0,51,--,--,0,1,,,,,,6/19/2020
3/25/2020,28,176,186,2248,2424,5,61,1,6,0,0,55,--,--,0,1,,,,,,6/19/2020
3/26/2020,41,217,185,2433,2650,10,71,5,11,0,0,60,--,--,0,1,,,,,,6/19/2020
3/27/2020,31,248,219,2652,2900,9,80,1,12,1,1,67,--,--,2,3,,,,,,6/19/2020
3/28/2020,64,312,263,2915,3227,13,93,3,15,2,3,75,--,--,1,4,,,,,,6/19/2020
3/29/2020,105,417,360,3275,3692,8,101,4,19,1,4,78,--,--,2,6,,,,,,6/19/2020
3/30/2020,78,495,225,3500,3995,20,121,5,24,0,4,93,--,--,3,9,,,,,,6/19/2020
3/31/2020,73,568,372,3872,4440,11,132,7,31,1,5,96,--,--,2,11,,,,,,6/19/2020
4/1/2020,101,669,706,4578,5247,18,150,7,38,0,5,107,--,--,1,12,,,,,,6/19/2020
4/2/2020,63,732,483,5061,5793,21,171,6,44,2,7,120,--,--,4,16,,,,,,6/19/2020
4/3/2020,100,832,793,5854,6686,23,194,7,51,0,7,136,--,--,3,19,,,,,,6/19/2020
4/4/2020,138,970,662,6516,7486,22,216,4,55,5,12,149,--,--,9,28,,,,,,6/19/2020
4/5/2020,183,1153,1161,7677,8830,20,236,9,64,1,13,159,45,37,2,30,,,,,,6/19/2020
4/6/2020,206,1359,1711,9388,10747,26,262,7,71,0,13,178,45,38,7,37,,,,,,6/19/2020
4/7/2020,260,1619,1646,11034,12653,20,282,3,74,2,15,193,45,35,5,42,,,,,,6/19/2020
4/8/2020,274,1893,1727,12761,14654,19,301,8,82,6,21,198,50,36,9,51,,,,,,6/19/2020
4/9/2020,279,2172,1531,14292,16464,32,333,9,91,4,25,217,50,38,7,58,,,,,,6/19/2020
4/10/2020,404,2576,2581,16873,19449,29,362,17,108,5,30,224,48,36,11,69,,,,,,6/19/2020
4/11/2020,279,2855,1918,18791,21646,29,391,11,119,2,32,240,49,40,11,80,,,,,,6/19/2020
4/12/2020,287,3142,1681,20472,23614,35,426,13,132,5,37,257,54,44,10,90,,,,,,6/19/2020
4/13/2020,186,3328,943,21415,24743,35,461,13,145,3,40,276,61,43,9,99,,,,,,6/19/2020
4/14/2020,268,3596,1811,23226,26822,27,488,17,162,5,45,281,62,43,8,107,,,,,,6/19/2020
4/15/2020,307,3903,1808,25034,28937,31,519,19,181,3,48,290,67,43,17,124,,,,,,6/19/2020
4/16/2020,392,4295,2505,27539,31834,36,555,25,206,6,54,295,70,43,14,138,,,,,,6/19/2020
4/17/2020,290,4585,1830,29369,33954,31,586,21,227,7,61,298,62,45,21,159,,,,,,6/19/2020
4/18/2020,284,4869,1733,31102,35971,26,612,18,245,4,65,302,67,43,15,174,,,,,,6/19/2020
4/19/2020,339,5208,2067,33169,38377,23,635,26,271,1,66,298,71,44,11,185,,,,,,6/19/2020
4/20/2020,380,5588,1913,35082,40670,46,681,29,300,2,68,313,72,45,10,195,,,,,,6/19/2020
4/21/2020,388,5976,2127,37209,43185,45,726,31,331,5,73,322,77,48,18,213,,,,,,6/19/2020
4/22/2020,383,6359,2408,39617,45976,41,767,32,363,5,78,326,77,52,17,230,,,,,,6/19/2020
4/23/2020,419,6778,2478,42095,48873,31,798,28,391,5,83,324,78,53,14,244,,,,,,6/19/2020
4/24/2020,416,7194,3298,45393,52587,35,833,27,418,4,87,328,81,56,15,259,,,,,,6/19/2020
4/25/2020,305,7499,2218,47611,55110,34,867,17,435,5,92,340,84,55,14,273,,,,,,6/19/2020
4/26/2020,274,7773,2318,49929,57702,33,900,15,450,3,95,355,80,55,14,287,,,,,,6/19/2020
4/27/2020,203,7976,1632,51561,59537,29,929,21,471,4,99,359,98,62,10,297,,,,,,6/19/2020
4/28/2020,324,8300,2275,53836,62136,44,973,24,495,3,102,376,76,51,22,319,,,,,,6/19/2020
4/29/2020,371,8671,3365,57201,65872,36,1009,38,533,11,113,363,80,54,18,337,,,,,,6/19/2020
4/30/2020,349,9020,2776,59977,68997,33,1042,38,571,6,119,352,83,59,24,361,,,,,,6/19/2020
5/1/2020,317,9337,3098,63075,72412,51,1093,39,610,3,122,361,84,61,14,375,,,,,,6/19/2020
5/2/2020,189,9526,1934,65009,74535,36,1129,39,649,5,127,353,89,62,24,399,,,,,,6/19/2020
5/3/2020,182,9708,2172,67181,76889,31,1160,27,676,8,135,349,86,60,20,419,,,,,,6/19/2020
5/4/2020,291,9999,2106,69287,79286,30,1190,31,707,5,140,343,82,56,18,437,,,,,,6/19/2020
5/5/2020,304,10303,2885,72172,82475,28,1218,32,739,6,146,333,71,52,16,453,,,,,,6/19/2020
5/6/2020,343,10646,2848,75020,85666,28,1246,44,783,9,155,308,77,56,20,473,,,,,,6/19/2020
5/7/2020,271,10917,2909,77929,88846,36,1282,42,825,5,160,297,70,52,21,494,,,,,,6/19/2020
5/8/2020,231,11148,2501,80430,91578,30,1312,29,854,5,165,293,73,52,22,516,,,,,,6/19/2020
5/9/2020,288,11436,3292,83722,95158,22,1334,21,875,4,169,290,72,53,14,530,,,,,,6/19/2020
5/10/2020,188,11624,2094,85816,97440,20,1354,23,898,6,175,281,68,48,13,543,,,,,,6/19/2020
5/11/2020,173,11797,1810,87626,99423,31,1385,16,914,6,181,290,65,42,13,556,,,,,,6/19/2020
5/12/2020,221,12018,2449,90075,102093,23,1408,18,932,4,185,291,63,41,22,578,,,,,,6/19/2020
5/13/2020,195,12213,3528,93603,105816,22,1430,24,956,1,186,288,66,44,12,590,,,,,,6/19/2020
5/14/2020,218,12431,3306,96909,109340,19,1449,27,983,3,189,277,64,45,14,604,,,,,,6/19/2020
5/15/2020,227,12658,3462,100371,113029,24,1473,41,1024,5,194,255,62,46,13,617,,,,,,6/19/2020
5/16/2020,251,12909,4024,104395,117304,25,1498,13,1037,5,199,262,59,44,13,630,,,,,,6/19/2020
5/17/2020,128,13037,2790,107185,120222,17,1515,7,1044,5,204,267,58,45,10,640,,,,,,6/19/2020
5/18/2020,139,13176,1921,109106,122282,19,1534,15,1059,5,209,266,56,41,18,658,,,,,,6/19/2020
5/19/2020,213,13389,3116,112222,125611,23,1557,31,1090,5,214,253,56,40,10,668,,,,,,6/19/2020
5/20/2020,186,13575,2789,115011,128586,19,1576,23,1113,7,221,242,51,34,22,690,,,,,,6/19/2020
5/21/2020,170,13745,3830,118841,132586,26,1602,15,1128,3,224,250,49,32,19,709,,,,,,6/19/2020
5/22/2020,202,13947,2984,121825,135772,19,1621,29,1157,5,229,235,--,--,7,716,,,,,,6/19/2020
5/23/2020,108,14055,2734,124559,138614,19,1640,11,1168,3,232,240,50,36,13,729,,,,,,6/19/2020
5/24/2020,84,14139,1359,125918,140057,12,1652,14,1182,2,234,236,49,35,8,737,,,,,,6/19/2020
5/25/2020,70,14209,1366,127284,141493,12,1664,14,1196,0,234,234,53,36,9,746,,,,,,6/19/2020
5/26/2020,152,14361,2562,129846,144207,23,1687,22,1218,5,239,230,47,33,15,761,,,,,,6/19/2020
5/27/2020,132,14493,2065,131911,146404,20,1707,17,1235,3,242,230,50,32,9,770,,,,,,6/19/2020
5/28/2020,132,14625,3289,135200,149825,17,1724,29,1264,4,246,214,46,29,7,777,,,,,,6/19/2020
5/29/2020,178,14803,3902,139102,153905,18,1742,27,1291,5,251,200,46,29,11,788,,,,,,6/19/2020
5/30/2020,104,14907,4134,143236,158143,15,1757,19,1310,4,255,192,48,31,10,798,,,,,,6/19/2020
5/31/2020,76,14983,2306,145542,160525,10,1767,10,1320,0,255,192,44,30,3,801,,,,,,6/19/2020
6/1/2020,99,15082,2722,148264,163346,8,1775,12,1332,1,256,187,42,29,4,805,,,,,,6/19/2020
6/2/2020,108,15190,3022,151286,166476,8,1783,9,1341,3,259,183,37,23,10,815,,,,,,6/19/2020
6/3/2020,103,15293,3407,154693,169986,13,1796,18,1359,6,265,172,--,--,10,825,,,,,,6/19/2020
6/4/2020,116,15409,4505,159198,174607,7,1803,25,1384,3,268,151,--,--,11,836,,,,,,6/19/2020
6/5/2020,107,15516,3841,163039,178555,14,1817,12,1396,5,273,148,28,20,9,845,,,,,,6/19/2020
6/6/2020,69,15585,2602,165641,181226,10,1827,7,1403,2,275,149,31,19,6,851,,,,,,6/19/2020
6/7/2020,48,15633,1567,167208,182841,11,1838,7,1410,1,276,152,27,16,4,855,,,,,,6/19/2020
6/8/2020,44,15677,1720,168928,184605,15,1853,12,1422,2,278,153,26,16,3,858,,,,,,6/19/2020
6/9/2020,67,15744,2506,171434,187178,10,1863,18,1440,0,278,145,28,17,1,859,,,,,,6/19/2020
6/10/2020,102,15846,2873,174307,190153,13,1876,12,1452,2,280,144,--,--,3,862,,,,,,6/19/2020
6/11/2020,87,15933,3628,177935,193868,7,1883,14,1466,1,281,136,--,--,5,867,,,,,,6/19/2020
6/12/2020,79,16012,4311,182246,198258,8,1891,14,1480,1,282,129,21,14,2,869,,,,,,6/19/2020
6/13/2020,47,16059,2727,184973,201032,6,1897,4,1484,0,282,131,16,13,2,871,,,,,,6/19/2020
6/14/2020,32,16091,1828,186801,202892,5,1902,7,1491,1,283,128,17,13,3,874,,,,,,6/19/2020
6/15/2020,75,16166,2944,189745,205911,12,1914,14,1505,0,283,126,23,13,3,877,,,,,,6/19/2020
6/16/2020,53,16219,2803,192548,208767,8,1922,10,1515,1,284,123,23,12,7,884,,,,,,6/19/2020
6/17/2020,50,16269,2776,195324,211593,,,,,,,,,,4,888,,,,,,6/19/2020
6/18/2020,68,16337,2928,198252,214589,,,,,,,,,,6,894,,,,,,6/19/2020
2/27/2020,0,0,0,0,0,1,1,0,0,0,0,1,--,--,0,0,,,,,,6/22/2020
2/28/2020,0,0,0,0,0,0,1,0,0,0,0,1,--,--,0,0,,,,,,6/22/2020
2/29/2020,0,0,0,0,0,0,1,0,0,0,0,1,--,--,0,0,,,,,,6/22/2020
3/1/2020,2,2,2,2,4,0,1,0,0,0,0,1,--,--,0,0,,,,,,6/22/2020
3/2/2020,0,2,1,3,5,1,2,0,0,0,0,2,--,--,0,0,,,,,,6/22/2020
3/3/2020,0,2,2,5,7,0,2,0,0,0,0,2,--,--,0,0,,,,,,6/22/2020
3/4/2020,0,2,12,17,19,1,3,0,0,0,0,3,--,--,0,0,,,,,,6/22/2020
3/5/2020,1,3,4,21,24,0,3,0,0,0,0,3,--,--,0,0,,,,,,6/22/2020
3/6/2020,0,3,12,33,36,0,3,0,0,0,0,3,--,--,0,0,,,,,,6/22/2020
3/7/2020,0,3,19,52,55,0,3,0,0,0,0,3,--,--,0,0,,,,,,6/22/2020
3/8/2020,0,3,18,70,73,0,3,0,0,0,0,3,--,--,0,0,,,,,,6/22/2020
3/9/2020,1,4,15,85,89,0,3,0,0,0,0,3,--,--,0,0,,,,,,6/22/2020
3/10/2020,1,5,25,110,115,0,3,0,0,0,0,3,--,--,0,0,,,,,,6/22/2020
3/11/2020,0,5,34,144,149,1,4,0,0,0,0,4,--,--,0,0,,,,,,6/22/2020
3/12/2020,8,13,42,186,199,1,5,0,0,0,0,5,--,--,0,0,,,,,,6/22/2020
3/13/2020,6,19,50,236,255,4,9,1,1,0,0,8,--,--,0,0,,,,,,6/22/2020
3/14/2020,0,19,90,326,345,0,9,0,1,0,0,8,--,--,0,0,,,,,,6/22/2020
3/15/2020,1,20,54,380,400,1,10,0,1,0,0,9,--,--,0,0,,,,,,6/22/2020
3/16/2020,2,22,95,475,497,2,12,0,1,0,0,11,--,--,0,0,,,,,,6/22/2020
3/17/2020,11,33,162,637,670,6,18,0,1,0,0,17,--,--,0,0,,,,,,6/22/2020
3/18/2020,11,44,116,753,797,3,21,0,1,0,0,20,--,--,0,0,,,,,,6/22/2020
3/19/2020,17,61,262,1015,1076,2,23,1,2,0,0,21,--,--,1,1,,,,,,6/22/2020
3/20/2020,13,74,197,1212,1286,5,28,0,2,0,0,26,--,--,0,1,,,,,,6/22/2020
3/21/2020,14,88,126,1338,1426,3,31,2,4,0,0,27,--,--,0,1,,,,,,6/22/2020
3/22/2020,25,113,282,1620,1733,2,33,0,4,0,0,29,--,--,0,1,,,,,,6/22/2020
3/23/2020,16,129,174,1794,1923,16,49,1,5,0,0,44,--,--,0,1,,,,,,6/22/2020
3/24/2020,19,148,244,2038,2186,7,56,0,5,0,0,51,--,--,0,1,,,,,,6/22/2020
3/25/2020,28,176,184,2222,2398,5,61,1,6,0,0,55,--,--,0,1,,,,,,6/22/2020
3/26/2020,41,217,181,2403,2620,10,71,5,11,0,0,60,--,--,0,1,,,,,,6/22/2020
3/27/2020,31,248,215,2618,2866,9,80,1,12,1,1,67,--,--,2,3,,,,,,6/22/2020
3/28/2020,64,312,261,2879,3191,13,93,3,15,2,3,75,--,--,1,4,,,,,,6/22/2020
3/29/2020,105,417,357,3236,3653,8,101,4,19,1,4,78,--,--,2,6,,,,,,6/22/2020
3/30/2020,78,495,223,3459,3954,20,121,5,24,0,4,93,--,--,3,9,,,,,,6/22/2020
3/31/2020,73,568,370,3829,4397,11,132,7,31,1,5,96,--,--,2,11,,,,,,6/22/2020
4/1/2020,101,669,703,4532,5201,18,150,7,38,0,5,107,--,--,1,12,,,,,,6/22/2020
4/2/2020,62,731,476,5008,5739,21,171,6,44,2,7,120,--,--,4,16,,,,,,6/22/2020
4/3/2020,101,832,779,5787,6619,23,194,7,51,0,7,136,--,--,3,19,,,,,,6/22/2020
4/4/2020,137,969,660,6447,7416,22,216,4,55,5,12,149,--,--,9,28,,,,,,6/22/2020
4/5/2020,182,1151,1158,7605,8756,20,236,9,64,1,13,159,45,37,2,30,,,,,,6/22/2020
4/6/2020,206,1357,1710,9315,10672,26,262,7,71,0,13,178,45,38,7,37,,,,,,6/22/2020
4/7/2020,260,1617,1633,10948,12565,20,282,3,74,2,15,193,45,35,5,42,,,,,,6/22/2020
4/8/2020,274,1891,1725,12673,14564,19,301,8,82,6,21,198,50,36,9,51,,,,,,6/22/2020
4/9/2020,279,2170,1524,14197,16367,32,333,9,91,4,25,217,50,38,7,58,,,,,,6/22/2020
4/10/2020,404,2574,2580,16777,19351,29,362,17,108,5,30,224,48,36,11,69,,,,,,6/22/2020
4/11/2020,280,2854,1918,18695,21549,29,391,11,119,2,32,240,49,40,11,80,,,,,,6/22/2020
4/12/2020,288,3142,1678,20373,23515,35,426,13,132,5,37,257,54,44,10,90,,,,,,6/22/2020
4/13/2020,187,3329,942,21315,24644,35,461,13,145,3,40,276,61,43,9,99,,,,,,6/22/2020
4/14/2020,268,3597,1795,23110,26707,27,488,17,162,5,45,281,62,43,8,107,,,,,,6/22/2020
4/15/2020,307,3904,1805,24915,28819,31,519,19,181,3,48,290,67,43,17,124,,,,,,6/22/2020
4/16/2020,392,4296,2504,27419,31715,36,555,25,206,6,54,295,70,43,14,138,,,,,,6/22/2020
4/17/2020,290,4586,1829,29248,33834,31,586,21,227,7,61,298,62,45,21,159,,,,,,6/22/2020
4/18/2020,284,4870,1731,30979,35849,26,612,18,245,4,65,302,67,43,15,174,,,,,,6/22/2020
4/19/2020,339,5209,2066,33045,38254,23,635,26,271,1,66,298,71,44,11,185,,,,,,6/22/2020
4/20/2020,379,5588,1914,34959,40547,46,681,29,300,2,68,313,72,45,10,195,,,,,,6/22/2020
4/21/2020,387,5975,2125,37084,43059,45,726,31,331,5,73,322,77,48,18,213,,,,,,6/22/2020
4/22/2020,382,6357,2405,39489,45846,41,767,32,363,5,78,326,77,52,17,230,,,,,,6/22/2020
4/23/2020,419,6776,2474,41963,48739,31,798,28,391,5,83,324,78,53,14,244,,,,,,6/22/2020
4/24/2020,415,7191,3289,45252,52443,35,833,27,418,4,87,328,81,56,15,259,,,,,,6/22/2020
4/25/2020,305,7496,2216,47468,54964,34,867,17,435,5,92,340,84,55,14,273,,,,,,6/22/2020
4/26/2020,275,7771,2312,49780,57551,33,900,15,450,3,95,355,80,55,14,287,,,,,,6/22/2020
4/27/2020,203,7974,1631,51411,59385,29,929,21,471,4,99,359,98,62,10,297,,,,,,6/22/2020
4/28/2020,324,8298,2272,53683,61981,44,973,24,495,3,102,376,76,51,22,319,,,,,,6/22/2020
4/29/2020,371,8669,3363,57046,65715,36,1009,38,533,11,113,363,80,54,18,337,,,,,,6/22/2020
4/30/2020,349,9018,2776,59822,68840,33,1042,38,571,6,119,352,83,59,24,361,,,,,,6/22/2020
5/1/2020,317,9335,3096,62918,72253,51,1093,39,610,3,122,361,84,61,14,375,,,,,,6/22/2020
5/2/2020,189,9524,1931,64849,74373,36,1129,39,649,5,127,353,89,62,24,399,,,,,,6/22/2020
5/3/2020,182,9706,2171,67020,76726,31,1160,27,676,8,135,349,86,60,20,419,,,,,,6/22/2020
5/4/2020,291,9997,2106,69126,79123,30,1190,31,707,5,140,343,82,56,18,437,,,,,,6/22/2020
5/5/2020,304,10301,2886,72012,82313,28,1218,32,739,6,146,333,71,52,16,453,,,,,,6/22/2020
5/6/2020,345,10646,2847,74859,85505,28,1246,44,783,9,155,308,77,56,20,473,,,,,,6/22/2020
5/7/2020,272,10918,2910,77769,88687,36,1282,42,825,5,160,297,70,52,21,494,,,,,,6/22/2020
5/8/2020,232,11150,2501,80270,91420,30,1312,29,854,5,165,293,73,52,22,516,,,,,,6/22/2020
5/9/2020,287,11437,3292,83562,94999,22,1334,21,875,4,169,290,72,53,14,530,,,,,,6/22/2020
5/10/2020,187,11624,2092,85654,97278,20,1354,23,898,6,175,281,68,48,13,543,,,,,,6/22/2020
5/11/2020,173,11797,1807,87461,99258,31,1385,16,914,6,181,290,65,42,13,556,,,,,,6/22/2020
5/12/2020,219,12016,2449,89910,101926,23,1408,18,932,4,185,291,63,41,22,578,,,,,,6/22/2020
5/13/2020,196,12212,3526,93436,105648,22,1430,24,956,1,186,288,66,44,12,590,,,,,,6/22/2020
5/14/2020,217,12429,3314,96750,109179,19,1449,27,983,3,189,277,64,45,14,604,,,,,,6/22/2020
5/15/2020,228,12657,3351,100101,112758,24,1473,41,1024,5,194,255,62,46,13,617,,,,,,6/22/2020
5/16/2020,252,12909,3934,104035,116944,25,1498,13,1037,5,199,262,59,44,13,630,,,,,,6/22/2020
5/17/2020,128,13037,2752,106787,119824,17,1515,7,1044,5,204,267,58,45,10,640,,,,,,6/22/2020
5/18/2020,139,13176,1923,108710,121886,19,1534,15,1059,5,209,266,56,41,18,658,,,,,,6/22/2020
5/19/2020,213,13389,3114,111824,125213,23,1557,31,1090,5,214,253,56,40,10,668,,,,,,6/22/2020
5/20/2020,186,13575,2786,114610,128185,19,1576,23,1113,7,221,242,51,34,22,690,,,,,,6/22/2020
5/21/2020,170,13745,3762,118372,132117,26,1602,15,1128,3,224,250,49,32,19,709,,,,,,6/22/2020
5/22/2020,202,13947,2982,121354,135301,19,1621,29,1157,5,229,235,--,--,7,716,,,,,,6/22/2020
5/23/2020,107,14054,2733,124087,138141,19,1640,11,1168,3,232,240,50,36,13,729,,,,,,6/22/2020
5/24/2020,85,14139,1359,125446,139585,12,1652,14,1182,2,234,236,49,35,8,737,,,,,,6/22/2020
5/25/2020,70,14209,1366,126812,141021,12,1664,14,1196,0,234,234,53,36,9,746,,,,,,6/22/2020
5/26/2020,152,14361,2558,129370,143731,23,1687,22,1218,5,239,230,47,33,15,761,,,,,,6/22/2020
5/27/2020,132,14493,2012,131382,145875,20,1707,17,1235,3,242,230,50,32,9,770,,,,,,6/22/2020
5/28/2020,132,14625,3286,134668,149293,17,1724,29,1264,4,246,214,46,29,7,777,,,,,,6/22/2020
5/29/2020,177,14802,3871,138539,153341,18,1742,27,1291,5,251,200,46,29,11,788,,,,,,6/22/2020
5/30/2020,104,14906,3919,142458,157364,15,1757,19,1310,4,255,192,48,31,10,798,,,,,,6/22/2020
5/31/2020,76,14982,1685,144143,159125,10,1767,10,1320,0,255,192,44,30,3,801,,,,,,6/22/2020
6/1/2020,98,15080,2739,146882,161962,8,1775,12,1332,1,256,187,42,29,4,805,,,,,,6/22/2020
6/2/2020,108,15188,2962,149844,165032,8,1783,9,1341,3,259,183,37,23,10,815,,,,,,6/22/2020
6/3/2020,103,15291,3453,153297,168588,13,1796,18,1359,6,265,172,--,--,10,825,,,,,,6/22/2020
6/4/2020,117,15408,4465,157762,173170,7,1803,25,1384,3,268,151,--,--,11,836,,,,,,6/22/2020
6/5/2020,106,15514,3447,161209,176723,14,1817,12,1396,5,273,148,28,20,9,845,,,,,,6/22/2020
6/6/2020,69,15583,2612,163821,179404,10,1827,7,1403,2,275,149,31,19,6,851,,,,,,6/22/2020
6/7/2020,49,15632,1585,165406,181038,11,1838,7,1410,1,276,152,27,16,4,855,,,,,,6/22/2020
6/8/2020,44,15676,1757,167163,182839,15,1853,12,1422,2,278,153,26,16,3,858,,,,,,6/22/2020
6/9/2020,67,15743,2546,169709,185452,10,1863,18,1440,0,278,145,28,17,1,859,,,,,,6/22/2020
6/10/2020,103,15846,2872,172581,188427,13,1876,12,1452,2,280,144,--,--,3,862,,,,,,6/22/2020
6/11/2020,86,15932,3385,175966,191898,7,1883,14,1466,1,281,136,--,--,5,867,,,,,,6/22/2020
6/12/2020,80,16012,4330,180296,196308,8,1891,14,1480,1,282,129,21,14,2,869,,,,,,6/22/2020
6/13/2020,48,16060,2731,183027,199087,6,1897,4,1484,0,282,131,16,13,2,871,,,,,,6/22/2020
6/14/2020,32,16092,1839,184866,200958,5,1902,7,1491,1,283,128,17,13,3,874,,,,,,6/22/2020
6/15/2020,76,16168,2981,187847,204015,12,1914,14,1505,0,283,126,23,13,4,878,,,,,,6/22/2020
6/16/2020,53,16221,2819,190666,206887,8,1922,10,1515,1,284,123,23,12,7,885,,,,,,6/22/2020
6/17/2020,49,16270,2589,193255,209525,10,1932,18,1533,4,288,111,--,--,5,890,,,,,,6/22/2020
6/18/2020,68,16338,2873,196128,212466,8,1940,11,1544,1,289,107,--,--,6,896,,,,,,6/22/2020
6/19/2020,60,16398,3439,199567,215965,10,1950,10,1554,1,290,106,18,15,2,898,,,,,,6/22/2020
6/20/2020,36,16434,1681,201248,217682,,,,,,,,,,3,901,,,,,,6/22/2020
6/21/2020,25,16459,961,202209,218668,,,,,,,,,,2,903,,,,,,6/22/2020
2/27/2020,0,0,0,0,0,1,1,0,0,0,0,1,--,--,0,0,,,,,,6/23/2020
2/28/2020,0,0,0,0,0,0,1,0,0,0,0,1,--,--,0,0,,,,,,6/23/2020
2/29/2020,0,0,0,0,0,0,1,0,0,0,0,1,--,--,0,0,,,,,,6/23/2020
3/1/2020,2,2,2,2,4,0,1,0,0,0,0,1,--,--,0,0,,,,,,6/23/2020
3/2/2020,0,2,1,3,5,1,2,0,0,0,0,2,--,--,0,0,,,,,,6/23/2020
3/3/2020,0,2,2,5,7,0,2,0,0,0,0,2,--,--,0,0,,,,,,6/23/2020
3/4/2020,0,2,12,17,19,1,3,0,0,0,0,3,--,--,0,0,,,,,,6/23/2020
3/5/2020,1,3,4,21,24,0,3,0,0,0,0,3,--,--,0,0,,,,,,6/23/2020
3/6/2020,0,3,12,33,36,0,3,0,0,0,0,3,--,--,0,0,,,,,,6/23/2020
3/7/2020,0,3,19,52,55,0,3,0,0,0,0,3,--,--,0,0,,,,,,6/23/2020
3/8/2020,0,3,18,70,73,0,3,0,0,0,0,3,--,--,0,0,,,,,,6/23/2020
3/9/2020,1,4,15,85,89,0,3,0,0,0,0,3,--,--,0,0,,,,,,6/23/2020
3/10/2020,1,5,25,110,115,0,3,0,0,0,0,3,--,--,0,0,,,,,,6/23/2020
3/11/2020,0,5,34,144,149,1,4,0,0,0,0,4,--,--,0,0,,,,,,6/23/2020
3/12/2020,8,13,42,186,199,1,5,0,0,0,0,5,--,--,0,0,,,,,,6/23/2020
3/13/2020,6,19,50,236,255,4,9,1,1,0,0,8,--,--,0,0,,,,,,6/23/2020
3/14/2020,0,19,90,326,345,0,9,0,1,0,0,8,--,--,0,0,,,,,,6/23/2020
3/15/2020,1,20,54,380,400,1,10,0,1,0,0,9,--,--,0,0,,,,,,6/23/2020
3/16/2020,2,22,95,475,497,2,12,0,1,0,0,11,--,--,0,0,,,,,,6/23/2020
3/17/2020,11,33,162,637,670,6,18,0,1,0,0,17,--,--,0,0,,,,,,6/23/2020
3/18/2020,11,44,116,753,797,3,21,0,1,0,0,20,--,--,0,0,,,,,,6/23/2020
3/19/2020,17,61,262,1015,1076,2,23,1,2,0,0,21,--,--,1,1,,,,,,6/23/2020
3/20/2020,13,74,197,1212,1286,5,28,0,2,0,0,26,--,--,0,1,,,,,,6/23/2020
3/21/2020,14,88,126,1338,1426,3,31,2,4,0,0,27,--,--,0,1,,,,,,6/23/2020
3/22/2020,25,113,282,1620,1733,2,33,0,4,0,0,29,--,--,0,1,,,,,,6/23/2020
3/23/2020,16,129,174,1794,1923,16,49,1,5,0,0,44,--,--,0,1,,,,,,6/23/2020
3/24/2020,19,148,244,2038,2186,7,56,0,5,0,0,51,--,--,0,1,,,,,,6/23/2020
3/25/2020,28,176,184,2222,2398,5,61,1,6,0,0,55,--,--,0,1,,,,,,6/23/2020
3/26/2020,41,217,181,2403,2620,10,71,5,11,0,0,60,--,--,0,1,,,,,,6/23/2020
3/27/2020,31,248,215,2618,2866,9,80,1,12,1,1,67,--,--,2,3,,,,,,6/23/2020
3/28/2020,64,312,261,2879,3191,13,93,3,15,2,3,75,--,--,1,4,,,,,,6/23/2020
3/29/2020,105,417,357,3236,3653,8,101,4,19,1,4,78,--,--,2,6,,,,,,6/23/2020
3/30/2020,78,495,223,3459,3954,20,121,5,24,0,4,93,--,--,3,9,,,,,,6/23/2020
3/31/2020,73,568,370,3829,4397,11,132,7,31,1,5,96,--,--,2,11,,,,,,6/23/2020
4/1/2020,100,668,703,4532,5200,18,150,7,38,0,5,107,--,--,1,12,,,,,,6/23/2020
4/2/2020,62,730,476,5008,5738,21,171,6,44,2,7,120,--,--,4,16,,,,,,6/23/2020
4/3/2020,101,831,779,5787,6618,23,194,7,51,0,7,136,--,--,3,19,,,,,,6/23/2020
4/4/2020,137,968,660,6447,7415,22,216,4,55,5,12,149,--,--,9,28,,,,,,6/23/2020
4/5/2020,182,1150,1158,7605,8755,20,236,9,64,1,13,159,45,37,2,30,,,,,,6/23/2020
4/6/2020,206,1356,1710,9315,10671,26,262,7,71,0,13,178,45,38,7,37,,,,,,6/23/2020
4/7/2020,260,1616,1633,10948,12564,20,282,4,75,2,15,192,45,35,5,42,,,,,,6/23/2020
4/8/2020,274,1890,1725,12673,14563,19,301,8,83,6,21,197,50,36,9,51,,,,,,6/23/2020
4/9/2020,279,2169,1524,14197,16366,32,333,9,92,4,25,216,50,38,7,58,,,,,,6/23/2020
4/10/2020,404,2573,2580,16777,19350,29,362,16,108,5,30,224,48,36,11,69,,,,,,6/23/2020
4/11/2020,280,2853,1918,18695,21548,29,391,11,119,2,32,240,49,40,11,80,,,,,,6/23/2020
4/12/2020,288,3141,1678,20373,23514,35,426,13,132,5,37,257,54,44,10,90,,,,,,6/23/2020
4/13/2020,187,3328,942,21315,24643,35,461,13,145,3,40,276,61,43,9,99,,,,,,6/23/2020
4/14/2020,268,3596,1795,23110,26706,27,488,17,162,5,45,281,62,43,8,107,,,,,,6/23/2020
4/15/2020,307,3903,1805,24915,28818,31,519,19,181,3,48,290,67,43,17,124,,,,,,6/23/2020
4/16/2020,392,4295,2504,27419,31714,36,555,25,206,6,54,295,70,43,14,138,,,,,,6/23/2020
4/17/2020,290,4585,1829,29248,33833,31,586,21,227,7,61,298,62,45,21,159,,,,,,6/23/2020
4/18/2020,284,4869,1731,30979,35848,26,612,18,245,4,65,302,67,43,15,174,,,,,,6/23/2020
4/19/2020,339,5208,2066,33045,38253,23,635,26,271,1,66,298,71,44,11,185,,,,,,6/23/2020
4/20/2020,379,5587,1914,34959,40546,46,681,29,300,2,68,313,72,45,10,195,,,,,,6/23/2020
4/21/2020,387,5974,2125,37084,43058,45,726,31,331,5,73,322,77,48,18,213,,,,,,6/23/2020
4/22/2020,382,6356,2405,39489,45845,41,767,32,363,5,78,326,77,52,17,230,,,,,,6/23/2020
4/23/2020,419,6775,2474,41963,48738,31,798,28,391,5,83,324,78,53,14,244,,,,,,6/23/2020
4/24/2020,415,7190,3289,45252,52442,35,833,27,418,4,87,328,81,56,15,259,,,,,,6/23/2020
4/25/2020,305,7495,2216,47468,54963,34,867,17,435,5,92,340,84,55,14,273,,,,,,6/23/2020
4/26/2020,275,7770,2312,49780,57550,33,900,15,450,3,95,355,80,55,14,287,,,,,,6/23/2020
4/27/2020,203,7973,1631,51411,59384,29,929,21,471,4,99,359,98,62,10,297,,,,,,6/23/2020
4/28/2020,324,8297,2272,53683,61980,44,973,24,495,3,102,376,76,51,22,319,,,,,,6/23/2020
4/29/2020,371,8668,3363,57046,65714,36,1009,38,533,11,113,363,80,54,18,337,,,,,,6/23/2020
4/30/2020,349,9017,2776,59822,68839,33,1042,38,571,6,119,352,83,59,24,361,,,,,,6/23/2020
5/1/2020,317,9334,3096,62918,72252,51,1093,39,610,3,122,361,84,61,14,375,,,,,,6/23/2020
5/2/2020,189,9523,1931,64849,74372,36,1129,39,649,5,127,353,89,62,24,399,,,,,,6/23/2020
5/3/2020,182,9705,2171,67020,76725,31,1160,26,675,8,135,350,86,60,20,419,,,,,,6/23/2020
5/4/2020,291,9996,2106,69126,79122,30,1190,31,706,6,141,343,82,56,18,437,,,,,,6/23/2020
5/5/2020,304,10300,2886,72012,82312,28,1218,32,738,6,147,333,71,52,16,453,,,,,,6/23/2020
5/6/2020,345,10645,2847,74859,85504,28,1246,44,782,9,156,308,77,56,20,473,,,,,,6/23/2020
5/7/2020,272,10917,2910,77769,88686,36,1282,42,824,5,161,297,70,52,21,494,,,,,,6/23/2020
5/8/2020,233,11150,2501,80270,91420,30,1312,29,853,5,166,293,73,52,22,516,,,,,,6/23/2020
5/9/2020,287,11437,3292,83562,94999,22,1334,21,874,4,170,290,72,53,14,530,,,,,,6/23/2020
5/10/2020,187,11624,2092,85654,97278,20,1354,23,897,6,176,281,68,48,13,543,,,,,,6/23/2020
5/11/2020,173,11797,1807,87461,99258,31,1385,16,913,6,182,290,65,42,13,556,,,,,,6/23/2020
5/12/2020,219,12016,2449,89910,101926,23,1408,18,931,4,186,291,63,41,22,578,,,,,,6/23/2020
5/13/2020,196,12212,3526,93436,105648,22,1430,24,955,1,187,288,66,44,12,590,,,,,,6/23/2020
5/14/2020,217,12429,3314,96750,109179,19,1449,27,982,3,190,277,64,45,14,604,,,,,,6/23/2020
5/15/2020,228,12657,3351,100101,112758,24,1473,41,1023,5,195,255,62,46,13,617,,,,,,6/23/2020
5/16/2020,252,12909,3934,104035,116944,25,1498,13,1036,5,200,262,59,44,13,630,,,,,,6/23/2020
5/17/2020,128,13037,2752,106787,119824,17,1515,7,1043,5,205,267,58,45,10,640,,,,,,6/23/2020
5/18/2020,139,13176,1923,108710,121886,19,1534,15,1058,5,210,266,56,41,18,658,,,,,,6/23/2020
5/19/2020,213,13389,3114,111824,125213,23,1557,31,1089,5,215,253,56,40,10,668,,,,,,6/23/2020
5/20/2020,186,13575,2786,114610,128185,19,1576,23,1112,7,222,242,51,34,22,690,,,,,,6/23/2020
5/21/2020,170,13745,3762,118372,132117,26,1602,15,1127,3,225,250,49,32,19,709,,,,,,6/23/2020
5/22/2020,202,13947,2982,121354,135301,19,1621,29,1156,5,230,235,--,--,7,716,,,,,,6/23/2020
5/23/2020,107,14054,2733,124087,138141,19,1640,11,1167,3,233,240,50,36,13,729,,,,,,6/23/2020
5/24/2020,85,14139,1359,125446,139585,12,1652,14,1181,2,235,236,49,35,8,737,,,,,,6/23/2020
5/25/2020,70,14209,1366,126812,141021,12,1664,14,1195,0,235,234,53,36,9,746,,,,,,6/23/2020
5/26/2020,152,14361,2558,129370,143731,23,1687,22,1217,5,240,230,47,33,15,761,,,,,,6/23/2020
5/27/2020,132,14493,2012,131382,145875,20,1707,17,1234,3,243,230,50,32,9,770,,,,,,6/23/2020
5/28/2020,132,14625,3286,134668,149293,17,1724,29,1263,4,247,214,46,29,7,777,,,,,,6/23/2020
5/29/2020,177,14802,3871,138539,153341,18,1742,27,1290,5,252,200,46,29,11,788,,,,,,6/23/2020
5/30/2020,104,14906,3919,142458,157364,15,1757,19,1309,4,256,192,48,31,10,798,,,,,,6/23/2020
5/31/2020,76,14982,1685,144143,159125,10,1767,10,1319,0,256,192,44,30,3,801,,,,,,6/23/2020
6/1/2020,98,15080,2739,146882,161962,8,1775,12,1331,1,257,187,42,29,4,805,,,,,,6/23/2020
6/2/2020,108,15188,2962,149844,165032,8,1783,9,1340,3,260,183,37,23,10,815,,,,,,6/23/2020
6/3/2020,103,15291,3453,153297,168588,13,1796,18,1358,6,266,172,--,--,10,825,,,,,,6/23/2020
6/4/2020,117,15408,4465,157762,173170,7,1803,25,1383,3,269,151,--,--,11,836,,,,,,6/23/2020
6/5/2020,105,15513,3447,161209,176722,14,1817,12,1395,5,274,148,28,20,9,845,,,,,,6/23/2020
6/6/2020,70,15583,2612,163821,179404,10,1827,7,1402,2,276,149,31,19,6,851,,,,,,6/23/2020
6/7/2020,49,15632,1585,165406,181038,11,1838,7,1409,1,277,152,27,16,4,855,,,,,,6/23/2020
6/8/2020,44,15676,1757,167163,182839,15,1853,12,1421,2,279,153,26,16,3,858,,,,,,6/23/2020
6/9/2020,67,15743,2546,169709,185452,10,1863,18,1439,0,279,145,28,17,1,859,,,,,,6/23/2020
6/10/2020,103,15846,2872,172581,188427,13,1876,12,1451,2,281,144,--,--,3,862,,,,,,6/23/2020
6/11/2020,86,15932,3385,175966,191898,7,1883,14,1465,1,282,136,--,--,5,867,,,,,,6/23/2020
6/12/2020,80,16012,4330,180296,196308,8,1891,14,1479,1,283,129,21,14,2,869,,,,,,6/23/2020
6/13/2020,48,16060,2731,183027,199087,6,1897,4,1483,0,283,131,16,13,2,871,,,,,,6/23/2020
6/14/2020,32,16092,1839,184866,200958,5,1902,7,1490,1,284,128,17,13,3,874,,,,,,6/23/2020
6/15/2020,76,16168,2981,187847,204015,12,1914,14,1504,0,284,126,23,13,4,878,,,,,,6/23/2020
6/16/2020,53,16221,2819,190666,206887,8,1922,10,1514,1,285,123,23,12,7,885,,,,,,6/23/2020
6/17/2020,49,16270,2589,193255,209525,11,1933,18,1532,4,289,112,--,--,6,891,,,,,,6/23/2020
6/18/2020,69,16339,2873,196128,212467,8,1941,11,1543,1,290,108,--,--,6,897,,,,,,6/23/2020
6/19/2020,59,16398,3439,199567,215965,11,1952,10,1553,1,291,108,18,15,3,900,,,,,,6/23/2020
6/20/2020,36,16434,1681,201248,217682,6,1958,9,1562,0,291,105,19,17,3,903,,,,,,6/23/2020
6/21/2020,28,16462,961,202209,218671,,,,,,,,,,2,905,,,,,,6/23/2020
6/22/2020,71,16533,3421,205630,222163,,,,,,,,,,1,906,,,,,,6/23/2020
2/27/2020,0,0,0,0,0,1,1,0,0,0,0,1,--,--,0,0,,,,,,6/24/2020
2/28/2020,0,0,0,0,0,0,1,0,0,0,0,1,--,--,0,0,,,,,,6/24/2020
2/29/2020,0,0,0,0,0,0,1,0,0,0,0,1,--,--,0,0,,,,,,6/24/2020
3/1/2020,2,2,2,2,4,0,1,0,0,0,0,1,--,--,0,0,,,,,,6/24/2020
3/2/2020,0,2,1,3,5,1,2,0,0,0,0,2,--,--,0,0,,,,,,6/24/2020
3/3/2020,0,2,2,5,7,0,2,0,0,0,0,2,--,--,0,0,,,,,,6/24/2020
3/4/2020,0,2,12,17,19,1,3,0,0,0,0,3,--,--,0,0,,,,,,6/24/2020
3/5/2020,1,3,4,21,24,0,3,0,0,0,0,3,--,--,0,0,,,,,,6/24/2020
3/6/2020,0,3,12,33,36,0,3,0,0,0,0,3,--,--,0,0,,,,,,6/24/2020
3/7/2020,0,3,19,52,55,0,3,0,0,0,0,3,--,--,0,0,,,,,,6/24/2020
3/8/2020,0,3,18,70,73,0,3,0,0,0,0,3,--,--,0,0,,,,,,6/24/2020
3/9/2020,1,4,15,85,89,0,3,0,0,0,0,3,--,--,0,0,,,,,,6/24/2020
3/10/2020,1,5,25,110,115,0,3,0,0,0,0,3,--,--,0,0,,,,,,6/24/2020
3/11/2020,0,5,34,144,149,1,4,0,0,0,0,4,--,--,0,0,,,,,,6/24/2020
3/12/2020,8,13,42,186,199,1,5,0,0,0,0,5,--,--,0,0,,,,,,6/24/2020
3/13/2020,6,19,50,236,255,4,9,1,1,0,0,8,--,--,0,0,,,,,,6/24/2020
3/14/2020,0,19,90,326,345,0,9,0,1,0,0,8,--,--,0,0,,,,,,6/24/2020
3/15/2020,1,20,54,380,400,1,10,0,1,0,0,9,--,--,0,0,,,,,,6/24/2020
3/16/2020,2,22,95,475,497,2,12,0,1,0,0,11,--,--,0,0,,,,,,6/24/2020
3/17/2020,11,33,162,637,670,6,18,0,1,0,0,17,--,--,0,0,,,,,,6/24/2020
3/18/2020,11,44,116,753,797,3,21,0,1,0,0,20,--,--,0,0,,,,,,6/24/2020
3/19/2020,17,61,262,1015,1076,2,23,1,2,0,0,21,--,--,1,1,,,,,,6/24/2020
3/20/2020,13,74,197,1212,1286,5,28,0,2,0,0,26,--,--,0,1,,,,,,6/24/2020
3/21/2020,14,88,126,1338,1426,3,31,2,4,0,0,27,--,--,0,1,,,,,,6/24/2020
3/22/2020,25,113,282,1620,1733,2,33,0,4,0,0,29,--,--,0,1,,,,,,6/24/2020
3/23/2020,16,129,169,1789,1918,16,49,1,5,0,0,44,--,--,0,1,,,,,,6/24/2020
3/24/2020,19,148,243,2032,2180,7,56,0,5,0,0,51,--,--,0,1,,,,,,6/24/2020
3/25/2020,28,176,183,2215,2391,5,61,1,6,0,0,55,--,--,0,1,,,,,,6/24/2020
3/26/2020,41,217,181,2396,2613,10,71,5,11,0,0,60,--,--,0,1,,,,,,6/24/2020
3/27/2020,31,248,215,2611,2859,9,80,1,12,1,1,67,--,--,2,3,,,,,,6/24/2020
3/28/2020,64,312,260,2871,3183,13,93,3,15,2,3,75,--,--,1,4,,,,,,6/24/2020
3/29/2020,105,417,356,3227,3644,8,101,4,19,1,4,78,--,--,2,6,,,,,,6/24/2020
3/30/2020,78,495,222,3449,3944,20,121,5,24,0,4,93,--,--,3,9,,,,,,6/24/2020
3/31/2020,73,568,369,3818,4386,11,132,7,31,1,5,96,--,--,2,11,,,,,,6/24/2020
4/1/2020,100,668,699,4517,5185,18,150,7,38,0,5,107,--,--,1,12,,,,,,6/24/2020
4/2/2020,62,730,477,4994,5724,21,171,6,44,2,7,120,--,--,4,16,,,,,,6/24/2020
4/3/2020,101,831,775,5769,6600,23,194,7,51,0,7,136,--,--,3,19,,,,,,6/24/2020
4/4/2020,137,968,660,6429,7397,22,216,4,55,5,12,149,--,--,9,28,,,,,,6/24/2020
4/5/2020,182,1150,1156,7585,8735,20,236,9,64,1,13,159,45,37,2,30,,,,,,6/24/2020
4/6/2020,206,1356,1707,9292,10648,26,262,7,71,0,13,178,45,38,7,37,,,,,,6/24/2020
4/7/2020,260,1616,1631,10923,12539,20,282,3,74,2,15,193,45,35,5,42,,,,,,6/24/2020
4/8/2020,274,1890,1723,12646,14536,19,301,8,82,6,21,198,50,36,10,52,,,,,,6/24/2020
4/9/2020,279,2169,1521,14167,16336,32,333,9,91,4,25,217,50,38,7,59,,,,,,6/24/2020
4/10/2020,404,2573,2577,16744,19317,29,362,17,108,5,30,224,48,36,11,70,,,,,,6/24/2020
4/11/2020,280,2853,1911,18655,21508,29,391,11,119,2,32,240,49,40,11,81,,,,,,6/24/2020
4/12/2020,288,3141,1674,20329,23470,35,426,13,132,5,37,257,54,44,10,91,,,,,,6/24/2020
4/13/2020,187,3328,938,21267,24595,35,461,13,145,3,40,276,61,43,9,100,,,,,,6/24/2020
4/14/2020,268,3596,1788,23055,26651,27,488,17,162,5,45,281,62,43,8,108,,,,,,6/24/2020
4/15/2020,307,3903,1803,24858,28761,31,519,19,181,3,48,290,67,43,17,125,,,,,,6/24/2020
4/16/2020,392,4295,2500,27358,31653,36,555,25,206,6,54,295,70,43,14,139,,,,,,6/24/2020
4/17/2020,290,4585,1823,29181,33766,31,586,21,227,7,61,298,62,45,21,160,,,,,,6/24/2020
4/18/2020,284,4869,1728,30909,35778,26,612,18,245,4,65,302,67,43,15,175,,,,,,6/24/2020
4/19/2020,339,5208,2059,32968,38176,23,635,26,271,1,66,298,71,44,11,186,,,,,,6/24/2020
4/20/2020,379,5587,1909,34877,40464,46,681,29,300,2,68,313,72,45,10,196,,,,,,6/24/2020
4/21/2020,387,5974,2114,36991,42965,45,726,31,331,5,73,322,77,48,18,214,,,,,,6/24/2020
4/22/2020,382,6356,2398,39389,45745,41,767,32,363,5,78,326,77,52,17,231,,,,,,6/24/2020
4/23/2020,419,6775,2471,41860,48635,31,798,28,391,5,83,324,78,53,14,245,,,,,,6/24/2020
4/24/2020,415,7190,3292,45152,52342,35,833,27,418,4,87,328,81,56,15,260,,,,,,6/24/2020
4/25/2020,305,7495,2210,47362,54857,34,867,17,435,5,92,340,84,55,14,274,,,,,,6/24/2020
4/26/2020,275,7770,2314,49676,57446,33,900,15,450,3,95,355,80,55,14,288,,,,,,6/24/2020
4/27/2020,203,7973,1624,51300,59273,29,929,21,471,4,99,359,98,62,10,298,,,,,,6/24/2020
4/28/2020,324,8297,2268,53568,61865,44,973,24,495,3,102,376,76,51,22,320,,,,,,6/24/2020
4/29/2020,371,8668,3351,56919,65587,36,1009,38,533,11,113,363,80,54,18,338,,,,,,6/24/2020
4/30/2020,349,9017,2772,59691,68708,33,1042,38,571,6,119,352,83,59,24,362,,,,,,6/24/2020
5/1/2020,317,9334,3089,62780,72114,51,1093,40,611,3,122,360,84,61,14,376,,,,,,6/24/2020
5/2/2020,189,9523,1926,64706,74229,36,1129,38,649,5,127,353,89,62,24,400,,,,,,6/24/2020
5/3/2020,182,9705,2168,66874,76579,31,1160,27,676,8,135,349,86,60,21,421,,,,,,6/24/2020
5/4/2020,291,9996,2101,68975,78971,30,1190,31,707,5,140,343,82,56,18,439,,,,,,6/24/2020
5/5/2020,304,10300,2878,71853,82153,28,1218,32,739,6,146,333,71,52,16,455,,,,,,6/24/2020
5/6/2020,345,10645,2836,74689,85334,28,1246,44,783,9,155,308,77,56,20,475,,,,,,6/24/2020
5/7/2020,272,10917,2904,77593,88510,36,1282,42,825,5,160,297,70,52,21,496,,,,,,6/24/2020
5/8/2020,233,11150,2494,80087,91237,30,1312,29,854,5,165,293,73,52,22,518,,,,,,6/24/2020
5/9/2020,287,11437,3290,83377,94814,22,1334,21,875,4,169,290,72,53,15,533,,,,,,6/24/2020
5/10/2020,187,11624,2090,85467,97091,20,1354,23,898,6,175,281,68,48,13,546,,,,,,6/24/2020
5/11/2020,173,11797,1796,87263,99060,31,1385,16,914,6,181,290,65,42,15,561,,,,,,6/24/2020
5/12/2020,219,12016,2433,89696,101712,23,1408,18,932,4,185,291,63,41,22,583,,,,,,6/24/2020
5/13/2020,196,12212,3518,93214,105426,22,1430,24,956,1,186,288,66,44,12,595,,,,,,6/24/2020
5/14/2020,217,12429,3292,96506,108935,19,1449,27,983,3,189,277,64,45,14,609,,,,,,6/24/2020
5/15/2020,228,12657,3314,99820,112477,24,1473,41,1024,5,194,255,62,46,13,622,,,,,,6/24/2020
5/16/2020,252,12909,3875,103695,116604,25,1498,13,1037,5,199,262,59,44,13,635,,,,,,6/24/2020
5/17/2020,128,13037,2706,106401,119438,17,1515,7,1044,5,204,267,58,45,10,645,,,,,,6/24/2020
5/18/2020,139,13176,1906,108307,121483,19,1534,15,1059,5,209,266,56,41,18,663,,,,,,6/24/2020
5/19/2020,213,13389,3080,111387,124776,23,1557,31,1090,5,214,253,56,40,10,673,,,,,,6/24/2020
5/20/2020,186,13575,2759,114146,127721,19,1576,23,1113,7,221,242,51,34,22,695,,,,,,6/24/2020
5/21/2020,170,13745,3748,117894,131639,26,1602,15,1128,3,224,250,49,32,19,714,,,,,,6/24/2020
5/22/2020,202,13947,2974,120868,134815,19,1621,29,1157,5,229,235,--,--,7,721,,,,,,6/24/2020
5/23/2020,107,14054,2725,123593,137647,19,1640,11,1168,3,232,240,50,36,13,734,,,,,,6/24/2020
5/24/2020,85,14139,1357,124950,139089,12,1652,14,1182,2,234,236,49,35,8,742,,,,,,6/24/2020
5/25/2020,70,14209,1366,126316,140525,12,1664,14,1196,0,234,234,53,36,9,751,,,,,,6/24/2020
5/26/2020,152,14361,2545,128861,143222,23,1687,22,1218,5,239,230,47,33,15,766,,,,,,6/24/2020
5/27/2020,132,14493,2005,130866,145359,20,1707,17,1235,3,242,230,50,32,9,775,,,,,,6/24/2020
5/28/2020,132,14625,3278,134144,148769,17,1724,29,1264,4,246,214,46,29,7,782,,,,,,6/24/2020
5/29/2020,177,14802,3863,138007,152809,18,1742,27,1291,5,251,200,46,29,11,793,,,,,,6/24/2020
5/30/2020,104,14906,3914,141921,156827,15,1757,19,1310,4,255,192,48,31,10,803,,,,,,6/24/2020
5/31/2020,76,14982,1675,143596,158578,10,1767,10,1320,0,255,192,44,30,3,806,,,,,,6/24/2020
6/1/2020,98,15080,2735,146331,161411,8,1775,12,1332,1,256,187,42,29,4,810,,,,,,6/24/2020
6/2/2020,108,15188,2953,149284,164472,8,1783,9,1341,3,259,183,37,23,10,820,,,,,,6/24/2020
6/3/2020,103,15291,3442,152726,168017,13,1796,18,1359,6,265,172,--,--,10,830,,,,,,6/24/2020
6/4/2020,117,15408,4454,157180,172588,7,1803,25,1384,3,268,151,--,--,11,841,,,,,,6/24/2020
6/5/2020,105,15513,3434,160614,176127,14,1817,12,1396,5,273,148,28,20,9,850,,,,,,6/24/2020
6/6/2020,70,15583,2604,163218,178801,10,1827,7,1403,2,275,149,31,19,6,856,,,,,,6/24/2020
6/7/2020,49,15632,1582,164800,180432,11,1838,7,1410,1,276,152,27,16,4,860,,,,,,6/24/2020
6/8/2020,44,15676,1750,166550,182226,15,1853,12,1422,2,278,153,26,16,3,863,,,,,,6/24/2020
6/9/2020,67,15743,2536,169086,184829,10,1863,18,1440,0,278,145,28,17,1,864,,,,,,6/24/2020
6/10/2020,103,15846,2861,171947,187793,13,1876,12,1452,2,280,144,--,--,3,867,,,,,,6/24/2020
6/11/2020,86,15932,3375,175322,191254,7,1883,15,1467,1,281,135,--,--,5,872,,,,,,6/24/2020
6/12/2020,80,16012,4326,179648,195660,8,1891,15,1482,1,282,127,21,14,2,874,,,,,,6/24/2020
6/13/2020,48,16060,2721,182369,198429,6,1897,4,1486,0,282,129,16,13,2,876,,,,,,6/24/2020
6/14/2020,32,16092,1835,184204,200296,6,1903,7,1493,1,283,127,17,13,3,879,,,,,,6/24/2020
6/15/2020,76,16168,2963,187167,203335,13,1916,14,1507,0,283,126,23,13,4,883,,,,,,6/24/2020
6/16/2020,53,16221,2811,189978,206199,9,1925,10,1517,1,284,124,23,12,7,890,,,,,,6/24/2020
6/17/2020,49,16270,2574,192552,208822,12,1937,19,1536,4,288,113,--,--,6,896,,,,,,6/24/2020
6/18/2020,69,16339,2869,195421,211760,8,1945,12,1548,1,289,108,--,--,6,902,,,,,,6/24/2020
6/19/2020,59,16398,3435,198856,215254,11,1956,11,1559,1,290,107,18,15,3,905,,,,,,6/24/2020
6/20/2020,36,16434,1676,200532,216966,6,1962,9,1568,0,290,104,19,17,3,908,,,,,,6/24/2020
6/21/2020,28,16462,959,201491,217953,5,1967,5,1573,0,290,104,20,16,2,910,,,,,,6/24/2020
6/22/2020,71,16533,3438,204929,221462,,,,,,,,,,1,911,,,,,,6/24/2020
6/23/2020,73,16606,3458,208387,224993,,,,,,,,,,1,912,,,,,,6/24/2020
2/27/2020,0,0,0,0,0,1,1,0,0,0,0,1,--,--,0,0,,,,,,6/25/2020
2/28/2020,0,0,0,0,0,0,1,0,0,0,0,1,--,--,0,0,,,,,,6/25/2020
2/29/2020,0,0,0,0,0,0,1,0,0,0,0,1,--,--,0,0,,,,,,6/25/2020
3/1/2020,2,2,2,2,4,0,1,0,0,0,0,1,--,--,0,0,,,,,,6/25/2020
3/2/2020,0,2,1,3,5,1,2,0,0,0,0,2,--,--,0,0,,,,,,6/25/2020
3/3/2020,0,2,2,5,7,0,2,0,0,0,0,2,--,--,0,0,,,,,,6/25/2020
3/4/2020,0,2,12,17,19,1,3,0,0,0,0,3,--,--,0,0,,,,,,6/25/2020
3/5/2020,1,3,4,21,24,0,3,0,0,0,0,3,--,--,0,0,,,,,,6/25/2020
3/6/2020,0,3,12,33,36,0,3,0,0,0,0,3,--,--,0,0,,,,,,6/25/2020
3/7/2020,0,3,19,52,55,0,3,0,0,0,0,3,--,--,0,0,,,,,,6/25/2020
3/8/2020,0,3,18,70,73,0,3,0,0,0,0,3,--,--,0,0,,,,,,6/25/2020
3/9/2020,1,4,15,85,89,0,3,0,0,0,0,3,--,--,0,0,,,,,,6/25/2020
3/10/2020,1,5,25,110,115,0,3,0,0,0,0,3,--,--,0,0,,,,,,6/25/2020
3/11/2020,0,5,34,144,149,1,4,0,0,0,0,4,--,--,0,0,,,,,,6/25/2020
3/12/2020,8,13,42,186,199,1,5,0,0,0,0,5,--,--,0,0,,,,,,6/25/2020
3/13/2020,6,19,50,236,255,4,9,1,1,0,0,8,--,--,0,0,,,,,,6/25/2020
3/14/2020,0,19,90,326,345,0,9,0,1,0,0,8,--,--,0,0,,,,,,6/25/2020
3/15/2020,1,20,54,380,400,1,10,0,1,0,0,9,--,--,0,0,,,,,,6/25/2020
3/16/2020,2,22,95,475,497,2,12,0,1,0,0,11,--,--,0,0,,,,,,6/25/2020
3/17/2020,11,33,162,637,670,6,18,0,1,0,0,17,--,--,0,0,,,,,,6/25/2020
3/18/2020,11,44,116,753,797,3,21,0,1,0,0,20,--,--,0,0,,,,,,6/25/2020
3/19/2020,17,61,262,1015,1076,2,23,1,2,0,0,21,--,--,1,1,,,,,,6/25/2020
3/20/2020,13,74,197,1212,1286,5,28,0,2,0,0,26,--,--,0,1,,,,,,6/25/2020
3/21/2020,14,88,126,1338,1426,3,31,2,4,0,0,27,--,--,0,1,,,,,,6/25/2020
3/22/2020,25,113,282,1620,1733,2,33,0,4,0,0,29,--,--,0,1,,,,,,6/25/2020
3/23/2020,16,129,169,1789,1918,16,49,1,5,0,0,44,--,--,0,1,,,,,,6/25/2020
3/24/2020,19,148,243,2032,2180,7,56,0,5,0,0,51,--,--,0,1,,,,,,6/25/2020
3/25/2020,28,176,183,2215,2391,5,61,1,6,0,0,55,--,--,0,1,,,,,,6/25/2020
3/26/2020,41,217,181,2396,2613,10,71,5,11,0,0,60,--,--,0,1,,,,,,6/25/2020
3/27/2020,31,248,215,2611,2859,9,80,1,12,1,1,67,--,--,2,3,,,,,,6/25/2020
3/28/2020,64,312,260,2871,3183,13,93,3,15,2,3,75,--,--,1,4,,,,,,6/25/2020
3/29/2020,105,417,356,3227,3644,8,101,4,19,1,4,78,--,--,2,6,,,,,,6/25/2020
3/30/2020,78,495,222,3449,3944,20,121,5,24,0,4,93,--,--,3,9,,,,,,6/25/2020
3/31/2020,73,568,369,3818,4386,11,132,7,31,1,5,96,--,--,2,11,,,,,,6/25/2020
4/1/2020,100,668,699,4517,5185,18,150,7,38,0,5,107,--,--,1,12,,,,,,6/25/2020
4/2/2020,62,730,477,4994,5724,21,171,6,44,2,7,120,--,--,4,16,,,,,,6/25/2020
4/3/2020,101,831,775,5769,6600,23,194,7,51,0,7,136,--,--,3,19,,,,,,6/25/2020
4/4/2020,137,968,660,6429,7397,22,216,4,55,5,12,149,--,--,9,28,,,,,,6/25/2020
4/5/2020,182,1150,1156,7585,8735,20,236,9,64,1,13,159,45,37,2,30,,,,,,6/25/2020
4/6/2020,206,1356,1707,9292,10648,26,262,7,71,0,13,178,45,38,7,37,,,,,,6/25/2020
4/7/2020,260,1616,1631,10923,12539,20,282,3,74,2,15,193,45,35,5,42,,,,,,6/25/2020
4/8/2020,274,1890,1723,12646,14536,19,301,8,82,6,21,198,50,36,10,52,,,,,,6/25/2020
4/9/2020,279,2169,1521,14167,16336,32,333,9,91,4,25,217,50,38,7,59,,,,,,6/25/2020
4/10/2020,404,2573,2577,16744,19317,29,362,17,108,5,30,224,48,36,11,70,,,,,,6/25/2020
4/11/2020,280,2853,1911,18655,21508,29,391,11,119,2,32,240,49,40,11,81,,,,,,6/25/2020
4/12/2020,288,3141,1674,20329,23470,35,426,13,132,5,37,257,54,44,10,91,,,,,,6/25/2020
4/13/2020,187,3328,938,21267,24595,35,461,13,145,3,40,276,61,43,9,100,,,,,,6/25/2020
4/14/2020,268,3596,1788,23055,26651,27,488,17,162,5,45,281,62,43,8,108,,,,,,6/25/2020
4/15/2020,307,3903,1803,24858,28761,31,519,19,181,3,48,290,67,43,17,125,,,,,,6/25/2020
4/16/2020,392,4295,2500,27358,31653,36,555,25,206,6,54,295,70,43,14,139,,,,,,6/25/2020
4/17/2020,290,4585,1823,29181,33766,31,586,21,227,7,61,298,62,45,21,160,,,,,,6/25/2020
4/18/2020,284,4869,1728,30909,35778,25,611,18,245,4,65,301,67,43,15,175,,,,,,6/25/2020
4/19/2020,339,5208,2059,32968,38176,23,634,26,271,1,66,297,71,44,11,186,,,,,,6/25/2020
4/20/2020,379,5587,1909,34877,40464,46,680,29,300,2,68,312,72,45,10,196,,,,,,6/25/2020
4/21/2020,387,5974,2114,36991,42965,45,725,31,331,5,73,321,77,48,18,214,,,,,,6/25/2020
4/22/2020,382,6356,2398,39389,45745,41,766,32,363,5,78,325,77,52,17,231,,,,,,6/25/2020
4/23/2020,419,6775,2471,41860,48635,31,797,28,391,5,83,323,78,53,14,245,,,,,,6/25/2020
4/24/2020,415,7190,3292,45152,52342,35,832,27,418,4,87,327,81,56,15,260,,,,,,6/25/2020
4/25/2020,305,7495,2210,47362,54857,34,866,17,435,5,92,339,84,55,14,274,,,,,,6/25/2020
4/26/2020,275,7770,2314,49676,57446,33,899,15,450,3,95,354,80,55,14,288,,,,,,6/25/2020
4/27/2020,203,7973,1624,51300,59273,29,928,21,471,4,99,358,98,62,10,298,,,,,,6/25/2020
4/28/2020,324,8297,2268,53568,61865,44,972,24,495,3,102,375,76,51,22,320,,,,,,6/25/2020
4/29/2020,371,8668,3351,56919,65587,36,1008,38,533,11,113,362,80,54,18,338,,,,,,6/25/2020
4/30/2020,349,9017,2772,59691,68708,33,1041,37,570,6,119,352,83,59,24,362,,,,,,6/25/2020
5/1/2020,317,9334,3089,62780,72114,51,1092,40,610,3,122,360,84,61,14,376,,,,,,6/25/2020
5/2/2020,189,9523,1926,64706,74229,36,1128,38,648,5,127,353,89,62,24,400,,,,,,6/25/2020
5/3/2020,182,9705,2168,66874,76579,31,1159,27,675,8,135,349,86,60,21,421,,,,,,6/25/2020
5/4/2020,291,9996,2101,68975,78971,30,1189,31,706,5,140,343,82,56,18,439,,,,,,6/25/2020
5/5/2020,304,10300,2878,71853,82153,28,1217,32,738,6,146,333,71,52,16,455,,,,,,6/25/2020
5/6/2020,345,10645,2836,74689,85334,28,1245,44,782,9,155,308,77,56,20,475,,,,,,6/25/2020
5/7/2020,273,10918,2904,77593,88511,36,1281,42,824,5,160,297,70,52,21,496,,,,,,6/25/2020
5/8/2020,232,11150,2494,80087,91237,30,1311,29,853,5,165,293,73,52,22,518,,,,,,6/25/2020
5/9/2020,287,11437,3290,83377,94814,22,1333,21,874,4,169,290,72,53,15,533,,,,,,6/25/2020
5/10/2020,187,11624,2090,85467,97091,20,1353,23,897,6,175,281,68,48,13,546,,,,,,6/25/2020
5/11/2020,173,11797,1796,87263,99060,31,1384,16,913,6,181,290,65,42,15,561,,,,,,6/25/2020
5/12/2020,219,12016,2433,89696,101712,23,1407,18,931,4,185,291,63,41,22,583,,,,,,6/25/2020
5/13/2020,196,12212,3518,93214,105426,22,1429,24,955,1,186,288,66,44,13,596,,,,,,6/25/2020
5/14/2020,217,12429,3292,96506,108935,19,1448,27,982,3,189,277,64,45,15,611,,,,,,6/25/2020
5/15/2020,228,12657,3314,99820,112477,24,1472,41,1023,5,194,255,62,46,13,624,,,,,,6/25/2020
5/16/2020,252,12909,3875,103695,116604,25,1497,13,1036,5,199,262,59,44,14,638,,,,,,6/25/2020
5/17/2020,128,13037,2706,106401,119438,17,1514,7,1043,5,204,267,58,45,10,648,,,,,,6/25/2020
5/18/2020,139,13176,1906,108307,121483,19,1533,15,1058,5,209,266,56,41,18,666,,,,,,6/25/2020
5/19/2020,213,13389,3080,111387,124776,23,1556,31,1089,5,214,253,56,40,10,676,,,,,,6/25/2020
5/20/2020,186,13575,2759,114146,127721,19,1575,23,1112,7,221,242,51,34,22,698,,,,,,6/25/2020
5/21/2020,170,13745,3748,117894,131639,26,1601,15,1127,3,224,250,49,32,19,717,,,,,,6/25/2020
5/22/2020,202,13947,2974,120868,134815,19,1620,29,1156,5,229,235,--,--,7,724,,,,,,6/25/2020
5/23/2020,107,14054,2725,123593,137647,19,1639,11,1167,3,232,240,50,36,13,737,,,,,,6/25/2020
5/24/2020,85,14139,1357,124950,139089,12,1651,14,1181,2,234,236,49,35,8,745,,,,,,6/25/2020
5/25/2020,70,14209,1366,126316,140525,12,1663,14,1195,0,234,234,53,36,9,754,,,,,,6/25/2020
5/26/2020,152,14361,2545,128861,143222,23,1686,22,1217,5,239,230,47,33,15,769,,,,,,6/25/2020
5/27/2020,132,14493,2005,130866,145359,20,1706,17,1234,3,242,230,50,32,9,778,,,,,,6/25/2020
5/28/2020,132,14625,3278,134144,148769,17,1723,29,1263,4,246,214,46,29,7,785,,,,,,6/25/2020
5/29/2020,177,14802,3863,138007,152809,18,1741,27,1290,5,251,200,46,29,11,796,,,,,,6/25/2020
5/30/2020,104,14906,3914,141921,156827,15,1756,19,1309,4,255,192,48,31,10,806,,,,,,6/25/2020
5/31/2020,76,14982,1675,143596,158578,10,1766,10,1319,0,255,192,44,30,3,809,,,,,,6/25/2020
6/1/2020,98,15080,2735,146331,161411,8,1774,12,1331,1,256,187,42,29,4,813,,,,,,6/25/2020
6/2/2020,108,15188,2953,149284,164472,8,1782,9,1340,3,259,183,37,23,10,823,,,,,,6/25/2020
6/3/2020,103,15291,3442,152726,168017,13,1795,18,1358,6,265,172,--,--,10,833,,,,,,6/25/2020
6/4/2020,117,15408,4454,157180,172588,7,1802,25,1383,3,268,151,--,--,11,844,,,,,,6/25/2020
6/5/2020,105,15513,3434,160614,176127,15,1817,12,1395,5,273,149,28,20,9,853,,,,,,6/25/2020
6/6/2020,70,15583,2604,163218,178801,10,1827,7,1402,2,275,150,31,19,6,859,,,,,,6/25/2020
6/7/2020,49,15632,1582,164800,180432,11,1838,7,1409,1,276,153,27,16,4,863,,,,,,6/25/2020
6/8/2020,44,15676,1750,166550,182226,15,1853,12,1421,2,278,154,26,16,3,866,,,,,,6/25/2020
6/9/2020,68,15744,2536,169086,184830,10,1863,18,1439,0,278,146,28,17,1,867,,,,,,6/25/2020
6/10/2020,103,15847,2861,171947,187794,13,1876,12,1451,2,280,145,--,--,3,870,,,,,,6/25/2020
6/11/2020,87,15934,3375,175322,191256,7,1883,15,1466,1,281,136,--,--,5,875,,,,,,6/25/2020
6/12/2020,80,16014,4326,179648,195662,8,1891,15,1481,1,282,128,21,14,2,877,,,,,,6/25/2020
6/13/2020,48,16062,2721,182369,198431,6,1897,4,1485,0,282,130,16,13,2,879,,,,,,6/25/2020
6/14/2020,32,16094,1835,184204,200298,6,1903,7,1492,1,283,128,17,13,3,882,,,,,,6/25/2020
6/15/2020,75,16169,2963,187167,203336,13,1916,14,1506,0,283,127,23,13,4,886,,,,,,6/25/2020
6/16/2020,53,16222,2811,189978,206200,9,1925,10,1516,1,284,125,23,12,7,893,,,,,,6/25/2020
6/17/2020,49,16271,2574,192552,208823,12,1937,19,1535,4,288,114,--,--,6,899,,,,,,6/25/2020
6/18/2020,70,16341,2869,195421,211762,9,1946,12,1547,1,289,110,--,--,6,905,,,,,,6/25/2020
6/19/2020,59,16400,3435,198856,215256,12,1958,11,1558,1,290,110,18,15,3,908,,,,,,6/25/2020
6/20/2020,36,16436,1676,200532,216968,7,1965,9,1567,0,290,108,19,17,3,911,,,,,,6/25/2020
6/21/2020,27,16463,959,201491,217954,5,1970,5,1572,0,290,108,20,16,2,913,,,,,,6/25/2020
6/22/2020,63,16526,3449,204940,221466,11,1981,16,1588,0,290,103,18,17,1,914,,,,,,6/25/2020
6/23/2020,74,16600,3459,208399,224999,,,,,,,,,,5,919,,,,,,6/25/2020
6/24/2020,40,16640,3101,211500,228140,,,,,,,,,,1,920,,,,,,6/25/2020
2/27/2020,0,0,0,0,0,1,1,0,0,0,0,1,--,--,0,0,,,,,,6/26/2020
2/28/2020,0,0,0,0,0,0,1,0,0,0,0,1,--,--,0,0,,,,,,6/26/2020
2/29/2020,0,0,0,0,0,0,1,0,0,0,0,1,--,--,0,0,,,,,,6/26/2020
3/1/2020,2,2,2,2,4,0,1,0,0,0,0,1,--,--,0,0,,,,,,6/26/2020
3/2/2020,0,2,1,3,5,1,2,0,0,0,0,2,--,--,0,0,,,,,,6/26/2020
3/3/2020,0,2,2,5,7,0,2,0,0,0,0,2,--,--,0,0,,,,,,6/26/2020
3/4/2020,0,2,12,17,19,1,3,0,0,0,0,3,--,--,0,0,,,,,,6/26/2020
3/5/2020,1,3,4,21,24,0,3,0,0,0,0,3,--,--,0,0,,,,,,6/26/2020
3/6/2020,0,3,12,33,36,0,3,0,0,0,0,3,--,--,0,0,,,,,,6/26/2020
3/7/2020,0,3,19,52,55,0,3,0,0,0,0,3,--,--,0,0,,,,,,6/26/2020
3/8/2020,0,3,18,70,73,0,3,0,0,0,0,3,--,--,0,0,,,,,,6/26/2020
3/9/2020,1,4,15,85,89,0,3,0,0,0,0,3,--,--,0,0,,,,,,6/26/2020
3/10/2020,1,5,25,110,115,0,3,0,0,0,0,3,--,--,0,0,,,,,,6/26/2020
3/11/2020,0,5,34,144,149,1,4,0,0,0,0,4,--,--,0,0,,,,,,6/26/2020
3/12/2020,8,13,42,186,199,1,5,0,0,0,0,5,--,--,0,0,,,,,,6/26/2020
3/13/2020,6,19,50,236,255,4,9,1,1,0,0,8,--,--,0,0,,,,,,6/26/2020
3/14/2020,0,19,90,326,345,0,9,0,1,0,0,8,--,--,0,0,,,,,,6/26/2020
3/15/2020,1,20,54,380,400,1,10,0,1,0,0,9,--,--,0,0,,,,,,6/26/2020
3/16/2020,2,22,95,475,497,2,12,0,1,0,0,11,--,--,0,0,,,,,,6/26/2020
3/17/2020,11,33,162,637,670,6,18,0,1,0,0,17,--,--,0,0,,,,,,6/26/2020
3/18/2020,11,44,116,753,797,3,21,0,1,0,0,20,--,--,0,0,,,,,,6/26/2020
3/19/2020,17,61,262,1015,1076,2,23,1,2,0,0,21,--,--,1,1,,,,,,6/26/2020
3/20/2020,13,74,197,1212,1286,5,28,0,2,0,0,26,--,--,0,1,,,,,,6/26/2020
3/21/2020,14,88,126,1338,1426,3,31,2,4,0,0,27,--,--,0,1,,,,,,6/26/2020
3/22/2020,25,113,282,1620,1733,2,33,0,4,0,0,29,--,--,0,1,,,,,,6/26/2020
3/23/2020,16,129,169,1789,1918,16,49,1,5,0,0,44,--,--,0,1,,,,,,6/26/2020
3/24/2020,19,148,243,2032,2180,7,56,0,5,0,0,51,--,--,0,1,,,,,,6/26/2020
3/25/2020,28,176,183,2215,2391,5,61,1,6,0,0,55,--,--,0,1,,,,,,6/26/2020
3/26/2020,41,217,181,2396,2613,10,71,5,11,0,0,60,--,--,0,1,,,,,,6/26/2020
3/27/2020,31,248,215,2611,2859,9,80,1,12,1,1,67,--,--,2,3,,,,,,6/26/2020
3/28/2020,64,312,260,2871,3183,13,93,3,15,2,3,75,--,--,1,4,,,,,,6/26/2020
3/29/2020,105,417,356,3227,3644,8,101,4,19,1,4,78,--,--,2,6,,,,,,6/26/2020
3/30/2020,78,495,222,3449,3944,20,121,5,24,0,4,93,--,--,3,9,,,,,,6/26/2020
3/31/2020,73,568,369,3818,4386,11,132,7,31,1,5,96,--,--,2,11,,,,,,6/26/2020
4/1/2020,100,668,699,4517,5185,18,150,7,38,0,5,107,--,--,1,12,,,,,,6/26/2020
4/2/2020,62,730,477,4994,5724,21,171,6,44,2,7,120,--,--,4,16,,,,,,6/26/2020
4/3/2020,101,831,775,5769,6600,23,194,7,51,0,7,136,--,--,3,19,,,,,,6/26/2020
4/4/2020,137,968,660,6429,7397,22,216,4,55,5,12,149,--,--,9,28,,,,,,6/26/2020
4/5/2020,182,1150,1156,7585,8735,20,236,9,64,1,13,159,45,37,2,30,,,,,,6/26/2020
4/6/2020,206,1356,1707,9292,10648,26,262,7,71,0,13,178,45,38,7,37,,,,,,6/26/2020
4/7/2020,260,1616,1631,10923,12539,20,282,3,74,2,15,193,45,35,5,42,,,,,,6/26/2020
4/8/2020,273,1889,1723,12646,14535,19,301,8,82,6,21,198,50,36,10,52,,,,,,6/26/2020
4/9/2020,279,2168,1521,14167,16335,32,333,9,91,4,25,217,50,38,7,59,,,,,,6/26/2020
4/10/2020,404,2572,2577,16744,19316,29,362,17,108,5,30,224,48,36,11,70,,,,,,6/26/2020
4/11/2020,280,2852,1911,18655,21507,29,391,11,119,2,32,240,49,40,11,81,,,,,,6/26/2020
4/12/2020,288,3140,1674,20329,23469,35,426,13,132,5,37,257,54,44,10,91,,,,,,6/26/2020
4/13/2020,187,3327,938,21267,24594,35,461,13,145,3,40,276,61,43,9,100,,,,,,6/26/2020
4/14/2020,267,3594,1788,23055,26649,27,488,17,162,5,45,281,62,43,8,108,,,,,,6/26/2020
4/15/2020,307,3901,1803,24858,28759,31,519,19,181,3,48,290,67,43,17,125,,,,,,6/26/2020
4/16/2020,392,4293,2500,27358,31651,36,555,25,206,6,54,295,70,43,14,139,,,,,,6/26/2020
4/17/2020,290,4583,1823,29181,33764,31,586,21,227,7,61,298,62,45,21,160,,,,,,6/26/2020
4/18/2020,284,4867,1728,30909,35776,26,612,18,245,4,65,302,67,43,15,175,,,,,,6/26/2020
4/19/2020,339,5206,2059,32968,38174,23,635,26,271,1,66,298,71,44,11,186,,,,,,6/26/2020
4/20/2020,379,5585,1909,34877,40462,46,681,29,300,2,68,313,72,45,10,196,,,,,,6/26/2020
4/21/2020,387,5972,2114,36991,42963,45,726,31,331,5,73,322,77,48,18,214,,,,,,6/26/2020
4/22/2020,382,6354,2398,39389,45743,41,767,32,363,5,78,326,77,52,17,231,,,,,,6/26/2020
4/23/2020,419,6773,2471,41860,48633,31,798,28,391,5,83,324,78,53,14,245,,,,,,6/26/2020
4/24/2020,415,7188,3292,45152,52340,35,833,27,418,4,87,328,81,56,15,260,,,,,,6/26/2020
4/25/2020,305,7493,2210,47362,54855,34,867,17,435,5,92,340,84,55,14,274,,,,,,6/26/2020
4/26/2020,275,7768,2314,49676,57444,33,900,15,450,3,95,355,80,55,14,288,,,,,,6/26/2020
4/27/2020,203,7971,1624,51300,59271,29,929,21,471,4,99,359,98,62,10,298,,,,,,6/26/2020
4/28/2020,324,8295,2268,53568,61863,44,973,24,495,3,102,376,76,51,22,320,,,,,,6/26/2020
4/29/2020,371,8666,3351,56919,65585,36,1009,38,533,11,113,363,80,54,18,338,,,,,,6/26/2020
4/30/2020,349,9015,2772,59691,68706,33,1042,38,571,6,119,352,83,59,24,362,,,,,,6/26/2020
5/1/2020,317,9332,3089,62780,72112,51,1093,40,611,3,122,360,84,61,14,376,,,,,,6/26/2020
5/2/2020,189,9521,1926,64706,74227,35,1128,38,649,5,127,352,89,62,24,400,,,,,,6/26/2020
5/3/2020,182,9703,2168,66874,76577,31,1159,27,676,8,135,348,86,60,21,421,,,,,,6/26/2020
5/4/2020,291,9994,2101,68975,78969,30,1189,31,707,5,140,342,82,56,18,439,,,,,,6/26/2020
5/5/2020,304,10298,2878,71853,82151,28,1217,32,739,6,146,332,71,52,16,455,,,,,,6/26/2020
5/6/2020,345,10643,2836,74689,85332,28,1245,44,783,9,155,307,77,56,20,475,,,,,,6/26/2020
5/7/2020,272,10915,2904,77593,88508,36,1281,41,824,5,160,297,70,52,21,496,,,,,,6/26/2020
5/8/2020,232,11147,2494,80087,91234,30,1311,29,853,5,165,293,73,52,22,518,,,,,,6/26/2020
5/9/2020,287,11434,3290,83377,94811,22,1333,21,874,4,169,290,72,53,15,533,,,,,,6/26/2020
5/10/2020,187,11621,2090,85467,97088,20,1353,23,897,6,175,281,68,48,13,546,,,,,,6/26/2020
5/11/2020,173,11794,1796,87263,99057,31,1384,16,913,6,181,290,65,42,15,561,,,,,,6/26/2020
5/12/2020,219,12013,2433,89696,101709,23,1407,18,931,4,185,291,63,41,22,583,,,,,,6/26/2020
5/13/2020,196,12209,3518,93214,105423,22,1429,24,955,1,186,288,66,44,13,596,,,,,,6/26/2020
5/14/2020,217,12426,3292,96506,108932,19,1448,27,982,3,189,277,64,45,15,611,,,,,,6/26/2020
5/15/2020,228,12654,3314,99820,112474,24,1472,41,1023,5,194,255,62,46,13,624,,,,,,6/26/2020
5/16/2020,252,12906,3875,103695,116601,25,1497,13,1036,5,199,262,59,44,14,638,,,,,,6/26/2020
5/17/2020,128,13034,2706,106401,119435,17,1514,7,1043,5,204,267,58,45,10,648,,,,,,6/26/2020
5/18/2020,139,13173,1906,108307,121480,19,1533,15,1058,5,209,266,56,41,18,666,,,,,,6/26/2020
5/19/2020,213,13386,3080,111387,124773,23,1556,31,1089,5,214,253,56,40,11,677,,,,,,6/26/2020
5/20/2020,186,13572,2759,114146,127718,19,1575,23,1112,7,221,242,51,34,22,699,,,,,,6/26/2020
5/21/2020,169,13741,3748,117894,131635,26,1601,15,1127,3,224,250,49,32,20,719,,,,,,6/26/2020
5/22/2020,202,13943,2973,120867,134810,19,1620,29,1156,5,229,235,--,--,8,727,,,,,,6/26/2020
5/23/2020,107,14050,2725,123592,137642,19,1639,11,1167,3,232,240,50,36,13,740,,,,,,6/26/2020
5/24/2020,85,14135,1357,124949,139084,12,1651,14,1181,2,234,236,49,35,8,748,,,,,,6/26/2020
5/25/2020,70,14205,1366,126315,140520,12,1663,14,1195,0,234,234,53,36,9,757,,,,,,6/26/2020
5/26/2020,152,14357,2544,128859,143216,23,1686,22,1217,5,239,230,47,33,15,772,,,,,,6/26/2020
5/27/2020,132,14489,2005,130864,145353,20,1706,17,1234,3,242,230,50,32,9,781,,,,,,6/26/2020
5/28/2020,132,14621,3278,134142,148763,17,1723,29,1263,4,246,214,46,29,7,788,,,,,,6/26/2020
5/29/2020,177,14798,3863,138005,152803,18,1741,27,1290,5,251,200,46,29,11,799,,,,,,6/26/2020
5/30/2020,104,14902,3913,141918,156820,15,1756,19,1309,4,255,192,48,31,10,809,,,,,,6/26/2020
5/31/2020,76,14978,1674,143592,158570,10,1766,10,1319,0,255,192,44,30,3,812,,,,,,6/26/2020
6/1/2020,90,15068,2735,146327,161395,8,1774,12,1331,1,256,187,42,29,4,816,,,,,,6/26/2020
6/2/2020,108,15176,2951,149278,164454,8,1782,9,1340,3,259,183,37,23,10,826,,,,,,6/26/2020
6/3/2020,103,15279,3441,152719,167998,13,1795,18,1358,6,265,172,--,--,10,836,,,,,,6/26/2020
6/4/2020,117,15396,4453,157172,172568,7,1802,25,1383,3,268,151,--,--,11,847,,,,,,6/26/2020
6/5/2020,105,15501,3432,160604,176105,15,1817,12,1395,5,273,149,28,20,9,856,,,,,,6/26/2020
6/6/2020,70,15571,2604,163208,178779,10,1827,7,1402,2,275,150,31,19,6,862,,,,,,6/26/2020
6/7/2020,49,15620,1582,164790,180410,11,1838,7,1409,1,276,153,27,16,4,866,,,,,,6/26/2020
6/8/2020,44,15664,1749,166539,182203,15,1853,12,1421,2,278,154,26,16,3,869,,,,,,6/26/2020
6/9/2020,68,15732,2536,169075,184807,10,1863,18,1439,0,278,146,28,17,1,870,,,,,,6/26/2020
6/10/2020,103,15835,2861,171936,187771,13,1876,12,1451,2,280,145,--,--,3,873,,,,,,6/26/2020
6/11/2020,87,15922,3375,175311,191233,7,1883,15,1466,1,281,136,--,--,5,878,,,,,,6/26/2020
6/12/2020,80,16002,4326,179637,195639,8,1891,15,1481,1,282,128,21,14,2,880,,,,,,6/26/2020
6/13/2020,48,16050,2721,182358,198408,6,1897,4,1485,0,282,130,16,13,2,882,,,,,,6/26/2020
6/14/2020,32,16082,1849,184207,200289,6,1903,7,1492,1,283,128,17,13,3,885,,,,,,6/26/2020
6/15/2020,75,16157,2963,187170,203327,13,1916,14,1506,0,283,127,23,13,4,889,,,,,,6/26/2020
6/16/2020,53,16210,2811,189981,206191,9,1925,10,1516,1,284,125,23,12,8,897,,,,,,6/26/2020
6/17/2020,49,16259,2574,192555,208814,12,1937,19,1535,4,288,114,--,--,6,903,,,,,,6/26/2020
6/18/2020,70,16329,2869,195424,211753,9,1946,12,1547,1,289,110,--,--,7,910,,,,,,6/26/2020
6/19/2020,58,16387,3435,198859,215246,12,1958,11,1558,1,290,110,18,15,3,913,,,,,,6/26/2020
6/20/2020,37,16424,1676,200535,216959,7,1965,9,1567,0,290,108,19,17,3,916,,,,,,6/26/2020
6/21/2020,27,16451,959,201494,217945,6,1971,5,1572,0,290,109,20,16,2,918,,,,,,6/26/2020
6/22/2020,63,16514,3475,204969,221483,11,1982,16,1588,0,290,104,18,17,1,919,,,,,,6/26/2020
6/23/2020,72,16586,3522,208491,225077,2,1984,12,1600,3,293,91,16,15,5,924,,,,,,6/26/2020
6/24/2020,50,16636,3128,211619,228255,,,,,,,,,,3,927,,,,,,6/26/2020
6/25/2020,25,16661,2228,213847,230508,,,,,,,,,,0,927,,,,,,6/26/2020
2/27/2020,0,0,0,0,0,1,1,0,0,0,0,1,--,--,0,0,,,,,,6/29/2020
2/28/2020,0,0,0,0,0,0,1,0,0,0,0,1,--,--,0,0,,,,,,6/29/2020
2/29/2020,0,0,0,0,0,0,1,0,0,0,0,1,--,--,0,0,,,,,,6/29/2020
3/1/2020,2,2,2,2,4,0,1,0,0,0,0,1,--,--,0,0,,,,,,6/29/2020
3/2/2020,0,2,1,3,5,1,2,0,0,0,0,2,--,--,0,0,,,,,,6/29/2020
3/3/2020,0,2,2,5,7,0,2,0,0,0,0,2,--,--,0,0,,,,,,6/29/2020
3/4/2020,0,2,12,17,19,1,3,0,0,0,0,3,--,--,0,0,,,,,,6/29/2020
3/5/2020,1,3,4,21,24,0,3,0,0,0,0,3,--,--,0,0,,,,,,6/29/2020
3/6/2020,0,3,12,33,36,0,3,0,0,0,0,3,--,--,0,0,,,,,,6/29/2020
3/7/2020,0,3,19,52,55,0,3,0,0,0,0,3,--,--,0,0,,,,,,6/29/2020
3/8/2020,0,3,18,70,73,0,3,0,0,0,0,3,--,--,0,0,,,,,,6/29/2020
3/9/2020,1,4,15,85,89,0,3,0,0,0,0,3,--,--,0,0,,,,,,6/29/2020
3/10/2020,1,5,25,110,115,0,3,0,0,0,0,3,--,--,0,0,,,,,,6/29/2020
3/11/2020,0,5,34,144,149,1,4,0,0,0,0,4,--,--,0,0,,,,,,6/29/2020
3/12/2020,8,13,42,186,199,1,5,0,0,0,0,5,--,--,0,0,,,,,,6/29/2020
3/13/2020,6,19,50,236,255,4,9,1,1,0,0,8,--,--,0,0,,,,,,6/29/2020
3/14/2020,0,19,90,326,345,0,9,0,1,0,0,8,--,--,0,0,,,,,,6/29/2020
3/15/2020,1,20,54,380,400,1,10,0,1,0,0,9,--,--,0,0,,,,,,6/29/2020
3/16/2020,2,22,95,475,497,2,12,0,1,0,0,11,--,--,0,0,,,,,,6/29/2020
3/17/2020,11,33,162,637,670,6,18,0,1,0,0,17,--,--,0,0,,,,,,6/29/2020
3/18/2020,11,44,116,753,797,3,21,0,1,0,0,20,--,--,0,0,,,,,,6/29/2020
3/19/2020,17,61,262,1015,1076,2,23,1,2,0,0,21,--,--,1,1,,,,,,6/29/2020
3/20/2020,13,74,197,1212,1286,5,28,0,2,0,0,26,--,--,0,1,,,,,,6/29/2020
3/21/2020,14,88,126,1338,1426,3,31,2,4,0,0,27,--,--,0,1,,,,,,6/29/2020
3/22/2020,25,113,282,1620,1733,2,33,0,4,0,0,29,--,--,0,1,,,,,,6/29/2020
3/23/2020,16,129,169,1789,1918,16,49,1,5,0,0,44,--,--,0,1,,,,,,6/29/2020
3/24/2020,19,148,243,2032,2180,7,56,0,5,0,0,51,--,--,0,1,,,,,,6/29/2020
3/25/2020,28,176,183,2215,2391,5,61,1,6,0,0,55,--,--,0,1,,,,,,6/29/2020
3/26/2020,41,217,181,2396,2613,10,71,5,11,0,0,60,--,--,0,1,,,,,,6/29/2020
3/27/2020,31,248,215,2611,2859,9,80,1,12,1,1,67,--,--,2,3,,,,,,6/29/2020
3/28/2020,64,312,260,2871,3183,13,93,3,15,2,3,75,--,--,1,4,,,,,,6/29/2020
3/29/2020,105,417,356,3227,3644,8,101,4,19,1,4,78,--,--,2,6,,,,,,6/29/2020
3/30/2020,78,495,222,3449,3944,20,121,5,24,0,4,93,--,--,3,9,,,,,,6/29/2020
3/31/2020,73,568,369,3818,4386,11,132,7,31,1,5,96,--,--,2,11,,,,,,6/29/2020
4/1/2020,100,668,699,4517,5185,18,150,7,38,0,5,107,--,--,1,12,,,,,,6/29/2020
4/2/2020,62,730,477,4994,5724,21,171,6,44,2,7,120,--,--,4,16,,,,,,6/29/2020
4/3/2020,101,831,775,5769,6600,23,194,7,51,0,7,136,--,--,3,19,,,,,,6/29/2020
4/4/2020,137,968,660,6429,7397,22,216,4,55,5,12,149,--,--,9,28,,,,,,6/29/2020
4/5/2020,182,1150,1156,7585,8735,20,236,9,64,1,13,159,45,37,2,30,,,,,,6/29/2020
4/6/2020,206,1356,1707,9292,10648,26,262,7,71,0,13,178,45,38,7,37,,,,,,6/29/2020
4/7/2020,260,1616,1631,10923,12539,20,282,3,74,2,15,193,45,35,5,42,,,,,,6/29/2020
4/8/2020,273,1889,1723,12646,14535,19,301,8,82,6,21,198,50,36,10,52,,,,,,6/29/2020
4/9/2020,279,2168,1521,14167,16335,32,333,9,91,4,25,217,50,38,7,59,,,,,,6/29/2020
4/10/2020,404,2572,2577,16744,19316,29,362,17,108,5,30,224,48,36,11,70,,,,,,6/29/2020
4/11/2020,280,2852,1911,18655,21507,29,391,11,119,2,32,240,49,40,11,81,,,,,,6/29/2020
4/12/2020,288,3140,1674,20329,23469,35,426,13,132,5,37,257,54,44,10,91,,,,,,6/29/2020
4/13/2020,187,3327,938,21267,24594,35,461,13,145,3,40,276,61,43,9,100,,,,,,6/29/2020
4/14/2020,267,3594,1788,23055,26649,27,488,17,162,5,45,281,62,43,8,108,,,,,,6/29/2020
4/15/2020,307,3901,1803,24858,28759,31,519,19,181,3,48,290,67,43,17,125,,,,,,6/29/2020
4/16/2020,392,4293,2500,27358,31651,36,555,25,206,6,54,295,70,43,14,139,,,,,,6/29/2020
4/17/2020,290,4583,1823,29181,33764,31,586,21,227,7,61,298,62,45,21,160,,,,,,6/29/2020
4/18/2020,283,4866,1728,30909,35775,26,612,18,245,4,65,302,67,43,15,175,,,,,,6/29/2020
4/19/2020,339,5205,2059,32968,38173,23,635,26,271,1,66,298,71,44,11,186,,,,,,6/29/2020
4/20/2020,379,5584,1909,34877,40461,46,681,29,300,2,68,313,72,45,10,196,,,,,,6/29/2020
4/21/2020,387,5971,2114,36991,42962,45,726,31,331,5,73,322,77,48,18,214,,,,,,6/29/2020
4/22/2020,382,6353,2398,39389,45742,41,767,32,363,5,78,326,77,52,17,231,,,,,,6/29/2020
4/23/2020,419,6772,2471,41860,48632,30,797,28,391,5,83,323,78,53,14,245,,,,,,6/29/2020
4/24/2020,415,7187,3292,45152,52339,35,832,27,418,4,87,327,81,56,15,260,,,,,,6/29/2020
4/25/2020,305,7492,2210,47362,54854,34,866,17,435,5,92,339,84,55,14,274,,,,,,6/29/2020
4/26/2020,276,7768,2314,49676,57444,33,899,15,450,3,95,354,80,55,14,288,,,,,,6/29/2020
4/27/2020,203,7971,1624,51300,59271,29,928,21,471,4,99,358,98,62,10,298,,,,,,6/29/2020
4/28/2020,323,8294,2268,53568,61862,44,972,24,495,3,102,375,76,51,22,320,,,,,,6/29/2020
4/29/2020,371,8665,3351,56919,65584,36,1008,37,532,11,113,363,80,54,18,338,,,,,,6/29/2020
4/30/2020,348,9013,2772,59691,68704,33,1041,38,570,6,119,352,83,59,24,362,,,,,,6/29/2020
5/1/2020,317,9330,3089,62780,72110,51,1092,39,609,3,122,361,84,61,14,376,,,,,,6/29/2020
5/2/2020,189,9519,1926,64706,74225,35,1127,39,648,5,127,352,89,62,24,400,,,,,,6/29/2020
5/3/2020,180,9699,2168,66874,76573,31,1158,27,675,8,135,348,86,60,21,421,,,,,,6/29/2020
5/4/2020,290,9989,2101,68975,78964,30,1188,31,706,5,140,342,82,56,18,439,,,,,,6/29/2020
5/5/2020,301,10290,2878,71853,82143,28,1216,32,738,6,146,332,71,52,16,455,,,,,,6/29/2020
5/6/2020,342,10632,2836,74689,85321,28,1244,44,782,9,155,307,77,56,20,475,,,,,,6/29/2020
5/7/2020,268,10900,2904,77593,88493,35,1279,41,823,5,160,296,70,52,21,496,,,,,,6/29/2020
5/8/2020,230,11130,2494,80087,91217,30,1309,29,852,5,165,292,73,52,22,518,,,,,,6/29/2020
5/9/2020,286,11416,3290,83377,94793,22,1331,21,873,4,169,289,72,53,15,533,,,,,,6/29/2020
5/10/2020,185,11601,2090,85467,97068,19,1350,23,896,6,175,279,68,48,13,546,,,,,,6/29/2020
5/11/2020,172,11773,1797,87264,99037,31,1381,16,912,6,181,288,65,42,15,561,,,,,,6/29/2020
5/12/2020,218,11991,2433,89697,101688,23,1404,18,930,4,185,289,63,41,22,583,,,,,,6/29/2020
5/13/2020,195,12186,3515,93212,105398,22,1426,24,954,1,186,286,66,44,13,596,,,,,,6/29/2020
5/14/2020,215,12401,3292,96504,108905,19,1445,27,981,3,189,275,64,45,15,611,,,,,,6/29/2020
5/15/2020,228,12629,3313,99817,112446,24,1469,40,1021,5,194,254,62,46,13,624,,,,,,6/29/2020
5/16/2020,252,12881,3875,103692,116573,25,1494,12,1033,5,199,262,59,44,14,638,,,,,,6/29/2020
5/17/2020,128,13009,2705,106397,119406,17,1511,7,1040,5,204,267,58,45,10,648,,,,,,6/29/2020
5/18/2020,138,13147,1906,108303,121450,19,1530,15,1055,5,209,266,56,41,18,666,,,,,,6/29/2020
5/19/2020,214,13361,3080,111383,124744,23,1553,31,1086,5,214,253,56,40,11,677,,,,,,6/29/2020
5/20/2020,186,13547,2758,114141,127688,19,1572,23,1109,7,221,242,51,34,22,699,,,,,,6/29/2020
5/21/2020,168,13715,3745,117886,131601,26,1598,15,1124,3,224,250,49,32,20,719,,,,,,6/29/2020
5/22/2020,200,13915,2973,120859,134774,19,1617,29,1153,5,229,235,--,--,10,729,,,,,,6/29/2020
5/23/2020,107,14022,2724,123583,137605,19,1636,11,1164,3,232,240,50,36,13,742,,,,,,6/29/2020
5/24/2020,84,14106,1352,124935,139041,12,1648,14,1178,2,234,236,49,35,8,750,,,,,,6/29/2020
5/25/2020,70,14176,1366,126301,140477,12,1660,14,1192,0,234,234,53,36,10,760,,,,,,6/29/2020
5/26/2020,149,14325,2544,128845,143170,23,1683,22,1214,5,239,230,47,33,15,775,,,,,,6/29/2020
5/27/2020,132,14457,2055,130900,145357,20,1703,17,1231,3,242,230,50,32,10,785,,,,,,6/29/2020
5/28/2020,131,14588,3281,134181,148769,16,1719,29,1260,4,246,213,46,29,7,792,,,,,,6/29/2020
5/29/2020,176,14764,3897,138078,152842,18,1737,27,1287,5,251,199,46,29,12,804,,,,,,6/29/2020
5/30/2020,104,14868,3957,142035,156903,15,1752,19,1306,4,255,191,48,31,11,815,,,,,,6/29/2020
5/31/2020,75,14943,1711,143746,158689,10,1762,10,1316,0,255,191,44,30,3,818,,,,,,6/29/2020
6/1/2020,98,15041,2733,146479,161520,8,1770,12,1328,1,256,186,42,29,5,823,,,,,,6/29/2020
6/2/2020,108,15149,2984,149463,164612,8,1778,9,1337,3,259,182,37,23,10,833,,,,,,6/29/2020
6/3/2020,103,15252,3442,152905,168157,13,1791,18,1355,6,265,171,--,--,11,844,,,,,,6/29/2020
6/4/2020,117,15369,4452,157357,172726,7,1798,25,1380,3,268,150,--,--,11,855,,,,,,6/29/2020
6/5/2020,106,15475,3478,160835,176310,15,1813,12,1392,5,273,148,28,20,9,864,,,,,,6/29/2020
6/6/2020,69,15544,2605,163440,178984,10,1823,7,1399,2,275,149,31,19,6,870,,,,,,6/29/2020
6/7/2020,49,15593,1581,165021,180614,11,1834,7,1406,1,276,152,27,16,4,874,,,,,,6/29/2020
6/8/2020,44,15637,1747,166768,182405,15,1849,12,1418,2,278,153,26,16,4,878,,,,,,6/29/2020
6/9/2020,67,15704,2533,169301,185005,10,1859,17,1435,0,278,146,28,17,1,879,,,,,,6/29/2020
6/10/2020,103,15807,2858,172159,187966,13,1872,12,1447,2,280,145,--,--,3,882,,,,,,6/29/2020
6/11/2020,87,15894,3375,175534,191428,7,1879,15,1462,1,281,136,--,--,6,888,,,,,,6/29/2020
6/12/2020,80,15974,4382,179916,195890,8,1887,15,1477,1,282,128,21,14,2,890,,,,,,6/29/2020
6/13/2020,49,16023,2742,182658,198681,6,1893,4,1481,0,282,130,16,13,3,893,,,,,,6/29/2020
6/14/2020,32,16055,1870,184528,200583,6,1899,7,1488,1,283,128,17,13,3,896,,,,,,6/29/2020
6/15/2020,76,16131,2961,187489,203620,14,1913,14,1502,0,283,128,23,13,4,900,,,,,,6/29/2020
6/16/2020,53,16184,2806,190295,206479,9,1922,10,1512,1,284,126,23,12,8,908,,,,,,6/29/2020
6/17/2020,49,16233,2566,192861,209094,12,1934,20,1532,4,288,114,--,--,6,914,,,,,,6/29/2020
6/18/2020,70,16303,2867,195728,212031,9,1943,12,1544,1,289,110,--,--,7,921,,,,,,6/29/2020
6/19/2020,57,16360,3429,199157,215517,12,1955,11,1555,1,290,110,18,15,3,924,,,,,,6/29/2020
6/20/2020,37,16397,1682,200839,217236,7,1962,9,1564,0,290,108,19,17,3,927,,,,,,6/29/2020
6/21/2020,27,16424,973,201812,218236,6,1968,5,1569,0,290,109,20,16,2,929,,,,,,6/29/2020
6/22/2020,61,16485,3543,205355,221840,12,1980,16,1585,0,290,105,18,17,1,930,,,,,,6/29/2020
6/23/2020,79,16564,3602,208957,225521,2,1982,12,1597,3,293,92,16,15,6,936,,,,,,6/29/2020
6/24/2020,51,16615,3242,212199,228814,7,1989,9,1606,1,294,89,--,--,5,941,,,,,,6/29/2020
6/25/2020,42,16657,2746,214945,231602,4,1993,13,1619,1,295,79,16,15,0,941,,,,,,6/29/2020
6/26/2020,60,16717,2275,217220,233937,2,1995,8,1627,0,295,73,15,14,1,942,,,,,,6/29/2020
6/27/2020,31,16748,3160,220380,237128,,,,,,,,,,4,946,,,,,,6/29/2020
6/28/2020,16,16764,1376,221756,238520,,,,,,,,,,0,946,,,,,,6/29/2020
2/27/2020,0,0,0,0,0,1,1,0,0,0,0,1,--,--,0,0,,,,,,6/30/2020
2/28/2020,0,0,0,0,0,0,1,0,0,0,0,1,--,--,0,0,,,,,,6/30/2020
2/29/2020,0,0,0,0,0,0,1,0,0,0,0,1,--,--,0,0,,,,,,6/30/2020
3/1/2020,2,2,2,2,4,0,1,0,0,0,0,1,--,--,0,0,,,,,,6/30/2020
3/2/2020,0,2,1,3,5,1,2,0,0,0,0,2,--,--,0,0,,,,,,6/30/2020
3/3/2020,0,2,2,5,7,0,2,0,0,0,0,2,--,--,0,0,,,,,,6/30/2020
3/4/2020,0,2,12,17,19,1,3,0,0,0,0,3,--,--,0,0,,,,,,6/30/2020
3/5/2020,1,3,4,21,24,0,3,0,0,0,0,3,--,--,0,0,,,,,,6/30/2020
3/6/2020,0,3,12,33,36,0,3,0,0,0,0,3,--,--,0,0,,,,,,6/30/2020
3/7/2020,0,3,19,52,55,0,3,0,0,0,0,3,--,--,0,0,,,,,,6/30/2020
3/8/2020,0,3,18,70,73,0,3,0,0,0,0,3,--,--,0,0,,,,,,6/30/2020
3/9/2020,1,4,15,85,89,0,3,0,0,0,0,3,--,--,0,0,,,,,,6/30/2020
3/10/2020,1,5,25,110,115,0,3,0,0,0,0,3,--,--,0,0,,,,,,6/30/2020
3/11/2020,0,5,34,144,149,1,4,0,0,0,0,4,--,--,0,0,,,,,,6/30/2020
3/12/2020,8,13,42,186,199,1,5,0,0,0,0,5,--,--,0,0,,,,,,6/30/2020
3/13/2020,6,19,50,236,255,4,9,1,1,0,0,8,--,--,0,0,,,,,,6/30/2020
3/14/2020,0,19,90,326,345,0,9,0,1,0,0,8,--,--,0,0,,,,,,6/30/2020
3/15/2020,1,20,54,380,400,1,10,0,1,0,0,9,--,--,0,0,,,,,,6/30/2020
3/16/2020,2,22,95,475,497,2,12,0,1,0,0,11,--,--,0,0,,,,,,6/30/2020
3/17/2020,11,33,162,637,670,6,18,0,1,0,0,17,--,--,0,0,,,,,,6/30/2020
3/18/2020,11,44,116,753,797,3,21,0,1,0,0,20,--,--,0,0,,,,,,6/30/2020
3/19/2020,17,61,262,1015,1076,2,23,1,2,0,0,21,--,--,1,1,,,,,,6/30/2020
3/20/2020,13,74,197,1212,1286,5,28,0,2,0,0,26,--,--,0,1,,,,,,6/30/2020
3/21/2020,14,88,126,1338,1426,3,31,2,4,0,0,27,--,--,0,1,,,,,,6/30/2020
3/22/2020,25,113,282,1620,1733,2,33,0,4,0,0,29,--,--,0,1,,,,,,6/30/2020
3/23/2020,16,129,169,1789,1918,16,49,1,5,0,0,44,--,--,0,1,,,,,,6/30/2020
3/24/2020,19,148,243,2032,2180,7,56,0,5,0,0,51,--,--,0,1,,,,,,6/30/2020
3/25/2020,28,176,183,2215,2391,5,61,1,6,0,0,55,--,--,0,1,,,,,,6/30/2020
3/26/2020,41,217,181,2396,2613,10,71,5,11,0,0,60,--,--,0,1,,,,,,6/30/2020
3/27/2020,31,248,215,2611,2859,9,80,1,12,1,1,67,--,--,2,3,,,,,,6/30/2020
3/28/2020,64,312,260,2871,3183,13,93,3,15,2,3,75,--,--,1,4,,,,,,6/30/2020
3/29/2020,105,417,356,3227,3644,8,101,4,19,1,4,78,--,--,2,6,,,,,,6/30/2020
3/30/2020,78,495,222,3449,3944,20,121,5,24,0,4,93,--,--,3,9,,,,,,6/30/2020
3/31/2020,73,568,369,3818,4386,11,132,7,31,1,5,96,--,--,2,11,,,,,,6/30/2020
4/1/2020,100,668,699,4517,5185,18,150,7,38,0,5,107,--,--,1,12,,,,,,6/30/2020
4/2/2020,62,730,477,4994,5724,21,171,6,44,2,7,120,--,--,4,16,,,,,,6/30/2020
4/3/2020,101,831,775,5769,6600,23,194,7,51,0,7,136,--,--,3,19,,,,,,6/30/2020
4/4/2020,137,968,660,6429,7397,22,216,4,55,5,12,149,--,--,9,28,,,,,,6/30/2020
4/5/2020,182,1150,1156,7585,8735,20,236,9,64,1,13,159,45,37,2,30,,,,,,6/30/2020
4/6/2020,206,1356,1707,9292,10648,26,262,7,71,0,13,178,45,38,7,37,,,,,,6/30/2020
4/7/2020,260,1616,1631,10923,12539,20,282,3,74,2,15,193,45,35,5,42,,,,,,6/30/2020
4/8/2020,273,1889,1723,12646,14535,19,301,8,82,6,21,198,50,36,10,52,,,,,,6/30/2020
4/9/2020,279,2168,1521,14167,16335,32,333,9,91,4,25,217,50,38,7,59,,,,,,6/30/2020
4/10/2020,404,2572,2577,16744,19316,29,362,17,108,5,30,224,48,36,11,70,,,,,,6/30/2020
4/11/2020,280,2852,1911,18655,21507,29,391,11,119,2,32,240,49,40,11,81,,,,,,6/30/2020
4/12/2020,288,3140,1674,20329,23469,35,426,13,132,5,37,257,54,44,10,91,,,,,,6/30/2020
4/13/2020,187,3327,938,21267,24594,35,461,13,145,3,40,276,61,43,9,100,,,,,,6/30/2020
4/14/2020,267,3594,1788,23055,26649,27,488,17,162,5,45,281,62,43,8,108,,,,,,6/30/2020
4/15/2020,307,3901,1803,24858,28759,31,519,19,181,3,48,290,67,43,17,125,,,,,,6/30/2020
4/16/2020,392,4293,2500,27358,31651,36,555,25,206,6,54,295,70,43,14,139,,,,,,6/30/2020
4/17/2020,290,4583,1823,29181,33764,31,586,21,227,7,61,298,62,45,21,160,,,,,,6/30/2020
4/18/2020,283,4866,1728,30909,35775,26,612,18,245,4,65,302,67,43,15,175,,,,,,6/30/2020
4/19/2020,339,5205,2059,32968,38173,23,635,26,271,1,66,298,71,44,11,186,,,,,,6/30/2020
4/20/2020,379,5584,1909,34877,40461,46,681,29,300,2,68,313,72,45,10,196,,,,,,6/30/2020
4/21/2020,387,5971,2114,36991,42962,45,726,31,331,5,73,322,77,48,18,214,,,,,,6/30/2020
4/22/2020,382,6353,2398,39389,45742,41,767,32,363,5,78,326,77,52,17,231,,,,,,6/30/2020
4/23/2020,419,6772,2471,41860,48632,30,797,28,391,5,83,323,78,53,14,245,,,,,,6/30/2020
4/24/2020,415,7187,3292,45152,52339,35,832,27,418,4,87,327,81,56,15,260,,,,,,6/30/2020
4/25/2020,305,7492,2210,47362,54854,34,866,17,435,5,92,339,84,55,14,274,,,,,,6/30/2020
4/26/2020,276,7768,2314,49676,57444,33,899,15,450,3,95,354,80,55,14,288,,,,,,6/30/2020
4/27/2020,203,7971,1624,51300,59271,29,928,21,471,4,99,358,98,62,10,298,,,,,,6/30/2020
4/28/2020,323,8294,2268,53568,61862,44,972,24,495,3,102,375,76,51,22,320,,,,,,6/30/2020
4/29/2020,371,8665,3351,56919,65584,36,1008,37,532,11,113,363,80,54,18,338,,,,,,6/30/2020
4/30/2020,348,9013,2772,59691,68704,33,1041,38,570,6,119,352,83,59,24,362,,,,,,6/30/2020
5/1/2020,317,9330,3089,62780,72110,51,1092,39,609,3,122,361,84,61,14,376,,,,,,6/30/2020
5/2/2020,189,9519,1926,64706,74225,35,1127,39,648,5,127,352,89,62,24,400,,,,,,6/30/2020
5/3/2020,180,9699,2168,66874,76573,31,1158,27,675,8,135,348,86,60,21,421,,,,,,6/30/2020
5/4/2020,290,9989,2101,68975,78964,30,1188,31,706,5,140,342,82,56,18,439,,,,,,6/30/2020
5/5/2020,301,10290,2878,71853,82143,28,1216,32,738,6,146,332,71,52,16,455,,,,,,6/30/2020
5/6/2020,342,10632,2836,74689,85321,28,1244,44,782,9,155,307,77,56,21,476,,,,,,6/30/2020
5/7/2020,268,10900,2904,77593,88493,35,1279,41,823,5,160,296,70,52,21,497,,,,,,6/30/2020
5/8/2020,230,11130,2494,80087,91217,30,1309,29,852,5,165,292,73,52,22,519,,,,,,6/30/2020
5/9/2020,286,11416,3290,83377,94793,22,1331,21,873,4,169,289,72,53,15,534,,,,,,6/30/2020
5/10/2020,185,11601,2090,85467,97068,19,1350,23,896,6,175,279,68,48,13,547,,,,,,6/30/2020
5/11/2020,172,11773,1797,87264,99037,31,1381,16,912,6,181,288,65,42,15,562,,,,,,6/30/2020
5/12/2020,218,11991,2433,89697,101688,23,1404,18,930,4,185,289,63,41,22,584,,,,,,6/30/2020
5/13/2020,195,12186,3515,93212,105398,22,1426,24,954,1,186,286,66,44,13,597,,,,,,6/30/2020
5/14/2020,215,12401,3292,96504,108905,19,1445,27,981,3,189,275,64,45,15,612,,,,,,6/30/2020
5/15/2020,228,12629,3313,99817,112446,24,1469,40,1021,5,194,254,62,46,13,625,,,,,,6/30/2020
5/16/2020,252,12881,3875,103692,116573,25,1494,12,1033,5,199,262,59,44,14,639,,,,,,6/30/2020
5/17/2020,127,13008,2705,106397,119405,17,1511,7,1040,5,204,267,58,45,10,649,,,,,,6/30/2020
5/18/2020,138,13146,1906,108303,121449,19,1530,15,1055,5,209,266,56,41,18,667,,,,,,6/30/2020
5/19/2020,214,13360,3080,111383,124743,23,1553,31,1086,5,214,253,56,40,11,678,,,,,,6/30/2020
5/20/2020,186,13546,2758,114141,127687,19,1572,23,1109,7,221,242,51,34,22,700,,,,,,6/30/2020
5/21/2020,168,13714,3745,117886,131600,26,1598,15,1124,3,224,250,49,32,20,720,,,,,,6/30/2020
5/22/2020,200,13914,2973,120859,134773,19,1617,29,1153,5,229,235,--,--,10,730,,,,,,6/30/2020
5/23/2020,107,14021,2724,123583,137604,19,1636,11,1164,3,232,240,50,36,13,743,,,,,,6/30/2020
5/24/2020,84,14105,1352,124935,139040,12,1648,14,1178,2,234,236,49,35,8,751,,,,,,6/30/2020
5/25/2020,70,14175,1366,126301,140476,12,1660,14,1192,0,234,234,53,36,10,761,,,,,,6/30/2020
5/26/2020,149,14324,2544,128845,143169,23,1683,22,1214,5,239,230,47,33,15,776,,,,,,6/30/2020
5/27/2020,132,14456,2055,130900,145356,20,1703,17,1231,3,242,230,50,32,10,786,,,,,,6/30/2020
5/28/2020,131,14587,3281,134181,148768,16,1719,29,1260,4,246,213,46,29,7,793,,,,,,6/30/2020
5/29/2020,176,14763,3897,138078,152841,18,1737,27,1287,5,251,199,46,29,12,805,,,,,,6/30/2020
5/30/2020,104,14867,3957,142035,156902,15,1752,19,1306,4,255,191,48,31,11,816,,,,,,6/30/2020
5/31/2020,76,14943,1711,143746,158689,10,1762,10,1316,0,255,191,44,30,3,819,,,,,,6/30/2020
6/1/2020,98,15041,2733,146479,161520,8,1770,12,1328,1,256,186,42,29,5,824,,,,,,6/30/2020
6/2/2020,108,15149,2984,149463,164612,8,1778,9,1337,3,259,182,37,23,10,834,,,,,,6/30/2020
6/3/2020,103,15252,3442,152905,168157,13,1791,18,1355,6,265,171,--,--,11,845,,,,,,6/30/2020
6/4/2020,117,15369,4452,157357,172726,7,1798,25,1380,3,268,150,--,--,11,856,,,,,,6/30/2020
6/5/2020,106,15475,3478,160835,176310,15,1813,12,1392,5,273,148,28,20,9,865,,,,,,6/30/2020
6/6/2020,69,15544,2605,163440,178984,10,1823,7,1399,2,275,149,31,19,6,871,,,,,,6/30/2020
6/7/2020,49,15593,1581,165021,180614,11,1834,7,1406,1,276,152,27,16,4,875,,,,,,6/30/2020
6/8/2020,44,15637,1747,166768,182405,15,1849,12,1418,2,278,153,26,16,4,879,,,,,,6/30/2020
6/9/2020,67,15704,2533,169301,185005,10,1859,17,1435,0,278,146,28,17,1,880,,,,,,6/30/2020
6/10/2020,103,15807,2858,172159,187966,13,1872,12,1447,2,280,145,--,--,3,883,,,,,,6/30/2020
6/11/2020,87,15894,3375,175534,191428,7,1879,15,1462,1,281,136,--,--,6,889,,,,,,6/30/2020
6/12/2020,79,15973,4382,179916,195889,8,1887,15,1477,1,282,128,21,14,2,891,,,,,,6/30/2020
6/13/2020,49,16022,2742,182658,198680,6,1893,4,1481,0,282,130,16,13,3,894,,,,,,6/30/2020
6/14/2020,32,16054,1870,184528,200582,6,1899,7,1488,1,283,128,17,13,3,897,,,,,,6/30/2020
6/15/2020,76,16130,2961,187489,203619,14,1913,14,1502,0,283,128,23,13,4,901,,,,,,6/30/2020
6/16/2020,53,16183,2806,190295,206478,9,1922,10,1512,1,284,126,23,12,8,909,,,,,,6/30/2020
6/17/2020,49,16232,2566,192861,209093,12,1934,20,1532,4,288,114,--,--,6,915,,,,,,6/30/2020
6/18/2020,70,16302,2867,195728,212030,9,1943,12,1544,1,289,110,--,--,7,922,,,,,,6/30/2020
6/19/2020,57,16359,3429,199157,215516,12,1955,11,1555,1,290,110,18,15,3,925,,,,,,6/30/2020
6/20/2020,37,16396,1682,200839,217235,7,1962,9,1564,0,290,108,19,17,3,928,,,,,,6/30/2020
6/21/2020,27,16423,973,201812,218235,6,1968,5,1569,0,290,109,20,16,2,930,,,,,,6/30/2020
6/22/2020,61,16484,3543,205355,221839,12,1980,16,1585,0,290,105,18,17,1,931,,,,,,6/30/2020
6/23/2020,78,16562,3602,208957,225519,3,1983,12,1597,3,293,93,16,15,6,937,,,,,,6/30/2020
6/24/2020,51,16613,3242,212199,228812,7,1990,9,1606,1,294,90,--,--,5,942,,,,,,6/30/2020
6/25/2020,42,16655,2746,214945,231600,5,1995,14,1620,1,295,80,16,15,1,943,,,,,,6/30/2020
6/26/2020,68,16723,2367,217312,234035,2,1997,8,1628,0,295,74,15,14,4,947,,,,,,6/30/2020
6/27/2020,35,16758,3189,220501,237259,4,2001,3,1631,1,296,74,13,13,2,949,,,,,,6/30/2020
6/28/2020,19,16777,1434,221935,238712,,,,,,,,,,1,950,,,,,,6/30/2020
6/29/2020,36,16813,3534,225469,242282,,,,,,,,,,0,950,,,,,,6/30/2020
2/27/2020,0,0,0,0,0,1,1,0,0,0,0,1,--,--,0,0,,,,,,7/1/2020
2/28/2020,0,0,0,0,0,0,1,0,0,0,0,1,--,--,0,0,,,,,,7/1/2020
2/29/2020,0,0,0,0,0,0,1,0,0,0,0,1,--,--,0,0,,,,,,7/1/2020
3/1/2020,2,2,2,2,4,0,1,0,0,0,0,1,--,--,0,0,,,,,,7/1/2020
3/2/2020,0,2,1,3,5,1,2,0,0,0,0,2,--,--,0,0,,,,,,7/1/2020
3/3/2020,0,2,2,5,7,0,2,0,0,0,0,2,--,--,0,0,,,,,,7/1/2020
3/4/2020,0,2,12,17,19,1,3,0,0,0,0,3,--,--,0,0,,,,,,7/1/2020
3/5/2020,1,3,4,21,24,0,3,0,0,0,0,3,--,--,0,0,,,,,,7/1/2020
3/6/2020,0,3,12,33,36,0,3,0,0,0,0,3,--,--,0,0,,,,,,7/1/2020
3/7/2020,0,3,19,52,55,0,3,0,0,0,0,3,--,--,0,0,,,,,,7/1/2020
3/8/2020,0,3,18,70,73,0,3,0,0,0,0,3,--,--,0,0,,,,,,7/1/2020
3/9/2020,1,4,15,85,89,0,3,0,0,0,0,3,--,--,0,0,,,,,,7/1/2020
3/10/2020,1,5,25,110,115,0,3,0,0,0,0,3,--,--,0,0,,,,,,7/1/2020
3/11/2020,0,5,34,144,149,1,4,0,0,0,0,4,--,--,0,0,,,,,,7/1/2020
3/12/2020,8,13,42,186,199,1,5,0,0,0,0,5,--,--,0,0,,,,,,7/1/2020
3/13/2020,6,19,50,236,255,4,9,1,1,0,0,8,--,--,0,0,,,,,,7/1/2020
3/14/2020,0,19,90,326,345,0,9,0,1,0,0,8,--,--,0,0,,,,,,7/1/2020
3/15/2020,1,20,54,380,400,1,10,0,1,0,0,9,--,--,0,0,,,,,,7/1/2020
3/16/2020,2,22,95,475,497,2,12,0,1,0,0,11,--,--,0,0,,,,,,7/1/2020
3/17/2020,11,33,162,637,670,6,18,0,1,0,0,17,--,--,0,0,,,,,,7/1/2020
3/18/2020,11,44,116,753,797,3,21,0,1,0,0,20,--,--,0,0,,,,,,7/1/2020
3/19/2020,17,61,262,1015,1076,2,23,1,2,0,0,21,--,--,1,1,,,,,,7/1/2020
3/20/2020,13,74,197,1212,1286,5,28,0,2,0,0,26,--,--,0,1,,,,,,7/1/2020
3/21/2020,14,88,126,1338,1426,3,31,2,4,0,0,27,--,--,0,1,,,,,,7/1/2020
3/22/2020,25,113,282,1620,1733,2,33,0,4,0,0,29,--,--,0,1,,,,,,7/1/2020
3/23/2020,16,129,169,1789,1918,16,49,1,5,0,0,44,--,--,0,1,,,,,,7/1/2020
3/24/2020,19,148,243,2032,2180,7,56,0,5,0,0,51,--,--,0,1,,,,,,7/1/2020
3/25/2020,28,176,183,2215,2391,5,61,1,6,0,0,55,--,--,0,1,,,,,,7/1/2020
3/26/2020,41,217,181,2396,2613,10,71,5,11,0,0,60,--,--,0,1,,,,,,7/1/2020
3/27/2020,31,248,215,2611,2859,9,80,1,12,1,1,67,--,--,2,3,,,,,,7/1/2020
3/28/2020,64,312,260,2871,3183,13,93,3,15,2,3,75,--,--,1,4,,,,,,7/1/2020
3/29/2020,105,417,356,3227,3644,8,101,4,19,1,4,78,--,--,2,6,,,,,,7/1/2020
3/30/2020,78,495,222,3449,3944,20,121,5,24,0,4,93,--,--,3,9,,,,,,7/1/2020
3/31/2020,73,568,369,3818,4386,11,132,7,31,1,5,96,--,--,2,11,,,,,,7/1/2020
4/1/2020,100,668,699,4517,5185,18,150,7,38,0,5,107,--,--,1,12,,,,,,7/1/2020
4/2/2020,62,730,477,4994,5724,21,171,6,44,2,7,120,--,--,4,16,,,,,,7/1/2020
4/3/2020,101,831,775,5769,6600,23,194,7,51,0,7,136,--,--,3,19,,,,,,7/1/2020
4/4/2020,137,968,660,6429,7397,22,216,4,55,5,12,149,--,--,9,28,,,,,,7/1/2020
4/5/2020,182,1150,1156,7585,8735,20,236,9,64,1,13,159,45,37,2,30,,,,,,7/1/2020
4/6/2020,206,1356,1707,9292,10648,26,262,7,71,0,13,178,45,38,7,37,,,,,,7/1/2020
4/7/2020,260,1616,1631,10923,12539,20,282,3,74,2,15,193,45,35,5,42,,,,,,7/1/2020
4/8/2020,273,1889,1723,12646,14535,19,301,8,82,6,21,198,50,36,10,52,,,,,,7/1/2020
4/9/2020,279,2168,1521,14167,16335,32,333,9,91,4,25,217,50,38,7,59,,,,,,7/1/2020
4/10/2020,404,2572,2577,16744,19316,29,362,17,108,5,30,224,48,36,11,70,,,,,,7/1/2020
4/11/2020,280,2852,1911,18655,21507,29,391,11,119,2,32,240,49,40,11,81,,,,,,7/1/2020
4/12/2020,288,3140,1674,20329,23469,35,426,13,132,5,37,257,54,44,10,91,,,,,,7/1/2020
4/13/2020,187,3327,938,21267,24594,35,461,13,145,3,40,276,61,43,9,100,,,,,,7/1/2020
4/14/2020,267,3594,1788,23055,26649,27,488,17,162,5,45,281,62,43,8,108,,,,,,7/1/2020
4/15/2020,307,3901,1803,24858,28759,31,519,19,181,3,48,290,67,43,17,125,,,,,,7/1/2020
4/16/2020,392,4293,2500,27358,31651,36,555,25,206,6,54,295,70,43,14,139,,,,,,7/1/2020
4/17/2020,290,4583,1823,29181,33764,31,586,21,227,7,61,298,62,45,21,160,,,,,,7/1/2020
4/18/2020,283,4866,1728,30909,35775,26,612,18,245,4,65,302,67,43,15,175,,,,,,7/1/2020
4/19/2020,339,5205,2059,32968,38173,23,635,26,271,1,66,298,71,44,11,186,,,,,,7/1/2020
4/20/2020,379,5584,1909,34877,40461,46,681,29,300,2,68,313,72,45,10,196,,,,,,7/1/2020
4/21/2020,387,5971,2114,36991,42962,45,726,31,331,5,73,322,77,48,18,214,,,,,,7/1/2020
4/22/2020,382,6353,2398,39389,45742,41,767,32,363,5,78,326,77,52,17,231,,,,,,7/1/2020
4/23/2020,419,6772,2471,41860,48632,30,797,28,391,5,83,323,78,53,14,245,,,,,,7/1/2020
4/24/2020,415,7187,3292,45152,52339,35,832,27,418,4,87,327,81,56,15,260,,,,,,7/1/2020
4/25/2020,305,7492,2210,47362,54854,34,866,17,435,5,92,339,84,55,14,274,,,,,,7/1/2020
4/26/2020,276,7768,2314,49676,57444,33,899,15,450,3,95,354,80,55,14,288,,,,,,7/1/2020
4/27/2020,203,7971,1624,51300,59271,29,928,21,471,4,99,358,98,62,10,298,,,,,,7/1/2020
4/28/2020,324,8295,2268,53568,61863,44,972,24,495,3,102,375,76,51,22,320,,,,,,7/1/2020
4/29/2020,371,8666,3351,56919,65585,36,1008,37,532,11,113,363,80,54,18,338,,,,,,7/1/2020
4/30/2020,348,9014,2772,59691,68705,33,1041,38,570,6,119,352,83,59,24,362,,,,,,7/1/2020
5/1/2020,317,9331,3089,62780,72111,51,1092,39,609,3,122,361,84,61,14,376,,,,,,7/1/2020
5/2/2020,189,9520,1926,64706,74226,35,1127,39,648,5,127,352,89,62,24,400,,,,,,7/1/2020
5/3/2020,181,9701,2168,66874,76575,31,1158,27,675,8,135,348,86,60,21,421,,,,,,7/1/2020
5/4/2020,291,9992,2101,68975,78967,30,1188,31,706,5,140,342,82,56,18,439,,,,,,7/1/2020
5/5/2020,303,10295,2878,71853,82148,28,1216,32,738,6,146,332,71,52,16,455,,,,,,7/1/2020
5/6/2020,342,10637,2836,74689,85326,28,1244,44,782,9,155,307,77,56,21,476,,,,,,7/1/2020
5/7/2020,271,10908,2904,77593,88501,36,1280,41,823,5,160,297,70,52,21,497,,,,,,7/1/2020
5/8/2020,231,11139,2494,80087,91226,30,1310,29,852,5,165,293,73,52,22,519,,,,,,7/1/2020
5/9/2020,286,11425,3290,83377,94802,22,1332,21,873,4,169,290,72,53,15,534,,,,,,7/1/2020
5/10/2020,186,11611,2090,85467,97078,19,1351,23,896,6,175,280,68,48,13,547,,,,,,7/1/2020
5/11/2020,173,11784,1797,87264,99048,31,1382,16,912,6,181,289,65,42,15,562,,,,,,7/1/2020
5/12/2020,218,12002,2433,89697,101699,23,1405,18,930,4,185,290,63,41,22,584,,,,,,7/1/2020
5/13/2020,195,12197,3515,93212,105409,22,1427,24,954,1,186,287,66,44,13,597,,,,,,7/1/2020
5/14/2020,215,12412,3292,96504,108916,19,1446,27,981,3,189,276,64,45,15,612,,,,,,7/1/2020
5/15/2020,228,12640,3313,99817,112457,24,1470,41,1022,5,194,254,62,46,13,625,,,,,,7/1/2020
5/16/2020,252,12892,3875,103692,116584,25,1495,12,1034,5,199,262,59,44,14,639,,,,,,7/1/2020
5/17/2020,127,13019,2705,106397,119416,17,1512,7,1041,5,204,267,58,45,10,649,,,,,,7/1/2020
5/18/2020,138,13157,1906,108303,121460,19,1531,15,1056,5,209,266,56,41,18,667,,,,,,7/1/2020
5/19/2020,214,13371,3080,111383,124754,23,1554,31,1087,5,214,253,56,40,11,678,,,,,,7/1/2020
5/20/2020,186,13557,2758,114141,127698,19,1573,23,1110,7,221,242,51,34,22,700,,,,,,7/1/2020
5/21/2020,169,13726,3745,117886,131612,26,1599,15,1125,3,224,250,49,32,20,720,,,,,,7/1/2020
5/22/2020,201,13927,2974,120860,134787,19,1618,29,1154,5,229,235,--,--,10,730,,,,,,7/1/2020
5/23/2020,107,14034,2724,123584,137618,19,1637,11,1165,3,232,240,50,36,13,743,,,,,,7/1/2020
5/24/2020,84,14118,1352,124936,139054,12,1649,14,1179,2,234,236,49,35,8,751,,,,,,7/1/2020
5/25/2020,70,14188,1366,126302,140490,12,1661,14,1193,0,234,234,53,36,10,761,,,,,,7/1/2020
5/26/2020,152,14340,2545,128847,143187,23,1684,22,1215,5,239,230,47,33,15,776,,,,,,7/1/2020
5/27/2020,132,14472,2055,130902,145374,20,1704,17,1232,3,242,230,50,32,10,786,,,,,,7/1/2020
5/28/2020,131,14603,3281,134183,148786,17,1721,29,1261,4,246,214,46,29,7,793,,,,,,7/1/2020
5/29/2020,177,14780,3897,138080,152860,18,1739,27,1288,5,251,200,46,29,12,805,,,,,,7/1/2020
5/30/2020,104,14884,3958,142038,156922,15,1754,19,1307,4,255,192,48,31,12,817,,,,,,7/1/2020
5/31/2020,76,14960,1712,143750,158710,10,1764,10,1317,0,255,192,44,30,3,820,,,,,,7/1/2020
6/1/2020,98,15058,2733,146483,161541,8,1772,12,1329,1,256,187,42,29,5,825,,,,,,7/1/2020
6/2/2020,108,15166,2986,149469,164635,8,1780,9,1338,3,259,183,37,23,10,835,,,,,,7/1/2020
6/3/2020,103,15269,3443,152912,168181,13,1793,18,1356,6,265,172,--,--,11,846,,,,,,7/1/2020
6/4/2020,117,15386,4453,157365,172751,7,1800,25,1381,3,268,151,--,--,11,857,,,,,,7/1/2020
6/5/2020,106,15492,3480,160845,176337,15,1815,12,1393,5,273,149,28,20,9,866,,,,,,7/1/2020
6/6/2020,69,15561,2605,163450,179011,10,1825,7,1400,2,275,150,31,19,6,872,,,,,,7/1/2020
6/7/2020,49,15610,1581,165031,180641,11,1836,7,1407,1,276,153,27,16,4,876,,,,,,7/1/2020
6/8/2020,44,15654,1748,166779,182433,15,1851,12,1419,2,278,154,26,16,4,880,,,,,,7/1/2020
6/9/2020,67,15721,2533,169312,185033,10,1861,18,1437,0,278,146,28,17,1,881,,,,,,7/1/2020
6/10/2020,103,15824,2858,172170,187994,13,1874,12,1449,2,280,145,--,--,3,884,,,,,,7/1/2020
6/11/2020,87,15911,3375,175545,191456,7,1881,15,1464,1,281,136,--,--,6,890,,,,,,7/1/2020
6/12/2020,79,15990,4382,179927,195917,8,1889,15,1479,1,282,128,21,14,2,892,,,,,,7/1/2020
6/13/2020,49,16039,2742,182669,198708,6,1895,4,1483,0,282,130,16,13,3,895,,,,,,7/1/2020
6/14/2020,32,16071,1870,184539,200610,6,1901,7,1490,1,283,128,17,13,3,898,,,,,,7/1/2020
6/15/2020,76,16147,2961,187500,203647,14,1915,14,1504,0,283,128,23,13,4,902,,,,,,7/1/2020
6/16/2020,53,16200,2806,190306,206506,9,1924,10,1514,1,284,126,23,12,8,910,,,,,,7/1/2020
6/17/2020,49,16249,2566,192872,209121,13,1937,20,1534,4,288,115,--,--,6,916,,,,,,7/1/2020
6/18/2020,70,16319,2867,195739,212058,9,1946,12,1546,1,289,111,--,--,7,923,,,,,,7/1/2020
6/19/2020,57,16376,3429,199168,215544,12,1958,11,1557,1,290,111,18,15,3,926,,,,,,7/1/2020
6/20/2020,37,16413,1682,200850,217263,7,1965,9,1566,0,290,109,19,17,3,929,,,,,,7/1/2020
6/21/2020,27,16440,973,201823,218263,6,1971,5,1571,0,290,110,20,16,2,931,,,,,,7/1/2020
6/22/2020,61,16501,3543,205366,221867,12,1983,16,1587,0,290,106,18,17,1,932,,,,,,7/1/2020
6/23/2020,78,16579,3602,208968,225547,3,1986,12,1599,3,293,94,16,15,6,938,,,,,,7/1/2020
6/24/2020,51,16630,3242,212210,228840,7,1993,9,1608,1,294,91,--,--,5,943,,,,,,7/1/2020
6/25/2020,42,16672,2746,214956,231628,5,1998,14,1622,1,295,81,16,15,1,944,,,,,,7/1/2020
6/26/2020,67,16739,2367,217323,234062,2,2000,9,1631,0,295,74,15,14,4,948,,,,,,7/1/2020
6/27/2020,35,16774,3189,220512,237286,4,2004,3,1634,1,296,74,13,13,5,953,,,,,,7/1/2020
6/28/2020,19,16793,1434,221946,238739,3,2007,4,1638,4,300,69,11,11,1,954,,,,,,7/1/2020
6/29/2020,33,16826,3614,225560,242386,,,,,,,,,,2,956,,,,,,7/1/2020
6/30/2020,27,16853,1802,227362,244215,,,,,,,,,,0,956,,,,,,7/1/2020
2/27/2020,0,0,0,0,0,1,1,0,0,0,0,1,--,--,0,0,,,,,,7/2/2020
2/28/2020,0,0,0,0,0,0,1,0,0,0,0,1,--,--,0,0,,,,,,7/2/2020
2/29/2020,0,0,0,0,0,0,1,0,0,0,0,1,--,--,0,0,,,,,,7/2/2020
3/1/2020,2,2,2,2,4,0,1,0,0,0,0,1,--,--,0,0,,,,,,7/2/2020
3/2/2020,0,2,1,3,5,1,2,0,0,0,0,2,--,--,0,0,,,,,,7/2/2020
3/3/2020,0,2,2,5,7,0,2,0,0,0,0,2,--,--,0,0,,,,,,7/2/2020
3/4/2020,0,2,12,17,19,1,3,0,0,0,0,3,--,--,0,0,,,,,,7/2/2020
3/5/2020,1,3,4,21,24,0,3,0,0,0,0,3,--,--,0,0,,,,,,7/2/2020
3/6/2020,0,3,12,33,36,0,3,0,0,0,0,3,--,--,0,0,,,,,,7/2/2020
3/7/2020,0,3,19,52,55,0,3,0,0,0,0,3,--,--,0,0,,,,,,7/2/2020
3/8/2020,0,3,18,70,73,0,3,0,0,0,0,3,--,--,0,0,,,,,,7/2/2020
3/9/2020,1,4,15,85,89,0,3,0,0,0,0,3,--,--,0,0,,,,,,7/2/2020
3/10/2020,1,5,25,110,115,0,3,0,0,0,0,3,--,--,0,0,,,,,,7/2/2020
3/11/2020,0,5,34,144,149,1,4,0,0,0,0,4,--,--,0,0,,,,,,7/2/2020
3/12/2020,8,13,42,186,199,1,5,0,0,0,0,5,--,--,0,0,,,,,,7/2/2020
3/13/2020,6,19,50,236,255,4,9,1,1,0,0,8,--,--,0,0,,,,,,7/2/2020
3/14/2020,0,19,90,326,345,0,9,0,1,0,0,8,--,--,0,0,,,,,,7/2/2020
3/15/2020,1,20,54,380,400,1,10,0,1,0,0,9,--,--,0,0,,,,,,7/2/2020
3/16/2020,2,22,95,475,497,2,12,0,1,0,0,11,--,--,0,0,,,,,,7/2/2020
3/17/2020,11,33,162,637,670,6,18,0,1,0,0,17,--,--,0,0,,,,,,7/2/2020
3/18/2020,11,44,116,753,797,3,21,0,1,0,0,20,--,--,0,0,,,,,,7/2/2020
3/19/2020,17,61,262,1015,1076,2,23,1,2,0,0,21,--,--,1,1,,,,,,7/2/2020
3/20/2020,13,74,197,1212,1286,5,28,0,2,0,0,26,--,--,0,1,,,,,,7/2/2020
3/21/2020,14,88,126,1338,1426,3,31,2,4,0,0,27,--,--,0,1,,,,,,7/2/2020
3/22/2020,25,113,282,1620,1733,2,33,0,4,0,0,29,--,--,0,1,,,,,,7/2/2020
3/23/2020,16,129,169,1789,1918,16,49,1,5,0,0,44,--,--,0,1,,,,,,7/2/2020
3/24/2020,19,148,243,2032,2180,7,56,0,5,0,0,51,--,--,0,1,,,,,,7/2/2020
3/25/2020,28,176,183,2215,2391,5,61,1,6,0,0,55,--,--,0,1,,,,,,7/2/2020
3/26/2020,41,217,181,2396,2613,10,71,5,11,0,0,60,--,--,0,1,,,,,,7/2/2020
3/27/2020,31,248,215,2611,2859,9,80,1,12,1,1,67,--,--,2,3,,,,,,7/2/2020
3/28/2020,64,312,260,2871,3183,13,93,3,15,2,3,75,--,--,1,4,,,,,,7/2/2020
3/29/2020,105,417,356,3227,3644,8,101,4,19,1,4,78,--,--,2,6,,,,,,7/2/2020
3/30/2020,78,495,222,3449,3944,20,121,5,24,0,4,93,--,--,3,9,,,,,,7/2/2020
3/31/2020,73,568,369,3818,4386,11,132,7,31,1,5,96,--,--,2,11,,,,,,7/2/2020
4/1/2020,100,668,699,4517,5185,18,150,7,38,0,5,107,--,--,1,12,,,,,,7/2/2020
4/2/2020,62,730,477,4994,5724,21,171,6,44,2,7,120,--,--,4,16,,,,,,7/2/2020
4/3/2020,101,831,775,5769,6600,23,194,7,51,0,7,136,--,--,3,19,,,,,,7/2/2020
4/4/2020,137,968,660,6429,7397,22,216,4,55,5,12,149,--,--,9,28,,,,,,7/2/2020
4/5/2020,182,1150,1156,7585,8735,20,236,9,64,1,13,159,45,37,2,30,,,,,,7/2/2020
4/6/2020,206,1356,1707,9292,10648,26,262,7,71,0,13,178,45,38,7,37,,,,,,7/2/2020
4/7/2020,260,1616,1631,10923,12539,20,282,4,75,2,15,192,45,35,5,42,,,,,,7/2/2020
4/8/2020,273,1889,1723,12646,14535,19,301,8,83,6,21,197,50,36,10,52,,,,,,7/2/2020
4/9/2020,279,2168,1521,14167,16335,32,333,9,92,4,25,216,50,38,7,59,,,,,,7/2/2020
4/10/2020,404,2572,2577,16744,19316,29,362,16,108,5,30,224,48,36,11,70,,,,,,7/2/2020
4/11/2020,280,2852,1911,18655,21507,29,391,11,119,2,32,240,49,40,11,81,,,,,,7/2/2020
4/12/2020,289,3141,1674,20329,23470,35,426,13,132,5,37,257,54,44,10,91,,,,,,7/2/2020
4/13/2020,187,3328,938,21267,24595,35,461,13,145,3,40,276,61,43,9,100,,,,,,7/2/2020
4/14/2020,267,3595,1788,23055,26650,27,488,17,162,5,45,281,62,43,8,108,,,,,,7/2/2020
4/15/2020,307,3902,1803,24858,28760,31,519,19,181,3,48,290,67,43,17,125,,,,,,7/2/2020
4/16/2020,392,4294,2500,27358,31652,36,555,25,206,6,54,295,70,43,14,139,,,,,,7/2/2020
4/17/2020,290,4584,1823,29181,33765,31,586,21,227,7,61,298,62,45,21,160,,,,,,7/2/2020
4/18/2020,283,4867,1728,30909,35776,26,612,18,245,4,65,302,67,43,15,175,,,,,,7/2/2020
4/19/2020,339,5206,2059,32968,38174,23,635,26,271,1,66,298,71,44,11,186,,,,,,7/2/2020
4/20/2020,378,5584,1909,34877,40461,46,681,29,300,2,68,313,72,45,10,196,,,,,,7/2/2020
4/21/2020,387,5971,2114,36991,42962,45,726,31,331,5,73,322,77,48,18,214,,,,,,7/2/2020
4/22/2020,382,6353,2398,39389,45742,41,767,32,363,5,78,326,77,52,17,231,,,,,,7/2/2020
4/23/2020,419,6772,2471,41860,48632,30,797,28,391,5,83,323,78,53,14,245,,,,,,7/2/2020
4/24/2020,415,7187,3292,45152,52339,35,832,27,418,4,87,327,81,56,15,260,,,,,,7/2/2020
4/25/2020,305,7492,2210,47362,54854,34,866,17,435,5,92,339,84,55,14,274,,,,,,7/2/2020
4/26/2020,276,7768,2314,49676,57444,33,899,15,450,3,95,354,80,55,14,288,,,,,,7/2/2020
4/27/2020,203,7971,1624,51300,59271,29,928,21,471,4,99,358,98,62,10,298,,,,,,7/2/2020
4/28/2020,324,8295,2268,53568,61863,44,972,24,495,3,102,375,76,51,22,320,,,,,,7/2/2020
4/29/2020,371,8666,3351,56919,65585,36,1008,37,532,11,113,363,80,54,18,338,,,,,,7/2/2020
4/30/2020,348,9014,2772,59691,68705,33,1041,38,570,6,119,352,83,59,24,362,,,,,,7/2/2020
5/1/2020,317,9331,3089,62780,72111,51,1092,39,609,3,122,361,84,61,14,376,,,,,,7/2/2020
5/2/2020,189,9520,1926,64706,74226,35,1127,39,648,5,127,352,89,62,24,400,,,,,,7/2/2020
5/3/2020,181,9701,2168,66874,76575,31,1158,27,675,8,135,348,86,60,21,421,,,,,,7/2/2020
5/4/2020,291,9992,2101,68975,78967,30,1188,31,706,5,140,342,82,56,18,439,,,,,,7/2/2020
5/5/2020,303,10295,2878,71853,82148,28,1216,32,738,6,146,332,71,52,16,455,,,,,,7/2/2020
5/6/2020,342,10637,2836,74689,85326,28,1244,44,782,9,155,307,77,56,21,476,,,,,,7/2/2020
5/7/2020,271,10908,2904,77593,88501,36,1280,41,823,5,160,297,70,52,21,497,,,,,,7/2/2020
5/8/2020,231,11139,2494,80087,91226,30,1310,29,852,5,165,293,73,52,22,519,,,,,,7/2/2020
5/9/2020,286,11425,3290,83377,94802,22,1332,21,873,4,169,290,72,53,15,534,,,,,,7/2/2020
5/10/2020,186,11611,2090,85467,97078,19,1351,23,896,6,175,280,68,48,13,547,,,,,,7/2/2020
5/11/2020,174,11785,1797,87264,99049,31,1382,16,912,6,181,289,65,42,15,562,,,,,,7/2/2020
5/12/2020,218,12003,2433,89697,101700,23,1405,18,930,4,185,290,63,41,22,584,,,,,,7/2/2020
5/13/2020,195,12198,3515,93212,105410,22,1427,24,954,1,186,287,66,44,13,597,,,,,,7/2/2020
5/14/2020,215,12413,3292,96504,108917,19,1446,27,981,3,189,276,64,45,15,612,,,,,,7/2/2020
5/15/2020,228,12641,3313,99817,112458,24,1470,41,1022,5,194,254,62,46,13,625,,,,,,7/2/2020
5/16/2020,252,12893,3875,103692,116585,25,1495,12,1034,5,199,262,59,44,14,639,,,,,,7/2/2020
5/17/2020,127,13020,2705,106397,119417,17,1512,7,1041,5,204,267,58,45,10,649,,,,,,7/2/2020
5/18/2020,138,13158,1906,108303,121461,19,1531,15,1056,5,209,266,56,41,18,667,,,,,,7/2/2020
5/19/2020,214,13372,3080,111383,124755,23,1554,31,1087,5,214,253,56,40,11,678,,,,,,7/2/2020
5/20/2020,186,13558,2758,114141,127699,19,1573,23,1110,7,221,242,51,34,22,700,,,,,,7/2/2020
5/21/2020,169,13727,3745,117886,131613,26,1599,15,1125,3,224,250,49,32,20,720,,,,,,7/2/2020
5/22/2020,201,13928,2974,120860,134788,19,1618,29,1154,5,229,235,--,--,10,730,,,,,,7/2/2020
5/23/2020,107,14035,2724,123584,137619,19,1637,11,1165,3,232,240,50,36,13,743,,,,,,7/2/2020
5/24/2020,84,14119,1352,124936,139055,12,1649,14,1179,2,234,236,49,35,8,751,,,,,,7/2/2020
5/25/2020,70,14189,1366,126302,140491,12,1661,14,1193,0,234,234,53,36,10,761,,,,,,7/2/2020
5/26/2020,152,14341,2545,128847,143188,23,1684,22,1215,5,239,230,47,33,15,776,,,,,,7/2/2020
5/27/2020,133,14474,2055,130902,145376,20,1704,17,1232,3,242,230,50,32,10,786,,,,,,7/2/2020
5/28/2020,131,14605,3281,134183,148788,17,1721,29,1261,4,246,214,46,29,7,793,,,,,,7/2/2020
5/29/2020,177,14782,3897,138080,152862,18,1739,27,1288,5,251,200,46,29,12,805,,,,,,7/2/2020
5/30/2020,104,14886,3958,142038,156924,15,1754,19,1307,4,255,192,48,31,12,817,,,,,,7/2/2020
5/31/2020,76,14962,1712,143750,158712,10,1764,10,1317,0,255,192,44,30,3,820,,,,,,7/2/2020
6/1/2020,98,15060,2733,146483,161543,8,1772,12,1329,1,256,187,42,29,5,825,,,,,,7/2/2020
6/2/2020,108,15168,2986,149469,164637,8,1780,9,1338,3,259,183,37,23,10,835,,,,,,7/2/2020
6/3/2020,103,15271,3443,152912,168183,13,1793,18,1356,6,265,172,--,--,11,846,,,,,,7/2/2020
6/4/2020,117,15388,4453,157365,172753,7,1800,25,1381,3,268,151,--,--,11,857,,,,,,7/2/2020
6/5/2020,105,15493,3480,160845,176338,15,1815,12,1393,5,273,149,28,20,9,866,,,,,,7/2/2020
6/6/2020,69,15562,2605,163450,179012,10,1825,7,1400,2,275,150,31,19,6,872,,,,,,7/2/2020
6/7/2020,49,15611,1581,165031,180642,11,1836,7,1407,1,276,153,27,16,4,876,,,,,,7/2/2020
6/8/2020,44,15655,1748,166779,182434,15,1851,12,1419,2,278,154,26,16,4,880,,,,,,7/2/2020
6/9/2020,67,15722,2533,169312,185034,10,1861,18,1437,0,278,146,28,17,1,881,,,,,,7/2/2020
6/10/2020,104,15826,2858,172170,187996,13,1874,12,1449,2,280,145,--,--,3,884,,,,,,7/2/2020
6/11/2020,87,15913,3375,175545,191458,7,1881,15,1464,1,281,136,--,--,6,890,,,,,,7/2/2020
6/12/2020,79,15992,4382,179927,195919,8,1889,15,1479,1,282,128,21,14,2,892,,,,,,7/2/2020
6/13/2020,49,16041,2742,182669,198710,6,1895,4,1483,0,282,130,16,13,3,895,,,,,,7/2/2020
6/14/2020,32,16073,1870,184539,200612,6,1901,7,1490,1,283,128,17,13,3,898,,,,,,7/2/2020
6/15/2020,76,16149,2961,187500,203649,14,1915,14,1504,0,283,128,23,13,4,902,,,,,,7/2/2020
6/16/2020,53,16202,2806,190306,206508,9,1924,10,1514,1,284,126,23,12,8,910,,,,,,7/2/2020
6/17/2020,49,16251,2566,192872,209123,13,1937,20,1534,4,288,115,--,--,6,916,,,,,,7/2/2020
6/18/2020,70,16321,2867,195739,212060,9,1946,12,1546,1,289,111,--,--,7,923,,,,,,7/2/2020
6/19/2020,57,16378,3429,199168,215546,12,1958,11,1557,1,290,111,18,15,3,926,,,,,,7/2/2020
6/20/2020,37,16415,1682,200850,217265,7,1965,9,1566,0,290,109,19,17,3,929,,,,,,7/2/2020
6/21/2020,27,16442,973,201823,218265,6,1971,5,1571,0,290,110,20,16,2,931,,,,,,7/2/2020
6/22/2020,60,16502,3543,205366,221868,12,1983,16,1587,0,290,106,18,17,1,932,,,,,,7/2/2020
6/23/2020,77,16579,3602,208968,225547,3,1986,12,1599,3,293,94,16,15,6,938,,,,,,7/2/2020
6/24/2020,51,16630,3243,212211,228841,8,1994,10,1609,1,294,91,--,--,5,943,,,,,,7/2/2020
6/25/2020,43,16673,2746,214957,231630,5,1999,14,1623,1,295,81,16,15,1,944,,,,,,7/2/2020
6/26/2020,67,16740,2369,217326,234066,2,2001,9,1632,0,295,74,15,14,4,948,,,,,,7/2/2020
6/27/2020,35,16775,3189,220515,237290,4,2005,3,1635,1,296,74,13,13,6,954,,,,,,7/2/2020
6/28/2020,19,16794,1434,221949,238743,3,2008,4,1639,4,300,69,11,11,1,955,,,,,,7/2/2020
6/29/2020,37,16831,3614,225563,242394,3,2011,5,1644,0,300,67,11,10,3,958,,,,,,7/2/2020
6/30/2020,36,16867,1879,227442,244309,,,,,,,,,,1,959,,,,,,7/2/2020
7/1/2020,74,16941,3885,231327,248268,,,,,,,,,,0,959,,,,,,7/2/2020
2/27/2020,0,0,0,0,0,1,1,0,0,0,0,1,--,--,0,0,,,,,,7/3/2020
2/28/2020,0,0,0,0,0,0,1,0,0,0,0,1,--,--,0,0,,,,,,7/3/2020
2/29/2020,0,0,0,0,0,0,1,0,0,0,0,1,--,--,0,0,,,,,,7/3/2020
3/1/2020,2,2,2,2,4,0,1,0,0,0,0,1,--,--,0,0,,,,,,7/3/2020
3/2/2020,0,2,1,3,5,1,2,0,0,0,0,2,--,--,0,0,,,,,,7/3/2020
3/3/2020,0,2,2,5,7,0,2,0,0,0,0,2,--,--,0,0,,,,,,7/3/2020
3/4/2020,0,2,12,17,19,1,3,0,0,0,0,3,--,--,0,0,,,,,,7/3/2020
3/5/2020,1,3,4,21,24,0,3,0,0,0,0,3,--,--,0,0,,,,,,7/3/2020
3/6/2020,0,3,12,33,36,0,3,0,0,0,0,3,--,--,0,0,,,,,,7/3/2020
3/7/2020,0,3,19,52,55,0,3,0,0,0,0,3,--,--,0,0,,,,,,7/3/2020
3/8/2020,0,3,18,70,73,0,3,0,0,0,0,3,--,--,0,0,,,,,,7/3/2020
3/9/2020,1,4,15,85,89,0,3,0,0,0,0,3,--,--,0,0,,,,,,7/3/2020
3/10/2020,1,5,25,110,115,0,3,0,0,0,0,3,--,--,0,0,,,,,,7/3/2020
3/11/2020,0,5,34,144,149,1,4,0,0,0,0,4,--,--,0,0,,,,,,7/3/2020
3/12/2020,8,13,42,186,199,1,5,0,0,0,0,5,--,--,0,0,,,,,,7/3/2020
3/13/2020,6,19,50,236,255,4,9,1,1,0,0,8,--,--,0,0,,,,,,7/3/2020
3/14/2020,0,19,90,326,345,0,9,0,1,0,0,8,--,--,0,0,,,,,,7/3/2020
3/15/2020,1,20,54,380,400,1,10,0,1,0,0,9,--,--,0,0,,,,,,7/3/2020
3/16/2020,2,22,95,475,497,2,12,0,1,0,0,11,--,--,0,0,,,,,,7/3/2020
3/17/2020,11,33,162,637,670,6,18,0,1,0,0,17,--,--,0,0,,,,,,7/3/2020
3/18/2020,11,44,116,753,797,3,21,0,1,0,0,20,--,--,0,0,,,,,,7/3/2020
3/19/2020,17,61,262,1015,1076,2,23,1,2,0,0,21,--,--,1,1,,,,,,7/3/2020
3/20/2020,13,74,197,1212,1286,5,28,0,2,0,0,26,--,--,0,1,,,,,,7/3/2020
3/21/2020,14,88,126,1338,1426,3,31,2,4,0,0,27,--,--,0,1,,,,,,7/3/2020
3/22/2020,25,113,282,1620,1733,2,33,0,4,0,0,29,--,--,0,1,,,,,,7/3/2020
3/23/2020,16,129,169,1789,1918,16,49,1,5,0,0,44,--,--,0,1,,,,,,7/3/2020
3/24/2020,19,148,243,2032,2180,7,56,0,5,0,0,51,--,--,0,1,,,,,,7/3/2020
3/25/2020,28,176,183,2215,2391,5,61,1,6,0,0,55,--,--,0,1,,,,,,7/3/2020
3/26/2020,41,217,181,2396,2613,10,71,5,11,0,0,60,--,--,0,1,,,,,,7/3/2020
3/27/2020,31,248,215,2611,2859,9,80,1,12,1,1,67,--,--,2,3,,,,,,7/3/2020
3/28/2020,64,312,260,2871,3183,13,93,3,15,2,3,75,--,--,1,4,,,,,,7/3/2020
3/29/2020,105,417,356,3227,3644,8,101,4,19,1,4,78,--,--,2,6,,,,,,7/3/2020
3/30/2020,78,495,222,3449,3944,20,121,5,24,0,4,93,--,--,3,9,,,,,,7/3/2020
3/31/2020,73,568,369,3818,4386,11,132,7,31,1,5,96,--,--,2,11,,,,,,7/3/2020
4/1/2020,100,668,699,4517,5185,18,150,7,38,0,5,107,--,--,1,12,,,,,,7/3/2020
4/2/2020,62,730,477,4994,5724,21,171,6,44,2,7,120,--,--,4,16,,,,,,7/3/2020
4/3/2020,101,831,775,5769,6600,23,194,7,51,0,7,136,--,--,3,19,,,,,,7/3/2020
4/4/2020,137,968,660,6429,7397,22,216,4,55,5,12,149,--,--,9,28,,,,,,7/3/2020
4/5/2020,182,1150,1156,7585,8735,20,236,9,64,1,13,159,45,37,2,30,,,,,,7/3/2020
4/6/2020,206,1356,1707,9292,10648,26,262,7,71,0,13,178,45,38,7,37,,,,,,7/3/2020
4/7/2020,260,1616,1631,10923,12539,20,282,4,75,2,15,192,45,35,5,42,,,,,,7/3/2020
4/8/2020,273,1889,1723,12646,14535,19,301,8,83,6,21,197,50,36,10,52,,,,,,7/3/2020
4/9/2020,279,2168,1521,14167,16335,32,333,9,92,4,25,216,50,38,7,59,,,,,,7/3/2020
4/10/2020,404,2572,2577,16744,19316,29,362,16,108,5,30,224,48,36,11,70,,,,,,7/3/2020
4/11/2020,280,2852,1911,18655,21507,29,391,11,119,2,32,240,49,40,11,81,,,,,,7/3/2020
4/12/2020,289,3141,1674,20329,23470,35,426,13,132,5,37,257,54,44,10,91,,,,,,7/3/2020
4/13/2020,187,3328,938,21267,24595,35,461,13,145,3,40,276,61,43,9,100,,,,,,7/3/2020
4/14/2020,267,3595,1788,23055,26650,27,488,17,162,5,45,281,62,43,8,108,,,,,,7/3/2020
4/15/2020,307,3902,1803,24858,28760,31,519,19,181,3,48,290,67,43,17,125,,,,,,7/3/2020
4/16/2020,392,4294,2500,27358,31652,36,555,25,206,6,54,295,70,43,14,139,,,,,,7/3/2020
4/17/2020,290,4584,1823,29181,33765,31,586,21,227,7,61,298,62,45,21,160,,,,,,7/3/2020
4/18/2020,283,4867,1728,30909,35776,26,612,18,245,4,65,302,67,43,15,175,,,,,,7/3/2020
4/19/2020,339,5206,2059,32968,38174,23,635,26,271,1,66,298,71,44,11,186,,,,,,7/3/2020
4/20/2020,378,5584,1909,34877,40461,46,681,29,300,2,68,313,72,45,10,196,,,,,,7/3/2020
4/21/2020,387,5971,2114,36991,42962,45,726,31,331,5,73,322,77,48,18,214,,,,,,7/3/2020
4/22/2020,382,6353,2398,39389,45742,41,767,32,363,5,78,326,77,52,17,231,,,,,,7/3/2020
4/23/2020,419,6772,2471,41860,48632,30,797,28,391,5,83,323,78,53,14,245,,,,,,7/3/2020
4/24/2020,415,7187,3292,45152,52339,35,832,27,418,4,87,327,81,56,15,260,,,,,,7/3/2020
4/25/2020,305,7492,2210,47362,54854,34,866,17,435,5,92,339,84,55,14,274,,,,,,7/3/2020
4/26/2020,276,7768,2314,49676,57444,33,899,15,450,3,95,354,80,55,14,288,,,,,,7/3/2020
4/27/2020,204,7972,1624,51300,59272,29,928,21,471,4,99,358,98,62,10,298,,,,,,7/3/2020
4/28/2020,324,8296,2268,53568,61864,44,972,24,495,3,102,375,76,51,22,320,,,,,,7/3/2020
4/29/2020,371,8667,3351,56919,65586,36,1008,37,532,11,113,363,80,54,18,338,,,,,,7/3/2020
4/30/2020,348,9015,2772,59691,68706,33,1041,38,570,6,119,352,83,59,24,362,,,,,,7/3/2020
5/1/2020,317,9332,3089,62780,72112,51,1092,39,609,3,122,361,84,61,14,376,,,,,,7/3/2020
5/2/2020,189,9521,1926,64706,74227,35,1127,39,648,5,127,352,89,62,24,400,,,,,,7/3/2020
5/3/2020,181,9702,2168,66874,76576,31,1158,27,675,8,135,348,86,60,21,421,,,,,,7/3/2020
5/4/2020,291,9993,2101,68975,78968,30,1188,31,706,5,140,342,82,56,18,439,,,,,,7/3/2020
5/5/2020,303,10296,2878,71853,82149,28,1216,32,738,6,146,332,71,52,16,455,,,,,,7/3/2020
5/6/2020,342,10638,2836,74689,85327,28,1244,44,782,9,155,307,77,56,21,476,,,,,,7/3/2020
5/7/2020,271,10909,2904,77593,88502,36,1280,41,823,5,160,297,70,52,21,497,,,,,,7/3/2020
5/8/2020,231,11140,2494,80087,91227,30,1310,29,852,5,165,293,73,52,22,519,,,,,,7/3/2020
5/9/2020,286,11426,3290,83377,94803,22,1332,21,873,4,169,290,72,53,15,534,,,,,,7/3/2020
5/10/2020,186,11612,2090,85467,97079,19,1351,23,896,6,175,280,68,48,13,547,,,,,,7/3/2020
5/11/2020,174,11786,1797,87264,99050,31,1382,16,912,6,181,289,65,42,15,562,,,,,,7/3/2020
5/12/2020,218,12004,2433,89697,101701,23,1405,18,930,4,185,290,63,41,22,584,,,,,,7/3/2020
5/13/2020,195,12199,3515,93212,105411,22,1427,24,954,1,186,287,66,44,13,597,,,,,,7/3/2020
5/14/2020,215,12414,3292,96504,108918,19,1446,27,981,3,189,276,64,45,15,612,,,,,,7/3/2020
5/15/2020,228,12642,3313,99817,112459,24,1470,41,1022,5,194,254,62,46,13,625,,,,,,7/3/2020
5/16/2020,252,12894,3875,103692,116586,25,1495,12,1034,5,199,262,59,44,14,639,,,,,,7/3/2020
5/17/2020,125,13019,2705,106397,119416,17,1512,7,1041,5,204,267,58,45,10,649,,,,,,7/3/2020
5/18/2020,138,13157,1906,108303,121460,19,1531,15,1056,5,209,266,56,41,18,667,,,,,,7/3/2020
5/19/2020,213,13370,3080,111383,124753,23,1554,31,1087,5,214,253,56,40,11,678,,,,,,7/3/2020
5/20/2020,186,13556,2758,114141,127697,19,1573,23,1110,7,221,242,51,34,22,700,,,,,,7/3/2020
5/21/2020,169,13725,3745,117886,131611,26,1599,15,1125,3,224,250,49,32,20,720,,,,,,7/3/2020
5/22/2020,200,13925,2974,120860,134785,19,1618,29,1154,5,229,235,--,--,10,730,,,,,,7/3/2020
5/23/2020,107,14032,2724,123584,137616,19,1637,11,1165,3,232,240,50,36,13,743,,,,,,7/3/2020
5/24/2020,84,14116,1352,124936,139052,12,1649,14,1179,2,234,236,49,35,8,751,,,,,,7/3/2020
5/25/2020,70,14186,1366,126302,140488,12,1661,14,1193,0,234,234,53,36,10,761,,,,,,7/3/2020
5/26/2020,152,14338,2545,128847,143185,23,1684,22,1215,5,239,230,47,33,15,776,,,,,,7/3/2020
5/27/2020,133,14471,2055,130902,145373,20,1704,17,1232,3,242,230,50,32,10,786,,,,,,7/3/2020
5/28/2020,131,14602,3281,134183,148785,17,1721,29,1261,4,246,214,46,29,7,793,,,,,,7/3/2020
5/29/2020,178,14780,3897,138080,152860,18,1739,27,1288,5,251,200,46,29,12,805,,,,,,7/3/2020
5/30/2020,104,14884,3958,142038,156922,15,1754,19,1307,4,255,192,48,31,12,817,,,,,,7/3/2020
5/31/2020,76,14960,1712,143750,158710,10,1764,10,1317,0,255,192,44,30,3,820,,,,,,7/3/2020
6/1/2020,98,15058,2733,146483,161541,8,1772,12,1329,1,256,187,42,29,5,825,,,,,,7/3/2020
6/2/2020,108,15166,2986,149469,164635,8,1780,9,1338,3,259,183,37,23,10,835,,,,,,7/3/2020
6/3/2020,103,15269,3443,152912,168181,13,1793,18,1356,6,265,172,--,--,11,846,,,,,,7/3/2020
6/4/2020,117,15386,4453,157365,172751,7,1800,25,1381,3,268,151,--,--,11,857,,,,,,7/3/2020
6/5/2020,105,15491,3480,160845,176336,15,1815,12,1393,5,273,149,28,20,9,866,,,,,,7/3/2020
6/6/2020,67,15558,2605,163450,179008,10,1825,7,1400,2,275,150,31,19,6,872,,,,,,7/3/2020
6/7/2020,49,15607,1581,165031,180638,11,1836,7,1407,1,276,153,27,16,4,876,,,,,,7/3/2020
6/8/2020,45,15652,1748,166779,182431,15,1851,12,1419,2,278,154,26,16,4,880,,,,,,7/3/2020
6/9/2020,67,15719,2533,169312,185031,10,1861,18,1437,0,278,146,28,17,1,881,,,,,,7/3/2020
6/10/2020,104,15823,2858,172170,187993,13,1874,12,1449,2,280,145,--,--,3,884,,,,,,7/3/2020
6/11/2020,87,15910,3375,175545,191455,7,1881,15,1464,1,281,136,--,--,6,890,,,,,,7/3/2020
6/12/2020,79,15989,4383,179928,195917,8,1889,15,1479,1,282,128,21,14,2,892,,,,,,7/3/2020
6/13/2020,49,16038,2742,182670,198708,6,1895,4,1483,0,282,130,16,13,3,895,,,,,,7/3/2020
6/14/2020,32,16070,1870,184540,200610,6,1901,7,1490,1,283,128,17,13,3,898,,,,,,7/3/2020
6/15/2020,76,16146,2961,187501,203647,14,1915,14,1504,0,283,128,23,13,4,902,,,,,,7/3/2020
6/16/2020,53,16199,2806,190307,206506,9,1924,10,1514,1,284,126,23,12,8,910,,,,,,7/3/2020
6/17/2020,49,16248,2566,192873,209121,13,1937,20,1534,4,288,115,--,--,6,916,,,,,,7/3/2020
6/18/2020,70,16318,2867,195740,212058,9,1946,12,1546,1,289,111,--,--,7,923,,,,,,7/3/2020
6/19/2020,57,16375,3429,199169,215544,12,1958,11,1557,1,290,111,18,15,3,926,,,,,,7/3/2020
6/20/2020,36,16411,1682,200851,217262,7,1965,9,1566,0,290,109,19,17,3,929,,,,,,7/3/2020
6/21/2020,27,16438,975,201826,218264,6,1971,5,1571,0,290,110,20,16,2,931,,,,,,7/3/2020
6/22/2020,60,16498,3548,205374,221872,12,1983,16,1587,0,290,106,18,17,1,932,,,,,,7/3/2020
6/23/2020,77,16575,3602,208976,225551,3,1986,12,1599,3,293,94,16,15,6,938,,,,,,7/3/2020
6/24/2020,52,16627,3243,212219,228846,8,1994,10,1609,1,294,91,--,--,5,943,,,,,,7/3/2020
6/25/2020,43,16670,2746,214965,231635,5,1999,14,1623,1,295,81,16,15,0,943,,,,,,7/3/2020
6/26/2020,67,16737,2369,217334,234071,2,2001,9,1632,0,295,74,15,14,1,944,,,,,,7/3/2020
6/27/2020,35,16772,3189,220523,237295,4,2005,3,1635,1,296,74,13,13,5,949,,,,,,7/3/2020
6/28/2020,21,16793,1435,221958,238751,3,2008,4,1639,4,300,69,11,11,6,955,,,,,,7/3/2020
6/29/2020,37,16830,3614,225572,242402,3,2011,5,1644,0,300,67,11,10,1,956,,,,,,7/3/2020
6/30/2020,40,16870,1881,227453,244323,1,2012,5,1649,1,301,62,,,3,959,,,,,,7/3/2020
7/1/2020,62,16932,3958,231411,248343,7,2019,8,1657,0,301,61,9,7,1,960,,,,,,7/3/2020
7/2/2020,59,16991,2552,233963,250954,,,,,,,,,,0,960,,,,,,7/3/2020
2/27/2020,0,0,0,0,0,1,1,0,0,0,0,1,--,--,0,0,,,,,,7/7/2020
2/28/2020,0,0,0,0,0,0,1,0,0,0,0,1,--,--,0,0,,,,,,7/7/2020
2/29/2020,0,0,0,0,0,0,1,0,0,0,0,1,--,--,0,0,,,,,,7/7/2020
3/1/2020,2,2,2,2,4,0,1,0,0,0,0,1,--,--,0,0,,,,,,7/7/2020
3/2/2020,0,2,1,3,5,1,2,0,0,0,0,2,--,--,0,0,,,,,,7/7/2020
3/3/2020,0,2,2,5,7,0,2,0,0,0,0,2,--,--,0,0,,,,,,7/7/2020
3/4/2020,0,2,12,17,19,1,3,0,0,0,0,3,--,--,0,0,,,,,,7/7/2020
3/5/2020,1,3,4,21,24,0,3,0,0,0,0,3,--,--,0,0,,,,,,7/7/2020
3/6/2020,0,3,12,33,36,0,3,0,0,0,0,3,--,--,0,0,,,,,,7/7/2020
3/7/2020,0,3,19,52,55,0,3,0,0,0,0,3,--,--,0,0,,,,,,7/7/2020
3/8/2020,0,3,18,70,73,0,3,0,0,0,0,3,--,--,0,0,,,,,,7/7/2020
3/9/2020,1,4,15,85,89,0,3,0,0,0,0,3,--,--,0,0,,,,,,7/7/2020
3/10/2020,1,5,25,110,115,0,3,0,0,0,0,3,--,--,0,0,,,,,,7/7/2020
3/11/2020,0,5,34,144,149,1,4,0,0,0,0,4,--,--,0,0,,,,,,7/7/2020
3/12/2020,8,13,42,186,199,1,5,0,0,0,0,5,--,--,0,0,,,,,,7/7/2020
3/13/2020,6,19,50,236,255,4,9,1,1,0,0,8,--,--,0,0,,,,,,7/7/2020
3/14/2020,0,19,90,326,345,0,9,0,1,0,0,8,--,--,0,0,,,,,,7/7/2020
3/15/2020,1,20,54,380,400,1,10,0,1,0,0,9,--,--,0,0,,,,,,7/7/2020
3/16/2020,2,22,95,475,497,2,12,0,1,0,0,11,--,--,0,0,,,,,,7/7/2020
3/17/2020,11,33,162,637,670,6,18,0,1,0,0,17,--,--,0,0,,,,,,7/7/2020
3/18/2020,11,44,116,753,797,3,21,0,1,0,0,20,--,--,0,0,,,,,,7/7/2020
3/19/2020,17,61,262,1015,1076,2,23,1,2,0,0,21,--,--,1,1,,,,,,7/7/2020
3/20/2020,13,74,197,1212,1286,5,28,0,2,0,0,26,--,--,0,1,,,,,,7/7/2020
3/21/2020,14,88,126,1338,1426,3,31,2,4,0,0,27,--,--,0,1,,,,,,7/7/2020
3/22/2020,25,113,282,1620,1733,2,33,0,4,0,0,29,--,--,0,1,,,,,,7/7/2020
3/23/2020,16,129,169,1789,1918,16,49,1,5,0,0,44,--,--,0,1,,,,,,7/7/2020
3/24/2020,19,148,243,2032,2180,7,56,0,5,0,0,51,--,--,0,1,,,,,,7/7/2020
3/25/2020,28,176,183,2215,2391,5,61,1,6,0,0,55,--,--,0,1,,,,,,7/7/2020
3/26/2020,41,217,181,2396,2613,10,71,5,11,0,0,60,--,--,0,1,,,,,,7/7/2020
3/27/2020,31,248,215,2611,2859,9,80,1,12,1,1,67,--,--,2,3,,,,,,7/7/2020
3/28/2020,64,312,260,2871,3183,13,93,3,15,2,3,75,--,--,1,4,,,,,,7/7/2020
3/29/2020,105,417,356,3227,3644,8,101,4,19,1,4,78,--,--,2,6,,,,,,7/7/2020
3/30/2020,78,495,222,3449,3944,20,121,5,24,0,4,93,--,--,3,9,,,,,,7/7/2020
3/31/2020,73,568,369,3818,4386,11,132,7,31,1,5,96,--,--,2,11,,,,,,7/7/2020
4/1/2020,100,668,699,4517,5185,18,150,7,38,0,5,107,--,--,1,12,,,,,,7/7/2020
4/2/2020,62,730,477,4994,5724,21,171,6,44,2,7,120,--,--,4,16,,,,,,7/7/2020
4/3/2020,101,831,775,5769,6600,23,194,7,51,0,7,136,--,--,3,19,,,,,,7/7/2020
4/4/2020,137,968,660,6429,7397,22,216,4,55,5,12,149,--,--,9,28,,,,,,7/7/2020
4/5/2020,182,1150,1156,7585,8735,20,236,9,64,1,13,159,45,37,2,30,,,,,,7/7/2020
4/6/2020,206,1356,1707,9292,10648,26,262,7,71,0,13,178,45,38,7,37,,,,,,7/7/2020
4/7/2020,260,1616,1631,10923,12539,20,282,3,74,2,15,193,45,35,5,42,,,,,,7/7/2020
4/8/2020,273,1889,1723,12646,14535,19,301,8,82,6,21,198,50,36,10,52,,,,,,7/7/2020
4/9/2020,279,2168,1521,14167,16335,32,333,9,91,4,25,217,50,38,7,59,,,,,,7/7/2020
4/10/2020,404,2572,2577,16744,19316,29,362,17,108,5,30,224,48,36,11,70,,,,,,7/7/2020
4/11/2020,280,2852,1911,18655,21507,29,391,11,119,2,32,240,49,40,11,81,,,,,,7/7/2020
4/12/2020,289,3141,1674,20329,23470,35,426,13,132,5,37,257,54,44,10,91,,,,,,7/7/2020
4/13/2020,187,3328,938,21267,24595,35,461,13,145,3,40,276,61,43,9,100,,,,,,7/7/2020
4/14/2020,267,3595,1788,23055,26650,27,488,17,162,5,45,281,62,43,8,108,,,,,,7/7/2020
4/15/2020,307,3902,1803,24858,28760,31,519,19,181,3,48,290,67,43,17,125,,,,,,7/7/2020
4/16/2020,392,4294,2500,27358,31652,36,555,25,206,6,54,295,70,43,14,139,,,,,,7/7/2020
4/17/2020,290,4584,1823,29181,33765,31,586,21,227,7,61,298,62,45,21,160,,,,,,7/7/2020
4/18/2020,283,4867,1728,30909,35776,26,612,18,245,4,65,302,67,43,15,175,,,,,,7/7/2020
4/19/2020,339,5206,2059,32968,38174,23,635,26,271,1,66,298,71,44,11,186,,,,,,7/7/2020
4/20/2020,378,5584,1909,34877,40461,46,681,29,300,2,68,313,72,45,10,196,,,,,,7/7/2020
4/21/2020,387,5971,2114,36991,42962,45,726,31,331,5,73,322,77,48,18,214,,,,,,7/7/2020
4/22/2020,382,6353,2398,39389,45742,41,767,32,363,5,78,326,77,52,17,231,,,,,,7/7/2020
4/23/2020,420,6773,2471,41860,48633,30,797,28,391,5,83,323,78,53,14,245,,,,,,7/7/2020
4/24/2020,415,7188,3292,45152,52340,35,832,27,418,4,87,327,81,56,15,260,,,,,,7/7/2020
4/25/2020,305,7493,2210,47362,54855,34,866,17,435,5,92,339,84,55,14,274,,,,,,7/7/2020
4/26/2020,276,7769,2314,49676,57445,33,899,15,450,3,95,354,80,55,14,288,,,,,,7/7/2020
4/27/2020,203,7972,1624,51300,59272,29,928,21,471,4,99,358,98,62,10,298,,,,,,7/7/2020
4/28/2020,324,8296,2268,53568,61864,44,972,24,495,3,102,375,76,51,22,320,,,,,,7/7/2020
4/29/2020,371,8667,3351,56919,65586,36,1008,37,532,11,113,363,80,54,18,338,,,,,,7/7/2020
4/30/2020,348,9015,2772,59691,68706,33,1041,38,570,6,119,352,83,59,24,362,,,,,,7/7/2020
5/1/2020,317,9332,3089,62780,72112,51,1092,39,609,3,122,361,84,61,14,376,,,,,,7/7/2020
5/2/2020,189,9521,1926,64706,74227,35,1127,39,648,5,127,352,89,62,24,400,,,,,,7/7/2020
5/3/2020,181,9702,2168,66874,76576,31,1158,27,675,8,135,348,86,60,21,421,,,,,,7/7/2020
5/4/2020,291,9993,2101,68975,78968,30,1188,31,706,5,140,342,82,56,18,439,,,,,,7/7/2020
5/5/2020,303,10296,2878,71853,82149,28,1216,32,738,6,146,332,71,52,16,455,,,,,,7/7/2020
5/6/2020,342,10638,2836,74689,85327,28,1244,44,782,9,155,307,77,56,21,476,,,,,,7/7/2020
5/7/2020,271,10909,2904,77593,88502,36,1280,41,823,5,160,297,70,52,21,497,,,,,,7/7/2020
5/8/2020,231,11140,2494,80087,91227,30,1310,29,852,5,165,293,73,52,22,519,,,,,,7/7/2020
5/9/2020,286,11426,3290,83377,94803,22,1332,21,873,4,169,290,72,53,15,534,,,,,,7/7/2020
5/10/2020,186,11612,2090,85467,97079,19,1351,23,896,6,175,280,68,48,13,547,,,,,,7/7/2020
5/11/2020,175,11787,1797,87264,99051,31,1382,16,912,6,181,289,65,42,15,562,,,,,,7/7/2020
5/12/2020,219,12006,2433,89697,101703,23,1405,18,930,4,185,290,63,41,22,584,,,,,,7/7/2020
5/13/2020,196,12202,3515,93212,105414,22,1427,24,954,1,186,287,66,44,13,597,,,,,,7/7/2020
5/14/2020,225,12427,3292,96504,108931,19,1446,27,981,3,189,276,64,45,15,612,,,,,,7/7/2020
5/15/2020,229,12656,3313,99817,112473,24,1470,41,1022,5,194,254,62,46,13,625,,,,,,7/7/2020
5/16/2020,252,12908,3875,103692,116600,25,1495,12,1034,5,199,262,59,44,14,639,,,,,,7/7/2020
5/17/2020,125,13033,2705,106397,119430,17,1512,7,1041,5,204,267,58,45,10,649,,,,,,7/7/2020
5/18/2020,137,13170,1906,108303,121473,19,1531,15,1056,5,209,266,56,41,18,667,,,,,,7/7/2020
5/19/2020,215,13385,3080,111383,124768,23,1554,31,1087,5,214,253,56,40,11,678,,,,,,7/7/2020
5/20/2020,187,13572,2758,114141,127713,19,1573,23,1110,7,221,242,51,34,22,700,,,,,,7/7/2020
5/21/2020,169,13741,3745,117886,131627,26,1599,15,1125,3,224,250,49,32,20,720,,,,,,7/7/2020
5/22/2020,201,13942,2974,120860,134802,19,1618,29,1154,5,229,235,--,--,10,730,,,,,,7/7/2020
5/23/2020,108,14050,2724,123584,137634,19,1637,11,1165,3,232,240,50,36,13,743,,,,,,7/7/2020
5/24/2020,84,14134,1352,124936,139070,12,1649,14,1179,2,234,236,49,35,8,751,,,,,,7/7/2020
5/25/2020,70,14204,1366,126302,140506,12,1661,14,1193,0,234,234,53,36,10,761,,,,,,7/7/2020
5/26/2020,154,14358,2545,128847,143205,24,1685,22,1215,5,239,231,47,33,15,776,,,,,,7/7/2020
5/27/2020,133,14491,2055,130902,145393,20,1705,17,1232,3,242,231,50,32,10,786,,,,,,7/7/2020
5/28/2020,132,14623,3281,134183,148806,17,1722,29,1261,4,246,215,46,29,7,793,,,,,,7/7/2020
5/29/2020,178,14801,3902,138085,152886,18,1740,27,1288,5,251,201,46,29,12,805,,,,,,7/7/2020
5/30/2020,103,14904,3958,142043,156947,15,1755,19,1307,4,255,193,48,31,12,817,,,,,,7/7/2020
5/31/2020,76,14980,1727,143770,158750,10,1765,10,1317,0,255,193,44,30,3,820,,,,,,7/7/2020
6/1/2020,98,15078,2734,146504,161582,8,1773,12,1329,1,256,188,42,29,5,825,,,,,,7/7/2020
6/2/2020,107,15185,2986,149490,164675,8,1781,9,1338,3,259,184,37,23,10,835,,,,,,7/7/2020
6/3/2020,105,15290,3447,152937,168227,13,1794,18,1356,6,265,173,--,--,11,846,,,,,,7/7/2020
6/4/2020,117,15407,4453,157390,172797,7,1801,25,1381,3,268,152,--,--,11,857,,,,,,7/7/2020
6/5/2020,105,15512,3484,160874,176386,15,1816,12,1393,5,273,150,28,20,9,866,,,,,,7/7/2020
6/6/2020,67,15579,2605,163479,179058,10,1826,7,1400,2,275,151,31,19,6,872,,,,,,7/7/2020
6/7/2020,49,15628,1581,165060,180688,11,1837,7,1407,1,276,154,27,16,4,876,,,,,,7/7/2020
6/8/2020,45,15673,1748,166808,182481,15,1852,12,1419,2,278,155,26,16,4,880,,,,,,7/7/2020
6/9/2020,67,15740,2533,169341,185081,10,1862,18,1437,0,278,147,28,17,1,881,,,,,,7/7/2020
6/10/2020,104,15844,2859,172200,188044,13,1875,12,1449,2,280,146,--,--,3,884,,,,,,7/7/2020
6/11/2020,87,15931,3375,175575,191506,7,1882,15,1464,1,281,137,--,--,6,890,,,,,,7/7/2020
6/12/2020,81,16012,4383,179958,195970,8,1890,15,1479,1,282,129,21,14,2,892,,,,,,7/7/2020
6/13/2020,49,16061,2742,182700,198761,6,1896,4,1483,0,282,131,16,13,3,895,,,,,,7/7/2020
6/14/2020,32,16093,1871,184571,200664,6,1902,8,1491,1,283,128,17,13,3,898,,,,,,7/7/2020
6/15/2020,76,16169,2961,187532,203701,14,1916,14,1505,0,283,128,23,13,4,902,,,,,,7/7/2020
6/16/2020,53,16222,2806,190338,206560,9,1925,10,1515,1,284,126,23,12,8,910,,,,,,7/7/2020
6/17/2020,51,16273,2566,192904,209177,14,1939,20,1535,4,288,116,--,--,6,916,,,,,,7/7/2020
6/18/2020,71,16344,2870,195774,212118,9,1948,12,1547,1,289,112,--,--,7,923,,,,,,7/7/2020
6/19/2020,59,16403,3429,199203,215606,12,1960,11,1558,1,290,112,18,15,3,926,,,,,,7/7/2020
6/20/2020,36,16439,1682,200885,217324,7,1967,9,1567,0,290,110,19,17,3,929,,,,,,7/7/2020
6/21/2020,27,16466,975,201860,218326,7,1974,5,1572,0,290,112,20,16,2,931,,,,,,7/7/2020
6/22/2020,60,16526,3548,205408,221934,12,1986,16,1588,0,290,108,18,17,1,932,,,,,,7/7/2020
6/23/2020,76,16602,3602,209010,225612,3,1989,13,1601,3,293,95,16,15,6,938,,,,,,7/7/2020
6/24/2020,50,16652,3243,212253,228905,8,1997,10,1611,1,294,92,--,--,5,943,,,,,,7/7/2020
6/25/2020,44,16696,2746,214999,231695,5,2002,14,1625,1,295,82,16,15,0,943,,,,,,7/7/2020
6/26/2020,69,16765,2369,217368,234133,2,2004,9,1634,0,295,75,15,14,1,944,,,,,,7/7/2020
6/27/2020,36,16801,3189,220557,237358,4,2008,3,1637,1,296,75,13,13,5,949,,,,,,7/7/2020
6/28/2020,21,16822,1435,221992,238814,3,2011,4,1641,4,300,70,11,11,6,955,,,,,,7/7/2020
6/29/2020,35,16857,3616,225608,242465,4,2015,5,1646,0,300,69,11,10,1,956,,,,,,7/7/2020
6/30/2020,39,16896,1881,227489,244385,1,2016,5,1651,1,301,64,--,--,3,959,,,,,,7/7/2020
7/1/2020,64,16960,3958,231447,248407,7,2023,9,1660,0,301,62,9,7,1,960,,,,,,7/7/2020
7/2/2020,72,17032,2589,234036,251068,4,2027,5,1665,1,302,60,6,6,0,960,,,,,,7/7/2020
7/3/2020,20,17052,1830,235866,252918,7,2034,6,1671,0,302,61,5,5,3,963,,,,,,7/7/2020
7/4/2020,24,17076,2226,238092,255168,1,2035,4,1675,1,303,57,6,5,1,964,,,,,,7/7/2020
7/5/2020,19,17095,2823,240915,258010,1,2036,2,1677,1,304,55,4,4,2,966,,,,,,7/7/2020
7/6/2020,59,17154,2621,243536,260690,,,,,,,,,,3,969,,,,,,7/7/2020
2/27/2020,0,0,0,0,0,1,1,0,0,0,0,1,--,--,0,0,,,,,,7/8/2020
2/28/2020,0,0,0,0,0,0,1,0,0,0,0,1,--,--,0,0,,,,,,7/8/2020
2/29/2020,0,0,0,0,0,0,1,0,0,0,0,1,--,--,0,0,,,,,,7/8/2020
3/1/2020,2,2,2,2,4,0,1,0,0,0,0,1,--,--,0,0,,,,,,7/8/2020
3/2/2020,0,2,1,3,5,1,2,0,0,0,0,2,--,--,0,0,,,,,,7/8/2020
3/3/2020,0,2,2,5,7,0,2,0,0,0,0,2,--,--,0,0,,,,,,7/8/2020
3/4/2020,0,2,12,17,19,1,3,0,0,0,0,3,--,--,0,0,,,,,,7/8/2020
3/5/2020,1,3,4,21,24,0,3,0,0,0,0,3,--,--,0,0,,,,,,7/8/2020
3/6/2020,0,3,12,33,36,0,3,0,0,0,0,3,--,--,0,0,,,,,,7/8/2020
3/7/2020,0,3,19,52,55,0,3,0,0,0,0,3,--,--,0,0,,,,,,7/8/2020
3/8/2020,0,3,18,70,73,0,3,0,0,0,0,3,--,--,0,0,,,,,,7/8/2020
3/9/2020,1,4,15,85,89,0,3,0,0,0,0,3,--,--,0,0,,,,,,7/8/2020
3/10/2020,1,5,25,110,115,0,3,0,0,0,0,3,--,--,0,0,,,,,,7/8/2020
3/11/2020,0,5,34,144,149,1,4,0,0,0,0,4,--,--,0,0,,,,,,7/8/2020
3/12/2020,8,13,42,186,199,1,5,0,0,0,0,5,--,--,0,0,,,,,,7/8/2020
3/13/2020,6,19,50,236,255,4,9,1,1,0,0,8,--,--,0,0,,,,,,7/8/2020
3/14/2020,0,19,90,326,345,0,9,0,1,0,0,8,--,--,0,0,,,,,,7/8/2020
3/15/2020,1,20,54,380,400,1,10,0,1,0,0,9,--,--,0,0,,,,,,7/8/2020
3/16/2020,2,22,95,475,497,2,12,0,1,0,0,11,--,--,0,0,,,,,,7/8/2020
3/17/2020,11,33,162,637,670,6,18,0,1,0,0,17,--,--,0,0,,,,,,7/8/2020
3/18/2020,11,44,116,753,797,3,21,0,1,0,0,20,--,--,0,0,,,,,,7/8/2020
3/19/2020,17,61,262,1015,1076,2,23,1,2,0,0,21,--,--,1,1,,,,,,7/8/2020
3/20/2020,13,74,197,1212,1286,5,28,0,2,0,0,26,--,--,0,1,,,,,,7/8/2020
3/21/2020,14,88,126,1338,1426,3,31,2,4,0,0,27,--,--,0,1,,,,,,7/8/2020
3/22/2020,25,113,282,1620,1733,2,33,0,4,0,0,29,--,--,0,1,,,,,,7/8/2020
3/23/2020,16,129,169,1789,1918,16,49,1,5,0,0,44,--,--,0,1,,,,,,7/8/2020
3/24/2020,19,148,243,2032,2180,7,56,0,5,0,0,51,--,--,0,1,,,,,,7/8/2020
3/25/2020,28,176,183,2215,2391,5,61,1,6,0,0,55,--,--,0,1,,,,,,7/8/2020
3/26/2020,41,217,181,2396,2613,10,71,5,11,0,0,60,--,--,0,1,,,,,,7/8/2020
3/27/2020,31,248,215,2611,2859,9,80,1,12,1,1,67,--,--,2,3,,,,,,7/8/2020
3/28/2020,64,312,260,2871,3183,13,93,3,15,2,3,75,--,--,1,4,,,,,,7/8/2020
3/29/2020,105,417,356,3227,3644,8,101,4,19,1,4,78,--,--,2,6,,,,,,7/8/2020
3/30/2020,78,495,222,3449,3944,20,121,5,24,0,4,93,--,--,3,9,,,,,,7/8/2020
3/31/2020,73,568,369,3818,4386,11,132,7,31,1,5,96,--,--,2,11,,,,,,7/8/2020
4/1/2020,100,668,699,4517,5185,18,150,7,38,0,5,107,--,--,1,12,,,,,,7/8/2020
4/2/2020,62,730,477,4994,5724,21,171,6,44,2,7,120,--,--,4,16,,,,,,7/8/2020
4/3/2020,101,831,775,5769,6600,23,194,7,51,0,7,136,--,--,3,19,,,,,,7/8/2020
4/4/2020,137,968,660,6429,7397,22,216,4,55,5,12,149,--,--,9,28,,,,,,7/8/2020
4/5/2020,182,1150,1156,7585,8735,20,236,9,64,1,13,159,45,37,2,30,,,,,,7/8/2020
4/6/2020,206,1356,1707,9292,10648,26,262,7,71,0,13,178,45,38,7,37,,,,,,7/8/2020
4/7/2020,261,1617,1631,10923,12540,20,282,3,74,2,15,193,45,35,5,42,,,,,,7/8/2020
4/8/2020,273,1890,1723,12646,14536,19,301,8,82,6,21,198,50,36,10,52,,,,,,7/8/2020
4/9/2020,279,2169,1521,14167,16336,32,333,9,91,4,25,217,50,38,7,59,,,,,,7/8/2020
4/10/2020,404,2573,2577,16744,19317,29,362,17,108,5,30,224,48,36,11,70,,,,,,7/8/2020
4/11/2020,280,2853,1911,18655,21508,29,391,11,119,2,32,240,49,40,11,81,,,,,,7/8/2020
4/12/2020,289,3142,1674,20329,23471,35,426,13,132,5,37,257,54,44,10,91,,,,,,7/8/2020
4/13/2020,187,3329,938,21267,24596,35,461,13,145,3,40,276,61,43,9,100,,,,,,7/8/2020
4/14/2020,267,3596,1788,23055,26651,27,488,17,162,5,45,281,62,43,8,108,,,,,,7/8/2020
4/15/2020,307,3903,1803,24858,28761,31,519,19,181,3,48,290,67,43,17,125,,,,,,7/8/2020
4/16/2020,392,4295,2500,27358,31653,36,555,25,206,6,54,295,70,43,14,139,,,,,,7/8/2020
4/17/2020,290,4585,1823,29181,33766,31,586,21,227,7,61,298,62,45,21,160,,,,,,7/8/2020
4/18/2020,283,4868,1728,30909,35777,26,612,18,245,4,65,302,67,43,15,175,,,,,,7/8/2020
4/19/2020,339,5207,2059,32968,38175,23,635,26,271,1,66,298,71,44,11,186,,,,,,7/8/2020
4/20/2020,378,5585,1909,34877,40462,46,681,29,300,2,68,313,72,45,10,196,,,,,,7/8/2020
4/21/2020,387,5972,2114,36991,42963,45,726,31,331,5,73,322,77,48,18,214,,,,,,7/8/2020
4/22/2020,382,6354,2398,39389,45743,41,767,32,363,5,78,326,77,52,17,231,,,,,,7/8/2020
4/23/2020,419,6773,2471,41860,48633,30,797,28,391,5,83,323,78,53,15,246,,,,,,7/8/2020
4/24/2020,415,7188,3292,45152,52340,35,832,27,418,4,87,327,81,56,15,261,,,,,,7/8/2020
4/25/2020,305,7493,2210,47362,54855,34,866,17,435,5,92,339,84,55,14,275,,,,,,7/8/2020
4/26/2020,276,7769,2314,49676,57445,33,899,15,450,3,95,354,80,55,14,289,,,,,,7/8/2020
4/27/2020,203,7972,1624,51300,59272,29,928,21,471,4,99,358,98,62,10,299,,,,,,7/8/2020
4/28/2020,324,8296,2268,53568,61864,44,972,24,495,3,102,375,76,51,22,321,,,,,,7/8/2020
4/29/2020,372,8668,3351,56919,65587,36,1008,37,532,11,113,363,80,54,18,339,,,,,,7/8/2020
4/30/2020,348,9016,2772,59691,68707,33,1041,38,570,6,119,352,83,59,24,363,,,,,,7/8/2020
5/1/2020,317,9333,3089,62780,72113,51,1092,39,609,3,122,361,84,61,14,377,,,,,,7/8/2020
5/2/2020,189,9522,1926,64706,74228,35,1127,39,648,5,127,352,89,62,24,401,,,,,,7/8/2020
5/3/2020,181,9703,2168,66874,76577,31,1158,27,675,8,135,348,86,60,21,422,,,,,,7/8/2020
5/4/2020,291,9994,2101,68975,78969,30,1188,31,706,5,140,342,82,56,18,440,,,,,,7/8/2020
5/5/2020,303,10297,2878,71853,82150,28,1216,32,738,6,146,332,71,52,16,456,,,,,,7/8/2020
5/6/2020,342,10639,2836,74689,85328,28,1244,44,782,9,155,307,77,56,21,477,,,,,,7/8/2020
5/7/2020,271,10910,2904,77593,88503,36,1280,41,823,5,160,297,70,52,21,498,,,,,,7/8/2020
5/8/2020,231,11141,2494,80087,91228,30,1310,29,852,5,165,293,73,52,22,520,,,,,,7/8/2020
5/9/2020,286,11427,3290,83377,94804,22,1332,21,873,4,169,290,72,53,15,535,,,,,,7/8/2020
5/10/2020,186,11613,2090,85467,97080,19,1351,23,896,6,175,280,68,48,13,548,,,,,,7/8/2020
5/11/2020,175,11788,1797,87264,99052,31,1382,16,912,6,181,289,65,42,15,563,,,,,,7/8/2020
5/12/2020,219,12007,2433,89697,101704,23,1405,18,930,4,185,290,63,41,22,585,,,,,,7/8/2020
5/13/2020,196,12203,3515,93212,105415,22,1427,24,954,1,186,287,66,44,13,598,,,,,,7/8/2020
5/14/2020,228,12431,3292,96504,108935,19,1446,27,981,3,189,276,64,45,15,613,,,,,,7/8/2020
5/15/2020,232,12663,3313,99817,112480,24,1470,41,1022,5,194,254,62,46,13,626,,,,,,7/8/2020
5/16/2020,252,12915,3875,103692,116607,25,1495,12,1034,5,199,262,59,44,14,640,,,,,,7/8/2020
5/17/2020,125,13040,2705,106397,119437,17,1512,7,1041,5,204,267,58,45,10,650,,,,,,7/8/2020
5/18/2020,137,13177,1906,108303,121480,19,1531,15,1056,5,209,266,56,41,18,668,,,,,,7/8/2020
5/19/2020,215,13392,3080,111383,124775,23,1554,31,1087,5,214,253,56,40,11,679,,,,,,7/8/2020
5/20/2020,187,13579,2758,114141,127720,19,1573,23,1110,7,221,242,51,34,22,701,,,,,,7/8/2020
5/21/2020,169,13748,3745,117886,131634,26,1599,15,1125,3,224,250,49,32,20,721,,,,,,7/8/2020
5/22/2020,201,13949,2974,120860,134809,19,1618,29,1154,5,229,235,--,--,10,731,,,,,,7/8/2020
5/23/2020,108,14057,2724,123584,137641,19,1637,11,1165,3,232,240,50,36,13,744,,,,,,7/8/2020
5/24/2020,84,14141,1352,124936,139077,12,1649,14,1179,2,234,236,49,35,8,752,,,,,,7/8/2020
5/25/2020,70,14211,1366,126302,140513,12,1661,14,1193,0,234,234,53,36,10,762,,,,,,7/8/2020
5/26/2020,154,14365,2545,128847,143212,24,1685,22,1215,5,239,231,47,33,15,777,,,,,,7/8/2020
5/27/2020,133,14498,2055,130902,145400,20,1705,17,1232,3,242,231,50,32,10,787,,,,,,7/8/2020
5/28/2020,132,14630,3281,134183,148813,17,1722,29,1261,4,246,215,46,29,7,794,,,,,,7/8/2020
5/29/2020,178,14808,3902,138085,152893,18,1740,27,1288,5,251,201,46,29,12,806,,,,,,7/8/2020
5/30/2020,104,14912,3958,142043,156955,15,1755,19,1307,4,255,193,48,31,12,818,,,,,,7/8/2020
5/31/2020,76,14988,1727,143770,158758,10,1765,10,1317,0,255,193,44,30,3,821,,,,,,7/8/2020
6/1/2020,99,15087,2734,146504,161591,8,1773,12,1329,1,256,188,42,29,5,826,,,,,,7/8/2020
6/2/2020,107,15194,2986,149490,164684,8,1781,9,1338,3,259,184,37,23,10,836,,,,,,7/8/2020
6/3/2020,105,15299,3447,152937,168236,13,1794,18,1356,6,265,173,--,--,11,847,,,,,,7/8/2020
6/4/2020,117,15416,4453,157390,172806,7,1801,25,1381,3,268,152,--,--,11,858,,,,,,7/8/2020
6/5/2020,105,15521,3484,160874,176395,15,1816,12,1393,5,273,150,28,20,9,867,,,,,,7/8/2020
6/6/2020,68,15589,2605,163479,179068,10,1826,7,1400,2,275,151,31,19,6,873,,,,,,7/8/2020
6/7/2020,49,15638,1581,165060,180698,11,1837,7,1407,1,276,154,27,16,4,877,,,,,,7/8/2020
6/8/2020,45,15683,1748,166808,182491,15,1852,12,1419,2,278,155,26,16,4,881,,,,,,7/8/2020
6/9/2020,68,15751,2533,169341,185092,10,1862,18,1437,0,278,147,28,17,1,882,,,,,,7/8/2020
6/10/2020,104,15855,2859,172200,188055,13,1875,12,1449,2,280,146,--,--,3,885,,,,,,7/8/2020
6/11/2020,87,15942,3375,175575,191517,7,1882,15,1464,1,281,137,--,--,6,891,,,,,,7/8/2020
6/12/2020,81,16023,4383,179958,195981,8,1890,15,1479,1,282,129,21,14,2,893,,,,,,7/8/2020
6/13/2020,49,16072,2742,182700,198772,6,1896,4,1483,0,282,131,16,13,3,896,,,,,,7/8/2020
6/14/2020,32,16104,1871,184571,200675,6,1902,8,1491,1,283,128,17,13,3,899,,,,,,7/8/2020
6/15/2020,76,16180,2961,187532,203712,14,1916,14,1505,0,283,128,23,13,4,903,,,,,,7/8/2020
6/16/2020,52,16232,2806,190338,206570,10,1926,10,1515,1,284,127,23,12,8,911,,,,,,7/8/2020
6/17/2020,51,16283,2566,192904,209187,15,1941,20,1535,4,288,118,--,--,6,917,,,,,,7/8/2020
6/18/2020,71,16354,2870,195774,212128,9,1950,13,1548,1,289,113,--,--,7,924,,,,,,7/8/2020
6/19/2020,59,16413,3429,199203,215616,12,1962,11,1559,1,290,113,18,15,3,927,,,,,,7/8/2020
6/20/2020,36,16449,1682,200885,217334,7,1969,9,1568,0,290,111,19,17,3,930,,,,,,7/8/2020
6/21/2020,27,16476,975,201860,218336,7,1976,5,1573,0,290,113,20,16,2,932,,,,,,7/8/2020
6/22/2020,59,16535,3548,205408,221943,12,1988,16,1589,0,290,109,18,17,1,933,,,,,,7/8/2020
6/23/2020,77,16612,3602,209010,225622,3,1991,13,1602,3,293,96,16,15,6,939,,,,,,7/8/2020
6/24/2020,51,16663,3243,212253,228916,8,1999,10,1612,1,294,93,--,--,5,944,,,,,,7/8/2020
6/25/2020,45,16708,2746,214999,231707,5,2004,14,1626,1,295,83,16,15,0,944,,,,,,7/8/2020
6/26/2020,69,16777,2369,217368,234145,2,2006,9,1635,0,295,76,15,14,1,945,,,,,,7/8/2020
6/27/2020,36,16813,3189,220557,237370,4,2010,3,1638,1,296,76,13,13,5,950,,,,,,7/8/2020
6/28/2020,22,16835,1435,221992,238827,3,2013,4,1642,4,300,71,11,11,6,956,,,,,,7/8/2020
6/29/2020,36,16871,3620,225612,242483,4,2017,5,1647,0,300,70,11,10,1,957,,,,,,7/8/2020
6/30/2020,40,16911,1881,227493,244404,1,2018,5,1652,1,301,65,--,--,3,960,,,,,,7/8/2020
7/1/2020,65,16976,3958,231451,248427,7,2025,9,1661,0,301,63,9,7,1,961,,,,,,7/8/2020
7/2/2020,59,17035,2606,234057,251092,4,2029,5,1666,1,302,61,6,6,0,961,,,,,,7/8/2020
7/3/2020,22,17057,1851,235908,252965,7,2036,6,1672,0,302,62,5,5,3,964,,,,,,7/8/2020
7/4/2020,27,17084,2227,238135,255219,2,2038,4,1676,1,303,59,6,5,1,965,,,,,,7/8/2020
7/5/2020,24,17108,2826,240961,258069,1,2039,2,1678,1,304,57,4,4,2,967,,,,,,7/8/2020
7/6/2020,55,17163,2709,243670,260833,4,2043,5,1683,0,304,56,5,5,3,970,,,,,,7/8/2020
7/7/2020,41,17204,3342,247012,264216,,,,,,,,,,1,971,,,,,,7/8/2020
2/27/2020,0,0,0,0,0,1,1,0,0,0,0,1,0,0,0,0,0,0,0,0,0,7/10/2020
2/28/2020,0,0,0,0,0,0,1,0,0,0,0,1,1,0,0,0,0,0,0,0,0,7/10/2020
2/29/2020,0,0,0,0,0,0,1,0,0,0,0,1,1,0,0,0,0,0,0,0,0,7/10/2020
3/1/2020,2,2,2,2,4,0,1,0,0,0,0,1,1,1,0,0,2,2,2,2,4,7/10/2020
3/2/2020,0,2,1,3,5,1,2,0,0,0,0,2,2,2,0,0,0,2,1,3,5,7/10/2020
3/3/2020,0,2,2,5,7,0,2,0,0,0,0,2,2,2,0,0,0,2,2,5,7,7/10/2020
3/4/2020,0,2,12,17,19,1,3,0,0,0,0,3,2,2,0,0,0,2,10,15,17,7/10/2020
3/5/2020,0,2,4,21,23,0,3,0,0,0,0,3,2,2,0,0,1,3,4,19,22,7/10/2020
3/6/2020,1,3,12,33,36,0,3,0,0,0,0,3,2,2,0,0,0,3,11,30,33,7/10/2020
3/7/2020,0,3,19,52,55,0,3,0,0,0,0,3,2,1,0,0,0,3,19,49,52,7/10/2020
3/8/2020,0,3,18,70,73,0,3,0,0,0,0,3,2,1,0,0,0,3,18,67,70,7/10/2020
3/9/2020,1,4,15,85,89,0,3,0,0,0,0,3,2,1,0,0,1,4,15,82,86,7/10/2020
3/10/2020,2,6,25,110,116,0,3,0,0,0,0,3,2,1,0,0,1,5,23,105,110,7/10/2020
3/11/2020,0,6,34,144,150,1,4,0,0,0,0,4,1,1,0,0,0,5,34,139,144,7/10/2020
3/12/2020,9,15,42,186,201,1,5,0,0,0,0,5,1,1,0,0,8,13,38,177,190,7/10/2020
3/13/2020,6,21,50,236,257,4,9,1,1,0,0,8,1,1,0,0,6,19,48,225,244,7/10/2020
3/14/2020,0,21,90,326,347,0,9,0,1,0,0,8,1,1,0,0,0,19,87,312,331,7/10/2020
3/15/2020,1,22,54,380,402,1,10,0,1,0,0,9,2,1,0,0,1,20,54,366,386,7/10/2020
3/16/2020,2,24,95,475,499,2,12,0,1,0,0,11,2,0,0,0,2,22,92,458,480,7/10/2020
3/17/2020,16,40,162,637,677,6,18,0,1,0,0,17,2,0,0,0,11,33,153,611,644,7/10/2020
3/18/2020,12,52,116,753,805,3,21,0,1,0,0,20,2,0,0,0,11,44,111,722,766,7/10/2020
3/19/2020,17,69,262,1015,1084,2,23,1,2,0,0,21,3,0,1,1,17,61,251,973,1034,7/10/2020
3/20/2020,15,84,197,1212,1296,5,28,0,2,0,0,26,4,0,0,1,13,74,193,1166,1240,7/10/2020
3/21/2020,21,105,126,1338,1443,3,31,2,4,0,0,27,5,0,0,1,14,88,123,1289,1377,7/10/2020
3/22/2020,30,135,282,1620,1755,2,33,0,4,0,0,29,5,0,0,1,25,113,265,1554,1667,7/10/2020
3/23/2020,14,149,169,1789,1938,15,48,1,5,0,0,43,9,3,0,1,16,129,166,1720,1849,7/10/2020
3/24/2020,20,169,243,2032,2201,7,55,0,5,0,0,50,10,4,0,1,19,148,238,1958,2106,7/10/2020
3/25/2020,26,195,183,2215,2410,5,60,1,6,0,0,54,11,3,0,1,28,176,173,2131,2307,7/10/2020
3/26/2020,35,230,181,2396,2626,10,70,5,11,0,0,59,14,5,0,1,41,217,176,2307,2524,7/10/2020
3/27/2020,27,257,215,2611,2868,9,79,1,12,1,1,66,17,6,2,3,31,248,202,2509,2757,7/10/2020
3/28/2020,59,316,260,2871,3187,13,92,3,15,2,3,74,15,6,1,4,64,312,242,2751,3063,7/10/2020
3/29/2020,106,422,356,3227,3649,8,100,4,19,1,4,77,18,8,2,6,105,417,314,3065,3482,7/10/2020
3/30/2020,62,484,222,3449,3933,20,120,5,24,0,4,92,20,11,3,9,78,495,192,3257,3752,7/10/2020
3/31/2020,71,555,369,3818,4373,11,131,7,31,1,5,95,22,13,2,11,73,568,300,3557,4125,7/10/2020
4/1/2020,99,654,699,4517,5171,18,149,7,38,0,5,106,30,15,1,12,100,668,649,4206,4874,7/10/2020
4/2/2020,52,706,477,4994,5700,21,170,6,44,2,7,119,36,21,4,16,62,730,437,4643,5373,7/10/2020
4/3/2020,108,814,775,5769,6583,23,193,7,51,0,7,135,43,25,3,19,100,830,719,5362,6192,7/10/2020
4/4/2020,143,957,660,6429,7386,22,215,4,55,5,12,148,41,30,9,28,137,967,624,5986,6953,7/10/2020
4/5/2020,187,1144,1156,7585,8729,20,235,9,64,1,13,158,44,36,2,30,182,1149,1072,7058,8207,7/10/2020
4/6/2020,218,1362,1707,9292,10654,26,261,7,71,0,13,177,48,40,7,37,206,1355,1583,8641,9996,7/10/2020
4/7/2020,285,1647,1631,10923,12570,20,281,4,75,2,15,191,49,42,5,42,261,1616,1496,10137,11753,7/10/2020
4/8/2020,290,1937,1723,12646,14583,19,300,7,82,6,21,197,49,38,10,52,272,1888,1577,11714,13602,7/10/2020
4/9/2020,284,2221,1521,14167,16388,32,332,9,91,4,25,216,52,40,7,59,279,2167,1370,13084,15251,7/10/2020
4/10/2020,420,2641,2577,16744,19385,29,361,16,107,5,30,224,58,41,11,70,404,2571,2383,15467,18038,7/10/2020
4/11/2020,299,2940,1911,18655,21595,29,390,11,118,2,32,240,61,48,11,81,280,2851,1736,17203,20054,7/10/2020
4/12/2020,315,3255,1674,20329,23584,35,425,13,131,5,37,257,59,49,10,91,289,3140,1453,18656,21796,7/10/2020
4/13/2020,162,3417,938,21267,24684,35,460,13,144,3,40,276,64,54,9,100,187,3327,852,19508,22835,7/10/2020
4/14/2020,289,3706,1788,23055,26761,27,487,17,161,5,45,281,72,53,8,108,267,3594,1565,21073,24667,7/10/2020
4/15/2020,353,4059,1803,24858,28917,31,518,19,180,3,48,290,72,54,17,125,307,3901,1582,22655,26556,7/10/2020
4/16/2020,449,4508,2500,27358,31866,36,554,25,205,6,54,295,72,53,14,139,392,4293,2100,24755,29048,7/10/2020
4/17/2020,308,4816,1823,29181,33997,32,586,20,225,7,61,300,66,45,21,160,290,4583,1504,26259,30842,7/10/2020
4/18/2020,322,5138,1728,30909,36047,26,612,18,243,4,65,304,63,49,15,175,283,4866,1374,27633,32499,7/10/2020
4/19/2020,382,5520,2059,32968,38488,23,635,26,269,1,66,300,65,55,11,186,339,5205,1765,29398,34603,7/10/2020
4/20/2020,396,5916,1909,34877,40793,46,681,29,298,2,68,315,75,56,10,196,378,5583,1601,30999,36582,7/10/2020
4/21/2020,445,6361,2114,36991,43352,45,726,31,329,5,73,324,72,56,18,214,387,5970,1730,32729,38699,7/10/2020
4/22/2020,420,6781,2398,39389,46170,41,767,32,361,5,78,328,73,58,18,232,382,6352,1930,34659,41011,7/10/2020
4/23/2020,482,7263,2471,41860,49123,30,797,28,389,5,83,325,76,62,15,247,419,6771,1900,36559,43330,7/10/2020
4/24/2020,494,7757,3292,45152,52909,35,832,27,416,4,87,329,85,63,15,262,414,7185,2657,39216,46401,7/10/2020
4/25/2020,394,8151,2210,47362,55513,34,866,17,433,5,92,341,85,62,14,276,305,7490,1794,41010,48500,7/10/2020
4/26/2020,316,8467,2314,49676,58143,33,899,15,448,3,95,356,86,59,14,290,276,7766,1894,42904,50670,7/10/2020
4/27/2020,250,8717,1624,51300,60017,29,928,21,469,4,99,360,86,61,10,300,203,7969,1175,44079,52048,7/10/2020
4/28/2020,411,9128,2268,53568,62696,44,972,24,493,3,102,377,88,59,22,322,323,8292,1781,45860,54152,7/10/2020
4/29/2020,476,9604,3351,56919,66523,36,1008,37,530,11,113,365,77,53,18,340,372,8664,2460,48320,56984,7/10/2020
4/30/2020,432,10036,2772,59691,69727,33,1041,38,568,6,119,354,82,57,24,364,348,9012,1966,50286,59298,7/10/2020
5/1/2020,457,10493,3089,62780,73273,51,1092,40,608,3,122,362,83,58,14,378,317,9329,2233,52519,61848,7/10/2020
5/2/2020,259,10752,1926,64706,75458,35,1127,38,646,5,127,354,89,61,24,402,189,9518,1299,53818,63336,7/10/2020
5/3/2020,284,11036,2168,66874,77910,31,1158,27,673,8,135,350,88,61,21,423,181,9699,1617,55435,65134,7/10/2020
5/4/2020,387,11423,2101,68975,80398,30,1188,31,704,5,140,344,86,57,18,441,291,9990,1583,57018,67008,7/10/2020
5/5/2020,435,11858,2878,71853,83711,28,1216,32,736,6,146,334,79,54,16,457,303,10293,1989,59007,69300,7/10/2020
5/6/2020,490,12348,2836,74689,87037,28,1244,44,780,9,155,309,77,54,21,478,342,10635,1943,60950,71585,7/10/2020
5/7/2020,416,12764,2904,77593,90357,36,1280,41,821,5,160,299,69,52,21,499,271,10906,1936,62886,73792,7/10/2020
5/8/2020,339,13103,2494,80087,93190,30,1310,29,850,5,165,295,69,53,22,521,231,11137,1696,64582,75719,7/10/2020
5/9/2020,446,13549,3290,83377,96926,22,1332,21,871,4,169,292,67,51,15,536,286,11423,2267,66849,78272,7/10/2020
5/10/2020,277,13826,2090,85467,99293,19,1351,23,894,6,175,282,68,49,13,549,186,11609,1505,68354,79963,7/10/2020
5/11/2020,241,14067,1797,87264,101331,31,1382,16,910,6,181,291,69,49,15,564,175,11784,1261,69615,81399,7/10/2020
5/12/2020,370,14437,2433,89697,104134,23,1405,18,928,4,185,292,67,48,22,586,219,12003,1557,71172,83175,7/10/2020
5/13/2020,345,14782,3515,93212,107994,22,1427,24,952,1,186,289,68,49,13,599,196,12199,1929,73101,85300,7/10/2020
5/14/2020,307,15089,3292,96504,111593,19,1446,27,979,3,189,278,63,45,15,614,228,12427,1930,75031,87458,7/10/2020
5/15/2020,364,15453,3313,99817,115270,24,1470,41,1020,5,194,256,61,45,13,627,232,12659,1712,76743,89402,7/10/2020
5/16/2020,419,15872,3875,103692,119564,25,1495,12,1032,5,199,264,60,46,15,642,252,12911,1774,78517,91428,7/10/2020
5/17/2020,223,16095,2705,106397,122492,17,1512,7,1039,5,204,269,58,45,10,652,125,13036,1543,80060,93096,7/10/2020
5/18/2020,224,16319,1906,108303,124622,19,1531,15,1054,5,209,268,56,40,18,670,137,13173,1300,81360,94533,7/10/2020
5/19/2020,402,16721,3080,111383,128104,23,1554,31,1085,5,214,255,55,38,11,681,215,13388,1884,83244,96632,7/10/2020
5/20/2020,320,17041,2758,114141,131182,19,1573,23,1108,7,221,244,51,33,22,703,187,13575,1526,84770,98345,7/10/2020
5/21/2020,364,17405,3745,117886,135291,26,1599,15,1123,3,224,252,52,29,20,723,169,13744,1949,86719,100463,7/10/2020
5/22/2020,344,17749,2974,120860,138609,20,1619,29,1152,5,229,238,51,29,10,733,202,13946,1458,88177,102123,7/10/2020
5/23/2020,234,17983,2724,123584,141567,19,1638,11,1163,3,232,243,51,32,13,746,108,14054,1322,89499,103553,7/10/2020
5/24/2020,151,18134,1352,124936,143070,12,1650,14,1177,2,234,239,52,36,8,754,84,14138,760,90259,104397,7/10/2020
5/25/2020,134,18268,1366,126302,144570,12,1662,14,1191,0,234,237,52,34,10,764,70,14208,750,91009,105217,7/10/2020
5/26/2020,273,18541,2545,128847,147388,24,1686,22,1213,5,239,234,47,33,15,779,154,14362,1732,92741,107103,7/10/2020
5/27/2020,272,18813,2055,130902,149715,20,1706,17,1230,3,242,234,49,33,10,789,133,14495,1113,93854,108349,7/10/2020
5/28/2020,337,19150,3281,134183,153333,17,1723,29,1259,4,246,218,46,32,7,796,132,14627,1075,94929,109556,7/10/2020
5/29/2020,415,19565,3902,138085,157650,18,1741,27,1286,6,252,203,42,31,12,808,178,14805,1535,96464,111269,7/10/2020
5/30/2020,211,19776,3958,142043,161819,15,1756,19,1305,4,256,195,39,29,12,820,104,14909,1834,98298,113207,7/10/2020
5/31/2020,146,19922,1727,143770,163692,10,1766,10,1315,0,256,195,42,26,3,823,76,14985,850,99148,114133,7/10/2020
6/1/2020,202,20124,2734,146504,166628,7,1773,13,1328,1,257,188,43,29,5,828,99,15084,1327,100475,115559,7/10/2020
6/2/2020,262,20386,2986,149490,169876,8,1781,9,1337,3,260,184,36,24,10,838,108,15192,1404,101879,117071,7/10/2020
6/3/2020,253,20639,3447,152937,173576,13,1794,18,1355,6,266,173,33,24,11,849,105,15297,1632,103511,118808,7/10/2020
6/4/2020,274,20913,4453,157390,178303,7,1801,25,1380,3,269,152,30,23,11,860,117,15414,2005,105516,120930,7/10/2020
6/5/2020,213,21126,3484,160874,182000,15,1816,12,1392,5,274,150,26,20,9,869,104,15518,1527,107043,122561,7/10/2020
6/6/2020,198,21324,2605,163479,184803,10,1826,7,1399,2,276,151,28,18,6,875,68,15586,1130,108173,123759,7/10/2020
6/7/2020,77,21401,1581,165060,186461,11,1837,7,1406,1,277,154,24,16,4,879,49,15635,761,108934,124569,7/10/2020
6/8/2020,115,21516,1748,166808,188324,15,1852,12,1418,2,279,155,26,17,4,883,44,15679,888,109822,125501,7/10/2020
6/9/2020,219,21735,2533,169341,191076,10,1862,18,1436,0,279,147,27,20,1,884,68,15747,1166,110988,126735,7/10/2020
6/10/2020,202,21937,2859,172200,194137,13,1875,12,1448,2,281,146,23,16,3,887,104,15851,1370,112358,128209,7/10/2020
6/11/2020,193,22130,3375,175575,197705,7,1882,15,1463,1,282,137,24,15,6,893,88,15939,1446,113804,129743,7/10/2020
6/12/2020,206,22336,4383,179958,202294,8,1890,15,1478,1,283,129,22,15,2,895,81,16020,2099,115903,131923,7/10/2020
6/13/2020,102,22438,2742,182700,205138,6,1896,4,1482,0,283,131,18,14,3,898,49,16069,1232,117135,133204,7/10/2020
6/14/2020,76,22514,1871,184571,207085,6,1902,8,1490,1,284,128,18,13,3,901,32,16101,887,118022,134123,7/10/2020
6/15/2020,180,22694,2961,187532,210226,14,1916,14,1504,0,284,128,18,15,4,905,76,16177,1713,119735,135912,7/10/2020
6/16/2020,106,22800,2806,190338,213138,10,1926,10,1514,1,285,127,20,15,8,913,52,16229,1494,121229,137458,7/10/2020
6/17/2020,113,22913,2566,192904,215817,15,1941,20,1534,4,289,118,16,13,6,919,51,16280,1209,122438,138718,7/10/2020
6/18/2020,145,23058,2870,195774,218832,9,1950,13,1547,1,290,113,17,15,7,926,71,16351,1224,123662,140013,7/10/2020
6/19/2020,131,23189,3429,199203,222392,12,1962,11,1558,1,291,113,18,16,3,929,59,16410,1185,124847,141257,7/10/2020
6/20/2020,74,23263,1682,200885,224148,7,1969,9,1567,0,291,111,18,17,4,933,36,16446,683,125530,141976,7/10/2020
6/21/2020,35,23298,975,201860,225158,7,1976,5,1572,0,291,113,18,17,2,935,27,16473,627,126157,142630,7/10/2020
6/22/2020,136,23434,3548,205408,228842,12,1988,16,1588,0,291,109,17,17,1,936,59,16532,1598,127755,144287,7/10/2020
6/23/2020,148,23582,3602,209010,232592,3,1991,13,1601,3,294,96,16,17,6,942,77,16609,1603,129358,145967,7/10/2020
6/24/2020,111,23693,3243,212253,235946,8,1999,10,1611,1,295,93,15,17,5,947,51,16660,1496,130854,147514,7/10/2020
6/25/2020,95,23788,2746,214999,238787,5,2004,14,1625,1,296,83,14,16,0,947,46,16706,1410,132264,148970,7/10/2020
6/26/2020,89,23877,2369,217368,241245,2,2006,9,1634,0,296,76,15,17,1,948,70,16776,1316,133580,150356,7/10/2020
6/27/2020,84,23961,3189,220557,244518,5,2011,3,1637,1,297,77,14,16,5,953,36,16812,1200,134780,151592,7/10/2020
6/28/2020,37,23998,1435,221992,245990,3,2014,4,1641,4,301,72,12,13,6,959,22,16834,581,135361,152195,7/10/2020
6/29/2020,86,24084,3620,225612,249696,4,2018,5,1646,0,301,71,11,13,1,960,37,16871,1323,136684,153555,7/10/2020
6/30/2020,59,24143,1881,227493,251636,1,2019,5,1651,1,302,66,9,10,3,963,41,16912,978,137662,154574,7/10/2020
7/1/2020,141,24284,3958,231451,255735,7,2026,9,1660,0,302,64,8,10,1,964,65,16977,1894,139556,156533,7/10/2020
7/2/2020,99,24383,2606,234057,258440,4,2030,5,1665,1,303,62,6,8,1,965,58,17035,986,140542,157577,7/10/2020
7/3/2020,42,24425,1851,235908,260333,7,2037,6,1671,0,303,63,5,7,3,968,23,17058,675,141217,158275,7/10/2020
7/4/2020,52,24477,2227,238135,262612,2,2039,4,1675,1,304,60,6,7,2,970,27,17085,952,142169,159254,7/10/2020
7/5/2020,46,24523,2826,240961,265484,1,2040,2,1677,1,305,58,4,6,2,972,25,17110,1376,143545,160655,7/10/2020
7/6/2020,101,24624,2709,243670,268294,4,2044,5,1682,0,305,57,5,7,3,975,55,17165,1521,145066,162231,7/10/2020
7/7/2020,74,24698,3343,247013,271711,4,2048,2,1684,0,305,59,4,6,1,976,32,17197,1523,146589,163786,7/10/2020
7/8/2020,93,24791,3257,250270,275061,3,2051,1,1685,0,305,61,4,5,0,976,70,17267,1342,147931,165198,7/10/2020
7/9/2020,94,24885,3202,253472,278357,,,,,,,,,,0,976,45,17312,1412,149343,166655,7/10/2020
2/27/2020,0,0,0,0,0,1,1,0,0,0,0,1,0,0,0,0,0,0,0,0,0,7/13/2020
2/28/2020,0,0,0,0,0,0,1,0,0,0,0,1,1,0,0,0,0,0,0,0,0,7/13/2020
2/29/2020,0,0,0,0,0,0,1,0,0,0,0,1,1,0,0,0,0,0,0,0,0,7/13/2020
3/1/2020,2,2,2,2,4,0,1,0,0,0,0,1,1,1,0,0,2,2,2,2,4,7/13/2020
3/2/2020,0,2,1,3,5,1,2,0,0,0,0,2,2,2,0,0,0,2,1,3,5,7/13/2020
3/3/2020,0,2,2,5,7,0,2,0,0,0,0,2,2,2,0,0,0,2,2,5,7,7/13/2020
3/4/2020,0,2,12,17,19,1,3,0,0,0,0,3,2,2,0,0,0,2,10,15,17,7/13/2020
3/5/2020,0,2,4,21,23,0,3,0,0,0,0,3,2,2,0,0,1,3,4,19,22,7/13/2020
3/6/2020,1,3,12,33,36,0,3,0,0,0,0,3,2,2,0,0,0,3,11,30,33,7/13/2020
3/7/2020,0,3,19,52,55,0,3,0,0,0,0,3,2,1,0,0,0,3,19,49,52,7/13/2020
3/8/2020,0,3,18,70,73,0,3,0,0,0,0,3,2,1,0,0,0,3,18,67,70,7/13/2020
3/9/2020,1,4,15,85,89,0,3,0,0,0,0,3,2,1,0,0,1,4,15,82,86,7/13/2020
3/10/2020,2,6,25,110,116,0,3,0,0,0,0,3,2,1,0,0,1,5,23,105,110,7/13/2020
3/11/2020,0,6,34,144,150,1,4,0,0,0,0,4,1,1,0,0,0,5,34,139,144,7/13/2020
3/12/2020,9,15,42,186,201,1,5,0,0,0,0,5,1,1,0,0,8,13,38,177,190,7/13/2020
3/13/2020,6,21,50,236,257,4,9,1,1,0,0,8,1,1,0,0,6,19,48,225,244,7/13/2020
3/14/2020,0,21,90,326,347,0,9,0,1,0,0,8,1,1,0,0,0,19,87,312,331,7/13/2020
3/15/2020,1,22,54,380,402,1,10,0,1,0,0,9,2,1,0,0,1,20,54,366,386,7/13/2020
3/16/2020,2,24,95,475,499,2,12,0,1,0,0,11,2,0,0,0,2,22,92,458,480,7/13/2020
3/17/2020,16,40,162,637,677,6,18,0,1,0,0,17,2,0,0,0,11,33,153,611,644,7/13/2020
3/18/2020,12,52,116,753,805,3,21,0,1,0,0,20,2,0,0,0,11,44,111,722,766,7/13/2020
3/19/2020,17,69,262,1015,1084,2,23,1,2,0,0,21,3,0,1,1,17,61,251,973,1034,7/13/2020
3/20/2020,15,84,197,1212,1296,5,28,0,2,0,0,26,4,0,0,1,13,74,193,1166,1240,7/13/2020
3/21/2020,21,105,126,1338,1443,3,31,2,4,0,0,27,5,0,0,1,14,88,123,1289,1377,7/13/2020
3/22/2020,30,135,282,1620,1755,2,33,0,4,0,0,29,5,0,0,1,25,113,265,1554,1667,7/13/2020
3/23/2020,14,149,169,1789,1938,15,48,1,5,0,0,43,9,3,0,1,16,129,165,1719,1848,7/13/2020
3/24/2020,20,169,243,2032,2201,7,55,0,5,0,0,50,10,4,0,1,19,148,238,1957,2105,7/13/2020
3/25/2020,26,195,183,2215,2410,5,60,1,6,0,0,54,11,3,0,1,28,176,173,2130,2306,7/13/2020
3/26/2020,35,230,181,2396,2626,10,70,5,11,0,0,59,14,5,0,1,41,217,176,2306,2523,7/13/2020
3/27/2020,27,257,215,2611,2868,9,79,1,12,1,1,66,17,6,2,3,31,248,202,2508,2756,7/13/2020
3/28/2020,59,316,260,2871,3187,13,92,3,15,2,3,74,15,6,1,4,64,312,242,2750,3062,7/13/2020
3/29/2020,106,422,356,3227,3649,8,100,4,19,1,4,77,18,8,2,6,105,417,314,3064,3481,7/13/2020
3/30/2020,62,484,222,3449,3933,20,120,5,24,0,4,92,20,11,3,9,78,495,192,3256,3751,7/13/2020
3/31/2020,71,555,369,3818,4373,11,131,7,31,1,5,95,22,13,2,11,73,568,300,3556,4124,7/13/2020
4/1/2020,99,654,699,4517,5171,18,149,7,38,0,5,106,30,15,1,12,100,668,649,4205,4873,7/13/2020
4/2/2020,52,706,477,4994,5700,21,170,6,44,2,7,119,36,21,4,16,62,730,437,4642,5372,7/13/2020
4/3/2020,108,814,775,5769,6583,23,193,7,51,0,7,135,43,25,3,19,100,830,719,5361,6191,7/13/2020
4/4/2020,143,957,660,6429,7386,22,215,4,55,5,12,148,41,30,9,28,137,967,623,5984,6951,7/13/2020
4/5/2020,187,1144,1156,7585,8729,20,235,9,64,1,13,158,44,36,2,30,182,1149,1071,7055,8204,7/13/2020
4/6/2020,218,1362,1707,9292,10654,26,261,7,71,0,13,177,48,40,7,37,206,1355,1583,8638,9993,7/13/2020
4/7/2020,285,1647,1631,10923,12570,20,281,4,75,2,15,191,49,42,5,42,261,1616,1496,10134,11750,7/13/2020
4/8/2020,290,1937,1723,12646,14583,19,300,7,82,6,21,197,49,38,10,52,272,1888,1577,11711,13599,7/13/2020
4/9/2020,284,2221,1521,14167,16388,32,332,9,91,4,25,216,52,40,7,59,278,2166,1370,13081,15247,7/13/2020
4/10/2020,420,2641,2577,16744,19385,29,361,16,107,5,30,224,58,41,11,70,404,2570,2383,15464,18034,7/13/2020
4/11/2020,299,2940,1911,18655,21595,29,390,11,118,2,32,240,61,48,11,81,280,2850,1735,17199,20049,7/13/2020
4/12/2020,315,3255,1674,20329,23584,35,425,13,131,5,37,257,59,49,10,91,289,3139,1453,18652,21791,7/13/2020
4/13/2020,162,3417,938,21267,24684,35,460,13,144,3,40,276,64,54,9,100,187,3326,851,19503,22829,7/13/2020
4/14/2020,289,3706,1788,23055,26761,27,487,17,161,5,45,281,72,53,8,108,267,3593,1564,21067,24660,7/13/2020
4/15/2020,353,4059,1803,24858,28917,31,518,19,180,3,48,290,72,54,17,125,307,3900,1580,22647,26547,7/13/2020
4/16/2020,449,4508,2500,27358,31866,36,554,25,205,6,54,295,72,53,14,139,392,4292,2099,24746,29038,7/13/2020
4/17/2020,308,4816,1823,29181,33997,32,586,20,225,7,61,300,66,45,21,160,290,4582,1503,26249,30831,7/13/2020
4/18/2020,322,5138,1728,30909,36047,26,612,18,243,4,65,304,63,49,15,175,284,4866,1373,27622,32488,7/13/2020
4/19/2020,382,5520,2059,32968,38488,23,635,26,269,1,66,300,65,55,11,186,339,5205,1765,29387,34592,7/13/2020
4/20/2020,396,5916,1909,34877,40793,46,681,29,298,2,68,315,75,56,10,196,378,5583,1600,30987,36570,7/13/2020
4/21/2020,445,6361,2114,36991,43352,45,726,31,329,5,73,324,72,56,18,214,387,5970,1730,32717,38687,7/13/2020
4/22/2020,420,6781,2398,39389,46170,41,767,32,361,5,78,328,73,58,18,232,382,6352,1930,34647,40999,7/13/2020
4/23/2020,482,7263,2471,41860,49123,30,797,28,389,5,83,325,76,62,15,247,419,6771,1900,36547,43318,7/13/2020
4/24/2020,494,7757,3292,45152,52909,35,832,27,416,4,87,329,85,63,15,262,414,7185,2656,39203,46388,7/13/2020
4/25/2020,394,8151,2210,47362,55513,34,866,17,433,5,92,341,85,62,14,276,305,7490,1792,40995,48485,7/13/2020
4/26/2020,316,8467,2314,49676,58143,33,899,15,448,3,95,356,86,59,14,290,276,7766,1894,42889,50655,7/13/2020
4/27/2020,250,8717,1624,51300,60017,29,928,21,469,4,99,360,86,61,10,300,203,7969,1175,44064,52033,7/13/2020
4/28/2020,411,9128,2268,53568,62696,44,972,24,493,3,102,377,88,59,22,322,324,8293,1781,45845,54138,7/13/2020
4/29/2020,476,9604,3351,56919,66523,36,1008,37,530,11,113,365,77,53,18,340,372,8665,2457,48302,56967,7/13/2020
4/30/2020,432,10036,2772,59691,69727,33,1041,38,568,6,119,354,82,57,24,364,348,9013,1965,50267,59280,7/13/2020
5/1/2020,457,10493,3089,62780,73273,51,1092,40,608,3,122,362,83,58,14,378,317,9330,2232,52499,61829,7/13/2020
5/2/2020,260,10753,1927,64707,75460,35,1127,38,646,5,127,354,89,61,24,402,189,9519,1300,53799,63318,7/13/2020
5/3/2020,284,11037,2168,66875,77912,31,1158,27,673,8,135,350,88,61,21,423,181,9700,1615,55414,65114,7/13/2020
5/4/2020,388,11425,2101,68976,80401,30,1188,31,704,5,140,344,86,57,18,441,291,9991,1582,56996,66987,7/13/2020
5/5/2020,436,11861,2878,71854,83715,28,1216,32,736,6,146,334,79,54,16,457,303,10294,1989,58985,69279,7/13/2020
5/6/2020,490,12351,2836,74690,87041,28,1244,44,780,9,155,309,77,54,21,478,342,10636,1939,60924,71560,7/13/2020
5/7/2020,425,12776,2975,77665,90441,36,1280,41,821,5,160,299,69,52,21,499,271,10907,1997,62921,73828,7/13/2020
5/8/2020,360,13136,2602,80267,93403,30,1310,29,850,5,165,295,69,53,22,521,231,11138,1788,64709,75847,7/13/2020
5/9/2020,457,13593,3355,83622,97215,22,1332,21,871,4,169,292,67,51,15,536,286,11424,2319,67028,78452,7/13/2020
5/10/2020,279,13872,2122,85744,99616,19,1351,23,894,6,175,282,68,49,13,549,186,11610,1534,68562,80172,7/13/2020
5/11/2020,259,14131,1861,87605,101736,31,1382,16,910,6,181,291,69,49,15,564,175,11785,1317,69879,81664,7/13/2020
5/12/2020,384,14515,2512,90117,104632,23,1405,18,928,4,185,292,67,48,22,586,219,12004,1616,71495,83499,7/13/2020
5/13/2020,352,14867,3570,93687,108554,22,1427,24,952,1,186,289,68,49,13,599,196,12200,1975,73470,85670,7/13/2020
5/14/2020,329,15196,3397,97084,112280,19,1446,27,979,3,189,278,63,45,15,614,228,12428,2024,75494,87922,7/13/2020
5/15/2020,381,15577,3433,100517,116094,24,1470,41,1020,5,194,256,61,45,13,627,232,12660,1811,77305,89965,7/13/2020
5/16/2020,419,15996,3883,104400,120396,25,1495,12,1032,5,199,264,60,46,15,642,252,12912,1779,79084,91996,7/13/2020
5/17/2020,223,16219,2708,107108,123327,17,1512,7,1039,5,204,269,58,45,10,652,125,13037,1545,80629,93666,7/13/2020
5/18/2020,248,16467,1992,109100,125567,19,1531,15,1054,5,209,268,56,40,18,670,137,13174,1364,81993,95167,7/13/2020
5/19/2020,414,16881,3153,112253,129134,23,1554,31,1085,5,214,255,55,38,11,681,215,13389,1941,83934,97323,7/13/2020
5/20/2020,327,17208,2779,115032,132240,19,1573,23,1108,7,221,244,51,33,22,703,187,13576,1542,85476,99052,7/13/2020
5/21/2020,370,17578,3794,118826,136404,26,1599,15,1123,3,224,252,52,29,20,723,169,13745,1989,87465,101210,7/13/2020
5/22/2020,350,17928,3026,121852,139780,20,1619,29,1152,5,229,238,51,29,10,733,202,13947,1495,88960,102907,7/13/2020
5/23/2020,240,18168,2735,124587,142755,19,1638,11,1163,3,232,243,51,32,13,746,108,14055,1330,90290,104345,7/13/2020
5/24/2020,153,18321,1359,125946,144267,12,1650,14,1177,2,234,239,52,36,8,754,84,14139,766,91056,105195,7/13/2020
5/25/2020,134,18455,1376,127322,145777,12,1662,14,1191,0,234,237,52,34,10,764,70,14209,755,91811,106020,7/13/2020
5/26/2020,284,18739,2609,129931,148670,24,1686,22,1213,5,239,234,47,33,15,779,154,14363,1778,93589,107952,7/13/2020
5/27/2020,276,19015,2110,132041,151056,20,1706,17,1230,3,242,234,49,33,10,789,133,14496,1152,94741,109237,7/13/2020
5/28/2020,345,19360,3374,135415,154775,17,1723,29,1259,4,246,218,46,32,8,797,132,14628,1146,95887,110515,7/13/2020
5/29/2020,418,19778,3968,139383,159161,18,1741,27,1286,6,252,203,42,31,12,809,178,14806,1590,97477,112283,7/13/2020
5/30/2020,211,19989,3958,143341,163330,15,1756,19,1305,4,256,195,39,29,12,821,104,14910,1828,99305,114215,7/13/2020
5/31/2020,147,20136,1728,145069,165205,10,1766,10,1315,0,256,195,42,26,3,824,76,14986,850,100155,115141,7/13/2020
6/1/2020,216,20352,2797,147866,168218,7,1773,13,1328,1,257,188,43,29,5,829,99,15085,1376,101531,116616,7/13/2020
6/2/2020,273,20625,3058,150924,171549,8,1781,9,1337,3,260,184,36,24,10,839,107,15192,1465,102996,118188,7/13/2020
6/3/2020,259,20884,3500,154424,175308,13,1794,18,1355,6,266,173,33,24,11,850,105,15297,1670,104666,119963,7/13/2020
6/4/2020,279,21163,4497,158921,180084,7,1801,25,1380,3,269,152,30,23,11,861,116,15413,2035,106701,122114,7/13/2020
6/5/2020,215,21378,3549,162470,183848,15,1816,12,1392,5,274,150,26,20,9,870,104,15517,1565,108266,123783,7/13/2020
6/6/2020,198,21576,2606,165076,186652,10,1826,7,1399,2,276,151,28,18,6,876,68,15585,1130,109396,124981,7/13/2020
6/7/2020,77,21653,1581,166657,188310,11,1837,7,1406,1,277,154,24,16,4,880,49,15634,760,110156,125790,7/13/2020
6/8/2020,122,21775,1820,168477,190252,15,1852,12,1418,2,279,155,26,17,4,884,44,15678,951,111107,126785,7/13/2020
6/9/2020,223,21998,2617,171094,193092,10,1862,18,1436,0,279,147,27,20,1,885,68,15746,1235,112342,128088,7/13/2020
6/10/2020,210,22208,2957,174051,196259,13,1875,12,1448,2,281,146,23,16,3,888,104,15850,1448,113790,129640,7/13/2020
6/11/2020,195,22403,3465,177516,199919,7,1882,15,1463,1,282,137,24,15,6,894,88,15938,1511,115301,131239,7/13/2020
6/12/2020,213,22616,4444,181960,204576,8,1890,15,1478,1,283,129,22,15,2,896,81,16019,2147,117448,133467,7/13/2020
6/13/2020,104,22720,2801,184761,207481,6,1896,4,1482,0,283,131,18,14,3,899,49,16068,1275,118723,134791,7/13/2020
6/14/2020,78,22798,1911,186672,209470,6,1902,8,1490,1,284,128,18,13,3,902,32,16100,918,119641,135741,7/13/2020
6/15/2020,188,22986,3050,189722,212708,14,1916,14,1504,0,284,128,18,15,4,906,76,16176,1774,121415,137591,7/13/2020
6/16/2020,114,23100,2885,192607,215707,10,1926,10,1514,1,285,127,20,15,8,914,52,16228,1555,122970,139198,7/13/2020
6/17/2020,122,23222,2673,195280,218502,15,1941,20,1534,4,289,118,16,13,6,920,51,16279,1291,124261,140540,7/13/2020
6/18/2020,150,23372,2964,198244,221616,9,1950,13,1547,1,290,113,17,15,7,927,71,16350,1302,125563,141913,7/13/2020
6/19/2020,139,23511,3524,201768,225279,12,1962,11,1558,1,291,113,18,16,3,930,59,16409,1268,126831,143240,7/13/2020
6/20/2020,79,23590,1733,203501,227091,7,1969,9,1567,0,291,111,18,17,4,934,36,16445,725,127556,144001,7/13/2020
6/21/2020,36,23626,1002,204503,228129,7,1976,5,1572,0,291,113,18,17,2,936,27,16472,647,128203,144675,7/13/2020
6/22/2020,142,23768,3661,208164,231932,12,1988,16,1588,0,291,109,17,17,1,937,58,16530,1690,129893,146423,7/13/2020
6/23/2020,161,23929,3721,211885,235814,3,1991,13,1601,3,294,96,16,17,6,943,73,16603,1698,131591,148194,7/13/2020
6/24/2020,118,24047,3355,215240,239287,8,1999,10,1611,1,295,93,15,17,5,948,51,16654,1577,133168,149822,7/13/2020
6/25/2020,102,24149,2836,218076,242225,5,2004,14,1625,1,296,83,14,16,0,948,45,16699,1480,134648,151347,7/13/2020
6/26/2020,93,24242,2431,220507,244749,2,2006,9,1634,0,296,76,15,17,1,949,70,16769,1363,136011,152780,7/13/2020
6/27/2020,84,24326,3193,223700,248026,5,2011,3,1637,1,297,77,14,16,5,954,35,16804,1201,137212,154016,7/13/2020
6/28/2020,37,24363,1435,225135,249498,3,2014,4,1641,4,301,72,12,13,6,960,22,16826,578,137790,154616,7/13/2020
6/29/2020,86,24449,3620,228755,253204,4,2018,5,1646,0,301,71,11,13,1,961,37,16863,1318,139108,155971,7/13/2020
6/30/2020,59,24508,1881,230636,255144,1,2019,5,1651,1,302,66,9,10,3,964,41,16904,973,140081,156985,7/13/2020
7/1/2020,141,24649,3958,234594,259243,7,2026,9,1660,0,302,64,8,10,1,965,65,16969,1891,141972,158941,7/13/2020
7/2/2020,99,24748,2606,237200,261948,5,2031,5,1665,1,303,63,6,8,1,966,58,17027,985,142957,159984,7/13/2020
7/3/2020,42,24790,1851,239051,263841,7,2038,6,1671,0,303,64,5,7,3,969,23,17050,673,143630,160680,7/13/2020
7/4/2020,52,24842,2227,241278,266120,2,2040,4,1675,1,304,61,6,7,2,971,27,17077,951,144581,161658,7/13/2020
7/5/2020,46,24888,2826,244104,268992,1,2041,2,1677,1,305,59,4,6,2,973,25,17102,1374,145955,163057,7/13/2020
7/6/2020,101,24989,2709,246813,271802,4,2045,5,1682,0,305,58,5,7,4,977,55,17157,1503,147458,164615,7/13/2020
7/7/2020,74,25063,3343,250156,275219,5,2050,2,1684,0,305,61,4,6,1,978,34,17191,1516,148974,166165,7/13/2020
7/8/2020,93,25156,3258,253414,278570,3,2053,1,1685,0,305,63,5,6,0,978,73,17264,1338,150312,167576,7/13/2020
7/9/2020,99,25255,3453,256867,282122,5,2058,0,1685,0,305,68,5,6,0,978,58,17322,1543,151855,169177,7/13/2020
7/10/2020,142,25397,3816,260683,286080,4,2062,3,1688,2,307,67,4,5,1,979,48,17370,1672,153527,170897,7/13/2020
7/11/2020,69,25466,2683,263366,288832,4,2066,3,1691,1,308,67,3,4,2,981,78,17448,1244,154771,172219,7/13/2020
7/12/2020,52,25518,1872,265238,290756,,,,,,,,,,3,984,39,17487,985,155756,173243,7/13/2020
2/27/2020,0,0,0,0,0,1,1,0,0,0,0,1,0,0,0,0,0,0,0,0,0,7/14/2020
2/28/2020,0,0,0,0,0,0,1,0,0,0,0,1,1,0,0,0,0,0,0,0,0,7/14/2020
2/29/2020,0,0,0,0,0,0,1,0,0,0,0,1,1,0,0,0,0,0,0,0,0,7/14/2020
3/1/2020,2,2,2,2,4,0,1,0,0,0,0,1,1,1,0,0,2,2,2,2,4,7/14/2020
3/2/2020,0,2,1,3,5,1,2,0,0,0,0,2,2,2,0,0,0,2,1,3,5,7/14/2020
3/3/2020,0,2,2,5,7,0,2,0,0,0,0,2,2,2,0,0,0,2,2,5,7,7/14/2020
3/4/2020,0,2,12,17,19,1,3,0,0,0,0,3,2,2,0,0,0,2,10,15,17,7/14/2020
3/5/2020,0,2,4,21,23,0,3,0,0,0,0,3,2,2,0,0,1,3,4,19,22,7/14/2020
3/6/2020,1,3,12,33,36,0,3,0,0,0,0,3,2,2,0,0,0,3,11,30,33,7/14/2020
3/7/2020,0,3,19,52,55,0,3,0,0,0,0,3,2,1,0,0,0,3,19,49,52,7/14/2020
3/8/2020,0,3,18,70,73,0,3,0,0,0,0,3,2,1,0,0,0,3,18,67,70,7/14/2020
3/9/2020,1,4,15,85,89,0,3,0,0,0,0,3,2,1,0,0,1,4,15,82,86,7/14/2020
3/10/2020,2,6,25,110,116,0,3,0,0,0,0,3,2,1,0,0,1,5,23,105,110,7/14/2020
3/11/2020,0,6,34,144,150,1,4,0,0,0,0,4,1,1,0,0,0,5,34,139,144,7/14/2020
3/12/2020,9,15,42,186,201,1,5,0,0,0,0,5,1,1,0,0,8,13,38,177,190,7/14/2020
3/13/2020,6,21,50,236,257,4,9,1,1,0,0,8,1,1,0,0,6,19,48,225,244,7/14/2020
3/14/2020,0,21,90,326,347,0,9,0,1,0,0,8,1,1,0,0,0,19,87,312,331,7/14/2020
3/15/2020,1,22,54,380,402,1,10,0,1,0,0,9,2,1,0,0,1,20,54,366,386,7/14/2020
3/16/2020,2,24,95,475,499,2,12,0,1,0,0,11,2,0,0,0,2,22,92,458,480,7/14/2020
3/17/2020,16,40,162,637,677,6,18,0,1,0,0,17,2,0,0,0,11,33,153,611,644,7/14/2020
3/18/2020,12,52,116,753,805,3,21,0,1,0,0,20,2,0,0,0,11,44,110,721,765,7/14/2020
3/19/2020,17,69,262,1015,1084,2,23,1,2,0,0,21,3,0,1,1,17,61,251,972,1033,7/14/2020
3/20/2020,15,84,197,1212,1296,5,28,0,2,0,0,26,4,0,0,1,13,74,193,1165,1239,7/14/2020
3/21/2020,21,105,126,1338,1443,3,31,2,4,0,0,27,5,0,0,1,14,88,123,1288,1376,7/14/2020
3/22/2020,30,135,282,1620,1755,2,33,0,4,0,0,29,5,0,0,1,25,113,265,1553,1666,7/14/2020
3/23/2020,14,149,169,1789,1938,15,48,1,5,0,0,43,9,3,0,1,16,129,165,1718,1847,7/14/2020
3/24/2020,20,169,243,2032,2201,7,55,0,5,0,0,50,10,4,0,1,19,148,238,1956,2104,7/14/2020
3/25/2020,26,195,183,2215,2410,5,60,1,6,0,0,54,11,3,0,1,28,176,173,2129,2305,7/14/2020
3/26/2020,35,230,181,2396,2626,10,70,5,11,0,0,59,14,5,0,1,41,217,176,2305,2522,7/14/2020
3/27/2020,27,257,215,2611,2868,9,79,1,12,1,1,66,17,6,2,3,31,248,202,2507,2755,7/14/2020
3/28/2020,59,316,260,2871,3187,13,92,3,15,2,3,74,15,6,1,4,64,312,242,2749,3061,7/14/2020
3/29/2020,106,422,356,3227,3649,8,100,4,19,1,4,77,18,8,2,6,105,417,314,3063,3480,7/14/2020
3/30/2020,62,484,222,3449,3933,20,120,5,24,0,4,92,20,11,3,9,78,495,192,3255,3750,7/14/2020
3/31/2020,71,555,369,3818,4373,11,131,7,31,1,5,95,22,13,2,11,73,568,300,3555,4123,7/14/2020
4/1/2020,99,654,699,4517,5171,18,149,7,38,0,5,106,30,15,1,12,100,668,649,4204,4872,7/14/2020
4/2/2020,52,706,477,4994,5700,21,170,6,44,2,7,119,36,21,4,16,62,730,437,4641,5371,7/14/2020
4/3/2020,108,814,775,5769,6583,23,193,7,51,0,7,135,43,25,3,19,100,830,719,5360,6190,7/14/2020
4/4/2020,143,957,660,6429,7386,22,215,4,55,5,12,148,41,30,9,28,137,967,623,5983,6950,7/14/2020
4/5/2020,187,1144,1156,7585,8729,20,235,9,64,1,13,158,44,36,2,30,182,1149,1070,7053,8202,7/14/2020
4/6/2020,218,1362,1707,9292,10654,26,261,7,71,0,13,177,48,40,7,37,206,1355,1582,8635,9990,7/14/2020
4/7/2020,285,1647,1631,10923,12570,20,281,4,75,2,15,191,49,42,5,42,261,1616,1496,10131,11747,7/14/2020
4/8/2020,290,1937,1723,12646,14583,19,300,7,82,6,21,197,49,38,10,52,272,1888,1577,11708,13596,7/14/2020
4/9/2020,284,2221,1521,14167,16388,32,332,9,91,4,25,216,52,40,7,59,278,2166,1370,13078,15244,7/14/2020
4/10/2020,420,2641,2577,16744,19385,29,361,16,107,5,30,224,58,41,11,70,404,2570,2383,15461,18031,7/14/2020
4/11/2020,299,2940,1911,18655,21595,29,390,11,118,2,32,240,61,48,11,81,280,2850,1732,17193,20043,7/14/2020
4/12/2020,315,3255,1674,20329,23584,35,425,13,131,5,37,257,59,49,10,91,289,3139,1452,18645,21784,7/14/2020
4/13/2020,162,3417,938,21267,24684,35,460,13,144,3,40,276,64,54,9,100,187,3326,849,19494,22820,7/14/2020
4/14/2020,289,3706,1788,23055,26761,27,487,17,161,5,45,281,72,53,8,108,268,3594,1564,21058,24652,7/14/2020
4/15/2020,353,4059,1803,24858,28917,31,518,19,180,3,48,290,72,54,17,125,307,3901,1580,22638,26539,7/14/2020
4/16/2020,449,4508,2500,27358,31866,36,554,25,205,6,54,295,72,53,14,139,392,4293,2099,24737,29030,7/14/2020
4/17/2020,308,4816,1823,29181,33997,32,586,20,225,7,61,300,66,45,21,160,291,4584,1501,26238,30822,7/14/2020
4/18/2020,322,5138,1728,30909,36047,26,612,18,243,4,65,304,63,49,15,175,284,4868,1373,27611,32479,7/14/2020
4/19/2020,382,5520,2059,32968,38488,23,635,26,269,1,66,300,65,55,11,186,338,5206,1763,29374,34580,7/14/2020
4/20/2020,396,5916,1909,34877,40793,46,681,29,298,2,68,315,75,56,10,196,378,5584,1600,30974,36558,7/14/2020
4/21/2020,445,6361,2114,36991,43352,45,726,31,329,5,73,324,72,56,18,214,388,5972,1728,32702,38674,7/14/2020
4/22/2020,420,6781,2398,39389,46170,41,767,32,361,5,78,328,73,58,18,232,382,6354,1925,34627,40981,7/14/2020
4/23/2020,482,7263,2471,41860,49123,30,797,28,389,5,83,325,76,62,15,247,420,6774,1894,36521,43295,7/14/2020
4/24/2020,494,7757,3292,45152,52909,35,832,27,416,4,87,329,85,63,15,262,414,7188,2655,39176,46364,7/14/2020
4/25/2020,394,8151,2210,47362,55513,34,866,17,433,5,92,341,85,62,14,276,305,7493,1791,40967,48460,7/14/2020
4/26/2020,316,8467,2314,49676,58143,33,899,15,448,3,95,356,86,59,14,290,278,7771,1892,42859,50630,7/14/2020
4/27/2020,250,8717,1624,51300,60017,29,928,21,469,4,99,360,86,61,10,300,203,7974,1174,44033,52007,7/14/2020
4/28/2020,411,9128,2268,53568,62696,44,972,24,493,3,102,377,88,59,22,322,324,8298,1781,45814,54112,7/14/2020
4/29/2020,476,9604,3351,56919,66523,36,1008,37,530,11,113,365,77,53,18,340,372,8670,2457,48271,56941,7/14/2020
4/30/2020,432,10036,2772,59691,69727,33,1041,38,568,6,119,354,82,57,24,364,348,9018,1964,50235,59253,7/14/2020
5/1/2020,457,10493,3089,62780,73273,51,1092,40,608,3,122,362,83,58,14,378,317,9335,2232,52467,61802,7/14/2020
5/2/2020,260,10753,1927,64707,75460,35,1127,38,646,5,127,354,89,61,24,402,189,9524,1300,53767,63291,7/14/2020
5/3/2020,284,11037,2168,66875,77912,31,1158,27,673,8,135,350,88,61,21,423,181,9705,1614,55381,65086,7/14/2020
5/4/2020,388,11425,2101,68976,80401,30,1188,31,704,5,140,344,86,57,18,441,292,9997,1578,56959,66956,7/14/2020
5/5/2020,436,11861,2878,71854,83715,28,1216,32,736,6,146,334,79,54,16,457,303,10300,1989,58948,69248,7/14/2020
5/6/2020,490,12351,2836,74690,87041,28,1244,44,780,9,155,309,77,54,21,478,341,10641,1938,60886,71527,7/14/2020
5/7/2020,425,12776,2975,77665,90441,36,1280,41,821,5,160,299,69,52,21,499,269,10910,1995,62881,73791,7/14/2020
5/8/2020,360,13136,2602,80267,93403,30,1310,29,850,5,165,295,69,53,22,521,231,11141,1788,64669,75810,7/14/2020
5/9/2020,457,13593,3355,83622,97215,22,1332,21,871,4,169,292,67,51,15,536,285,11426,2319,66988,78414,7/14/2020
5/10/2020,279,13872,2122,85744,99616,19,1351,23,894,6,175,282,68,49,13,549,186,11612,1532,68520,80132,7/14/2020
5/11/2020,259,14131,1861,87605,101736,31,1382,16,910,6,181,291,69,49,15,564,175,11787,1316,69836,81623,7/14/2020
5/12/2020,384,14515,2512,90117,104632,23,1405,18,928,4,185,292,67,48,22,586,217,12004,1615,71451,83455,7/14/2020
5/13/2020,352,14867,3570,93687,108554,22,1427,24,952,1,186,289,68,49,13,599,196,12200,1975,73426,85626,7/14/2020
5/14/2020,329,15196,3397,97084,112280,19,1446,27,979,3,189,278,63,45,15,614,227,12427,2023,75449,87876,7/14/2020
5/15/2020,381,15577,3433,100517,116094,24,1470,41,1020,5,194,256,61,45,13,627,232,12659,1809,77258,89917,7/14/2020
5/16/2020,419,15996,3883,104400,120396,25,1495,12,1032,5,199,264,60,46,15,642,252,12911,1779,79037,91948,7/14/2020
5/17/2020,223,16219,2708,107108,123327,17,1512,7,1039,5,204,269,58,45,10,652,124,13035,1545,80582,93617,7/14/2020
5/18/2020,248,16467,1992,109100,125567,19,1531,15,1054,5,209,268,56,40,18,670,137,13172,1364,81946,95118,7/14/2020
5/19/2020,414,16881,3153,112253,129134,23,1554,31,1085,5,214,255,55,38,11,681,214,13386,1941,83887,97273,7/14/2020
5/20/2020,327,17208,2779,115032,132240,19,1573,23,1108,7,221,244,51,33,22,703,187,13573,1541,85428,99001,7/14/2020
5/21/2020,370,17578,3794,118826,136404,26,1599,15,1123,3,224,252,52,29,20,723,169,13742,1988,87416,101158,7/14/2020
5/22/2020,350,17928,3026,121852,139780,20,1619,29,1152,5,229,238,51,29,10,733,201,13943,1495,88911,102854,7/14/2020
5/23/2020,240,18168,2735,124587,142755,19,1638,11,1163,3,232,243,51,32,13,746,108,14051,1330,90241,104292,7/14/2020
5/24/2020,153,18321,1359,125946,144267,12,1650,14,1177,2,234,239,52,36,8,754,84,14135,766,91007,105142,7/14/2020
5/25/2020,134,18455,1376,127322,145777,12,1662,14,1191,0,234,237,52,34,10,764,70,14205,755,91762,105967,7/14/2020
5/26/2020,284,18739,2609,129931,148670,24,1686,22,1213,5,239,234,47,33,15,779,154,14359,1778,93540,107899,7/14/2020
5/27/2020,276,19015,2110,132041,151056,20,1706,17,1230,3,242,234,49,33,10,789,133,14492,1152,94692,109184,7/14/2020
5/28/2020,345,19360,3374,135415,154775,17,1723,29,1259,4,246,218,46,32,8,797,132,14624,1146,95838,110462,7/14/2020
5/29/2020,418,19778,3968,139383,159161,18,1741,27,1286,6,252,203,42,31,12,809,178,14802,1589,97427,112229,7/14/2020
5/30/2020,211,19989,3958,143341,163330,15,1756,19,1305,4,256,195,39,29,12,821,104,14906,1828,99255,114161,7/14/2020
5/31/2020,147,20136,1728,145069,165205,10,1766,10,1315,0,256,195,42,26,3,824,76,14982,850,100105,115087,7/14/2020
6/1/2020,216,20352,2797,147866,168218,7,1773,13,1328,1,257,188,43,29,5,829,99,15081,1376,101481,116562,7/14/2020
6/2/2020,273,20625,3058,150924,171549,8,1781,9,1337,3,260,184,36,24,10,839,108,15189,1464,102945,118134,7/14/2020
6/3/2020,259,20884,3500,154424,175308,13,1794,18,1355,6,266,173,33,24,11,850,105,15294,1670,104615,119909,7/14/2020
6/4/2020,279,21163,4497,158921,180084,7,1801,25,1380,3,269,152,30,23,11,861,116,15410,2035,106650,122060,7/14/2020
6/5/2020,215,21378,3549,162470,183848,15,1816,12,1392,5,274,150,26,20,9,870,104,15514,1565,108215,123729,7/14/2020
6/6/2020,198,21576,2606,165076,186652,10,1826,7,1399,2,276,151,28,18,6,876,68,15582,1129,109344,124926,7/14/2020
6/7/2020,77,21653,1581,166657,188310,11,1837,7,1406,1,277,154,24,16,4,880,49,15631,760,110104,125735,7/14/2020
6/8/2020,122,21775,1820,168477,190252,15,1852,12,1418,2,279,155,26,17,4,884,44,15675,950,111054,126729,7/14/2020
6/9/2020,223,21998,2617,171094,193092,10,1862,18,1436,0,279,147,27,20,1,885,67,15742,1235,112289,128031,7/14/2020
6/10/2020,210,22208,2957,174051,196259,13,1875,12,1448,2,281,146,23,16,3,888,104,15846,1448,113737,129583,7/14/2020
6/11/2020,195,22403,3465,177516,199919,7,1882,15,1463,1,282,137,24,15,6,894,88,15934,1510,115247,131181,7/14/2020
6/12/2020,213,22616,4444,181960,204576,8,1890,15,1478,1,283,129,22,15,2,896,81,16015,2147,117394,133409,7/14/2020
6/13/2020,104,22720,2801,184761,207481,6,1896,4,1482,0,283,131,18,14,3,899,50,16065,1274,118668,134733,7/14/2020
6/14/2020,78,22798,1911,186672,209470,6,1902,8,1490,1,284,128,18,13,3,902,32,16097,917,119585,135682,7/14/2020
6/15/2020,188,22986,3050,189722,212708,14,1916,14,1504,0,284,128,18,15,4,906,77,16174,1774,121359,137533,7/14/2020
6/16/2020,114,23100,2885,192607,215707,10,1926,10,1514,1,285,127,20,15,8,914,52,16226,1555,122914,139140,7/14/2020
6/17/2020,122,23222,2673,195280,218502,15,1941,20,1534,4,289,118,16,13,6,920,51,16277,1290,124204,140481,7/14/2020
6/18/2020,150,23372,2964,198244,221616,9,1950,13,1547,1,290,113,17,15,7,927,70,16347,1302,125506,141853,7/14/2020
6/19/2020,139,23511,3524,201768,225279,12,1962,11,1558,1,291,113,18,16,3,930,59,16406,1267,126773,143179,7/14/2020
6/20/2020,79,23590,1733,203501,227091,7,1969,9,1567,0,291,111,18,17,4,934,36,16442,725,127498,143940,7/14/2020
6/21/2020,36,23626,1002,204503,228129,7,1976,5,1572,0,291,113,18,17,2,936,27,16469,647,128145,144614,7/14/2020
6/22/2020,142,23768,3661,208164,231932,12,1988,16,1588,0,291,109,17,17,1,937,58,16527,1689,129834,146361,7/14/2020
6/23/2020,161,23929,3721,211885,235814,3,1991,13,1601,3,294,96,16,17,6,943,75,16602,1698,131532,148134,7/14/2020
6/24/2020,118,24047,3355,215240,239287,8,1999,10,1611,1,295,93,15,17,5,948,50,16652,1576,133108,149760,7/14/2020
6/25/2020,102,24149,2836,218076,242225,5,2004,14,1625,1,296,83,14,16,0,948,46,16698,1480,134588,151286,7/14/2020
6/26/2020,93,24242,2431,220507,244749,2,2006,9,1634,0,296,76,15,17,1,949,71,16769,1363,135951,152720,7/14/2020
6/27/2020,84,24326,3193,223700,248026,5,2011,3,1637,1,297,77,14,16,5,954,34,16803,1201,137152,153955,7/14/2020
6/28/2020,37,24363,1435,225135,249498,3,2014,4,1641,4,301,72,12,13,6,960,22,16825,578,137730,154555,7/14/2020
6/29/2020,86,24449,3620,228755,253204,4,2018,5,1646,0,301,71,11,13,1,961,37,16862,1318,139048,155910,7/14/2020
6/30/2020,59,24508,1881,230636,255144,1,2019,5,1651,1,302,66,9,10,3,964,41,16903,973,140021,156924,7/14/2020
7/1/2020,141,24649,3958,234594,259243,7,2026,9,1660,0,302,64,8,10,1,965,65,16968,1891,141912,158880,7/14/2020
7/2/2020,99,24748,2606,237200,261948,5,2031,5,1665,1,303,63,6,8,1,966,57,17025,985,142897,159922,7/14/2020
7/3/2020,42,24790,1851,239051,263841,7,2038,6,1671,0,303,64,5,7,3,969,23,17048,673,143570,160618,7/14/2020
7/4/2020,52,24842,2227,241278,266120,2,2040,4,1675,1,304,61,6,7,2,971,27,17075,951,144521,161596,7/14/2020
7/5/2020,46,24888,2826,244104,268992,1,2041,2,1677,1,305,59,4,6,2,973,25,17100,1374,145895,162995,7/14/2020
7/6/2020,101,24989,2709,246813,271802,4,2045,5,1682,0,305,58,5,7,4,977,57,17157,1503,147398,164555,7/14/2020
7/7/2020,74,25063,3343,250156,275219,5,2050,2,1684,0,305,61,4,6,1,978,34,17191,1516,148914,166105,7/14/2020
7/8/2020,93,25156,3258,253414,278570,3,2053,1,1685,0,305,63,5,6,0,978,73,17264,1338,150252,167516,7/14/2020
7/9/2020,99,25255,3453,256867,282122,5,2058,0,1685,0,305,68,5,6,0,978,56,17320,1543,151795,169115,7/14/2020
7/10/2020,144,25399,3874,260741,286140,4,2063,3,1688,2,307,68,7,6,2,980,48,17368,1708,153503,170871,7/14/2020
7/11/2020,70,25469,2709,263450,288919,6,2069,3,1691,1,308,70,6,5,2,982,83,17451,1262,154765,172216,7/14/2020
7/12/2020,52,25521,1903,265353,290874,1,2070,1,1692,1,309,69,5,3,3,985,35,17486,1007,155772,173258,7/14/2020
7/13/2020,132,25653,2838,268191,293844,,,,,,,,,,0,985,102,17588,1298,157070,174658,7/14/2020
2/27/2020,0,0,0,0,0,1,1,0,0,0,0,1,0,0,0,0,0,0,0,0,0,7/16/2020
2/28/2020,0,0,0,0,0,0,1,0,0,0,0,1,1,0,0,0,0,0,0,0,0,7/16/2020
2/29/2020,0,0,0,0,0,0,1,0,0,0,0,1,1,0,0,0,0,0,0,0,0,7/16/2020
3/1/2020,2,2,2,2,4,0,1,0,0,0,0,1,1,1,0,0,2,2,2,2,4,7/16/2020
3/2/2020,0,2,1,3,5,1,2,0,0,0,0,2,2,2,0,0,0,2,1,3,5,7/16/2020
3/3/2020,0,2,2,5,7,0,2,0,0,0,0,2,2,2,0,0,0,2,2,5,7,7/16/2020
3/4/2020,0,2,12,17,19,1,3,0,0,0,0,3,2,2,0,0,0,2,10,15,17,7/16/2020
3/5/2020,0,2,4,21,23,0,3,0,0,0,0,3,2,2,0,0,1,3,4,19,22,7/16/2020
3/6/2020,1,3,12,33,36,0,3,0,0,0,0,3,2,2,0,0,0,3,11,30,33,7/16/2020
3/7/2020,0,3,19,52,55,0,3,0,0,0,0,3,2,1,0,0,0,3,19,49,52,7/16/2020
3/8/2020,0,3,18,70,73,0,3,0,0,0,0,3,2,1,0,0,0,3,18,67,70,7/16/2020
3/9/2020,1,4,15,85,89,0,3,0,0,0,0,3,2,1,0,0,1,4,15,82,86,7/16/2020
3/10/2020,2,6,25,110,116,0,3,0,0,0,0,3,2,1,0,0,1,5,23,105,110,7/16/2020
3/11/2020,0,6,34,144,150,1,4,0,0,0,0,4,1,1,0,0,0,5,34,139,144,7/16/2020
3/12/2020,9,15,42,186,201,1,5,0,0,0,0,5,1,1,0,0,8,13,38,177,190,7/16/2020
3/13/2020,6,21,50,236,257,4,9,1,1,0,0,8,1,1,0,0,6,19,48,225,244,7/16/2020
3/14/2020,0,21,90,326,347,0,9,0,1,0,0,8,1,1,0,0,0,19,86,311,330,7/16/2020
3/15/2020,1,22,54,380,402,1,10,0,1,0,0,9,2,1,0,0,1,20,54,365,385,7/16/2020
3/16/2020,2,24,95,475,499,2,12,0,1,0,0,11,2,0,0,0,2,22,92,457,479,7/16/2020
3/17/2020,16,40,162,637,677,6,18,0,1,0,0,17,2,0,0,0,11,33,153,610,643,7/16/2020
3/18/2020,12,52,116,753,805,3,21,0,1,0,0,20,2,0,0,0,11,44,110,720,764,7/16/2020
3/19/2020,17,69,262,1015,1084,2,23,1,2,0,0,21,3,0,1,1,17,61,251,971,1032,7/16/2020
3/20/2020,15,84,197,1212,1296,5,28,0,2,0,0,26,4,0,0,1,13,74,193,1164,1238,7/16/2020
3/21/2020,21,105,126,1338,1443,3,31,2,4,0,0,27,5,0,0,1,14,88,123,1287,1375,7/16/2020
3/22/2020,30,135,282,1620,1755,2,33,0,4,0,0,29,5,0,0,1,25,113,265,1552,1665,7/16/2020
3/23/2020,14,149,169,1789,1938,15,48,1,5,0,0,43,9,3,0,1,16,129,165,1717,1846,7/16/2020
3/24/2020,20,169,243,2032,2201,7,55,0,5,0,0,50,10,4,0,1,19,148,238,1955,2103,7/16/2020
3/25/2020,26,195,183,2215,2410,5,60,1,6,0,0,54,11,3,0,1,28,176,173,2128,2304,7/16/2020
3/26/2020,35,230,181,2396,2626,10,70,5,11,0,0,59,14,5,0,1,41,217,176,2304,2521,7/16/2020
3/27/2020,27,257,215,2611,2868,9,79,1,12,1,1,66,17,6,2,3,31,248,202,2506,2754,7/16/2020
3/28/2020,59,316,260,2871,3187,13,92,3,15,2,3,74,15,6,1,4,63,311,242,2748,3059,7/16/2020
3/29/2020,106,422,356,3227,3649,8,100,4,19,1,4,77,18,8,2,6,105,416,313,3061,3477,7/16/2020
3/30/2020,62,484,222,3449,3933,20,120,5,24,0,4,92,20,11,3,9,78,494,192,3253,3747,7/16/2020
3/31/2020,71,555,369,3818,4373,11,131,7,31,1,5,95,22,13,2,11,73,567,300,3553,4120,7/16/2020
4/1/2020,99,654,699,4517,5171,18,149,7,38,0,5,106,30,15,1,12,100,667,649,4202,4869,7/16/2020
4/2/2020,52,706,477,4994,5700,21,170,6,44,2,7,119,36,21,4,16,62,729,437,4639,5368,7/16/2020
4/3/2020,108,814,775,5769,6583,23,193,7,51,0,7,135,43,25,3,19,100,829,719,5358,6187,7/16/2020
4/4/2020,143,957,660,6429,7386,22,215,4,55,5,12,148,41,30,9,28,137,966,623,5981,6947,7/16/2020
4/5/2020,187,1144,1156,7585,8729,20,235,9,64,1,13,158,44,36,2,30,182,1148,1070,7051,8199,7/16/2020
4/6/2020,218,1362,1707,9292,10654,26,261,7,71,0,13,177,48,40,7,37,206,1354,1580,8631,9985,7/16/2020
4/7/2020,285,1647,1631,10923,12570,20,281,3,74,2,15,192,49,42,5,42,261,1615,1496,10127,11742,7/16/2020
4/8/2020,290,1937,1723,12646,14583,19,300,7,81,6,21,198,49,38,10,52,272,1887,1577,11704,13591,7/16/2020
4/9/2020,284,2221,1521,14167,16388,32,332,9,90,4,25,217,52,40,7,59,278,2165,1369,13073,15238,7/16/2020
4/10/2020,420,2641,2577,16744,19385,29,361,17,107,5,30,224,58,41,11,70,404,2569,2383,15456,18025,7/16/2020
4/11/2020,299,2940,1911,18655,21595,29,390,11,118,2,32,240,61,48,11,81,280,2849,1731,17187,20036,7/16/2020
4/12/2020,315,3255,1674,20329,23584,35,425,13,131,5,37,257,59,49,10,91,289,3138,1452,18639,21777,7/16/2020
4/13/2020,162,3417,938,21267,24684,35,460,13,144,3,40,276,64,54,9,100,187,3325,848,19487,22812,7/16/2020
4/14/2020,289,3706,1788,23055,26761,27,487,17,161,5,45,281,72,53,8,108,267,3592,1564,21051,24643,7/16/2020
4/15/2020,353,4059,1803,24858,28917,31,518,19,180,3,48,290,72,54,17,125,307,3899,1580,22631,26530,7/16/2020
4/16/2020,449,4508,2500,27358,31866,36,554,25,205,6,54,295,72,53,14,139,393,4292,2099,24730,29022,7/16/2020
4/17/2020,308,4816,1823,29181,33997,32,586,20,225,7,61,300,66,45,21,160,291,4583,1493,26223,30806,7/16/2020
4/18/2020,322,5138,1728,30909,36047,26,612,18,243,4,65,304,63,49,15,175,284,4867,1369,27592,32459,7/16/2020
4/19/2020,382,5520,2059,32968,38488,23,635,26,269,1,66,300,65,55,11,186,338,5205,1763,29355,34560,7/16/2020
4/20/2020,396,5916,1909,34877,40793,46,681,29,298,2,68,315,75,56,10,196,378,5583,1597,30952,36535,7/16/2020
4/21/2020,445,6361,2114,36991,43352,45,726,31,329,5,73,324,72,56,18,214,388,5971,1728,32680,38651,7/16/2020
4/22/2020,420,6781,2398,39389,46170,41,767,32,361,5,78,328,73,58,18,232,382,6353,1922,34602,40955,7/16/2020
4/23/2020,482,7263,2471,41860,49123,30,797,28,389,5,83,325,76,62,15,247,420,6773,1893,36495,43268,7/16/2020
4/24/2020,494,7757,3292,45152,52909,35,832,27,416,4,87,329,85,63,15,262,414,7187,2655,39150,46337,7/16/2020
4/25/2020,394,8151,2210,47362,55513,34,866,17,433,5,92,341,85,62,14,276,305,7492,1790,40940,48432,7/16/2020
4/26/2020,316,8467,2314,49676,58143,33,899,15,448,3,95,356,86,59,14,290,277,7769,1891,42831,50600,7/16/2020
4/27/2020,250,8717,1624,51300,60017,29,928,21,469,4,99,360,86,61,10,300,203,7972,1174,44005,51977,7/16/2020
4/28/2020,411,9128,2268,53568,62696,44,972,24,493,3,102,377,88,59,22,322,324,8296,1780,45785,54081,7/16/2020
4/29/2020,476,9604,3351,56919,66523,36,1008,37,530,11,113,365,78,53,18,340,372,8668,2456,48241,56909,7/16/2020
4/30/2020,432,10036,2772,59691,69727,33,1041,38,568,6,119,354,83,57,24,364,348,9016,1963,50204,59220,7/16/2020
5/1/2020,457,10493,3089,62780,73273,51,1092,39,607,3,122,363,84,58,14,378,317,9333,2231,52435,61768,7/16/2020
5/2/2020,260,10753,1927,64707,75460,35,1127,39,646,5,127,354,90,61,24,402,189,9522,1300,53735,63257,7/16/2020
5/3/2020,284,11037,2168,66875,77912,31,1158,27,673,8,135,350,89,61,21,423,181,9703,1613,55348,65051,7/16/2020
5/4/2020,388,11425,2101,68976,80401,30,1188,31,704,5,140,344,87,57,18,441,292,9995,1578,56926,66921,7/16/2020
5/5/2020,436,11861,2878,71854,83715,28,1216,32,736,6,146,334,80,54,16,457,303,10298,1987,58913,69211,7/16/2020
5/6/2020,490,12351,2836,74690,87041,28,1244,44,780,9,155,309,78,54,21,478,341,10639,1936,60849,71488,7/16/2020
5/7/2020,425,12776,2975,77665,90441,36,1280,41,821,5,160,299,70,52,21,499,269,10908,1995,62844,73752,7/16/2020
5/8/2020,360,13136,2602,80267,93403,30,1310,29,850,5,165,295,70,53,22,521,231,11139,1788,64632,75771,7/16/2020
5/9/2020,457,13593,3355,83622,97215,22,1332,21,871,4,169,292,68,51,15,536,285,11424,2319,66951,78375,7/16/2020
5/10/2020,279,13872,2122,85744,99616,19,1351,23,894,6,175,282,69,49,13,549,186,11610,1531,68482,80092,7/16/2020
5/11/2020,259,14131,1861,87605,101736,31,1382,16,910,6,181,291,70,49,15,564,175,11785,1316,69798,81583,7/16/2020
5/12/2020,384,14515,2512,90117,104632,23,1405,18,928,4,185,292,68,48,22,586,217,12002,1615,71413,83415,7/16/2020
5/13/2020,352,14867,3570,93687,108554,22,1427,24,952,1,186,289,69,49,13,599,196,12198,1975,73388,85586,7/16/2020
5/14/2020,329,15196,3397,97084,112280,19,1446,27,979,3,189,278,64,45,15,614,227,12425,2023,75411,87836,7/16/2020
5/15/2020,381,15577,3433,100517,116094,24,1470,41,1020,5,194,256,62,45,13,627,232,12657,1809,77220,89877,7/16/2020
5/16/2020,419,15996,3883,104400,120396,25,1495,12,1032,5,199,264,61,46,15,642,252,12909,1779,78999,91908,7/16/2020
5/17/2020,223,16219,2708,107108,123327,17,1512,7,1039,5,204,269,59,45,10,652,124,13033,1545,80544,93577,7/16/2020
5/18/2020,248,16467,1992,109100,125567,19,1531,15,1054,5,209,268,57,40,18,670,137,13170,1363,81907,95077,7/16/2020
5/19/2020,414,16881,3153,112253,129134,23,1554,31,1085,5,214,255,56,38,11,681,214,13384,1940,83847,97231,7/16/2020
5/20/2020,327,17208,2779,115032,132240,19,1573,23,1108,7,221,244,52,33,22,703,187,13571,1540,85387,98958,7/16/2020
5/21/2020,370,17578,3794,118826,136404,26,1599,15,1123,3,224,252,53,29,20,723,169,13740,1986,87373,101113,7/16/2020
5/22/2020,350,17928,3026,121852,139780,20,1619,29,1152,5,229,238,52,29,10,733,201,13941,1493,88866,102807,7/16/2020
5/23/2020,240,18168,2735,124587,142755,19,1638,11,1163,3,232,243,52,32,13,746,108,14049,1330,90196,104245,7/16/2020
5/24/2020,153,18321,1359,125946,144267,12,1650,14,1177,2,234,239,53,36,8,754,84,14133,766,90962,105095,7/16/2020
5/25/2020,134,18455,1376,127322,145777,12,1662,14,1191,0,234,237,53,34,10,764,70,14203,755,91717,105920,7/16/2020
5/26/2020,284,18739,2609,129931,148670,24,1686,22,1213,5,239,234,48,33,15,779,154,14357,1778,93495,107852,7/16/2020
5/27/2020,276,19015,2110,132041,151056,20,1706,17,1230,3,242,234,50,33,10,789,133,14490,1152,94647,109137,7/16/2020
5/28/2020,345,19360,3374,135415,154775,17,1723,29,1259,4,246,218,47,32,8,797,132,14622,1145,95792,110414,7/16/2020
5/29/2020,418,19778,3968,139383,159161,18,1741,27,1286,6,252,203,43,31,12,809,178,14800,1589,97381,112181,7/16/2020
5/30/2020,211,19989,3958,143341,163330,15,1756,19,1305,4,256,195,40,29,12,821,104,14904,1828,99209,114113,7/16/2020
5/31/2020,147,20136,1728,145069,165205,10,1766,10,1315,0,256,195,43,26,3,824,76,14980,850,100059,115039,7/16/2020
6/1/2020,216,20352,2797,147866,168218,7,1773,13,1328,1,257,188,44,29,5,829,99,15079,1376,101435,116514,7/16/2020
6/2/2020,273,20625,3058,150924,171549,8,1781,9,1337,3,260,184,37,24,10,839,108,15187,1463,102898,118085,7/16/2020
6/3/2020,259,20884,3500,154424,175308,13,1794,18,1355,6,266,173,34,24,11,850,105,15292,1669,104567,119859,7/16/2020
6/4/2020,279,21163,4497,158921,180084,7,1801,25,1380,3,269,152,31,23,11,861,115,15407,2035,106602,122009,7/16/2020
6/5/2020,215,21378,3549,162470,183848,15,1816,12,1392,5,274,150,27,20,9,870,104,15511,1565,108167,123678,7/16/2020
6/6/2020,198,21576,2606,165076,186652,10,1826,7,1399,2,276,151,29,18,6,876,68,15579,1129,109296,124875,7/16/2020
6/7/2020,77,21653,1581,166657,188310,11,1837,7,1406,1,277,154,25,16,4,880,49,15628,760,110056,125684,7/16/2020
6/8/2020,122,21775,1820,168477,190252,15,1852,12,1418,2,279,155,27,17,4,884,44,15672,950,111006,126678,7/16/2020
6/9/2020,223,21998,2617,171094,193092,10,1862,18,1436,0,279,147,28,20,1,885,67,15739,1235,112241,127980,7/16/2020
6/10/2020,210,22208,2957,174051,196259,13,1875,12,1448,2,281,146,24,16,3,888,104,15843,1447,113688,129531,7/16/2020
6/11/2020,195,22403,3465,177516,199919,7,1882,15,1463,1,282,137,25,15,6,894,88,15931,1510,115198,131129,7/16/2020
6/12/2020,213,22616,4444,181960,204576,8,1890,15,1478,1,283,129,23,15,2,896,81,16012,2147,117345,133357,7/16/2020
6/13/2020,104,22720,2801,184761,207481,6,1896,4,1482,0,283,131,19,14,3,899,50,16062,1274,118619,134681,7/16/2020
6/14/2020,78,22798,1911,186672,209470,6,1902,8,1490,1,284,128,19,13,3,902,32,16094,917,119536,135630,7/16/2020
6/15/2020,188,22986,3050,189722,212708,14,1916,14,1504,0,284,128,19,15,4,906,77,16171,1774,121310,137481,7/16/2020
6/16/2020,114,23100,2885,192607,215707,10,1926,10,1514,1,285,127,21,15,8,914,52,16223,1555,122865,139088,7/16/2020
6/17/2020,122,23222,2673,195280,218502,15,1941,20,1534,4,289,118,17,13,6,920,51,16274,1290,124155,140429,7/16/2020
6/18/2020,150,23372,2964,198244,221616,9,1950,13,1547,1,290,113,18,15,7,927,70,16344,1301,125456,141800,7/16/2020
6/19/2020,139,23511,3524,201768,225279,12,1962,11,1558,1,291,113,19,16,3,930,59,16403,1267,126723,143126,7/16/2020
6/20/2020,79,23590,1733,203501,227091,7,1969,9,1567,0,291,111,19,17,4,934,36,16439,725,127448,143887,7/16/2020
6/21/2020,36,23626,1002,204503,228129,7,1976,5,1572,0,291,113,19,17,2,936,27,16466,647,128095,144561,7/16/2020
6/22/2020,142,23768,3661,208164,231932,12,1988,16,1588,0,291,109,18,17,1,937,59,16525,1689,129784,146309,7/16/2020
6/23/2020,161,23929,3721,211885,235814,3,1991,13,1601,3,294,96,17,17,6,943,73,16598,1698,131482,148080,7/16/2020
6/24/2020,118,24047,3355,215240,239287,8,1999,10,1611,1,295,93,16,17,5,948,50,16648,1576,133058,149706,7/16/2020
6/25/2020,102,24149,2836,218076,242225,5,2004,14,1625,1,296,83,15,16,0,948,45,16693,1480,134538,151231,7/16/2020
6/26/2020,93,24242,2431,220507,244749,2,2006,9,1634,0,296,76,16,17,1,949,71,16764,1363,135901,152665,7/16/2020
6/27/2020,84,24326,3193,223700,248026,5,2011,3,1637,1,297,77,15,16,5,954,34,16798,1201,137102,153900,7/16/2020
6/28/2020,37,24363,1439,225139,249502,3,2014,4,1641,4,301,72,13,13,6,960,22,16820,582,137684,154504,7/16/2020
6/29/2020,86,24449,3620,228759,253208,4,2018,5,1646,0,301,71,12,13,1,961,37,16857,1318,139002,155859,7/16/2020
6/30/2020,59,24508,1881,230640,255148,1,2019,5,1651,1,302,66,10,10,3,964,41,16898,973,139975,156873,7/16/2020
7/1/2020,141,24649,3958,234598,259247,7,2026,9,1660,0,302,64,9,10,1,965,66,16964,1891,141866,158830,7/16/2020
7/2/2020,99,24748,2606,237204,261952,5,2031,5,1665,1,303,63,7,8,1,966,56,17020,985,142851,159871,7/16/2020
7/3/2020,42,24790,1851,239055,263845,7,2038,6,1671,0,303,64,6,7,3,969,23,17043,673,143524,160567,7/16/2020
7/4/2020,52,24842,2228,241283,266125,2,2040,4,1675,1,304,61,7,7,2,971,27,17070,952,144476,161546,7/16/2020
7/5/2020,46,24888,2826,244109,268997,1,2041,2,1677,1,305,59,5,6,2,973,25,17095,1374,145850,162945,7/16/2020
7/6/2020,101,24989,2709,246818,271807,6,2047,6,1683,0,305,59,7,8,4,977,57,17152,1503,147353,164505,7/16/2020
7/7/2020,74,25063,3343,250161,275224,5,2052,5,1688,0,305,59,6,7,1,978,34,17186,1515,148868,166054,7/16/2020
7/8/2020,94,25157,3261,253422,278579,3,2055,2,1690,0,305,60,7,7,0,978,72,17258,1339,150207,167465,7/16/2020
7/9/2020,100,25257,3471,256893,282150,5,2060,1,1691,0,305,64,7,7,0,978,55,17313,1558,151765,169078,7/16/2020
7/10/2020,158,25415,4197,261090,286505,4,2064,3,1694,2,307,63,6,6,3,981,51,17364,1965,153730,171094,7/16/2020
7/11/2020,68,25483,2721,263811,289294,6,2070,3,1697,1,308,65,5,5,2,983,84,17448,1251,154981,172429,7/16/2020
7/12/2020,46,25529,1650,265461,290990,1,2071,1,1698,1,309,64,4,3,3,986,38,17486,814,155795,173281,7/16/2020
7/13/2020,136,25665,2989,268450,294115,7,2078,10,1708,0,309,61,4,3,1,987,108,17594,1385,157180,174774,7/16/2020
7/14/2020,81,25746,3077,271527,297273,6,2084,3,1711,0,309,64,4,3,1,988,49,17643,1253,158433,176076,7/16/2020
7/15/2020,104,25850,3424,274951,300801,,,,,,,,,,0,988,68,17711,1244,159677,177388,7/16/2020
2/27/2020,0,0,0,0,0,1,1,0,0,0,0,1,0,0,0,0,0,0,0,0,0,7/17/2020
2/28/2020,0,0,0,0,0,0,1,0,0,0,0,1,1,0,0,0,0,0,0,0,0,7/17/2020
2/29/2020,0,0,0,0,0,0,1,0,0,0,0,1,1,0,0,0,0,0,0,0,0,7/17/2020
3/1/2020,2,2,2,2,4,0,1,0,0,0,0,1,1,1,0,0,2,2,2,2,4,7/17/2020
3/2/2020,0,2,1,3,5,1,2,0,0,0,0,2,2,2,0,0,0,2,1,3,5,7/17/2020
3/3/2020,0,2,2,5,7,0,2,0,0,0,0,2,2,2,0,0,0,2,2,5,7,7/17/2020
3/4/2020,0,2,12,17,19,1,3,0,0,0,0,3,2,2,0,0,0,2,10,15,17,7/17/2020
3/5/2020,0,2,4,21,23,0,3,0,0,0,0,3,2,2,0,0,1,3,4,19,22,7/17/2020
3/6/2020,1,3,12,33,36,0,3,0,0,0,0,3,2,2,0,0,0,3,11,30,33,7/17/2020
3/7/2020,0,3,19,52,55,0,3,0,0,0,0,3,2,1,0,0,0,3,19,49,52,7/17/2020
3/8/2020,0,3,18,70,73,0,3,0,0,0,0,3,2,1,0,0,0,3,18,67,70,7/17/2020
3/9/2020,1,4,15,85,89,0,3,0,0,0,0,3,2,1,0,0,1,4,15,82,86,7/17/2020
3/10/2020,2,6,25,110,116,0,3,0,0,0,0,3,2,1,0,0,1,5,23,105,110,7/17/2020
3/11/2020,0,6,34,144,150,1,4,0,0,0,0,4,1,1,0,0,0,5,34,139,144,7/17/2020
3/12/2020,9,15,42,186,201,1,5,0,0,0,0,5,1,1,0,0,8,13,38,177,190,7/17/2020
3/13/2020,6,21,50,236,257,4,9,1,1,0,0,8,1,1,0,0,6,19,48,225,244,7/17/2020
3/14/2020,0,21,90,326,347,0,9,0,1,0,0,8,1,1,0,0,0,19,86,311,330,7/17/2020
3/15/2020,1,22,54,380,402,1,10,0,1,0,0,9,2,1,0,0,1,20,54,365,385,7/17/2020
3/16/2020,2,24,95,475,499,2,12,0,1,0,0,11,2,0,0,0,2,22,92,457,479,7/17/2020
3/17/2020,16,40,162,637,677,6,18,0,1,0,0,17,2,0,0,0,11,33,153,610,643,7/17/2020
3/18/2020,12,52,116,753,805,3,21,0,1,0,0,20,2,0,0,0,11,44,110,720,764,7/17/2020
3/19/2020,17,69,262,1015,1084,2,23,1,2,0,0,21,3,0,1,1,17,61,251,971,1032,7/17/2020
3/20/2020,15,84,197,1212,1296,5,28,0,2,0,0,26,4,0,0,1,13,74,193,1164,1238,7/17/2020
3/21/2020,21,105,126,1338,1443,3,31,2,4,0,0,27,5,0,0,1,14,88,123,1287,1375,7/17/2020
3/22/2020,30,135,282,1620,1755,2,33,0,4,0,0,29,5,0,0,1,25,113,265,1552,1665,7/17/2020
3/23/2020,14,149,169,1789,1938,15,48,1,5,0,0,43,9,3,0,1,16,129,165,1717,1846,7/17/2020
3/24/2020,20,169,243,2032,2201,7,55,0,5,0,0,50,10,4,0,1,19,148,238,1955,2103,7/17/2020
3/25/2020,26,195,183,2215,2410,5,60,1,6,0,0,54,11,3,0,1,28,176,173,2128,2304,7/17/2020
3/26/2020,35,230,181,2396,2626,10,70,5,11,0,0,59,14,5,0,1,41,217,176,2304,2521,7/17/2020
3/27/2020,27,257,215,2611,2868,9,79,1,12,1,1,66,17,6,2,3,31,248,202,2506,2754,7/17/2020
3/28/2020,59,316,260,2871,3187,13,92,3,15,2,3,74,15,6,1,4,63,311,242,2748,3059,7/17/2020
3/29/2020,106,422,356,3227,3649,8,100,4,19,1,4,77,18,8,2,6,105,416,313,3061,3477,7/17/2020
3/30/2020,62,484,222,3449,3933,20,120,5,24,0,4,92,20,11,3,9,78,494,192,3253,3747,7/17/2020
3/31/2020,71,555,369,3818,4373,11,131,7,31,1,5,95,22,13,2,11,73,567,300,3553,4120,7/17/2020
4/1/2020,99,654,699,4517,5171,18,149,7,38,0,5,106,30,15,1,12,100,667,649,4202,4869,7/17/2020
4/2/2020,52,706,477,4994,5700,21,170,6,44,2,7,119,36,21,4,16,62,729,437,4639,5368,7/17/2020
4/3/2020,108,814,775,5769,6583,23,193,7,51,0,7,135,43,25,3,19,100,829,718,5357,6186,7/17/2020
4/4/2020,143,957,660,6429,7386,22,215,4,55,5,12,148,41,30,9,28,137,966,623,5980,6946,7/17/2020
4/5/2020,187,1144,1156,7585,8729,20,235,9,64,1,13,158,44,36,2,30,182,1148,1070,7050,8198,7/17/2020
4/6/2020,218,1362,1707,9292,10654,26,261,7,71,0,13,177,48,40,7,37,206,1354,1580,8630,9984,7/17/2020
4/7/2020,285,1647,1631,10923,12570,20,281,4,75,2,15,191,49,42,5,42,261,1615,1496,10126,11741,7/17/2020
4/8/2020,290,1937,1723,12646,14583,19,300,7,82,6,21,197,49,38,10,52,272,1887,1576,11702,13589,7/17/2020
4/9/2020,284,2221,1521,14167,16388,32,332,9,91,4,25,216,52,40,7,59,278,2165,1369,13071,15236,7/17/2020
4/10/2020,420,2641,2577,16744,19385,29,361,16,107,5,30,224,58,41,11,70,404,2569,2383,15454,18023,7/17/2020
4/11/2020,299,2940,1911,18655,21595,29,390,11,118,2,32,240,61,48,11,81,280,2849,1731,17185,20034,7/17/2020
4/12/2020,315,3255,1674,20329,23584,35,425,13,131,5,37,257,59,49,10,91,289,3138,1452,18637,21775,7/17/2020
4/13/2020,162,3417,938,21267,24684,35,460,13,144,3,40,276,64,54,9,100,187,3325,848,19485,22810,7/17/2020
4/14/2020,289,3706,1788,23055,26761,27,487,17,161,5,45,281,72,53,8,108,267,3592,1564,21049,24641,7/17/2020
4/15/2020,353,4059,1803,24858,28917,31,518,19,180,3,48,290,72,54,17,125,307,3899,1580,22629,26528,7/17/2020
4/16/2020,449,4508,2500,27358,31866,36,554,25,205,6,54,295,72,53,14,139,393,4292,2098,24727,29019,7/17/2020
4/17/2020,308,4816,1823,29181,33997,32,586,20,225,7,61,300,66,45,21,160,291,4583,1492,26219,30802,7/17/2020
4/18/2020,322,5138,1728,30909,36047,26,612,18,243,4,65,304,63,49,15,175,284,4867,1369,27588,32455,7/17/2020
4/19/2020,382,5520,2059,32968,38488,23,635,26,269,1,66,300,65,55,11,186,338,5205,1763,29351,34556,7/17/2020
4/20/2020,396,5916,1909,34877,40793,46,681,29,298,2,68,315,75,56,10,196,378,5583,1597,30948,36531,7/17/2020
4/21/2020,445,6361,2114,36991,43352,45,726,31,329,5,73,324,72,56,18,214,388,5971,1728,32676,38647,7/17/2020
4/22/2020,420,6781,2398,39389,46170,41,767,32,361,5,78,328,73,58,18,232,382,6353,1922,34598,40951,7/17/2020
4/23/2020,482,7263,2471,41860,49123,30,797,28,389,5,83,325,76,62,15,247,420,6773,1893,36491,43264,7/17/2020
4/24/2020,494,7757,3292,45152,52909,35,832,27,416,4,87,329,85,63,15,262,414,7187,2655,39146,46333,7/17/2020
4/25/2020,394,8151,2210,47362,55513,34,866,17,433,5,92,341,85,62,14,276,305,7492,1790,40936,48428,7/17/2020
4/26/2020,316,8467,2314,49676,58143,33,899,15,448,3,95,356,86,59,14,290,277,7769,1891,42827,50596,7/17/2020
4/27/2020,250,8717,1624,51300,60017,29,928,21,469,4,99,360,86,61,10,300,203,7972,1174,44001,51973,7/17/2020
4/28/2020,411,9128,2268,53568,62696,44,972,24,493,3,102,377,88,59,22,322,324,8296,1780,45781,54077,7/17/2020
4/29/2020,476,9604,3351,56919,66523,36,1008,37,530,11,113,365,78,53,18,340,372,8668,2455,48236,56904,7/17/2020
4/30/2020,432,10036,2772,59691,69727,32,1040,38,568,6,119,353,83,57,24,364,348,9016,1963,50199,59215,7/17/2020
5/1/2020,457,10493,3089,62780,73273,51,1091,39,607,3,122,362,84,58,14,378,317,9333,2230,52429,61762,7/17/2020
5/2/2020,260,10753,1927,64707,75460,35,1126,39,646,5,127,353,90,61,24,402,189,9522,1300,53729,63251,7/17/2020
5/3/2020,284,11037,2168,66875,77912,31,1157,27,673,8,135,349,89,61,21,423,181,9703,1613,55342,65045,7/17/2020
5/4/2020,388,11425,2101,68976,80401,30,1187,31,704,5,140,343,87,57,18,441,292,9995,1578,56920,66915,7/17/2020
5/5/2020,436,11861,2878,71854,83715,28,1215,32,736,6,146,333,80,54,16,457,303,10298,1987,58907,69205,7/17/2020
5/6/2020,490,12351,2836,74690,87041,28,1243,44,780,9,155,308,78,54,21,478,341,10639,1936,60843,71482,7/17/2020
5/7/2020,425,12776,2975,77665,90441,36,1279,40,820,5,160,299,70,52,21,499,269,10908,1994,62837,73745,7/17/2020
5/8/2020,360,13136,2602,80267,93403,30,1309,29,849,5,165,295,70,53,22,521,231,11139,1788,64625,75764,7/17/2020
5/9/2020,457,13593,3355,83622,97215,22,1331,21,870,4,169,292,68,51,15,536,285,11424,2319,66944,78368,7/17/2020
5/10/2020,279,13872,2122,85744,99616,19,1350,23,893,6,175,282,69,49,13,549,186,11610,1531,68475,80085,7/17/2020
5/11/2020,259,14131,1861,87605,101736,31,1381,16,909,6,181,291,70,49,15,564,175,11785,1316,69791,81576,7/17/2020
5/12/2020,384,14515,2512,90117,104632,23,1404,18,927,4,185,292,68,48,22,586,217,12002,1615,71406,83408,7/17/2020
5/13/2020,352,14867,3570,93687,108554,22,1426,24,951,1,186,289,69,49,13,599,196,12198,1974,73380,85578,7/17/2020
5/14/2020,329,15196,3397,97084,112280,19,1445,27,978,3,189,278,64,45,15,614,227,12425,2023,75403,87828,7/17/2020
5/15/2020,381,15577,3433,100517,116094,24,1469,41,1019,5,194,256,62,45,13,627,232,12657,1807,77210,89867,7/17/2020
5/16/2020,419,15996,3883,104400,120396,25,1494,12,1031,5,199,264,61,46,15,642,252,12909,1779,78989,91898,7/17/2020
5/17/2020,223,16219,2708,107108,123327,17,1511,7,1038,5,204,269,59,45,10,652,124,13033,1545,80534,93567,7/17/2020
5/18/2020,248,16467,1992,109100,125567,19,1530,15,1053,5,209,268,57,40,18,670,137,13170,1363,81897,95067,7/17/2020
5/19/2020,414,16881,3153,112253,129134,23,1553,31,1084,5,214,255,56,38,11,681,214,13384,1940,83837,97221,7/17/2020
5/20/2020,327,17208,2779,115032,132240,19,1572,23,1107,7,221,244,52,33,22,703,187,13571,1540,85377,98948,7/17/2020
5/21/2020,370,17578,3794,118826,136404,26,1598,15,1122,3,224,252,53,29,20,723,169,13740,1986,87363,101103,7/17/2020
5/22/2020,350,17928,3026,121852,139780,20,1618,29,1151,5,229,238,52,29,10,733,201,13941,1493,88856,102797,7/17/2020
5/23/2020,240,18168,2735,124587,142755,19,1637,11,1162,3,232,243,52,32,13,746,108,14049,1330,90186,104235,7/17/2020
5/24/2020,153,18321,1359,125946,144267,12,1649,14,1176,2,234,239,53,36,8,754,84,14133,766,90952,105085,7/17/2020
5/25/2020,134,18455,1376,127322,145777,12,1661,14,1190,0,234,237,53,34,10,764,70,14203,755,91707,105910,7/17/2020
5/26/2020,284,18739,2609,129931,148670,24,1685,22,1212,5,239,234,48,33,15,779,154,14357,1778,93485,107842,7/17/2020
5/27/2020,276,19015,2110,132041,151056,20,1705,17,1229,3,242,234,50,33,10,789,133,14490,1152,94637,109127,7/17/2020
5/28/2020,345,19360,3374,135415,154775,17,1722,29,1258,4,246,218,47,32,8,797,132,14622,1145,95782,110404,7/17/2020
5/29/2020,418,19778,3968,139383,159161,18,1740,27,1285,6,252,203,43,31,12,809,178,14800,1589,97371,112171,7/17/2020
5/30/2020,211,19989,3958,143341,163330,15,1755,19,1304,4,256,195,40,29,12,821,104,14904,1828,99199,114103,7/17/2020
5/31/2020,147,20136,1728,145069,165205,10,1765,10,1314,0,256,195,43,26,3,824,76,14980,850,100049,115029,7/17/2020
6/1/2020,216,20352,2797,147866,168218,7,1772,13,1327,1,257,188,44,29,5,829,99,15079,1376,101425,116504,7/17/2020
6/2/2020,273,20625,3058,150924,171549,8,1780,9,1336,3,260,184,37,24,10,839,108,15187,1462,102887,118074,7/17/2020
6/3/2020,259,20884,3500,154424,175308,13,1793,18,1354,6,266,173,34,24,11,850,105,15292,1669,104556,119848,7/17/2020
6/4/2020,279,21163,4497,158921,180084,7,1800,25,1379,3,269,152,31,23,11,861,114,15406,2035,106591,121997,7/17/2020
6/5/2020,215,21378,3549,162470,183848,15,1815,12,1391,5,274,150,27,20,9,870,104,15510,1565,108156,123666,7/17/2020
6/6/2020,198,21576,2606,165076,186652,10,1825,7,1398,2,276,151,29,18,6,876,68,15578,1129,109285,124863,7/17/2020
6/7/2020,77,21653,1581,166657,188310,11,1836,7,1405,1,277,154,25,16,4,880,49,15627,759,110044,125671,7/17/2020
6/8/2020,122,21775,1820,168477,190252,15,1851,12,1417,2,279,155,27,17,4,884,44,15671,950,110994,126665,7/17/2020
6/9/2020,223,21998,2617,171094,193092,10,1861,18,1435,0,279,147,28,20,1,885,67,15738,1235,112229,127967,7/17/2020
6/10/2020,210,22208,2957,174051,196259,13,1874,12,1447,2,281,146,24,16,3,888,104,15842,1447,113676,129518,7/17/2020
6/11/2020,195,22403,3465,177516,199919,7,1881,15,1462,1,282,137,25,15,6,894,88,15930,1510,115186,131116,7/17/2020
6/12/2020,213,22616,4444,181960,204576,8,1889,15,1477,1,283,129,23,15,2,896,81,16011,2147,117333,133344,7/17/2020
6/13/2020,104,22720,2801,184761,207481,6,1895,4,1481,0,283,131,19,14,3,899,50,16061,1274,118607,134668,7/17/2020
6/14/2020,78,22798,1911,186672,209470,6,1901,8,1489,1,284,128,19,13,3,902,32,16093,917,119524,135617,7/17/2020
6/15/2020,188,22986,3050,189722,212708,14,1915,14,1503,0,284,128,19,15,4,906,77,16170,1774,121298,137468,7/17/2020
6/16/2020,114,23100,2885,192607,215707,10,1925,10,1513,1,285,127,21,15,8,914,52,16222,1555,122853,139075,7/17/2020
6/17/2020,122,23222,2673,195280,218502,15,1940,20,1533,4,289,118,17,13,6,920,51,16273,1290,124143,140416,7/17/2020
6/18/2020,150,23372,2964,198244,221616,9,1949,13,1546,1,290,113,18,15,7,927,70,16343,1301,125444,141787,7/17/2020
6/19/2020,139,23511,3524,201768,225279,12,1961,11,1557,1,291,113,19,16,3,930,59,16402,1266,126710,143112,7/17/2020
6/20/2020,79,23590,1733,203501,227091,7,1968,9,1566,0,291,111,19,17,4,934,36,16438,725,127435,143873,7/17/2020
6/21/2020,36,23626,1002,204503,228129,7,1975,5,1571,0,291,113,19,17,2,936,27,16465,647,128082,144547,7/17/2020
6/22/2020,142,23768,3661,208164,231932,12,1987,16,1587,0,291,109,18,17,1,937,59,16524,1689,129771,146295,7/17/2020
6/23/2020,161,23929,3721,211885,235814,3,1990,13,1600,3,294,96,17,17,6,943,71,16595,1698,131469,148064,7/17/2020
6/24/2020,118,24047,3355,215240,239287,8,1998,10,1610,1,295,93,16,17,5,948,50,16645,1576,133045,149690,7/17/2020
6/25/2020,102,24149,2836,218076,242225,5,2003,14,1624,1,296,83,15,16,0,948,45,16690,1480,134525,151215,7/17/2020
6/26/2020,93,24242,2431,220507,244749,2,2005,9,1633,0,296,76,16,17,1,949,71,16761,1363,135888,152649,7/17/2020
6/27/2020,84,24326,3193,223700,248026,5,2010,3,1636,1,297,77,15,16,5,954,34,16795,1201,137089,153884,7/17/2020
6/28/2020,37,24363,1439,225139,249502,3,2013,4,1640,4,301,72,13,13,6,960,22,16817,582,137671,154488,7/17/2020
6/29/2020,86,24449,3620,228759,253208,4,2017,5,1645,0,301,71,12,13,1,961,37,16854,1318,138989,155843,7/17/2020
6/30/2020,59,24508,1881,230640,255148,1,2018,5,1650,1,302,66,10,10,3,964,41,16895,973,139962,156857,7/17/2020
7/1/2020,141,24649,3958,234598,259247,7,2025,9,1659,0,302,64,9,10,1,965,67,16962,1890,141852,158814,7/17/2020
7/2/2020,99,24748,2606,237204,261952,5,2030,5,1664,1,303,63,7,8,1,966,56,17018,985,142837,159855,7/17/2020
7/3/2020,42,24790,1851,239055,263845,7,2037,6,1670,0,303,64,6,7,3,969,23,17041,673,143510,160551,7/17/2020
7/4/2020,52,24842,2228,241283,266125,2,2039,4,1674,1,304,61,7,7,2,971,27,17068,952,144462,161530,7/17/2020
7/5/2020,46,24888,2826,244109,268997,1,2040,2,1676,1,305,59,5,6,2,973,25,17093,1374,145836,162929,7/17/2020
7/6/2020,101,24989,2709,246818,271807,6,2046,6,1682,0,305,59,7,8,4,977,57,17150,1503,147339,164489,7/17/2020
7/7/2020,74,25063,3343,250161,275224,5,2051,5,1687,0,305,59,6,7,1,978,35,17185,1515,148854,166039,7/17/2020
7/8/2020,94,25157,3261,253422,278579,3,2054,2,1689,0,305,60,7,7,0,978,72,17257,1339,150193,167450,7/17/2020
7/9/2020,100,25257,3471,256893,282150,5,2059,1,1690,0,305,64,7,7,0,978,55,17312,1557,151750,169062,7/17/2020
7/10/2020,158,25415,4197,261090,286505,4,2063,3,1693,2,307,63,6,6,3,981,52,17364,1964,153714,171078,7/17/2020
7/11/2020,68,25483,2721,263811,289294,6,2069,3,1696,1,308,65,5,5,3,984,84,17448,1251,154965,172413,7/17/2020
7/12/2020,46,25529,1650,265461,290990,1,2070,1,1697,1,309,64,4,3,3,987,38,17486,814,155779,173265,7/17/2020
7/13/2020,136,25665,2991,268452,294117,7,2077,10,1707,0,309,61,4,3,1,988,111,17597,1387,157166,174763,7/17/2020
7/14/2020,83,25748,3145,271597,297345,7,2084,4,1711,0,309,64,4,3,1,989,58,17655,1294,158460,176115,7/17/2020
7/15/2020,120,25868,3896,275493,301361,4,2088,6,1717,0,309,62,4,2,0,989,67,17722,1583,160043,177765,7/17/2020
7/16/2020,98,25966,3311,278804,304770,,,,,,,,,,1,990,71,17793,1365,161408,179201,7/17/2020
2/27/2020,0,0,0,0,0,1,1,0,0,0,0,1,0,0,0,0,0,0,0,0,0,7/20/2020
2/28/2020,0,0,0,0,0,0,1,0,0,0,0,1,1,0,0,0,0,0,0,0,0,7/20/2020
2/29/2020,0,0,0,0,0,0,1,0,0,0,0,1,1,0,0,0,0,0,0,0,0,7/20/2020
3/1/2020,2,2,2,2,4,0,1,0,0,0,0,1,1,1,0,0,2,2,2,2,4,7/20/2020
3/2/2020,0,2,1,3,5,1,2,0,0,0,0,2,2,2,0,0,0,2,1,3,5,7/20/2020
3/3/2020,0,2,2,5,7,0,2,0,0,0,0,2,2,2,0,0,0,2,2,5,7,7/20/2020
3/4/2020,0,2,12,17,19,1,3,0,0,0,0,3,2,2,0,0,0,2,10,15,17,7/20/2020
3/5/2020,0,2,4,21,23,0,3,0,0,0,0,3,2,2,0,0,1,3,4,19,22,7/20/2020
3/6/2020,1,3,12,33,36,0,3,0,0,0,0,3,2,2,0,0,0,3,11,30,33,7/20/2020
3/7/2020,0,3,19,52,55,0,3,0,0,0,0,3,2,1,0,0,0,3,19,49,52,7/20/2020
3/8/2020,0,3,18,70,73,0,3,0,0,0,0,3,2,1,0,0,0,3,18,67,70,7/20/2020
3/9/2020,1,4,15,85,89,0,3,0,0,0,0,3,2,1,0,0,1,4,15,82,86,7/20/2020
3/10/2020,2,6,25,110,116,0,3,0,0,0,0,3,2,1,0,0,1,5,23,105,110,7/20/2020
3/11/2020,0,6,34,144,150,1,4,0,0,0,0,4,1,1,0,0,0,5,34,139,144,7/20/2020
3/12/2020,9,15,42,186,201,1,5,0,0,0,0,5,1,1,0,0,8,13,38,177,190,7/20/2020
3/13/2020,6,21,50,236,257,4,9,1,1,0,0,8,1,1,0,0,6,19,48,225,244,7/20/2020
3/14/2020,0,21,90,326,347,0,9,0,1,0,0,8,1,1,0,0,0,19,86,311,330,7/20/2020
3/15/2020,1,22,54,380,402,1,10,0,1,0,0,9,2,1,0,0,1,20,54,365,385,7/20/2020
3/16/2020,2,24,95,475,499,2,12,0,1,0,0,11,2,0,0,0,2,22,92,457,479,7/20/2020
3/17/2020,16,40,162,637,677,6,18,0,1,0,0,17,2,0,0,0,11,33,153,610,643,7/20/2020
3/18/2020,12,52,116,753,805,3,21,0,1,0,0,20,2,0,0,0,11,44,111,721,765,7/20/2020
3/19/2020,17,69,262,1015,1084,2,23,1,2,0,0,21,3,0,1,1,17,61,251,972,1033,7/20/2020
3/20/2020,15,84,197,1212,1296,5,28,0,2,0,0,26,4,0,0,1,13,74,193,1165,1239,7/20/2020
3/21/2020,21,105,126,1338,1443,3,31,2,4,0,0,27,5,0,0,1,14,88,123,1288,1376,7/20/2020
3/22/2020,30,135,282,1620,1755,2,33,0,4,0,0,29,5,0,0,1,25,113,265,1553,1666,7/20/2020
3/23/2020,14,149,169,1789,1938,15,48,1,5,0,0,43,9,3,0,1,16,129,165,1718,1847,7/20/2020
3/24/2020,20,169,243,2032,2201,7,55,0,5,0,0,50,10,4,0,1,19,148,238,1956,2104,7/20/2020
3/25/2020,26,195,183,2215,2410,5,60,1,6,0,0,54,11,3,0,1,28,176,173,2129,2305,7/20/2020
3/26/2020,35,230,181,2396,2626,10,70,5,11,0,0,59,14,5,0,1,41,217,176,2305,2522,7/20/2020
3/27/2020,27,257,215,2611,2868,9,79,1,12,1,1,66,17,6,2,3,31,248,202,2507,2755,7/20/2020
3/28/2020,59,316,260,2871,3187,13,92,3,15,2,3,74,15,6,1,4,63,311,242,2749,3060,7/20/2020
3/29/2020,106,422,356,3227,3649,8,100,4,19,1,4,77,18,8,2,6,105,416,314,3063,3479,7/20/2020
3/30/2020,62,484,222,3449,3933,20,120,5,24,0,4,92,20,11,3,9,78,494,192,3255,3749,7/20/2020
3/31/2020,71,555,369,3818,4373,11,131,7,31,1,5,95,22,13,2,11,73,567,300,3555,4122,7/20/2020
4/1/2020,99,654,699,4517,5171,18,149,7,38,0,5,106,30,15,1,12,100,667,649,4204,4871,7/20/2020
4/2/2020,52,706,477,4994,5700,21,170,6,44,2,7,119,36,21,4,16,62,729,437,4641,5370,7/20/2020
4/3/2020,108,814,775,5769,6583,23,193,7,51,0,7,135,43,25,3,19,100,829,718,5359,6188,7/20/2020
4/4/2020,143,957,660,6429,7386,22,215,4,55,5,12,148,41,30,9,28,137,966,623,5982,6948,7/20/2020
4/5/2020,187,1144,1156,7585,8729,20,235,9,64,1,13,158,44,36,2,30,182,1148,1072,7054,8202,7/20/2020
4/6/2020,218,1362,1707,9292,10654,26,261,7,71,0,13,177,48,40,7,37,206,1354,1581,8635,9989,7/20/2020
4/7/2020,285,1647,1631,10923,12570,20,281,3,74,2,15,192,49,42,5,42,261,1615,1496,10131,11746,7/20/2020
4/8/2020,290,1937,1723,12646,14583,19,300,7,81,6,21,198,49,38,10,52,272,1887,1575,11706,13593,7/20/2020
4/9/2020,284,2221,1521,14167,16388,32,332,9,90,4,25,217,52,40,7,59,278,2165,1367,13073,15238,7/20/2020
4/10/2020,420,2641,2577,16744,19385,29,361,17,107,5,30,224,58,41,11,70,404,2569,2382,15455,18024,7/20/2020
4/11/2020,299,2940,1911,18655,21595,29,390,11,118,2,32,240,61,48,11,81,280,2849,1732,17187,20036,7/20/2020
4/12/2020,315,3255,1674,20329,23584,35,425,13,131,5,37,257,59,49,10,91,289,3138,1453,18640,21778,7/20/2020
4/13/2020,162,3417,938,21267,24684,35,460,13,144,3,40,276,64,54,9,100,187,3325,848,19488,22813,7/20/2020
4/14/2020,289,3706,1788,23055,26761,27,487,17,161,5,45,281,72,53,8,108,265,3590,1564,21052,24642,7/20/2020
4/15/2020,353,4059,1803,24858,28917,31,518,19,180,3,48,290,72,54,17,125,307,3897,1582,22634,26531,7/20/2020
4/16/2020,449,4508,2500,27358,31866,36,554,25,205,6,54,295,72,53,14,139,392,4289,2098,24732,29021,7/20/2020
4/17/2020,308,4816,1823,29181,33997,32,586,20,225,7,61,300,66,45,21,160,291,4580,1487,26219,30799,7/20/2020
4/18/2020,322,5138,1728,30909,36047,26,612,18,243,4,65,304,63,49,15,175,284,4864,1368,27587,32451,7/20/2020
4/19/2020,382,5520,2059,32968,38488,23,635,26,269,1,66,300,65,55,11,186,338,5202,1763,29350,34552,7/20/2020
4/20/2020,396,5916,1909,34877,40793,46,681,29,298,2,68,315,75,56,10,196,378,5580,1597,30947,36527,7/20/2020
4/21/2020,445,6361,2114,36991,43352,45,726,31,329,5,73,324,72,56,18,214,388,5968,1729,32676,38644,7/20/2020
4/22/2020,420,6781,2398,39389,46170,41,767,32,361,5,78,328,73,58,18,232,382,6350,1927,34603,40953,7/20/2020
4/23/2020,482,7263,2471,41860,49123,30,797,28,389,5,83,325,76,62,15,247,420,6770,1896,36499,43269,7/20/2020
4/24/2020,494,7757,3292,45152,52909,35,832,27,416,4,87,329,85,63,15,262,414,7184,2655,39154,46338,7/20/2020
4/25/2020,394,8151,2210,47362,55513,34,866,17,433,5,92,341,85,62,14,276,305,7489,1792,40946,48435,7/20/2020
4/26/2020,316,8467,2314,49676,58143,33,899,15,448,3,95,356,86,59,14,290,277,7766,1891,42837,50603,7/20/2020
4/27/2020,250,8717,1624,51300,60017,29,928,21,469,4,99,360,86,61,10,300,203,7969,1173,44010,51979,7/20/2020
4/28/2020,411,9128,2268,53568,62696,44,972,24,493,3,102,377,88,59,22,322,324,8293,1779,45789,54082,7/20/2020
4/29/2020,476,9604,3351,56919,66523,36,1008,37,530,11,113,365,78,53,18,340,372,8665,2457,48246,56911,7/20/2020
4/30/2020,432,10036,2772,59691,69727,32,1040,38,568,6,119,353,83,57,24,364,348,9013,1966,50212,59225,7/20/2020
5/1/2020,457,10493,3089,62780,73273,51,1091,39,607,3,122,362,84,58,14,378,317,9330,2229,52441,61771,7/20/2020
5/2/2020,260,10753,1927,64707,75460,35,1126,39,646,5,127,353,90,61,24,402,189,9519,1300,53741,63260,7/20/2020
5/3/2020,284,11037,2168,66875,77912,31,1157,27,673,8,135,349,89,61,21,423,181,9700,1615,55356,65056,7/20/2020
5/4/2020,388,11425,2101,68976,80401,30,1187,31,704,5,140,343,87,57,18,441,292,9992,1581,56937,66929,7/20/2020
5/5/2020,436,11861,2878,71854,83715,28,1215,32,736,6,146,333,80,54,16,457,303,10295,1987,58924,69219,7/20/2020
5/6/2020,490,12351,2836,74690,87041,28,1243,44,780,9,155,308,78,54,21,478,341,10636,1941,60865,71501,7/20/2020
5/7/2020,425,12776,2975,77665,90441,36,1279,40,820,5,160,299,70,52,21,499,269,10905,1996,62861,73766,7/20/2020
5/8/2020,360,13136,2602,80267,93403,30,1309,29,849,5,165,295,70,53,22,521,231,11136,1788,64649,75785,7/20/2020
5/9/2020,457,13593,3355,83622,97215,22,1331,21,870,4,169,292,68,51,15,536,285,11421,2318,66967,78388,7/20/2020
5/10/2020,279,13872,2122,85744,99616,19,1350,23,893,6,175,282,69,49,13,549,186,11607,1531,68498,80105,7/20/2020
5/11/2020,259,14131,1861,87605,101736,31,1381,16,909,6,181,291,70,49,15,564,175,11782,1317,69815,81597,7/20/2020
5/12/2020,384,14515,2512,90117,104632,23,1404,18,927,4,185,292,68,48,22,586,217,11999,1624,71439,83438,7/20/2020
5/13/2020,352,14867,3570,93687,108554,22,1426,24,951,1,186,289,69,49,13,599,196,12195,1975,73414,85609,7/20/2020
5/14/2020,329,15196,3397,97084,112280,19,1445,27,978,3,189,278,64,45,15,614,227,12422,2022,75436,87858,7/20/2020
5/15/2020,381,15577,3433,100517,116094,24,1469,41,1019,5,194,256,62,45,13,627,232,12654,1809,77245,89899,7/20/2020
5/16/2020,419,15996,3883,104400,120396,25,1494,12,1031,5,199,264,61,46,15,642,252,12906,1778,79023,91929,7/20/2020
5/17/2020,223,16219,2708,107108,123327,17,1511,7,1038,5,204,269,59,45,10,652,124,13030,1545,80568,93598,7/20/2020
5/18/2020,248,16467,1992,109100,125567,19,1530,15,1053,5,209,268,57,40,18,670,137,13167,1362,81930,95097,7/20/2020
5/19/2020,414,16881,3153,112253,129134,23,1553,31,1084,5,214,255,56,38,11,681,214,13381,1939,83869,97250,7/20/2020
5/20/2020,327,17208,2779,115032,132240,19,1572,23,1107,7,221,244,52,33,22,703,187,13568,1541,85410,98978,7/20/2020
5/21/2020,370,17578,3794,118826,136404,26,1598,15,1122,3,224,252,53,29,20,723,170,13738,1984,87394,101132,7/20/2020
5/22/2020,350,17928,3026,121852,139780,20,1618,29,1151,5,229,238,52,29,10,733,201,13939,1493,88887,102826,7/20/2020
5/23/2020,240,18168,2735,124587,142755,19,1637,11,1162,3,232,243,52,32,13,746,108,14047,1330,90217,104264,7/20/2020
5/24/2020,153,18321,1359,125946,144267,12,1649,14,1176,2,234,239,53,36,8,754,84,14131,766,90983,105114,7/20/2020
5/25/2020,134,18455,1376,127322,145777,12,1661,14,1190,0,234,237,53,34,10,764,70,14201,755,91738,105939,7/20/2020
5/26/2020,284,18739,2609,129931,148670,24,1685,22,1212,5,239,234,48,33,15,779,154,14355,1778,93516,107871,7/20/2020
5/27/2020,276,19015,2121,132052,151067,20,1705,17,1229,3,242,234,50,33,10,789,133,14488,1152,94668,109156,7/20/2020
5/28/2020,346,19361,3377,135429,154790,17,1722,29,1258,4,246,218,47,32,8,797,132,14620,1147,95815,110435,7/20/2020
5/29/2020,418,19779,3973,139402,159181,18,1740,27,1285,6,252,203,43,31,12,809,178,14798,1589,97404,112202,7/20/2020
5/30/2020,211,19990,3964,143366,163356,15,1755,19,1304,4,256,195,40,29,12,821,104,14902,1829,99233,114135,7/20/2020
5/31/2020,148,20138,1741,145107,165245,10,1765,10,1314,0,256,195,43,26,3,824,76,14978,851,100084,115062,7/20/2020
6/1/2020,216,20354,2802,147909,168263,7,1772,13,1327,1,257,188,44,29,5,829,99,15077,1374,101458,116535,7/20/2020
6/2/2020,273,20627,3066,150975,171602,8,1780,9,1336,3,260,184,37,24,10,839,107,15184,1463,102921,118105,7/20/2020
6/3/2020,259,20886,3508,154483,175369,13,1793,18,1354,6,266,173,34,24,11,850,105,15289,1673,104594,119883,7/20/2020
6/4/2020,281,21167,4515,158998,180165,7,1800,25,1379,3,269,152,31,23,11,861,115,15404,2043,106637,122041,7/20/2020
6/5/2020,215,21382,3572,162570,183952,15,1815,12,1391,5,274,150,27,20,9,870,104,15508,1575,108212,123720,7/20/2020
6/6/2020,198,21580,2617,165187,186767,10,1825,7,1398,2,276,151,29,18,6,876,68,15576,1137,109349,124925,7/20/2020
6/7/2020,77,21657,1583,166770,188427,11,1836,7,1405,1,277,154,25,16,4,880,49,15625,759,110108,125733,7/20/2020
6/8/2020,122,21779,1830,168600,190379,15,1851,12,1417,2,279,155,27,17,4,884,44,15669,954,111062,126731,7/20/2020
6/9/2020,224,22003,2637,171237,193240,10,1861,18,1435,0,279,147,28,20,1,885,67,15736,1249,112311,128047,7/20/2020
6/10/2020,210,22213,2971,174208,196421,13,1874,12,1447,2,281,146,24,16,3,888,104,15840,1455,113766,129606,7/20/2020
6/11/2020,195,22408,3489,177697,200105,7,1881,15,1462,1,282,137,25,15,6,894,88,15928,1526,115292,131220,7/20/2020
6/12/2020,213,22621,4465,182162,204783,8,1889,15,1477,1,283,129,23,15,2,896,80,16008,2159,117451,133459,7/20/2020
6/13/2020,105,22726,2806,184968,207694,6,1895,4,1481,0,283,131,19,14,3,899,50,16058,1278,118729,134787,7/20/2020
6/14/2020,78,22804,1916,186884,209688,6,1901,8,1489,1,284,128,19,13,3,902,32,16090,918,119647,135737,7/20/2020
6/15/2020,188,22992,3061,189945,212937,14,1915,14,1503,0,284,128,19,15,4,906,77,16167,1778,121425,137592,7/20/2020
6/16/2020,115,23107,2903,192848,215955,10,1925,10,1513,1,285,127,21,15,8,914,52,16219,1565,122990,139209,7/20/2020
6/17/2020,123,23230,2688,195536,218766,15,1940,20,1533,4,289,118,17,13,6,920,50,16269,1300,124290,140559,7/20/2020
6/18/2020,150,23380,2979,198515,221895,9,1949,13,1546,1,290,113,18,15,7,927,70,16339,1308,125598,141937,7/20/2020
6/19/2020,139,23519,3534,202049,225568,12,1961,11,1557,1,291,113,19,16,3,930,58,16397,1272,126870,143267,7/20/2020
6/20/2020,79,23598,1734,203783,227381,7,1968,9,1566,0,291,111,19,17,4,934,35,16432,726,127596,144028,7/20/2020
6/21/2020,36,23634,1006,204789,228423,7,1975,5,1571,0,291,113,19,17,2,936,27,16459,650,128246,144705,7/20/2020
6/22/2020,142,23776,3678,208467,232243,12,1987,16,1587,0,291,109,18,17,1,937,70,16529,1699,129945,146474,7/20/2020
6/23/2020,161,23937,3740,212207,236144,3,1990,13,1600,3,294,96,17,17,6,943,83,16612,1711,131656,148268,7/20/2020
6/24/2020,119,24056,3372,215579,239635,8,1998,10,1610,1,295,93,16,17,5,948,46,16658,1586,133242,149900,7/20/2020
6/25/2020,102,24158,2855,218434,242592,5,2003,14,1624,1,296,83,15,16,1,949,53,16711,1488,134730,151441,7/20/2020
6/26/2020,93,24251,2439,220873,245124,2,2005,9,1633,0,296,76,16,17,1,950,64,16775,1364,136094,152869,7/20/2020
6/27/2020,84,24335,3194,224067,248402,5,2010,3,1636,1,297,77,15,16,5,955,37,16812,1200,137294,154106,7/20/2020
6/28/2020,37,24372,1444,225511,249883,4,2014,4,1640,4,301,73,13,13,6,961,18,16830,583,137877,154707,7/20/2020
6/29/2020,86,24458,3635,229146,253604,4,2018,5,1645,0,301,72,12,13,1,962,38,16868,1323,139200,156068,7/20/2020
6/30/2020,59,24517,1896,231042,255559,1,2019,5,1650,1,302,67,10,10,3,965,34,16902,981,140181,157083,7/20/2020
7/1/2020,142,24659,3971,235013,259672,7,2026,9,1659,0,302,65,9,10,1,966,79,16981,1895,142076,159057,7/20/2020
7/2/2020,101,24760,2621,237634,262394,5,2031,5,1664,1,303,64,7,8,1,967,56,17037,993,143069,160106,7/20/2020
7/3/2020,42,24802,1858,239492,264294,7,2038,6,1670,0,303,65,6,7,3,970,20,17057,673,143742,160799,7/20/2020
7/4/2020,52,24854,2230,241722,266576,2,2040,4,1674,1,304,62,7,7,2,972,27,17084,953,144695,161779,7/20/2020
7/5/2020,46,24900,2828,244550,269450,1,2041,2,1676,1,305,60,5,6,2,974,22,17106,1375,146070,163176,7/20/2020
7/6/2020,102,25002,2731,247281,272283,6,2047,6,1682,0,305,60,7,8,4,978,60,17166,1514,147584,164750,7/20/2020
7/7/2020,74,25076,3356,250637,275713,5,2052,6,1688,0,305,59,6,7,1,979,47,17213,1523,149107,166320,7/20/2020
7/8/2020,94,25170,3277,253914,279084,3,2055,2,1690,0,305,60,7,7,0,979,55,17268,1344,150451,167719,7/20/2020
7/9/2020,93,25263,3487,257401,282664,7,2062,1,1691,0,305,66,7,7,0,979,48,17316,1562,152013,169329,7/20/2020
7/10/2020,127,25390,4244,261645,287035,4,2066,3,1694,2,307,65,6,6,3,982,77,17393,1977,153990,171383,7/20/2020
7/11/2020,60,25450,2733,264378,289828,6,2072,3,1697,1,308,67,5,5,3,985,36,17429,1257,155247,172676,7/20/2020
7/12/2020,41,25491,1662,266040,291531,1,2073,2,1699,1,309,65,5,4,3,988,29,17458,818,156065,173523,7/20/2020
7/13/2020,91,25582,3055,269095,294677,7,2080,10,1709,0,309,62,5,4,1,989,60,17518,1405,157470,174988,7/20/2020
7/14/2020,65,25647,3176,272271,297918,7,2087,4,1713,0,309,65,4,4,1,990,42,17560,1308,158778,176338,7/20/2020
7/15/2020,120,25767,3927,276198,301965,4,2091,6,1719,0,309,63,4,3,0,990,88,17648,1606,160384,178032,7/20/2020
7/16/2020,99,25866,3490,279688,305554,4,2095,8,1727,0,309,59,4,3,1,991,76,17724,1476,161860,179584,7/20/2020
7/17/2020,148,26014,4017,283705,309719,13,2108,3,1730,1,310,68,3,3,0,991,77,17801,1734,163594,181395,7/20/2020
7/18/2020,64,26078,2880,286585,312663,2,2110,8,1738,1,311,61,2,2,3,994,57,17858,1170,164764,182622,7/20/2020
7/19/2020,74,26152,2419,289004,315156,,,,,,,,,,1,995,46,17904,957,165721,183625,7/20/2020
2/27/2020,0,0,0,0,0,1,1,0,0,0,0,1,0,0,0,0,0,0,0,0,0,7/21/2020
2/28/2020,0,0,0,0,0,0,1,0,0,0,0,1,1,0,0,0,0,0,0,0,0,7/21/2020
2/29/2020,0,0,0,0,0,0,1,0,0,0,0,1,1,0,0,0,0,0,0,0,0,7/21/2020
3/1/2020,2,2,2,2,4,0,1,0,0,0,0,1,1,1,0,0,2,2,2,2,4,7/21/2020
3/2/2020,0,2,1,3,5,1,2,0,0,0,0,2,2,2,0,0,0,2,1,3,5,7/21/2020
3/3/2020,0,2,2,5,7,0,2,0,0,0,0,2,2,2,0,0,0,2,2,5,7,7/21/2020
3/4/2020,0,2,12,17,19,1,3,0,0,0,0,3,2,2,0,0,0,2,10,15,17,7/21/2020
3/5/2020,0,2,4,21,23,0,3,0,0,0,0,3,2,2,0,0,1,3,4,19,22,7/21/2020
3/6/2020,1,3,12,33,36,0,3,0,0,0,0,3,2,2,0,0,0,3,11,30,33,7/21/2020
3/7/2020,0,3,19,52,55,0,3,0,0,0,0,3,2,1,0,0,0,3,19,49,52,7/21/2020
3/8/2020,0,3,18,70,73,0,3,0,0,0,0,3,2,1,0,0,0,3,18,67,70,7/21/2020
3/9/2020,1,4,15,85,89,0,3,0,0,0,0,3,2,1,0,0,1,4,15,82,86,7/21/2020
3/10/2020,2,6,25,110,116,0,3,0,0,0,0,3,2,1,0,0,1,5,23,105,110,7/21/2020
3/11/2020,0,6,34,144,150,1,4,0,0,0,0,4,1,1,0,0,0,5,34,139,144,7/21/2020
3/12/2020,9,15,42,186,201,1,5,0,0,0,0,5,1,1,0,0,8,13,38,177,190,7/21/2020
3/13/2020,6,21,50,236,257,4,9,1,1,0,0,8,1,1,0,0,6,19,48,225,244,7/21/2020
3/14/2020,0,21,90,326,347,0,9,0,1,0,0,8,1,1,0,0,0,19,86,311,330,7/21/2020
3/15/2020,1,22,54,380,402,1,10,0,1,0,0,9,2,1,0,0,1,20,54,365,385,7/21/2020
3/16/2020,2,24,95,475,499,2,12,0,1,0,0,11,2,0,0,0,2,22,92,457,479,7/21/2020
3/17/2020,16,40,162,637,677,6,18,0,1,0,0,17,2,0,0,0,11,33,153,610,643,7/21/2020
3/18/2020,12,52,116,753,805,3,21,0,1,0,0,20,2,0,0,0,11,44,111,721,765,7/21/2020
3/19/2020,17,69,262,1015,1084,2,23,1,2,0,0,21,3,0,1,1,17,61,251,972,1033,7/21/2020
3/20/2020,15,84,197,1212,1296,5,28,0,2,0,0,26,4,0,0,1,13,74,193,1165,1239,7/21/2020
3/21/2020,21,105,126,1338,1443,3,31,2,4,0,0,27,5,0,0,1,14,88,123,1288,1376,7/21/2020
3/22/2020,30,135,282,1620,1755,2,33,0,4,0,0,29,5,0,0,1,25,113,265,1553,1666,7/21/2020
3/23/2020,14,149,169,1789,1938,15,48,1,5,0,0,43,9,3,0,1,16,129,165,1718,1847,7/21/2020
3/24/2020,20,169,243,2032,2201,7,55,0,5,0,0,50,10,4,0,1,19,148,238,1956,2104,7/21/2020
3/25/2020,26,195,183,2215,2410,5,60,1,6,0,0,54,11,3,0,1,28,176,173,2129,2305,7/21/2020
3/26/2020,35,230,181,2396,2626,10,70,5,11,0,0,59,14,5,0,1,41,217,176,2305,2522,7/21/2020
3/27/2020,27,257,215,2611,2868,9,79,1,12,1,1,66,17,6,2,3,31,248,202,2507,2755,7/21/2020
3/28/2020,59,316,260,2871,3187,13,92,3,15,2,3,74,15,6,1,4,63,311,242,2749,3060,7/21/2020
3/29/2020,106,422,356,3227,3649,8,100,4,19,1,4,77,18,8,2,6,105,416,314,3063,3479,7/21/2020
3/30/2020,62,484,222,3449,3933,20,120,5,24,0,4,92,20,11,3,9,78,494,192,3255,3749,7/21/2020
3/31/2020,71,555,369,3818,4373,11,131,7,31,1,5,95,22,13,2,11,73,567,300,3555,4122,7/21/2020
4/1/2020,99,654,699,4517,5171,18,149,7,38,0,5,106,30,15,1,12,100,667,649,4204,4871,7/21/2020
4/2/2020,52,706,477,4994,5700,21,170,6,44,2,7,119,36,21,4,16,62,729,437,4641,5370,7/21/2020
4/3/2020,108,814,775,5769,6583,23,193,7,51,0,7,135,43,25,3,19,100,829,718,5359,6188,7/21/2020
4/4/2020,143,957,660,6429,7386,22,215,4,55,5,12,148,41,30,9,28,137,966,623,5982,6948,7/21/2020
4/5/2020,187,1144,1156,7585,8729,20,235,9,64,1,13,158,44,36,2,30,182,1148,1072,7054,8202,7/21/2020
4/6/2020,218,1362,1707,9292,10654,26,261,7,71,0,13,177,48,40,7,37,206,1354,1581,8635,9989,7/21/2020
4/7/2020,285,1647,1631,10923,12570,20,281,4,75,2,15,191,49,42,5,42,261,1615,1496,10131,11746,7/21/2020
4/8/2020,290,1937,1723,12646,14583,19,300,7,82,6,21,197,49,38,10,52,272,1887,1575,11706,13593,7/21/2020
4/9/2020,284,2221,1521,14167,16388,32,332,9,91,4,25,216,52,40,7,59,278,2165,1367,13073,15238,7/21/2020
4/10/2020,420,2641,2577,16744,19385,29,361,16,107,5,30,224,58,41,11,70,404,2569,2382,15455,18024,7/21/2020
4/11/2020,299,2940,1911,18655,21595,29,390,11,118,2,32,240,61,48,11,81,280,2849,1732,17187,20036,7/21/2020
4/12/2020,315,3255,1674,20329,23584,35,425,13,131,5,37,257,59,49,10,91,289,3138,1453,18640,21778,7/21/2020
4/13/2020,162,3417,938,21267,24684,35,460,13,144,3,40,276,64,54,9,100,187,3325,848,19488,22813,7/21/2020
4/14/2020,289,3706,1788,23055,26761,27,487,17,161,5,45,281,72,53,8,108,265,3590,1564,21052,24642,7/21/2020
4/15/2020,353,4059,1803,24858,28917,31,518,19,180,3,48,290,72,54,17,125,307,3897,1582,22634,26531,7/21/2020
4/16/2020,449,4508,2500,27358,31866,36,554,25,205,6,54,295,72,53,14,139,392,4289,2098,24732,29021,7/21/2020
4/17/2020,308,4816,1823,29181,33997,32,586,20,225,7,61,300,66,45,21,160,291,4580,1487,26219,30799,7/21/2020
4/18/2020,322,5138,1728,30909,36047,26,612,18,243,4,65,304,63,49,15,175,284,4864,1368,27587,32451,7/21/2020
4/19/2020,382,5520,2059,32968,38488,23,635,26,269,1,66,300,65,55,11,186,338,5202,1763,29350,34552,7/21/2020
4/20/2020,396,5916,1909,34877,40793,46,681,29,298,2,68,315,75,56,10,196,378,5580,1597,30947,36527,7/21/2020
4/21/2020,445,6361,2114,36991,43352,45,726,31,329,5,73,324,72,56,18,214,388,5968,1729,32676,38644,7/21/2020
4/22/2020,420,6781,2398,39389,46170,41,767,32,361,5,78,328,73,58,18,232,382,6350,1927,34603,40953,7/21/2020
4/23/2020,482,7263,2471,41860,49123,30,797,28,389,5,83,325,76,62,15,247,420,6770,1896,36499,43269,7/21/2020
4/24/2020,494,7757,3292,45152,52909,35,832,27,416,4,87,329,85,63,15,262,414,7184,2655,39154,46338,7/21/2020
4/25/2020,394,8151,2210,47362,55513,34,866,17,433,5,92,341,85,62,14,276,305,7489,1792,40946,48435,7/21/2020
4/26/2020,316,8467,2314,49676,58143,33,899,15,448,3,95,356,86,59,14,290,277,7766,1891,42837,50603,7/21/2020
4/27/2020,250,8717,1624,51300,60017,29,928,21,469,4,99,360,86,61,10,300,203,7969,1173,44010,51979,7/21/2020
4/28/2020,411,9128,2268,53568,62696,44,972,24,493,3,102,377,88,59,22,322,324,8293,1779,45789,54082,7/21/2020
4/29/2020,476,9604,3351,56919,66523,36,1008,37,530,11,113,365,78,53,18,340,372,8665,2457,48246,56911,7/21/2020
4/30/2020,432,10036,2772,59691,69727,32,1040,38,568,6,119,353,83,57,24,364,348,9013,1966,50212,59225,7/21/2020
5/1/2020,457,10493,3089,62780,73273,51,1091,39,607,3,122,362,84,58,14,378,317,9330,2229,52441,61771,7/21/2020
5/2/2020,260,10753,1927,64707,75460,35,1126,39,646,5,127,353,90,61,24,402,189,9519,1300,53741,63260,7/21/2020
5/3/2020,284,11037,2168,66875,77912,31,1157,27,673,8,135,349,89,61,21,423,181,9700,1615,55356,65056,7/21/2020
5/4/2020,388,11425,2101,68976,80401,30,1187,31,704,5,140,343,87,57,18,441,292,9992,1581,56937,66929,7/21/2020
5/5/2020,436,11861,2878,71854,83715,28,1215,32,736,6,146,333,80,54,16,457,303,10295,1987,58924,69219,7/21/2020
5/6/2020,490,12351,2836,74690,87041,28,1243,44,780,9,155,308,78,54,21,478,341,10636,1941,60865,71501,7/21/2020
5/7/2020,425,12776,2975,77665,90441,36,1279,40,820,5,160,299,70,52,21,499,269,10905,1996,62861,73766,7/21/2020
5/8/2020,360,13136,2602,80267,93403,30,1309,29,849,5,165,295,70,53,22,521,231,11136,1788,64649,75785,7/21/2020
5/9/2020,457,13593,3355,83622,97215,22,1331,21,870,4,169,292,68,51,15,536,285,11421,2318,66967,78388,7/21/2020
5/10/2020,279,13872,2122,85744,99616,19,1350,23,893,6,175,282,69,49,13,549,186,11607,1531,68498,80105,7/21/2020
5/11/2020,259,14131,1861,87605,101736,31,1381,16,909,6,181,291,70,49,15,564,175,11782,1317,69815,81597,7/21/2020
5/12/2020,384,14515,2512,90117,104632,23,1404,18,927,4,185,292,68,48,22,586,217,11999,1624,71439,83438,7/21/2020
5/13/2020,352,14867,3570,93687,108554,22,1426,24,951,1,186,289,69,49,13,599,196,12195,1975,73414,85609,7/21/2020
5/14/2020,329,15196,3397,97084,112280,19,1445,27,978,3,189,278,64,45,15,614,227,12422,2022,75436,87858,7/21/2020
5/15/2020,381,15577,3433,100517,116094,24,1469,41,1019,5,194,256,62,45,13,627,232,12654,1809,77245,89899,7/21/2020
5/16/2020,419,15996,3883,104400,120396,25,1494,12,1031,5,199,264,61,46,15,642,252,12906,1778,79023,91929,7/21/2020
5/17/2020,223,16219,2708,107108,123327,17,1511,7,1038,5,204,269,59,45,10,652,124,13030,1545,80568,93598,7/21/2020
5/18/2020,248,16467,1992,109100,125567,19,1530,15,1053,5,209,268,57,40,18,670,137,13167,1362,81930,95097,7/21/2020
5/19/2020,414,16881,3153,112253,129134,23,1553,31,1084,5,214,255,56,38,11,681,214,13381,1939,83869,97250,7/21/2020
5/20/2020,327,17208,2779,115032,132240,19,1572,23,1107,7,221,244,52,33,22,703,187,13568,1541,85410,98978,7/21/2020
5/21/2020,370,17578,3794,118826,136404,26,1598,15,1122,3,224,252,53,29,20,723,170,13738,1984,87394,101132,7/21/2020
5/22/2020,350,17928,3026,121852,139780,20,1618,29,1151,5,229,238,52,29,10,733,201,13939,1493,88887,102826,7/21/2020
5/23/2020,240,18168,2735,124587,142755,19,1637,11,1162,3,232,243,52,32,13,746,108,14047,1330,90217,104264,7/21/2020
5/24/2020,153,18321,1359,125946,144267,12,1649,14,1176,2,234,239,53,36,8,754,84,14131,766,90983,105114,7/21/2020
5/25/2020,134,18455,1376,127322,145777,12,1661,14,1190,0,234,237,53,34,10,764,70,14201,755,91738,105939,7/21/2020
5/26/2020,284,18739,2609,129931,148670,24,1685,22,1212,5,239,234,48,33,15,779,154,14355,1778,93516,107871,7/21/2020
5/27/2020,276,19015,2121,132052,151067,20,1705,17,1229,3,242,234,50,33,10,789,133,14488,1152,94668,109156,7/21/2020
5/28/2020,346,19361,3377,135429,154790,17,1722,29,1258,4,246,218,47,32,8,797,132,14620,1147,95815,110435,7/21/2020
5/29/2020,418,19779,3973,139402,159181,18,1740,27,1285,6,252,203,43,31,12,809,178,14798,1589,97404,112202,7/21/2020
5/30/2020,211,19990,3964,143366,163356,15,1755,19,1304,4,256,195,40,29,12,821,104,14902,1829,99233,114135,7/21/2020
5/31/2020,148,20138,1741,145107,165245,10,1765,10,1314,0,256,195,43,26,3,824,76,14978,851,100084,115062,7/21/2020
6/1/2020,216,20354,2802,147909,168263,7,1772,13,1327,1,257,188,44,29,5,829,99,15077,1374,101458,116535,7/21/2020
6/2/2020,273,20627,3066,150975,171602,8,1780,9,1336,3,260,184,37,24,10,839,107,15184,1463,102921,118105,7/21/2020
6/3/2020,259,20886,3508,154483,175369,13,1793,18,1354,6,266,173,34,24,11,850,105,15289,1673,104594,119883,7/21/2020
6/4/2020,281,21167,4515,158998,180165,7,1800,25,1379,3,269,152,31,23,11,861,115,15404,2043,106637,122041,7/21/2020
6/5/2020,215,21382,3572,162570,183952,15,1815,12,1391,5,274,150,27,20,9,870,104,15508,1575,108212,123720,7/21/2020
6/6/2020,198,21580,2617,165187,186767,10,1825,7,1398,2,276,151,29,18,6,876,68,15576,1137,109349,124925,7/21/2020
6/7/2020,77,21657,1583,166770,188427,11,1836,7,1405,1,277,154,25,16,4,880,49,15625,759,110108,125733,7/21/2020
6/8/2020,122,21779,1830,168600,190379,15,1851,12,1417,2,279,155,27,17,4,884,44,15669,954,111062,126731,7/21/2020
6/9/2020,224,22003,2637,171237,193240,10,1861,18,1435,0,279,147,28,20,1,885,67,15736,1249,112311,128047,7/21/2020
6/10/2020,210,22213,2971,174208,196421,13,1874,12,1447,2,281,146,24,16,3,888,104,15840,1455,113766,129606,7/21/2020
6/11/2020,195,22408,3489,177697,200105,7,1881,15,1462,1,282,137,25,15,6,894,88,15928,1526,115292,131220,7/21/2020
6/12/2020,213,22621,4465,182162,204783,8,1889,15,1477,1,283,129,23,15,2,896,80,16008,2159,117451,133459,7/21/2020
6/13/2020,105,22726,2806,184968,207694,6,1895,4,1481,0,283,131,19,14,3,899,50,16058,1278,118729,134787,7/21/2020
6/14/2020,78,22804,1916,186884,209688,6,1901,8,1489,1,284,128,19,13,3,902,32,16090,918,119647,135737,7/21/2020
6/15/2020,188,22992,3061,189945,212937,14,1915,14,1503,0,284,128,19,15,4,906,77,16167,1778,121425,137592,7/21/2020
6/16/2020,115,23107,2903,192848,215955,10,1925,10,1513,1,285,127,21,15,8,914,52,16219,1565,122990,139209,7/21/2020
6/17/2020,123,23230,2688,195536,218766,15,1940,20,1533,4,289,118,17,13,6,920,50,16269,1300,124290,140559,7/21/2020
6/18/2020,150,23380,2979,198515,221895,9,1949,13,1546,1,290,113,18,15,7,927,70,16339,1308,125598,141937,7/21/2020
6/19/2020,139,23519,3534,202049,225568,12,1961,11,1557,1,291,113,19,16,3,930,58,16397,1272,126870,143267,7/21/2020
6/20/2020,79,23598,1734,203783,227381,7,1968,9,1566,0,291,111,19,17,4,934,35,16432,726,127596,144028,7/21/2020
6/21/2020,36,23634,1006,204789,228423,7,1975,5,1571,0,291,113,19,17,2,936,27,16459,650,128246,144705,7/21/2020
6/22/2020,142,23776,3678,208467,232243,12,1987,16,1587,0,291,109,18,17,1,937,70,16529,1699,129945,146474,7/21/2020
6/23/2020,161,23937,3740,212207,236144,3,1990,13,1600,3,294,96,17,17,6,943,83,16612,1711,131656,148268,7/21/2020
6/24/2020,119,24056,3372,215579,239635,8,1998,10,1610,1,295,93,16,17,5,948,46,16658,1586,133242,149900,7/21/2020
6/25/2020,102,24158,2855,218434,242592,5,2003,14,1624,1,296,83,15,16,1,949,53,16711,1488,134730,151441,7/21/2020
6/26/2020,93,24251,2439,220873,245124,2,2005,9,1633,0,296,76,16,17,1,950,64,16775,1364,136094,152869,7/21/2020
6/27/2020,84,24335,3194,224067,248402,5,2010,3,1636,1,297,77,15,16,5,955,37,16812,1200,137294,154106,7/21/2020
6/28/2020,37,24372,1444,225511,249883,4,2014,4,1640,4,301,73,13,13,6,961,18,16830,583,137877,154707,7/21/2020
6/29/2020,86,24458,3635,229146,253604,4,2018,5,1645,0,301,72,12,13,1,962,38,16868,1323,139200,156068,7/21/2020
6/30/2020,59,24517,1896,231042,255559,1,2019,5,1650,1,302,67,10,10,3,965,34,16902,981,140181,157083,7/21/2020
7/1/2020,142,24659,3971,235013,259672,7,2026,9,1659,0,302,65,9,10,1,966,79,16981,1895,142076,159057,7/21/2020
7/2/2020,101,24760,2621,237634,262394,5,2031,5,1664,1,303,64,7,8,1,967,56,17037,993,143069,160106,7/21/2020
7/3/2020,42,24802,1858,239492,264294,7,2038,6,1670,0,303,65,6,7,3,970,20,17057,673,143742,160799,7/21/2020
7/4/2020,52,24854,2230,241722,266576,2,2040,4,1674,1,304,62,7,7,2,972,27,17084,953,144695,161779,7/21/2020
7/5/2020,46,24900,2828,244550,269450,1,2041,2,1676,1,305,60,5,6,2,974,22,17106,1375,146070,163176,7/21/2020
7/6/2020,102,25002,2731,247281,272283,6,2047,6,1682,0,305,60,7,8,4,978,60,17166,1514,147584,164750,7/21/2020
7/7/2020,74,25076,3356,250637,275713,5,2052,6,1688,0,305,59,6,7,1,979,47,17213,1523,149107,166320,7/21/2020
7/8/2020,94,25170,3277,253914,279084,3,2055,2,1690,0,305,60,7,7,0,979,55,17268,1344,150451,167719,7/21/2020
7/9/2020,93,25263,3487,257401,282664,7,2062,1,1691,0,305,66,7,7,0,979,48,17316,1562,152013,169329,7/21/2020
7/10/2020,127,25390,4244,261645,287035,4,2066,3,1694,2,307,65,6,6,3,982,77,17393,1977,153990,171383,7/21/2020
7/11/2020,60,25450,2733,264378,289828,6,2072,3,1697,1,308,67,5,5,3,985,36,17429,1257,155247,172676,7/21/2020
7/12/2020,41,25491,1662,266040,291531,1,2073,2,1699,1,309,65,5,4,3,988,29,17458,818,156065,173523,7/21/2020
7/13/2020,91,25582,3055,269095,294677,7,2080,10,1709,0,309,62,5,4,1,989,60,17518,1405,157470,174988,7/21/2020
7/14/2020,65,25647,3176,272271,297918,7,2087,4,1713,0,309,65,4,4,1,990,43,17561,1308,158778,176339,7/21/2020
7/15/2020,120,25767,3927,276198,301965,4,2091,6,1719,0,309,63,4,3,0,990,88,17649,1606,160384,178033,7/21/2020
7/16/2020,99,25866,3490,279688,305554,4,2095,8,1727,0,309,59,4,3,1,991,80,17729,1476,161860,179589,7/21/2020
7/17/2020,148,26014,4017,283705,309719,13,2108,3,1730,1,310,68,3,3,0,991,77,17806,1734,163594,181400,7/21/2020
7/18/2020,64,26078,2880,286585,312663,5,2113,8,1738,1,311,64,3,2,3,994,73,17879,1170,164764,182643,7/21/2020
7/19/2020,74,26152,2419,289004,315156,3,2116,3,1741,0,311,64,4,2,1,995,54,17933,957,165721,183654,7/21/2020
7/20/2020,70,26222,2318,291322,317544,,,,,,,,,,1,996,53,17986,1257,166978,184964,7/21/2020
2/27/2020,0,0,0,0,0,1,1,0,0,0,0,1,0,0,0,0,0,0,0,0,0,7/22/2020
2/28/2020,0,0,0,0,0,0,1,0,0,0,0,1,1,0,0,0,0,0,0,0,0,7/22/2020
2/29/2020,0,0,0,0,0,0,1,0,0,0,0,1,1,0,0,0,0,0,0,0,0,7/22/2020
3/1/2020,2,2,2,2,4,0,1,0,0,0,0,1,1,1,0,0,2,2,2,2,4,7/22/2020
3/2/2020,0,2,1,3,5,1,2,0,0,0,0,2,2,2,0,0,0,2,1,3,5,7/22/2020
3/3/2020,0,2,2,5,7,0,2,0,0,0,0,2,2,2,0,0,0,2,2,5,7,7/22/2020
3/4/2020,0,2,12,17,19,1,3,0,0,0,0,3,2,2,0,0,0,2,10,15,17,7/22/2020
3/5/2020,0,2,4,21,23,0,3,0,0,0,0,3,2,2,0,0,1,3,4,19,22,7/22/2020
3/6/2020,1,3,12,33,36,0,3,0,0,0,0,3,2,2,0,0,0,3,11,30,33,7/22/2020
3/7/2020,0,3,19,52,55,0,3,0,0,0,0,3,2,1,0,0,0,3,19,49,52,7/22/2020
3/8/2020,0,3,18,70,73,0,3,0,0,0,0,3,2,1,0,0,0,3,18,67,70,7/22/2020
3/9/2020,1,4,15,85,89,0,3,0,0,0,0,3,2,1,0,0,1,4,15,82,86,7/22/2020
3/10/2020,2,6,25,110,116,0,3,0,0,0,0,3,2,1,0,0,1,5,23,105,110,7/22/2020
3/11/2020,0,6,34,144,150,1,4,0,0,0,0,4,1,1,0,0,0,5,34,139,144,7/22/2020
3/12/2020,9,15,42,186,201,1,5,0,0,0,0,5,1,1,0,0,8,13,38,177,190,7/22/2020
3/13/2020,6,21,50,236,257,4,9,1,1,0,0,8,1,1,0,0,6,19,48,225,244,7/22/2020
3/14/2020,0,21,90,326,347,0,9,0,1,0,0,8,1,1,0,0,0,19,86,311,330,7/22/2020
3/15/2020,1,22,54,380,402,1,10,0,1,0,0,9,2,1,0,0,1,20,54,365,385,7/22/2020
3/16/2020,2,24,95,475,499,2,12,0,1,0,0,11,2,0,0,0,2,22,92,457,479,7/22/2020
3/17/2020,16,40,162,637,677,6,18,0,1,0,0,17,2,0,0,0,11,33,153,610,643,7/22/2020
3/18/2020,12,52,116,753,805,3,21,0,1,0,0,20,2,0,0,0,11,44,111,721,765,7/22/2020
3/19/2020,17,69,262,1015,1084,2,23,1,2,0,0,21,3,0,1,1,17,61,251,972,1033,7/22/2020
3/20/2020,15,84,197,1212,1296,5,28,0,2,0,0,26,4,0,0,1,13,74,193,1165,1239,7/22/2020
3/21/2020,21,105,126,1338,1443,3,31,2,4,0,0,27,5,0,0,1,14,88,123,1288,1376,7/22/2020
3/22/2020,30,135,282,1620,1755,2,33,0,4,0,0,29,5,0,0,1,25,113,265,1553,1666,7/22/2020
3/23/2020,14,149,169,1789,1938,15,48,1,5,0,0,43,9,3,0,1,16,129,166,1719,1848,7/22/2020
3/24/2020,20,169,243,2032,2201,7,55,0,5,0,0,50,10,4,0,1,19,148,238,1957,2105,7/22/2020
3/25/2020,26,195,183,2215,2410,5,60,1,6,0,0,54,11,3,0,1,28,176,173,2130,2306,7/22/2020
3/26/2020,35,230,181,2396,2626,10,70,5,11,0,0,59,14,5,0,1,41,217,176,2306,2523,7/22/2020
3/27/2020,27,257,215,2611,2868,9,79,1,12,1,1,66,17,6,2,3,31,248,202,2508,2756,7/22/2020
3/28/2020,59,316,260,2871,3187,13,92,3,15,2,3,74,15,6,1,4,63,311,242,2750,3061,7/22/2020
3/29/2020,106,422,356,3227,3649,8,100,4,19,1,4,77,18,8,2,6,105,416,314,3064,3480,7/22/2020
3/30/2020,62,484,222,3449,3933,20,120,5,24,0,4,92,20,11,3,9,78,494,192,3256,3750,7/22/2020
3/31/2020,71,555,369,3818,4373,11,131,7,31,1,5,95,22,13,2,11,73,567,300,3556,4123,7/22/2020
4/1/2020,99,654,699,4517,5171,18,149,7,38,0,5,106,30,15,1,12,100,667,649,4205,4872,7/22/2020
4/2/2020,52,706,477,4994,5700,21,170,6,44,2,7,119,36,21,4,16,62,729,437,4642,5371,7/22/2020
4/3/2020,108,814,775,5769,6583,23,193,7,51,0,7,135,43,25,3,19,100,829,718,5360,6189,7/22/2020
4/4/2020,143,957,660,6429,7386,22,215,4,55,5,12,148,41,30,9,28,137,966,623,5983,6949,7/22/2020
4/5/2020,187,1144,1156,7585,8729,20,235,9,64,1,13,158,44,36,2,30,182,1148,1072,7055,8203,7/22/2020
4/6/2020,218,1362,1707,9292,10654,26,261,7,71,0,13,177,48,40,7,37,206,1354,1581,8636,9990,7/22/2020
4/7/2020,285,1647,1631,10923,12570,20,281,4,75,2,15,191,49,42,5,42,261,1615,1494,10130,11745,7/22/2020
4/8/2020,290,1937,1723,12646,14583,19,300,7,82,6,21,197,49,38,10,52,272,1887,1573,11703,13590,7/22/2020
4/9/2020,284,2221,1521,14167,16388,32,332,9,91,4,25,216,52,40,7,59,278,2165,1366,13069,15234,7/22/2020
4/10/2020,420,2641,2577,16744,19385,29,361,16,107,5,30,224,58,41,11,70,404,2569,2382,15451,18020,7/22/2020
4/11/2020,299,2940,1911,18655,21595,29,390,11,118,2,32,240,61,48,11,81,280,2849,1732,17183,20032,7/22/2020
4/12/2020,315,3255,1674,20329,23584,35,425,13,131,5,37,257,59,49,10,91,289,3138,1453,18636,21774,7/22/2020
4/13/2020,162,3417,938,21267,24684,35,460,13,144,3,40,276,64,54,9,100,187,3325,847,19483,22808,7/22/2020
4/14/2020,289,3706,1788,23055,26761,27,487,17,161,5,45,281,72,53,8,108,265,3590,1564,21047,24637,7/22/2020
4/15/2020,353,4059,1803,24858,28917,31,518,19,180,3,48,290,72,54,17,125,307,3897,1580,22627,26524,7/22/2020
4/16/2020,449,4508,2500,27358,31866,36,554,25,205,6,54,295,72,53,14,139,392,4289,2098,24725,29014,7/22/2020
4/17/2020,308,4816,1823,29181,33997,32,586,20,225,7,61,300,66,45,21,160,291,4580,1487,26212,30792,7/22/2020
4/18/2020,322,5138,1728,30909,36047,26,612,18,243,4,65,304,63,49,15,175,284,4864,1368,27580,32444,7/22/2020
4/19/2020,382,5520,2059,32968,38488,23,635,26,269,1,66,300,65,55,11,186,338,5202,1763,29343,34545,7/22/2020
4/20/2020,396,5916,1909,34877,40793,46,681,29,298,2,68,315,75,56,10,196,377,5579,1597,30940,36519,7/22/2020
4/21/2020,445,6361,2114,36991,43352,45,726,31,329,5,73,324,72,56,18,214,388,5967,1729,32669,38636,7/22/2020
4/22/2020,420,6781,2398,39389,46170,41,767,32,361,5,78,328,73,58,18,232,382,6349,1927,34596,40945,7/22/2020
4/23/2020,482,7263,2471,41860,49123,30,797,28,389,5,83,325,76,62,15,247,420,6769,1896,36492,43261,7/22/2020
4/24/2020,494,7757,3292,45152,52909,35,832,27,416,4,87,329,85,63,15,262,414,7183,2655,39147,46330,7/22/2020
4/25/2020,394,8151,2210,47362,55513,34,866,17,433,5,92,341,85,62,14,276,305,7488,1791,40938,48426,7/22/2020
4/26/2020,316,8467,2314,49676,58143,33,899,15,448,3,95,356,86,59,14,290,277,7765,1891,42829,50594,7/22/2020
4/27/2020,250,8717,1624,51300,60017,29,928,21,469,4,99,360,86,61,10,300,204,7969,1172,44001,51970,7/22/2020
4/28/2020,411,9128,2268,53568,62696,44,972,24,493,3,102,377,88,59,22,322,324,8293,1779,45780,54073,7/22/2020
4/29/2020,476,9604,3351,56919,66523,36,1008,37,530,11,113,365,78,53,18,340,372,8665,2457,48237,56902,7/22/2020
4/30/2020,432,10036,2772,59691,69727,32,1040,38,568,6,119,353,83,57,24,364,348,9013,1966,50203,59216,7/22/2020
5/1/2020,457,10493,3089,62780,73273,51,1091,39,607,3,122,362,84,58,14,378,317,9330,2229,52432,61762,7/22/2020
5/2/2020,260,10753,1927,64707,75460,35,1126,39,646,5,127,353,90,61,24,402,189,9519,1300,53732,63251,7/22/2020
5/3/2020,284,11037,2168,66875,77912,31,1157,27,673,8,135,349,89,61,21,423,181,9700,1614,55346,65046,7/22/2020
5/4/2020,388,11425,2101,68976,80401,30,1187,31,704,5,140,343,87,57,18,441,292,9992,1581,56927,66919,7/22/2020
5/5/2020,436,11861,2878,71854,83715,28,1215,32,736,6,146,333,80,54,16,457,303,10295,1987,58914,69209,7/22/2020
5/6/2020,490,12351,2836,74690,87041,28,1243,44,780,9,155,308,78,54,21,478,341,10636,1941,60855,71491,7/22/2020
5/7/2020,425,12776,2975,77665,90441,36,1279,40,820,5,160,299,70,52,21,499,269,10905,1996,62851,73756,7/22/2020
5/8/2020,360,13136,2603,80268,93404,30,1309,29,849,5,165,295,70,53,22,521,231,11136,1788,64639,75775,7/22/2020
5/9/2020,457,13593,3356,83624,97217,22,1331,21,870,4,169,292,68,51,15,536,285,11421,2318,66957,78378,7/22/2020
5/10/2020,280,13873,2122,85746,99619,19,1350,23,893,6,175,282,69,49,13,549,186,11607,1531,68488,80095,7/22/2020
5/11/2020,259,14132,1861,87607,101739,31,1381,16,909,6,181,291,70,49,15,564,175,11782,1317,69805,81587,7/22/2020
5/12/2020,384,14516,2515,90122,104638,23,1404,18,927,4,185,292,68,48,22,586,217,11999,1624,71429,83428,7/22/2020
5/13/2020,352,14868,3571,93693,108561,22,1426,24,951,1,186,289,69,49,13,599,196,12195,1974,73403,85598,7/22/2020
5/14/2020,330,15198,3410,97103,112301,19,1445,27,978,3,189,278,64,45,15,614,227,12422,2022,75425,87847,7/22/2020
5/15/2020,384,15582,3461,100564,116146,24,1469,41,1019,5,194,256,62,45,13,627,232,12654,1820,77245,89899,7/22/2020
5/16/2020,425,16007,3940,104504,120511,25,1494,12,1031,5,199,264,61,46,15,642,252,12906,1815,79060,91966,7/22/2020
5/17/2020,229,16236,2750,107254,123490,17,1511,7,1038,5,204,269,59,45,10,652,124,13030,1569,80629,93659,7/22/2020
5/18/2020,250,16486,1997,109251,125737,19,1530,15,1053,5,209,268,57,40,18,670,137,13167,1367,81996,95163,7/22/2020
5/19/2020,416,16902,3178,112429,129331,23,1553,31,1084,5,214,255,56,38,11,681,214,13381,1962,83958,97339,7/22/2020
5/20/2020,327,17229,2798,115227,132456,19,1572,23,1107,7,221,244,52,33,22,703,187,13568,1553,85511,99079,7/22/2020
5/21/2020,370,17599,3797,119024,136623,26,1598,15,1122,3,224,252,53,29,20,723,170,13738,1987,87498,101236,7/22/2020
5/22/2020,350,17949,3026,122050,139999,20,1618,29,1151,5,229,238,52,29,10,733,201,13939,1492,88990,102929,7/22/2020
5/23/2020,240,18189,2735,124785,142974,19,1637,11,1162,3,232,243,52,32,13,746,108,14047,1329,90319,104366,7/22/2020
5/24/2020,153,18342,1359,126144,144486,12,1649,14,1176,2,234,239,53,36,8,754,84,14131,766,91085,105216,7/22/2020
5/25/2020,134,18476,1376,127520,145996,12,1661,14,1190,0,234,237,53,34,10,764,70,14201,755,91840,106041,7/22/2020
5/26/2020,284,18760,2609,130129,148889,24,1685,22,1212,5,239,234,48,33,15,779,154,14355,1778,93618,107973,7/22/2020
5/27/2020,276,19036,2121,132250,151286,20,1705,17,1229,3,242,234,50,33,10,789,133,14488,1152,94770,109258,7/22/2020
5/28/2020,346,19382,3377,135627,155009,17,1722,29,1258,4,246,218,47,32,8,797,132,14620,1146,95916,110536,7/22/2020
5/29/2020,418,19800,3973,139600,159400,18,1740,27,1285,6,252,203,43,31,12,809,178,14798,1589,97505,112303,7/22/2020
5/30/2020,211,20011,3964,143564,163575,15,1755,19,1304,4,256,195,40,29,12,821,104,14902,1829,99334,114236,7/22/2020
5/31/2020,148,20159,1741,145305,165464,10,1765,10,1314,0,256,195,43,26,3,824,76,14978,851,100185,115163,7/22/2020
6/1/2020,216,20375,2802,148107,168482,7,1772,13,1327,1,257,188,44,29,5,829,99,15077,1372,101557,116634,7/22/2020
6/2/2020,273,20648,3066,151173,171821,8,1780,9,1336,3,260,184,37,24,10,839,107,15184,1463,103020,118204,7/22/2020
6/3/2020,259,20907,3508,154681,175588,13,1793,18,1354,6,266,173,34,24,11,850,105,15289,1673,104693,119982,7/22/2020
6/4/2020,281,21188,4515,159196,180384,7,1800,25,1379,3,269,152,31,23,11,861,114,15403,2041,106734,122137,7/22/2020
6/5/2020,215,21403,3572,162768,184171,15,1815,12,1391,5,274,150,27,20,9,870,104,15507,1572,108306,123813,7/22/2020
6/6/2020,198,21601,2617,165385,186986,10,1825,7,1398,2,276,151,29,18,6,876,68,15575,1135,109441,125016,7/22/2020
6/7/2020,77,21678,1583,166968,188646,11,1836,7,1405,1,277,154,25,16,4,880,49,15624,758,110199,125823,7/22/2020
6/8/2020,122,21800,1830,168798,190598,15,1851,12,1417,2,279,155,27,17,4,884,44,15668,954,111153,126821,7/22/2020
6/9/2020,224,22024,2637,171435,193459,10,1861,18,1435,0,279,147,28,20,1,885,67,15735,1249,112402,128137,7/22/2020
6/10/2020,210,22234,2972,174407,196641,13,1874,12,1447,2,281,146,24,16,3,888,104,15839,1456,113858,129697,7/22/2020
6/11/2020,195,22429,3489,177896,200325,7,1881,15,1462,1,282,137,25,15,6,894,88,15927,1526,115384,131311,7/22/2020
6/12/2020,213,22642,4465,182361,205003,8,1889,15,1477,1,283,129,23,15,2,896,80,16007,2158,117542,133549,7/22/2020
6/13/2020,105,22747,2806,185167,207914,6,1895,4,1481,0,283,131,19,14,3,899,50,16057,1278,118820,134877,7/22/2020
6/14/2020,78,22825,1916,187083,209908,6,1901,8,1489,1,284,128,19,13,3,902,32,16089,917,119737,135826,7/22/2020
6/15/2020,188,23013,3061,190144,213157,14,1915,14,1503,0,284,128,19,15,4,906,77,16166,1777,121514,137680,7/22/2020
6/16/2020,115,23128,2903,193047,216175,10,1925,10,1513,1,285,127,21,15,8,914,52,16218,1565,123079,139297,7/22/2020
6/17/2020,123,23251,2688,195735,218986,15,1940,20,1533,4,289,118,17,13,6,920,50,16268,1300,124379,140647,7/22/2020
6/18/2020,150,23401,2979,198714,222115,9,1949,13,1546,1,290,113,18,15,7,927,70,16338,1308,125687,142025,7/22/2020
6/19/2020,139,23540,3534,202248,225788,12,1961,11,1557,1,291,113,19,16,3,930,58,16396,1272,126959,143355,7/22/2020
6/20/2020,79,23619,1734,203982,227601,7,1968,9,1566,0,291,111,19,17,4,934,35,16431,726,127685,144116,7/22/2020
6/21/2020,36,23655,1006,204988,228643,7,1975,5,1571,0,291,113,19,17,2,936,27,16458,650,128335,144793,7/22/2020
6/22/2020,142,23797,3678,208666,232463,12,1987,16,1587,0,291,109,18,17,1,937,70,16528,1697,130032,146560,7/22/2020
6/23/2020,161,23958,3740,212406,236364,3,1990,13,1600,3,294,96,17,17,6,943,83,16611,1711,131743,148354,7/22/2020
6/24/2020,119,24077,3372,215778,239855,8,1998,10,1610,1,295,93,16,17,5,948,46,16657,1585,133328,149985,7/22/2020
6/25/2020,102,24179,2856,218634,242813,5,2003,14,1624,1,296,83,15,16,1,949,53,16710,1489,134817,151527,7/22/2020
6/26/2020,93,24272,2439,221073,245345,2,2005,9,1633,0,296,76,16,17,1,950,64,16774,1365,136182,152956,7/22/2020
6/27/2020,84,24356,3194,224267,248623,5,2010,3,1636,1,297,77,15,16,5,955,38,16812,1200,137382,154194,7/22/2020
6/28/2020,37,24393,1444,225711,250104,4,2014,4,1640,4,301,73,13,13,6,961,18,16830,583,137965,154795,7/22/2020
6/29/2020,86,24479,3635,229346,253825,4,2018,5,1645,0,301,72,12,13,1,962,38,16868,1323,139288,156156,7/22/2020
6/30/2020,59,24538,1896,231242,255780,1,2019,5,1650,1,302,67,10,10,3,965,34,16902,980,140268,157170,7/22/2020
7/1/2020,144,24682,3986,235228,259910,7,2026,9,1659,0,302,65,9,10,1,966,81,16983,1897,142165,159148,7/22/2020
7/2/2020,99,24781,2609,237837,262618,5,2031,5,1664,1,303,64,7,8,1,967,54,17037,989,143154,160191,7/22/2020
7/3/2020,42,24823,1859,239696,264519,7,2038,6,1670,0,303,65,6,7,3,970,20,17057,672,143826,160883,7/22/2020
7/4/2020,52,24875,2230,241926,266801,2,2040,4,1674,1,304,62,7,7,2,972,27,17084,954,144780,161864,7/22/2020
7/5/2020,46,24921,2828,244754,269675,1,2041,2,1676,1,305,60,5,6,2,974,22,17106,1375,146155,163261,7/22/2020
7/6/2020,102,25023,2726,247480,272503,6,2047,6,1682,0,305,60,7,8,4,978,60,17166,1513,147668,164834,7/22/2020
7/7/2020,74,25097,3354,250834,275931,5,2052,6,1688,0,305,59,6,7,1,979,47,17213,1520,149188,166401,7/22/2020
7/8/2020,94,25191,3274,254108,279299,3,2055,2,1690,0,305,60,7,7,0,979,55,17268,1340,150528,167796,7/22/2020
7/9/2020,93,25284,3481,257589,282873,7,2062,1,1691,0,305,66,7,7,0,979,48,17316,1558,152086,169402,7/22/2020
7/10/2020,125,25409,4239,261828,287237,5,2067,3,1694,2,307,66,6,6,3,982,77,17393,1972,154058,171451,7/22/2020
7/11/2020,59,25468,2730,264558,290026,6,2073,3,1697,1,308,68,5,5,3,985,35,17428,1256,155314,172742,7/22/2020
7/12/2020,42,25510,1662,266220,291730,1,2074,2,1699,1,309,66,5,4,3,988,30,17458,817,156131,173589,7/22/2020
7/13/2020,84,25594,3052,269272,294866,7,2081,10,1709,0,309,63,5,4,1,989,57,17515,1402,157533,175048,7/22/2020
7/14/2020,69,25663,3170,272442,298105,7,2088,4,1713,0,309,66,4,4,1,990,46,17561,1306,158839,176400,7/22/2020
7/15/2020,120,25783,3923,276365,302148,4,2092,6,1719,0,309,64,4,3,0,990,90,17651,1604,160443,178094,7/22/2020
7/16/2020,99,25882,3489,279854,305736,5,2097,8,1727,0,309,61,4,3,1,991,76,17727,1472,161915,179642,7/22/2020
7/17/2020,149,26031,4010,283864,309895,14,2111,3,1730,1,310,71,3,3,0,991,78,17805,1733,163648,181453,7/22/2020
7/18/2020,66,26097,2965,286829,312926,5,2116,9,1739,1,311,66,3,2,3,994,69,17874,1233,164881,182755,7/22/2020
7/19/2020,79,26176,2533,289362,315538,4,2120,3,1742,0,311,67,4,2,1,995,57,17931,1042,165923,183854,7/22/2020
7/20/2020,71,26247,2454,291816,318063,7,2127,7,1749,0,311,67,5,3,1,996,55,17986,1348,167271,185257,7/22/2020
7/21/2020,103,26350,3706,295522,321872,,,,,,,,,,1,997,76,18062,1523,168794,186856,7/22/2020
2/27/2020,0,0,0,0,0,1,1,0,0,0,0,1,0,0,0,0,0,0,0,0,0,7/23/2020
2/28/2020,0,0,0,0,0,0,1,0,0,0,0,1,1,0,0,0,0,0,0,0,0,7/23/2020
2/29/2020,0,0,0,0,0,0,1,0,0,0,0,1,1,0,0,0,0,0,0,0,0,7/23/2020
3/1/2020,2,2,2,2,4,0,1,0,0,0,0,1,1,1,0,0,2,2,2,2,4,7/23/2020
3/2/2020,0,2,1,3,5,1,2,0,0,0,0,2,2,2,0,0,0,2,1,3,5,7/23/2020
3/3/2020,0,2,2,5,7,0,2,0,0,0,0,2,2,2,0,0,0,2,2,5,7,7/23/2020
3/4/2020,0,2,12,17,19,1,3,0,0,0,0,3,2,2,0,0,0,2,10,15,17,7/23/2020
3/5/2020,0,2,4,21,23,0,3,0,0,0,0,3,2,2,0,0,1,3,4,19,22,7/23/2020
3/6/2020,1,3,12,33,36,0,3,0,0,0,0,3,2,2,0,0,0,3,11,30,33,7/23/2020
3/7/2020,0,3,19,52,55,0,3,0,0,0,0,3,2,1,0,0,0,3,19,49,52,7/23/2020
3/8/2020,0,3,18,70,73,0,3,0,0,0,0,3,2,1,0,0,0,3,18,67,70,7/23/2020
3/9/2020,1,4,15,85,89,0,3,0,0,0,0,3,2,1,0,0,1,4,15,82,86,7/23/2020
3/10/2020,2,6,25,110,116,0,3,0,0,0,0,3,2,1,0,0,1,5,23,105,110,7/23/2020
3/11/2020,0,6,34,144,150,1,4,0,0,0,0,4,1,1,0,0,0,5,34,139,144,7/23/2020
3/12/2020,9,15,42,186,201,1,5,0,0,0,0,5,1,1,0,0,8,13,38,177,190,7/23/2020
3/13/2020,6,21,50,236,257,4,9,1,1,0,0,8,1,1,0,0,6,19,48,225,244,7/23/2020
3/14/2020,0,21,90,326,347,0,9,0,1,0,0,8,1,1,0,0,0,19,86,311,330,7/23/2020
3/15/2020,1,22,54,380,402,1,10,0,1,0,0,9,2,1,0,0,1,20,54,365,385,7/23/2020
3/16/2020,2,24,95,475,499,2,12,0,1,0,0,11,2,0,0,0,2,22,92,457,479,7/23/2020
3/17/2020,16,40,162,637,677,6,18,0,1,0,0,17,2,0,0,0,11,33,153,610,643,7/23/2020
3/18/2020,12,52,116,753,805,3,21,0,1,0,0,20,2,0,0,0,11,44,111,721,765,7/23/2020
3/19/2020,17,69,262,1015,1084,2,23,1,2,0,0,21,3,0,1,1,17,61,251,972,1033,7/23/2020
3/20/2020,15,84,197,1212,1296,5,28,0,2,0,0,26,4,0,0,1,13,74,193,1165,1239,7/23/2020
3/21/2020,21,105,126,1338,1443,3,31,2,4,0,0,27,5,0,0,1,14,88,123,1288,1376,7/23/2020
3/22/2020,30,135,282,1620,1755,2,33,0,4,0,0,29,5,0,0,1,25,113,265,1553,1666,7/23/2020
3/23/2020,14,149,169,1789,1938,15,48,1,5,0,0,43,9,3,0,1,16,129,166,1719,1848,7/23/2020
3/24/2020,20,169,243,2032,2201,7,55,0,5,0,0,50,10,4,0,1,19,148,238,1957,2105,7/23/2020
3/25/2020,26,195,183,2215,2410,5,60,1,6,0,0,54,11,3,0,1,28,176,173,2130,2306,7/23/2020
3/26/2020,35,230,181,2396,2626,10,70,5,11,0,0,59,14,5,0,1,41,217,176,2306,2523,7/23/2020
3/27/2020,27,257,215,2611,2868,9,79,1,12,1,1,66,17,6,2,3,31,248,202,2508,2756,7/23/2020
3/28/2020,59,316,260,2871,3187,13,92,3,15,2,3,74,15,6,1,4,63,311,242,2750,3061,7/23/2020
3/29/2020,106,422,356,3227,3649,8,100,4,19,1,4,77,18,8,2,6,105,416,314,3064,3480,7/23/2020
3/30/2020,62,484,222,3449,3933,20,120,5,24,0,4,92,20,11,3,9,78,494,192,3256,3750,7/23/2020
3/31/2020,71,555,369,3818,4373,11,131,7,31,1,5,95,22,13,2,11,73,567,300,3556,4123,7/23/2020
4/1/2020,99,654,699,4517,5171,18,149,7,38,0,5,106,30,15,1,12,100,667,649,4205,4872,7/23/2020
4/2/2020,52,706,477,4994,5700,21,170,6,44,2,7,119,36,21,4,16,62,729,436,4641,5370,7/23/2020
4/3/2020,108,814,775,5769,6583,23,193,7,51,0,7,135,43,25,3,19,100,829,718,5359,6188,7/23/2020
4/4/2020,143,957,660,6429,7386,22,215,4,55,5,12,148,41,30,9,28,137,966,623,5982,6948,7/23/2020
4/5/2020,187,1144,1156,7585,8729,20,235,9,64,1,13,158,44,36,2,30,182,1148,1072,7054,8202,7/23/2020
4/6/2020,218,1362,1707,9292,10654,26,261,7,71,0,13,177,48,40,7,37,206,1354,1580,8634,9988,7/23/2020
4/7/2020,285,1647,1631,10923,12570,20,281,4,75,2,15,191,49,42,5,42,260,1614,1494,10128,11742,7/23/2020
4/8/2020,290,1937,1723,12646,14583,19,300,7,82,6,21,197,49,38,10,52,272,1886,1573,11701,13587,7/23/2020
4/9/2020,284,2221,1521,14167,16388,32,332,9,91,4,25,216,52,40,7,59,278,2164,1366,13067,15231,7/23/2020
4/10/2020,420,2641,2577,16744,19385,29,361,16,107,5,30,224,58,41,11,70,404,2568,2382,15449,18017,7/23/2020
4/11/2020,299,2940,1911,18655,21595,29,390,11,118,2,32,240,61,48,11,81,280,2848,1731,17180,20028,7/23/2020
4/12/2020,315,3255,1674,20329,23584,35,425,13,131,5,37,257,59,49,10,91,289,3137,1453,18633,21770,7/23/2020
4/13/2020,162,3417,938,21267,24684,35,460,13,144,3,40,276,64,54,9,100,187,3324,847,19480,22804,7/23/2020
4/14/2020,289,3706,1788,23055,26761,27,487,17,161,5,45,281,72,53,8,108,265,3589,1563,21043,24632,7/23/2020
4/15/2020,353,4059,1803,24858,28917,31,518,19,180,3,48,290,72,54,17,125,307,3896,1579,22622,26518,7/23/2020
4/16/2020,449,4508,2500,27358,31866,36,554,25,205,6,54,295,72,53,14,139,392,4288,2098,24720,29008,7/23/2020
4/17/2020,308,4816,1823,29181,33997,32,586,20,225,7,61,300,66,45,21,160,291,4579,1484,26204,30783,7/23/2020
4/18/2020,322,5138,1728,30909,36047,26,612,18,243,4,65,304,63,49,15,175,284,4863,1364,27568,32431,7/23/2020
4/19/2020,382,5520,2059,32968,38488,23,635,26,269,1,66,300,65,55,11,186,338,5201,1763,29331,34532,7/23/2020
4/20/2020,396,5916,1909,34877,40793,46,681,29,298,2,68,315,75,56,10,196,377,5578,1597,30928,36506,7/23/2020
4/21/2020,445,6361,2114,36991,43352,45,726,31,329,5,73,324,72,56,18,214,388,5966,1728,32656,38622,7/23/2020
4/22/2020,420,6781,2398,39389,46170,41,767,32,361,5,78,328,73,58,18,232,382,6348,1927,34583,40931,7/23/2020
4/23/2020,482,7263,2471,41860,49123,30,797,28,389,5,83,325,76,62,15,247,420,6768,1896,36479,43247,7/23/2020
4/24/2020,494,7757,3292,45152,52909,35,832,27,416,4,87,329,85,63,15,262,414,7182,2655,39134,46316,7/23/2020
4/25/2020,394,8151,2210,47362,55513,34,866,17,433,5,92,341,85,62,14,276,305,7487,1791,40925,48412,7/23/2020
4/26/2020,316,8467,2314,49676,58143,33,899,15,448,3,95,356,86,59,14,290,277,7764,1891,42816,50580,7/23/2020
4/27/2020,250,8717,1624,51300,60017,29,928,21,469,4,99,360,86,61,10,300,204,7968,1172,43988,51956,7/23/2020
4/28/2020,411,9128,2268,53568,62696,44,972,24,493,3,102,377,88,59,22,322,324,8292,1779,45767,54059,7/23/2020
4/29/2020,476,9604,3351,56919,66523,36,1008,37,530,11,113,365,78,53,18,340,372,8664,2456,48223,56887,7/23/2020
4/30/2020,432,10036,2772,59691,69727,32,1040,38,568,6,119,353,83,57,24,364,348,9012,1965,50188,59200,7/23/2020
5/1/2020,457,10493,3089,62780,73273,51,1091,39,607,3,122,362,84,58,14,378,317,9329,2229,52417,61746,7/23/2020
5/2/2020,260,10753,1927,64707,75460,35,1126,39,646,5,127,353,90,61,24,402,189,9518,1299,53716,63234,7/23/2020
5/3/2020,284,11037,2168,66875,77912,31,1157,27,673,8,135,349,89,61,21,423,181,9699,1613,55329,65028,7/23/2020
5/4/2020,388,11425,2101,68976,80401,30,1187,31,704,5,140,343,87,57,18,441,292,9991,1581,56910,66901,7/23/2020
5/5/2020,436,11861,2878,71854,83715,28,1215,32,736,6,146,333,80,54,16,457,303,10294,1986,58896,69190,7/23/2020
5/6/2020,490,12351,2836,74690,87041,28,1243,44,780,9,155,308,78,54,21,478,341,10635,1940,60836,71471,7/23/2020
5/7/2020,425,12776,2975,77665,90441,36,1279,40,820,5,160,299,70,52,21,499,269,10904,1996,62832,73736,7/23/2020
5/8/2020,360,13136,2603,80268,93404,30,1309,29,849,5,165,295,70,53,22,521,231,11135,1788,64620,75755,7/23/2020
5/9/2020,457,13593,3356,83624,97217,22,1331,21,870,4,169,292,68,51,15,536,285,11420,2318,66938,78358,7/23/2020
5/10/2020,280,13873,2122,85746,99619,19,1350,23,893,6,175,282,69,49,13,549,186,11606,1531,68469,80075,7/23/2020
5/11/2020,259,14132,1861,87607,101739,31,1381,16,909,6,181,291,70,49,15,564,175,11781,1317,69786,81567,7/23/2020
5/12/2020,384,14516,2515,90122,104638,23,1404,18,927,4,185,292,68,48,22,586,217,11998,1624,71410,83408,7/23/2020
5/13/2020,352,14868,3571,93693,108561,22,1426,24,951,1,186,289,69,49,13,599,196,12194,1974,73384,85578,7/23/2020
5/14/2020,330,15198,3410,97103,112301,19,1445,27,978,3,189,278,64,45,15,614,227,12421,2022,75406,87827,7/23/2020
5/15/2020,384,15582,3461,100564,116146,24,1469,41,1019,5,194,256,62,45,13,627,232,12653,1820,77226,89879,7/23/2020
5/16/2020,425,16007,3940,104504,120511,25,1494,12,1031,5,199,264,61,46,15,642,252,12905,1815,79041,91946,7/23/2020
5/17/2020,229,16236,2750,107254,123490,17,1511,7,1038,5,204,269,59,45,10,652,124,13029,1569,80610,93639,7/23/2020
5/18/2020,250,16486,1997,109251,125737,19,1530,15,1053,5,209,268,57,40,18,670,137,13166,1367,81977,95143,7/23/2020
5/19/2020,416,16902,3178,112429,129331,23,1553,31,1084,5,214,255,56,38,11,681,214,13380,1962,83939,97319,7/23/2020
5/20/2020,327,17229,2798,115227,132456,19,1572,23,1107,7,221,244,52,33,22,703,187,13567,1551,85490,99057,7/23/2020
5/21/2020,370,17599,3797,119024,136623,26,1598,15,1122,3,224,252,53,29,20,723,170,13737,1987,87477,101214,7/23/2020
5/22/2020,350,17949,3026,122050,139999,20,1618,29,1151,5,229,238,52,29,10,733,201,13938,1492,88969,102907,7/23/2020
5/23/2020,240,18189,2735,124785,142974,19,1637,11,1162,3,232,243,52,32,13,746,108,14046,1329,90298,104344,7/23/2020
5/24/2020,153,18342,1359,126144,144486,12,1649,14,1176,2,234,239,53,36,8,754,84,14130,766,91064,105194,7/23/2020
5/25/2020,134,18476,1376,127520,145996,12,1661,14,1190,0,234,237,53,34,10,764,70,14200,755,91819,106019,7/23/2020
5/26/2020,284,18760,2609,130129,148889,24,1685,22,1212,5,239,234,48,33,15,779,154,14354,1778,93597,107951,7/23/2020
5/27/2020,276,19036,2121,132250,151286,20,1705,17,1229,3,242,234,50,33,10,789,133,14487,1152,94749,109236,7/23/2020
5/28/2020,346,19382,3377,135627,155009,17,1722,29,1258,4,246,218,47,32,8,797,132,14619,1146,95895,110514,7/23/2020
5/29/2020,418,19800,3973,139600,159400,18,1740,27,1285,6,252,203,43,31,12,809,178,14797,1589,97484,112281,7/23/2020
5/30/2020,211,20011,3964,143564,163575,15,1755,19,1304,4,256,195,40,29,12,821,104,14901,1828,99312,114213,7/23/2020
5/31/2020,148,20159,1741,145305,165464,10,1765,10,1314,0,256,195,43,26,3,824,76,14977,851,100163,115140,7/23/2020
6/1/2020,216,20375,2802,148107,168482,7,1772,13,1327,1,257,188,44,29,5,829,99,15076,1372,101535,116611,7/23/2020
6/2/2020,273,20648,3066,151173,171821,8,1780,9,1336,3,260,184,37,24,10,839,107,15183,1463,102998,118181,7/23/2020
6/3/2020,259,20907,3508,154681,175588,13,1793,18,1354,6,266,173,34,24,11,850,105,15288,1673,104671,119959,7/23/2020
6/4/2020,281,21188,4515,159196,180384,7,1800,25,1379,3,269,152,31,23,11,861,114,15402,2041,106712,122114,7/23/2020
6/5/2020,215,21403,3572,162768,184171,15,1815,12,1391,5,274,150,27,20,9,870,104,15506,1572,108284,123790,7/23/2020
6/6/2020,198,21601,2617,165385,186986,10,1825,7,1398,2,276,151,29,18,6,876,68,15574,1135,109419,124993,7/23/2020
6/7/2020,77,21678,1583,166968,188646,11,1836,7,1405,1,277,154,25,16,4,880,49,15623,758,110177,125800,7/23/2020
6/8/2020,122,21800,1830,168798,190598,15,1851,12,1417,2,279,155,27,17,4,884,44,15667,954,111131,126798,7/23/2020
6/9/2020,224,22024,2637,171435,193459,10,1861,18,1435,0,279,147,28,20,1,885,67,15734,1249,112380,128114,7/23/2020
6/10/2020,210,22234,2972,174407,196641,13,1874,12,1447,2,281,146,24,16,3,888,104,15838,1456,113836,129674,7/23/2020
6/11/2020,195,22429,3489,177896,200325,7,1881,15,1462,1,282,137,25,15,6,894,88,15926,1526,115362,131288,7/23/2020
6/12/2020,213,22642,4465,182361,205003,8,1889,15,1477,1,283,129,23,15,2,896,80,16006,2158,117520,133526,7/23/2020
6/13/2020,105,22747,2806,185167,207914,6,1895,4,1481,0,283,131,19,14,3,899,50,16056,1278,118798,134854,7/23/2020
6/14/2020,78,22825,1916,187083,209908,6,1901,8,1489,1,284,128,19,13,3,902,32,16088,917,119715,135803,7/23/2020
6/15/2020,188,23013,3061,190144,213157,14,1915,14,1503,0,284,128,19,15,4,906,77,16165,1777,121492,137657,7/23/2020
6/16/2020,115,23128,2903,193047,216175,10,1925,10,1513,1,285,127,21,15,8,914,52,16217,1565,123057,139274,7/23/2020
6/17/2020,123,23251,2688,195735,218986,15,1940,20,1533,4,289,118,17,13,6,920,50,16267,1299,124356,140623,7/23/2020
6/18/2020,150,23401,2979,198714,222115,9,1949,13,1546,1,290,113,18,15,7,927,70,16337,1308,125664,142001,7/23/2020
6/19/2020,139,23540,3534,202248,225788,12,1961,11,1557,1,291,113,19,16,3,930,58,16395,1272,126936,143331,7/23/2020
6/20/2020,79,23619,1734,203982,227601,7,1968,9,1566,0,291,111,19,17,4,934,35,16430,726,127662,144092,7/23/2020
6/21/2020,36,23655,1006,204988,228643,7,1975,5,1571,0,291,113,19,17,2,936,27,16457,650,128312,144769,7/23/2020
6/22/2020,142,23797,3678,208666,232463,12,1987,16,1587,0,291,109,18,17,1,937,70,16527,1697,130009,146536,7/23/2020
6/23/2020,161,23958,3740,212406,236364,3,1990,13,1600,3,294,96,17,17,6,943,83,16610,1711,131720,148330,7/23/2020
6/24/2020,119,24077,3372,215778,239855,8,1998,10,1610,1,295,93,16,17,5,948,46,16656,1585,133305,149961,7/23/2020
6/25/2020,102,24179,2856,218634,242813,5,2003,14,1624,1,296,83,15,16,1,949,53,16709,1489,134794,151503,7/23/2020
6/26/2020,93,24272,2439,221073,245345,2,2005,9,1633,0,296,76,16,17,1,950,64,16773,1365,136159,152932,7/23/2020
6/27/2020,84,24356,3194,224267,248623,5,2010,3,1636,1,297,77,15,16,5,955,37,16810,1200,137359,154169,7/23/2020
6/28/2020,37,24393,1444,225711,250104,4,2014,4,1640,4,301,73,13,13,6,961,18,16828,583,137942,154770,7/23/2020
6/29/2020,86,24479,3635,229346,253825,4,2018,5,1645,0,301,72,12,13,1,962,38,16866,1323,139265,156131,7/23/2020
6/30/2020,59,24538,1896,231242,255780,1,2019,5,1650,1,302,67,10,10,3,965,34,16900,980,140245,157145,7/23/2020
7/1/2020,144,24682,3986,235228,259910,7,2026,9,1659,0,302,65,9,10,1,966,81,16981,1897,142142,159123,7/23/2020
7/2/2020,99,24781,2609,237837,262618,5,2031,5,1664,1,303,64,7,8,1,967,54,17035,989,143131,160166,7/23/2020
7/3/2020,42,24823,1859,239696,264519,7,2038,6,1670,0,303,65,6,7,3,970,20,17055,672,143803,160858,7/23/2020
7/4/2020,52,24875,2230,241926,266801,2,2040,4,1674,1,304,62,7,7,2,972,27,17082,954,144757,161839,7/23/2020
7/5/2020,46,24921,2828,244754,269675,1,2041,2,1676,1,305,60,5,6,2,974,22,17104,1375,146132,163236,7/23/2020
7/6/2020,102,25023,2726,247480,272503,6,2047,6,1682,0,305,60,7,8,4,978,60,17164,1512,147644,164808,7/23/2020
7/7/2020,74,25097,3354,250834,275931,5,2052,6,1688,0,305,59,6,7,1,979,47,17211,1520,149164,166375,7/23/2020
7/8/2020,94,25191,3274,254108,279299,3,2055,2,1690,0,305,60,7,7,0,979,55,17266,1340,150504,167770,7/23/2020
7/9/2020,93,25284,3481,257589,282873,7,2062,1,1691,0,305,66,7,7,0,979,48,17314,1556,152060,169374,7/23/2020
7/10/2020,125,25409,4239,261828,287237,5,2067,3,1694,2,307,66,6,6,3,982,77,17391,1972,154032,171423,7/23/2020
7/11/2020,59,25468,2730,264558,290026,6,2073,3,1697,1,308,68,5,5,3,985,35,17426,1255,155287,172713,7/23/2020
7/12/2020,42,25510,1662,266220,291730,1,2074,2,1699,1,309,66,5,4,3,988,30,17456,817,156104,173560,7/23/2020
7/13/2020,84,25594,3052,269272,294866,7,2081,10,1709,0,309,63,5,4,1,989,57,17513,1402,157506,175019,7/23/2020
7/14/2020,69,25663,3170,272442,298105,7,2088,4,1713,0,309,66,4,4,1,990,45,17558,1306,158812,176370,7/23/2020
7/15/2020,120,25783,3923,276365,302148,4,2092,6,1719,0,309,64,4,3,0,990,91,17649,1602,160414,178063,7/23/2020
7/16/2020,99,25882,3489,279854,305736,5,2097,8,1727,0,309,61,4,3,1,991,76,17725,1472,161886,179611,7/23/2020
7/17/2020,149,26031,4011,283865,309896,14,2111,3,1730,1,310,71,3,3,0,991,86,17811,1732,163618,181429,7/23/2020
7/18/2020,78,26109,3094,286959,313068,5,2116,9,1739,1,311,66,3,2,4,995,70,17881,1333,164951,182832,7/23/2020
7/19/2020,79,26188,2536,289495,315683,4,2120,3,1742,0,311,67,4,2,2,997,56,17937,1045,165996,183933,7/23/2020
7/20/2020,71,26259,2463,291958,318217,8,2128,7,1749,0,311,68,5,3,2,999,57,17994,1354,167350,185344,7/23/2020
7/21/2020,117,26376,4036,295994,322370,9,2137,10,1759,0,311,67,7,4,1,1000,78,18072,1756,169106,187178,7/23/2020
7/22/2020,113,26489,3496,299490,325979,,,,,,,,,,1,1001,76,18148,2085,171191,189339,7/23/2020
2/27/2020,0,0,0,0,0,1,1,0,0,0,0,1,0,0,0,0,0,0,0,0,0,7/24/2020
2/28/2020,0,0,0,0,0,0,1,0,0,0,0,1,1,0,0,0,0,0,0,0,0,7/24/2020
2/29/2020,0,0,0,0,0,0,1,0,0,0,0,1,1,0,0,0,0,0,0,0,0,7/24/2020
3/1/2020,2,2,2,2,4,0,1,0,0,0,0,1,1,1,0,0,2,2,2,2,4,7/24/2020
3/2/2020,0,2,1,3,5,1,2,0,0,0,0,2,2,2,0,0,0,2,1,3,5,7/24/2020
3/3/2020,0,2,2,5,7,0,2,0,0,0,0,2,2,2,0,0,0,2,2,5,7,7/24/2020
3/4/2020,0,2,12,17,19,1,3,0,0,0,0,3,2,2,0,0,0,2,10,15,17,7/24/2020
3/5/2020,0,2,4,21,23,0,3,0,0,0,0,3,2,2,0,0,1,3,4,19,22,7/24/2020
3/6/2020,1,3,12,33,36,0,3,0,0,0,0,3,2,2,0,0,0,3,11,30,33,7/24/2020
3/7/2020,0,3,19,52,55,0,3,0,0,0,0,3,2,1,0,0,0,3,19,49,52,7/24/2020
3/8/2020,0,3,18,70,73,0,3,0,0,0,0,3,2,1,0,0,0,3,18,67,70,7/24/2020
3/9/2020,1,4,15,85,89,0,3,0,0,0,0,3,2,1,0,0,1,4,15,82,86,7/24/2020
3/10/2020,2,6,25,110,116,0,3,0,0,0,0,3,2,1,0,0,1,5,23,105,110,7/24/2020
3/11/2020,0,6,34,144,150,1,4,0,0,0,0,4,1,1,0,0,0,5,34,139,144,7/24/2020
3/12/2020,9,15,42,186,201,1,5,0,0,0,0,5,1,1,0,0,8,13,38,177,190,7/24/2020
3/13/2020,6,21,50,236,257,4,9,1,1,0,0,8,1,1,0,0,6,19,48,225,244,7/24/2020
3/14/2020,0,21,90,326,347,0,9,0,1,0,0,8,1,1,0,0,0,19,86,311,330,7/24/2020
3/15/2020,1,22,54,380,402,1,10,0,1,0,0,9,2,1,0,0,1,20,54,365,385,7/24/2020
3/16/2020,2,24,95,475,499,2,12,0,1,0,0,11,2,0,0,0,2,22,92,457,479,7/24/2020
3/17/2020,16,40,162,637,677,6,18,0,1,0,0,17,2,0,0,0,11,33,153,610,643,7/24/2020
3/18/2020,12,52,116,753,805,3,21,0,1,0,0,20,2,0,0,0,11,44,111,721,765,7/24/2020
3/19/2020,17,69,262,1015,1084,2,23,1,2,0,0,21,3,0,1,1,17,61,251,972,1033,7/24/2020
3/20/2020,15,84,197,1212,1296,5,28,0,2,0,0,26,4,0,0,1,13,74,193,1165,1239,7/24/2020
3/21/2020,21,105,126,1338,1443,3,31,2,4,0,0,27,5,0,0,1,14,88,123,1288,1376,7/24/2020
3/22/2020,30,135,282,1620,1755,2,33,0,4,0,0,29,5,0,0,1,25,113,265,1553,1666,7/24/2020
3/23/2020,14,149,169,1789,1938,15,48,1,5,0,0,43,9,3,0,1,16,129,166,1719,1848,7/24/2020
3/24/2020,20,169,243,2032,2201,7,55,0,5,0,0,50,10,4,0,1,19,148,238,1957,2105,7/24/2020
3/25/2020,26,195,183,2215,2410,5,60,1,6,0,0,54,11,3,0,1,28,176,173,2130,2306,7/24/2020
3/26/2020,35,230,181,2396,2626,10,70,5,11,0,0,59,14,5,0,1,41,217,176,2306,2523,7/24/2020
3/27/2020,27,257,215,2611,2868,9,79,1,12,1,1,66,17,6,2,3,31,248,202,2508,2756,7/24/2020
3/28/2020,59,316,260,2871,3187,13,92,3,15,2,3,74,15,6,1,4,63,311,242,2750,3061,7/24/2020
3/29/2020,106,422,356,3227,3649,8,100,4,19,1,4,77,18,8,2,6,105,416,314,3064,3480,7/24/2020
3/30/2020,62,484,222,3449,3933,20,120,5,24,0,4,92,20,11,3,9,78,494,192,3256,3750,7/24/2020
3/31/2020,71,555,369,3818,4373,11,131,7,31,1,5,95,22,13,2,11,73,567,300,3556,4123,7/24/2020
4/1/2020,99,654,699,4517,5171,18,149,7,38,0,5,106,30,15,1,12,100,667,649,4205,4872,7/24/2020
4/2/2020,52,706,477,4994,5700,21,170,6,44,2,7,119,36,21,4,16,62,729,436,4641,5370,7/24/2020
4/3/2020,108,814,775,5769,6583,23,193,7,51,0,7,135,43,25,3,19,100,829,718,5359,6188,7/24/2020
4/4/2020,143,957,660,6429,7386,22,215,4,55,5,12,148,41,30,9,28,137,966,623,5982,6948,7/24/2020
4/5/2020,187,1144,1156,7585,8729,20,235,9,64,1,13,158,44,36,2,30,182,1148,1072,7054,8202,7/24/2020
4/6/2020,218,1362,1707,9292,10654,26,261,7,71,0,13,177,48,40,7,37,206,1354,1580,8634,9988,7/24/2020
4/7/2020,285,1647,1631,10923,12570,20,281,4,75,2,15,191,49,42,5,42,260,1614,1494,10128,11742,7/24/2020
4/8/2020,290,1937,1723,12646,14583,19,300,7,82,6,21,197,49,38,10,52,272,1886,1572,11700,13586,7/24/2020
4/9/2020,284,2221,1521,14167,16388,32,332,9,91,4,25,216,52,40,7,59,278,2164,1366,13066,15230,7/24/2020
4/10/2020,420,2641,2577,16744,19385,29,361,16,107,5,30,224,58,41,11,70,404,2568,2382,15448,18016,7/24/2020
4/11/2020,299,2940,1911,18655,21595,29,390,11,118,2,32,240,61,48,12,82,280,2848,1731,17179,20027,7/24/2020
4/12/2020,315,3255,1674,20329,23584,35,425,13,131,5,37,257,59,49,10,92,289,3137,1452,18631,21768,7/24/2020
4/13/2020,162,3417,938,21267,24684,35,460,13,144,3,40,276,64,54,9,101,187,3324,846,19477,22801,7/24/2020
4/14/2020,289,3706,1788,23055,26761,27,487,17,161,5,45,281,72,53,8,109,265,3589,1561,21038,24627,7/24/2020
4/15/2020,353,4059,1803,24858,28917,31,518,19,180,3,48,290,72,54,17,126,307,3896,1579,22617,26513,7/24/2020
4/16/2020,449,4508,2500,27358,31866,36,554,25,205,6,54,295,72,53,14,140,392,4288,2098,24715,29003,7/24/2020
4/17/2020,308,4816,1823,29181,33997,32,586,20,225,7,61,300,66,45,21,161,291,4579,1481,26196,30775,7/24/2020
4/18/2020,322,5138,1728,30909,36047,26,612,18,243,4,65,304,63,49,15,176,284,4863,1364,27560,32423,7/24/2020
4/19/2020,382,5520,2059,32968,38488,23,635,26,269,1,66,300,65,55,11,187,338,5201,1763,29323,34524,7/24/2020
4/20/2020,396,5916,1909,34877,40793,46,681,29,298,2,68,315,75,56,10,197,377,5578,1597,30920,36498,7/24/2020
4/21/2020,445,6361,2114,36991,43352,45,726,31,329,5,73,324,72,56,18,215,388,5966,1728,32648,38614,7/24/2020
4/22/2020,420,6781,2398,39389,46170,41,767,32,361,5,78,328,73,58,18,233,382,6348,1926,34574,40922,7/24/2020
4/23/2020,482,7263,2471,41860,49123,30,797,28,389,5,83,325,76,62,15,248,420,6768,1895,36469,43237,7/24/2020
4/24/2020,494,7757,3292,45152,52909,35,832,27,416,4,87,329,85,63,15,263,414,7182,2652,39121,46303,7/24/2020
4/25/2020,394,8151,2210,47362,55513,34,866,17,433,5,92,341,85,62,14,277,305,7487,1790,40911,48398,7/24/2020
4/26/2020,316,8467,2314,49676,58143,33,899,15,448,3,95,356,86,59,14,291,277,7764,1891,42802,50566,7/24/2020
4/27/2020,250,8717,1624,51300,60017,29,928,21,469,4,99,360,86,61,10,301,204,7968,1171,43973,51941,7/24/2020
4/28/2020,411,9128,2268,53568,62696,44,972,24,493,3,102,377,88,59,22,323,324,8292,1779,45752,54044,7/24/2020
4/29/2020,476,9604,3351,56919,66523,36,1008,37,530,11,113,365,78,53,18,341,372,8664,2456,48208,56872,7/24/2020
4/30/2020,432,10036,2772,59691,69727,32,1040,38,568,6,119,353,83,57,24,365,348,9012,1965,50173,59185,7/24/2020
5/1/2020,457,10493,3089,62780,73273,51,1091,40,608,3,122,361,84,58,14,379,317,9329,2229,52402,61731,7/24/2020
5/2/2020,260,10753,1927,64707,75460,35,1126,38,646,5,127,353,90,61,24,403,189,9518,1299,53701,63219,7/24/2020
5/3/2020,284,11037,2168,66875,77912,31,1157,27,673,8,135,349,89,61,21,424,181,9699,1613,55314,65013,7/24/2020
5/4/2020,388,11425,2101,68976,80401,30,1187,31,704,5,140,343,87,57,18,442,292,9991,1581,56895,66886,7/24/2020
5/5/2020,436,11861,2878,71854,83715,28,1215,32,736,6,146,333,80,54,16,458,305,10296,1986,58881,69177,7/24/2020
5/6/2020,490,12351,2836,74690,87041,28,1243,44,780,9,155,308,78,54,21,479,341,10637,1939,60820,71457,7/24/2020
5/7/2020,425,12776,2975,77665,90441,36,1279,40,820,5,160,299,70,52,21,500,269,10906,1996,62816,73722,7/24/2020
5/8/2020,360,13136,2603,80268,93404,30,1309,29,849,5,165,295,70,53,22,522,231,11137,1788,64604,75741,7/24/2020
5/9/2020,457,13593,3356,83624,97217,22,1331,21,870,4,169,292,68,51,15,537,285,11422,2318,66922,78344,7/24/2020
5/10/2020,280,13873,2122,85746,99619,19,1350,23,893,6,175,282,69,49,13,550,186,11608,1531,68453,80061,7/24/2020
5/11/2020,259,14132,1861,87607,101739,31,1381,16,909,6,181,291,70,49,15,565,175,11783,1317,69770,81553,7/24/2020
5/12/2020,384,14516,2515,90122,104638,23,1404,18,927,4,185,292,68,48,22,587,217,12000,1624,71394,83394,7/24/2020
5/13/2020,352,14868,3571,93693,108561,22,1426,24,951,1,186,289,69,49,13,600,196,12196,1974,73368,85564,7/24/2020
5/14/2020,330,15198,3410,97103,112301,19,1445,27,978,3,189,278,64,45,15,615,227,12423,2022,75390,87813,7/24/2020
5/15/2020,384,15582,3461,100564,116146,24,1469,41,1019,5,194,256,62,45,13,628,232,12655,1819,77209,89864,7/24/2020
5/16/2020,425,16007,3940,104504,120511,25,1494,12,1031,5,199,264,61,46,15,643,252,12907,1814,79023,91930,7/24/2020
5/17/2020,229,16236,2750,107254,123490,17,1511,7,1038,5,204,269,59,45,10,653,124,13031,1569,80592,93623,7/24/2020
5/18/2020,250,16486,1997,109251,125737,19,1530,15,1053,5,209,268,57,40,18,671,137,13168,1367,81959,95127,7/24/2020
5/19/2020,416,16902,3178,112429,129331,23,1553,31,1084,5,214,255,56,38,11,682,214,13382,1962,83921,97303,7/24/2020
5/20/2020,327,17229,2798,115227,132456,19,1572,23,1107,7,221,244,52,33,22,704,187,13569,1551,85472,99041,7/24/2020
5/21/2020,370,17599,3797,119024,136623,26,1598,15,1122,3,224,252,53,29,20,724,170,13739,1987,87459,101198,7/24/2020
5/22/2020,350,17949,3026,122050,139999,20,1618,29,1151,5,229,238,52,29,10,734,201,13940,1492,88951,102891,7/24/2020
5/23/2020,240,18189,2735,124785,142974,19,1637,11,1162,3,232,243,52,32,13,747,108,14048,1329,90280,104328,7/24/2020
5/24/2020,153,18342,1359,126144,144486,12,1649,14,1176,2,234,239,53,36,8,755,84,14132,766,91046,105178,7/24/2020
5/25/2020,134,18476,1376,127520,145996,12,1661,14,1190,0,234,237,53,34,10,765,70,14202,754,91800,106002,7/24/2020
5/26/2020,284,18760,2609,130129,148889,24,1685,22,1212,5,239,234,48,33,15,780,154,14356,1778,93578,107934,7/24/2020
5/27/2020,276,19036,2121,132250,151286,20,1705,17,1229,3,242,234,50,33,10,790,133,14489,1152,94730,109219,7/24/2020
5/28/2020,346,19382,3377,135627,155009,17,1722,29,1258,4,246,218,47,32,8,798,132,14621,1145,95875,110496,7/24/2020
5/29/2020,418,19800,3973,139600,159400,18,1740,27,1285,6,252,203,43,31,12,810,178,14799,1588,97463,112262,7/24/2020
5/30/2020,211,20011,3964,143564,163575,15,1755,19,1304,4,256,195,40,29,12,822,104,14903,1827,99290,114193,7/24/2020
5/31/2020,148,20159,1741,145305,165464,10,1765,10,1314,0,256,195,43,26,3,825,76,14979,851,100141,115120,7/24/2020
6/1/2020,216,20375,2802,148107,168482,7,1772,13,1327,1,257,188,44,29,5,830,99,15078,1372,101513,116591,7/24/2020
6/2/2020,273,20648,3066,151173,171821,8,1780,9,1336,3,260,184,37,24,10,840,107,15185,1463,102976,118161,7/24/2020
6/3/2020,259,20907,3508,154681,175588,13,1793,18,1354,6,266,173,34,24,11,851,105,15290,1673,104649,119939,7/24/2020
6/4/2020,281,21188,4515,159196,180384,7,1800,25,1379,3,269,152,31,23,11,862,114,15404,2040,106689,122093,7/24/2020
6/5/2020,215,21403,3572,162768,184171,15,1815,12,1391,5,274,150,27,20,9,871,104,15508,1572,108261,123769,7/24/2020
6/6/2020,198,21601,2617,165385,186986,10,1825,7,1398,2,276,151,29,18,6,877,68,15576,1134,109395,124971,7/24/2020
6/7/2020,77,21678,1583,166968,188646,11,1836,7,1405,1,277,154,25,16,4,881,49,15625,758,110153,125778,7/24/2020
6/8/2020,122,21800,1830,168798,190598,15,1851,12,1417,2,279,155,27,17,4,885,44,15669,954,111107,126776,7/24/2020
6/9/2020,224,22024,2637,171435,193459,10,1861,18,1435,0,279,147,28,20,1,886,67,15736,1249,112356,128092,7/24/2020
6/10/2020,210,22234,2972,174407,196641,13,1874,12,1447,2,281,146,24,16,3,889,104,15840,1456,113812,129652,7/24/2020
6/11/2020,195,22429,3489,177896,200325,7,1881,15,1462,1,282,137,25,15,6,895,88,15928,1526,115338,131266,7/24/2020
6/12/2020,213,22642,4465,182361,205003,8,1889,15,1477,1,283,129,23,15,2,897,80,16008,2158,117496,133504,7/24/2020
6/13/2020,105,22747,2806,185167,207914,6,1895,4,1481,0,283,131,19,14,3,900,50,16058,1278,118774,134832,7/24/2020
6/14/2020,78,22825,1916,187083,209908,6,1901,8,1489,1,284,128,19,13,3,903,32,16090,917,119691,135781,7/24/2020
6/15/2020,188,23013,3061,190144,213157,14,1915,14,1503,0,284,128,19,15,4,907,77,16167,1777,121468,137635,7/24/2020
6/16/2020,115,23128,2903,193047,216175,10,1925,10,1513,1,285,127,21,15,8,915,52,16219,1565,123033,139252,7/24/2020
6/17/2020,123,23251,2688,195735,218986,15,1940,20,1533,4,289,118,17,13,6,921,50,16269,1299,124332,140601,7/24/2020
6/18/2020,150,23401,2979,198714,222115,9,1949,13,1546,1,290,113,18,15,7,928,70,16339,1308,125640,141979,7/24/2020
6/19/2020,139,23540,3534,202248,225788,12,1961,11,1557,1,291,113,19,16,3,931,58,16397,1271,126911,143308,7/24/2020
6/20/2020,79,23619,1734,203982,227601,7,1968,9,1566,0,291,111,19,17,4,935,35,16432,726,127637,144069,7/24/2020
6/21/2020,36,23655,1006,204988,228643,7,1975,5,1571,0,291,113,19,17,2,937,27,16459,650,128287,144746,7/24/2020
6/22/2020,142,23797,3678,208666,232463,12,1987,16,1587,0,291,109,18,17,1,938,70,16529,1697,129984,146513,7/24/2020
6/23/2020,161,23958,3740,212406,236364,3,1990,13,1600,3,294,96,17,17,6,944,83,16612,1711,131695,148307,7/24/2020
6/24/2020,119,24077,3372,215778,239855,8,1998,10,1610,1,295,93,16,17,5,949,46,16658,1585,133280,149938,7/24/2020
6/25/2020,102,24179,2856,218634,242813,5,2003,14,1624,1,296,83,15,16,1,950,53,16711,1488,134768,151479,7/24/2020
6/26/2020,93,24272,2439,221073,245345,2,2005,9,1633,0,296,76,16,17,1,951,64,16775,1365,136133,152908,7/24/2020
6/27/2020,84,24356,3194,224267,248623,5,2010,3,1636,1,297,77,15,16,5,956,37,16812,1200,137333,154145,7/24/2020
6/28/2020,37,24393,1444,225711,250104,4,2014,4,1640,4,301,73,13,13,6,962,18,16830,583,137916,154746,7/24/2020
6/29/2020,86,24479,3635,229346,253825,4,2018,5,1645,0,301,72,12,13,1,963,38,16868,1323,139239,156107,7/24/2020
6/30/2020,59,24538,1896,231242,255780,1,2019,5,1650,1,302,67,10,10,3,966,34,16902,980,140219,157121,7/24/2020
7/1/2020,144,24682,3986,235228,259910,7,2026,9,1659,0,302,65,9,10,1,967,81,16983,1897,142116,159099,7/24/2020
7/2/2020,99,24781,2609,237837,262618,5,2031,5,1664,1,303,64,7,8,1,968,54,17037,989,143105,160142,7/24/2020
7/3/2020,42,24823,1859,239696,264519,7,2038,6,1670,0,303,65,6,7,3,971,20,17057,671,143776,160833,7/24/2020
7/4/2020,52,24875,2230,241926,266801,2,2040,4,1674,1,304,62,7,7,2,973,27,17084,954,144730,161814,7/24/2020
7/5/2020,46,24921,2828,244754,269675,1,2041,2,1676,1,305,60,5,6,2,975,22,17106,1374,146104,163210,7/24/2020
7/6/2020,102,25023,2726,247480,272503,6,2047,6,1682,0,305,60,7,8,4,979,60,17166,1512,147616,164782,7/24/2020
7/7/2020,74,25097,3354,250834,275931,5,2052,6,1688,0,305,59,6,7,1,980,47,17213,1520,149136,166349,7/24/2020
7/8/2020,94,25191,3274,254108,279299,3,2055,2,1690,0,305,60,7,7,0,980,55,17268,1340,150476,167744,7/24/2020
7/9/2020,93,25284,3481,257589,282873,7,2062,1,1691,0,305,66,7,7,0,980,48,17316,1556,152032,169348,7/24/2020
7/10/2020,125,25409,4239,261828,287237,5,2067,3,1694,2,307,66,6,6,3,983,77,17393,1972,154004,171397,7/24/2020
7/11/2020,59,25468,2730,264558,290026,6,2073,3,1697,1,308,68,5,5,3,986,35,17428,1255,155259,172687,7/24/2020
7/12/2020,42,25510,1662,266220,291730,1,2074,2,1699,1,309,66,5,4,3,989,30,17458,817,156076,173534,7/24/2020
7/13/2020,84,25594,3052,269272,294866,7,2081,10,1709,0,309,63,5,4,1,990,57,17515,1402,157478,174993,7/24/2020
7/14/2020,69,25663,3170,272442,298105,7,2088,4,1713,0,309,66,4,4,1,991,45,17560,1305,158783,176343,7/24/2020
7/15/2020,120,25783,3923,276365,302148,4,2092,6,1719,0,309,64,4,3,0,991,90,17650,1601,160384,178034,7/24/2020
7/16/2020,99,25882,3489,279854,305736,5,2097,8,1727,0,309,61,4,3,1,992,76,17726,1471,161855,179581,7/24/2020
7/17/2020,149,26031,4011,283865,309896,14,2111,3,1730,1,310,71,3,3,0,992,88,17814,1732,163587,181401,7/24/2020
7/18/2020,78,26109,3094,286959,313068,5,2116,9,1739,1,311,66,3,2,4,996,70,17884,1333,164920,182804,7/24/2020
7/19/2020,79,26188,2536,289495,315683,4,2120,3,1742,0,311,67,4,2,2,998,57,17941,1045,165965,183906,7/24/2020
7/20/2020,71,26259,2463,291958,318217,8,2128,7,1749,0,311,68,5,3,2,1000,62,18003,1354,167319,185322,7/24/2020
7/21/2020,120,26379,4068,296026,322405,9,2137,10,1759,0,311,67,7,4,1,1001,78,18081,1781,169100,187181,7/24/2020
7/22/2020,115,26494,3676,299702,326196,9,2146,10,1769,0,311,66,6,5,1,1002,69,18150,1505,170605,188755,7/24/2020
7/23/2020,99,26593,3261,302963,329556,,,,,,,,,,0,1002,74,18224,1199,171804,190028,7/24/2020
2/27/2020,0,0,0,0,0,1,1,0,0,0,0,1,0,0,0,0,0,0,0,0,0,7/27/2020
2/28/2020,0,0,0,0,0,0,1,0,0,0,0,1,1,0,0,0,0,0,0,0,0,7/27/2020
2/29/2020,0,0,0,0,0,0,1,0,0,0,0,1,1,0,0,0,0,0,0,0,0,7/27/2020
3/1/2020,2,2,2,2,4,0,1,0,0,0,0,1,1,1,0,0,2,2,2,2,4,7/27/2020
3/2/2020,0,2,1,3,5,1,2,0,0,0,0,2,2,2,0,0,0,2,1,3,5,7/27/2020
3/3/2020,0,2,2,5,7,0,2,0,0,0,0,2,2,2,0,0,0,2,2,5,7,7/27/2020
3/4/2020,0,2,12,17,19,1,3,0,0,0,0,3,2,2,0,0,0,2,10,15,17,7/27/2020
3/5/2020,0,2,4,21,23,0,3,0,0,0,0,3,2,2,0,0,1,3,4,19,22,7/27/2020
3/6/2020,1,3,12,33,36,0,3,0,0,0,0,3,2,2,0,0,0,3,11,30,33,7/27/2020
3/7/2020,0,3,19,52,55,0,3,0,0,0,0,3,2,1,0,0,0,3,19,49,52,7/27/2020
3/8/2020,0,3,18,70,73,0,3,0,0,0,0,3,2,1,0,0,0,3,18,67,70,7/27/2020
3/9/2020,1,4,15,85,89,0,3,0,0,0,0,3,2,1,0,0,1,4,15,82,86,7/27/2020
3/10/2020,2,6,25,110,116,0,3,0,0,0,0,3,2,1,0,0,1,5,23,105,110,7/27/2020
3/11/2020,0,6,34,144,150,1,4,0,0,0,0,4,1,1,0,0,0,5,34,139,144,7/27/2020
3/12/2020,9,15,42,186,201,1,5,0,0,0,0,5,1,1,0,0,8,13,38,177,190,7/27/2020
3/13/2020,6,21,50,236,257,4,9,1,1,0,0,8,1,1,0,0,6,19,48,225,244,7/27/2020
3/14/2020,0,21,90,326,347,0,9,0,1,0,0,8,1,1,0,0,0,19,86,311,330,7/27/2020
3/15/2020,1,22,54,380,402,1,10,0,1,0,0,9,2,1,0,0,1,20,54,365,385,7/27/2020
3/16/2020,2,24,95,475,499,2,12,0,1,0,0,11,2,0,0,0,2,22,92,457,479,7/27/2020
3/17/2020,16,40,162,637,677,6,18,0,1,0,0,17,2,0,0,0,11,33,153,610,643,7/27/2020
3/18/2020,12,52,116,753,805,3,21,0,1,0,0,20,2,0,0,0,11,44,111,721,765,7/27/2020
3/19/2020,17,69,262,1015,1084,2,23,1,2,0,0,21,3,0,1,1,17,61,251,972,1033,7/27/2020
3/20/2020,15,84,197,1212,1296,5,28,0,2,0,0,26,4,0,0,1,13,74,193,1165,1239,7/27/2020
3/21/2020,21,105,126,1338,1443,3,31,2,4,0,0,27,5,0,0,1,14,88,123,1288,1376,7/27/2020
3/22/2020,30,135,282,1620,1755,2,33,0,4,0,0,29,5,0,0,1,25,113,265,1553,1666,7/27/2020
3/23/2020,14,149,169,1789,1938,15,48,1,5,0,0,43,9,3,0,1,16,129,166,1719,1848,7/27/2020
3/24/2020,20,169,243,2032,2201,7,55,0,5,0,0,50,10,4,0,1,19,148,238,1957,2105,7/27/2020
3/25/2020,26,195,183,2215,2410,5,60,1,6,0,0,54,11,3,0,1,28,176,173,2130,2306,7/27/2020
3/26/2020,35,230,181,2396,2626,10,70,5,11,0,0,59,14,5,0,1,41,217,176,2306,2523,7/27/2020
3/27/2020,27,257,215,2611,2868,9,79,1,12,1,1,66,17,6,2,3,31,248,202,2508,2756,7/27/2020
3/28/2020,59,316,260,2871,3187,13,92,3,15,2,3,74,15,6,1,4,63,311,242,2750,3061,7/27/2020
3/29/2020,106,422,356,3227,3649,8,100,4,19,1,4,77,18,8,2,6,105,416,314,3064,3480,7/27/2020
3/30/2020,62,484,222,3449,3933,20,120,5,24,0,4,92,20,11,3,9,78,494,192,3256,3750,7/27/2020
3/31/2020,71,555,369,3818,4373,11,131,7,31,1,5,95,22,13,2,11,73,567,299,3555,4122,7/27/2020
4/1/2020,99,654,699,4517,5171,18,149,7,38,0,5,106,30,15,1,12,100,667,649,4204,4871,7/27/2020
4/2/2020,52,706,477,4994,5700,21,170,6,44,2,7,119,36,21,4,16,62,729,436,4640,5369,7/27/2020
4/3/2020,108,814,775,5769,6583,23,193,7,51,0,7,135,43,25,3,19,100,829,718,5358,6187,7/27/2020
4/4/2020,143,957,660,6429,7386,22,215,4,55,5,12,148,41,30,9,28,137,966,623,5981,6947,7/27/2020
4/5/2020,187,1144,1156,7585,8729,20,235,9,64,1,13,158,44,36,2,30,182,1148,1072,7053,8201,7/27/2020
4/6/2020,218,1362,1707,9292,10654,26,261,7,71,0,13,177,48,40,7,37,206,1354,1580,8633,9987,7/27/2020
4/7/2020,285,1647,1631,10923,12570,20,281,4,75,2,15,191,49,42,5,42,260,1614,1493,10126,11740,7/27/2020
4/8/2020,290,1937,1723,12646,14583,19,300,7,82,6,21,197,49,38,10,52,272,1886,1572,11698,13584,7/27/2020
4/9/2020,284,2221,1521,14167,16388,32,332,9,91,4,25,216,52,40,7,59,278,2164,1366,13064,15228,7/27/2020
4/10/2020,420,2641,2577,16744,19385,29,361,16,107,5,30,224,58,41,11,70,404,2568,2381,15445,18013,7/27/2020
4/11/2020,299,2940,1911,18655,21595,29,390,11,118,2,32,240,61,48,12,82,280,2848,1731,17176,20024,7/27/2020
4/12/2020,315,3255,1674,20329,23584,35,425,13,131,5,37,257,59,49,10,92,289,3137,1451,18627,21764,7/27/2020
4/13/2020,162,3417,938,21267,24684,35,460,13,144,3,40,276,64,54,9,101,187,3324,845,19472,22796,7/27/2020
4/14/2020,289,3706,1788,23055,26761,27,487,17,161,5,45,281,72,53,8,109,265,3589,1557,21029,24618,7/27/2020
4/15/2020,353,4059,1803,24858,28917,31,518,19,180,3,48,290,72,54,17,126,307,3896,1579,22608,26504,7/27/2020
4/16/2020,449,4508,2500,27358,31866,36,554,25,205,6,54,295,72,53,14,140,392,4288,2097,24705,28993,7/27/2020
4/17/2020,308,4816,1823,29181,33997,32,586,20,225,7,61,300,66,45,21,161,291,4579,1476,26181,30760,7/27/2020
4/18/2020,322,5138,1728,30909,36047,26,612,18,243,4,65,304,63,49,15,176,284,4863,1362,27543,32406,7/27/2020
4/19/2020,382,5520,2059,32968,38488,23,635,26,269,1,66,300,65,55,11,187,338,5201,1762,29305,34506,7/27/2020
4/20/2020,396,5916,1909,34877,40793,46,681,29,298,2,68,315,75,56,10,197,377,5578,1595,30900,36478,7/27/2020
4/21/2020,445,6361,2114,36991,43352,45,726,31,329,5,73,324,72,56,18,215,388,5966,1727,32627,38593,7/27/2020
4/22/2020,420,6781,2398,39389,46170,41,767,32,361,5,78,328,73,58,18,233,382,6348,1925,34552,40900,7/27/2020
4/23/2020,482,7263,2471,41860,49123,30,797,28,389,5,83,325,76,62,15,248,420,6768,1892,36444,43212,7/27/2020
4/24/2020,494,7757,3292,45152,52909,35,832,27,416,4,87,329,85,63,15,263,414,7182,2652,39096,46278,7/27/2020
4/25/2020,394,8151,2210,47362,55513,34,866,17,433,5,92,341,85,62,14,277,305,7487,1787,40883,48370,7/27/2020
4/26/2020,316,8467,2314,49676,58143,33,899,15,448,3,95,356,86,59,14,291,277,7764,1891,42774,50538,7/27/2020
4/27/2020,250,8717,1624,51300,60017,29,928,21,469,4,99,360,86,61,10,301,204,7968,1171,43945,51913,7/27/2020
4/28/2020,411,9128,2268,53568,62696,44,972,24,493,3,102,377,88,59,22,323,324,8292,1778,45723,54015,7/27/2020
4/29/2020,476,9604,3351,56919,66523,36,1008,37,530,11,113,365,78,53,18,341,372,8664,2455,48178,56842,7/27/2020
4/30/2020,432,10036,2772,59691,69727,32,1040,38,568,6,119,353,83,57,24,365,348,9012,1964,50142,59154,7/27/2020
5/1/2020,457,10493,3089,62780,73273,51,1091,39,607,3,122,362,84,58,14,379,317,9329,2226,52368,61697,7/27/2020
5/2/2020,260,10753,1927,64707,75460,35,1126,39,646,5,127,353,90,61,24,403,189,9518,1299,53667,63185,7/27/2020
5/3/2020,284,11037,2168,66875,77912,31,1157,27,673,8,135,349,89,61,21,424,181,9699,1612,55279,64978,7/27/2020
5/4/2020,388,11425,2101,68976,80401,30,1187,31,704,5,140,343,87,57,18,442,293,9992,1581,56860,66852,7/27/2020
5/5/2020,436,11861,2878,71854,83715,28,1215,32,736,6,146,333,80,54,16,458,304,10296,1986,58846,69142,7/27/2020
5/6/2020,490,12351,2836,74690,87041,28,1243,44,780,9,155,308,78,54,21,479,341,10637,1937,60783,71420,7/27/2020
5/7/2020,425,12776,2975,77665,90441,36,1279,40,820,5,160,299,70,52,21,500,269,10906,1994,62777,73683,7/27/2020
5/8/2020,360,13136,2603,80268,93404,30,1309,29,849,5,165,295,70,53,22,522,231,11137,1788,64565,75702,7/27/2020
5/9/2020,457,13593,3356,83624,97217,22,1331,21,870,4,169,292,68,51,15,537,285,11422,2317,66882,78304,7/27/2020
5/10/2020,280,13873,2122,85746,99619,19,1350,23,893,6,175,282,69,49,13,550,186,11608,1531,68413,80021,7/27/2020
5/11/2020,259,14132,1861,87607,101739,31,1381,16,909,6,181,291,70,49,15,565,176,11784,1317,69730,81514,7/27/2020
5/12/2020,387,14519,2622,90229,104748,23,1404,18,927,4,185,292,68,48,22,587,217,12001,1724,71454,83455,7/27/2020
5/13/2020,352,14871,3634,93863,108734,22,1426,24,951,1,186,289,69,49,13,600,196,12197,2031,73485,85682,7/27/2020
5/14/2020,330,15201,3415,97278,112479,19,1445,27,978,3,189,278,64,45,15,615,227,12424,2026,75511,87935,7/27/2020
5/15/2020,382,15583,3470,100748,116331,24,1469,41,1019,5,194,256,62,45,13,628,234,12658,1825,77336,89994,7/27/2020
5/16/2020,438,16021,4168,104916,120937,25,1494,12,1031,5,199,264,61,46,15,643,252,12910,1979,79315,92225,7/27/2020
5/17/2020,231,16252,2775,107691,123943,17,1511,7,1038,5,204,269,59,45,10,653,124,13034,1572,80887,93921,7/27/2020
5/18/2020,251,16503,2007,109698,126201,19,1530,15,1053,5,209,268,57,40,18,671,139,13173,1376,82263,95436,7/27/2020
5/19/2020,416,16919,3178,112876,129795,23,1553,31,1084,5,214,255,56,38,11,682,214,13387,1946,84209,97596,7/27/2020
5/20/2020,327,17246,2768,115644,132890,19,1572,23,1107,7,221,244,52,33,22,704,187,13574,1521,85730,99304,7/27/2020
5/21/2020,374,17620,3755,119399,137019,26,1598,15,1122,3,224,252,53,29,20,724,170,13744,1948,87678,101422,7/27/2020
5/22/2020,351,17971,3167,122566,140537,20,1618,29,1151,5,229,238,52,29,10,734,205,13949,1617,89295,103244,7/27/2020
5/23/2020,240,18211,2740,125306,143517,19,1637,11,1162,3,232,243,52,32,13,747,109,14058,1286,90581,104639,7/27/2020
5/24/2020,153,18364,1362,126668,145032,12,1649,14,1176,2,234,239,53,36,8,755,84,14142,766,91347,105489,7/27/2020
5/25/2020,134,18498,1376,128044,146542,12,1661,14,1190,0,234,237,53,34,10,765,70,14212,754,92101,106313,7/27/2020
5/26/2020,284,18782,2616,130660,149442,24,1685,22,1212,5,239,234,48,33,15,780,154,14366,1784,93885,108251,7/27/2020
5/27/2020,276,19058,2121,132781,151839,20,1705,17,1229,3,242,234,50,33,10,790,133,14499,1137,95022,109521,7/27/2020
5/28/2020,346,19404,3378,136159,155563,17,1722,29,1258,4,246,218,47,32,8,798,132,14631,1130,96152,110783,7/27/2020
5/29/2020,418,19822,3980,140139,159961,18,1740,27,1285,6,252,203,43,31,12,810,178,14809,1591,97743,112552,7/27/2020
5/30/2020,211,20033,3968,144107,164140,15,1755,19,1304,4,256,195,40,29,12,822,104,14913,1827,99570,114483,7/27/2020
5/31/2020,148,20181,1752,145859,166040,10,1765,10,1314,0,256,195,43,26,3,825,76,14989,855,100425,115414,7/27/2020
6/1/2020,216,20397,2803,148662,169059,7,1772,13,1327,1,257,188,44,29,5,830,99,15088,1370,101795,116883,7/27/2020
6/2/2020,273,20670,3071,151733,172403,8,1780,9,1336,3,260,184,37,25,10,840,107,15195,1462,103257,118452,7/27/2020
6/3/2020,259,20929,3508,155241,176170,13,1793,18,1354,6,266,173,34,25,11,851,105,15300,1671,104928,120228,7/27/2020
6/4/2020,281,21210,4515,159756,180966,7,1800,25,1379,3,269,152,31,24,11,862,114,15414,2038,106966,122380,7/27/2020
6/5/2020,215,21425,3578,163334,184759,15,1815,12,1391,5,274,150,27,21,9,871,104,15518,1575,108541,124059,7/27/2020
6/6/2020,198,21623,2619,165953,187576,10,1825,7,1398,2,276,151,29,19,6,877,68,15586,1134,109675,125261,7/27/2020
6/7/2020,77,21700,1604,167557,189257,11,1836,7,1405,1,277,154,25,17,4,881,49,15635,768,110443,126078,7/27/2020
6/8/2020,122,21822,1836,169393,191215,15,1851,12,1417,2,279,155,27,18,4,885,44,15679,956,111399,127078,7/27/2020
6/9/2020,225,22047,2673,172066,194113,10,1861,18,1435,0,279,147,28,21,1,886,67,15746,1264,112663,128409,7/27/2020
6/10/2020,210,22257,2977,175043,197300,13,1874,12,1447,2,281,146,24,17,3,889,104,15850,1457,114120,129970,7/27/2020
6/11/2020,195,22452,3494,178537,200989,7,1881,15,1462,1,282,137,25,16,6,895,88,15938,1524,115644,131582,7/27/2020
6/12/2020,213,22665,4598,183135,205800,8,1889,15,1477,1,283,129,24,16,2,897,80,16018,2189,117833,133851,7/27/2020
6/13/2020,110,22775,3025,186160,208935,6,1895,4,1481,0,283,131,20,15,3,900,50,16068,1370,119203,135271,7/27/2020
6/14/2020,78,22853,2034,188194,211047,6,1901,8,1489,1,284,128,20,14,3,903,32,16100,963,120166,136266,7/27/2020
6/15/2020,189,23042,3098,191292,214334,14,1915,14,1503,0,284,128,20,16,4,907,78,16178,1783,121949,138127,7/27/2020
6/16/2020,115,23157,3000,194292,217449,10,1925,10,1513,1,285,127,22,16,8,915,52,16230,1575,123524,139754,7/27/2020
6/17/2020,123,23280,2821,197113,220393,15,1940,20,1533,4,289,118,18,14,6,921,52,16282,1310,124834,141116,7/27/2020
6/18/2020,150,23430,3033,200146,223576,9,1949,13,1546,1,290,113,19,16,7,928,70,16352,1327,126161,142513,7/27/2020
6/19/2020,140,23570,3750,203896,227466,12,1961,11,1557,1,291,113,20,17,3,931,58,16410,1367,127528,143938,7/27/2020
6/20/2020,80,23650,1873,205769,229419,7,1968,9,1566,0,291,111,20,18,4,935,36,16446,805,128333,144779,7/27/2020
6/21/2020,36,23686,1027,206796,230482,7,1975,5,1571,0,291,113,20,18,2,937,27,16473,668,129001,145474,7/27/2020
6/22/2020,142,23828,3704,210500,234328,12,1987,16,1587,0,291,109,19,18,1,938,70,16543,1697,130698,147241,7/27/2020
6/23/2020,162,23990,3836,214336,238326,3,1990,13,1600,3,294,96,18,18,6,944,83,16626,1782,132480,149106,7/27/2020
6/24/2020,120,24110,3497,217833,241943,8,1998,10,1610,1,295,93,17,18,5,949,46,16672,1686,134166,150838,7/27/2020
6/25/2020,102,24212,2869,220702,244914,5,2003,14,1624,1,296,83,16,17,1,950,53,16725,1496,135662,152387,7/27/2020
6/26/2020,93,24305,2439,223141,247446,2,2005,9,1633,0,296,76,17,18,1,951,63,16788,1294,136956,153744,7/27/2020
6/27/2020,84,24389,3194,226335,250724,5,2010,3,1636,1,297,77,16,17,5,956,37,16825,1198,138154,154979,7/27/2020
6/28/2020,37,24426,1445,227780,252206,4,2014,4,1640,4,301,73,14,14,6,962,18,16843,581,138735,155578,7/27/2020
6/29/2020,86,24512,3648,231428,255940,4,2018,5,1645,0,301,72,13,14,1,963,38,16881,1324,140059,156940,7/27/2020
6/30/2020,59,24571,1907,233335,257906,1,2019,5,1650,1,302,67,11,11,3,966,34,16915,966,141025,157940,7/27/2020
7/1/2020,144,24715,4041,237376,262091,7,2026,9,1659,0,302,65,10,11,1,967,81,16996,1901,142926,159922,7/27/2020
7/2/2020,99,24814,2721,240097,264911,5,2031,5,1664,1,303,64,8,9,1,968,54,17050,1024,143950,161000,7/27/2020
7/3/2020,42,24856,1957,242054,266910,7,2038,6,1670,0,303,65,7,8,3,971,20,17070,727,144677,161747,7/27/2020
7/4/2020,53,24909,2269,244323,269232,2,2040,4,1674,1,304,62,8,8,2,973,29,17099,952,145629,162728,7/27/2020
7/5/2020,46,24955,2877,247200,272155,1,2041,2,1676,1,305,60,6,7,2,975,22,17121,1408,147037,164158,7/27/2020
7/6/2020,102,25057,2728,249928,274985,6,2047,6,1682,0,305,60,8,9,4,979,60,17181,1493,148530,165711,7/27/2020
7/7/2020,74,25131,3355,253283,278414,5,2052,6,1688,0,305,59,7,8,1,980,46,17227,1476,150006,167233,7/27/2020
7/8/2020,94,25225,3288,256571,281796,3,2055,2,1690,0,305,60,8,8,0,980,56,17283,1340,151346,168629,7/27/2020
7/9/2020,94,25319,3581,260152,285471,7,2062,1,1691,0,305,66,8,8,0,980,49,17332,1533,152879,170211,7/27/2020
7/10/2020,125,25444,4260,264412,289856,5,2067,3,1694,2,307,66,7,7,3,983,77,17409,1981,154860,172269,7/27/2020
7/11/2020,60,25504,2769,267181,292685,6,2073,3,1697,1,308,68,6,6,3,986,35,17444,1189,156049,173493,7/27/2020
7/12/2020,42,25546,1678,268859,294405,1,2074,2,1699,1,309,66,6,5,3,989,30,17474,824,156873,174347,7/27/2020
7/13/2020,84,25630,3055,271914,297544,7,2081,10,1709,0,309,63,6,5,1,990,57,17531,1400,158273,175804,7/27/2020
7/14/2020,69,25699,3178,275092,300791,7,2088,4,1713,0,309,66,5,5,1,991,45,17576,1303,159576,177152,7/27/2020
7/15/2020,120,25819,3966,279058,304877,4,2092,6,1719,0,309,64,5,4,0,991,90,17666,1598,161174,178840,7/27/2020
7/16/2020,99,25918,3522,282580,308498,5,2097,8,1727,0,309,61,5,4,1,992,77,17743,1476,162650,180393,7/27/2020
7/17/2020,149,26067,4011,286591,312658,14,2111,3,1730,1,310,71,4,4,0,992,80,17823,1729,164379,182202,7/27/2020
7/18/2020,78,26145,3094,289685,315830,5,2116,9,1739,1,311,66,4,3,4,996,73,17896,1327,165706,183602,7/27/2020
7/19/2020,79,26224,2536,292221,318445,6,2122,3,1742,0,311,69,5,3,2,998,57,17953,1044,166750,184703,7/27/2020
7/20/2020,71,26295,2463,294684,320979,8,2130,7,1749,0,311,70,6,4,2,1000,62,18015,1353,168103,186118,7/27/2020
7/21/2020,120,26415,4071,298755,325170,9,2139,10,1759,0,311,69,8,5,1,1001,99,18114,1777,169880,187994,7/27/2020
7/22/2020,115,26530,3680,302435,328965,11,2150,11,1770,0,311,69,7,6,1,1002,78,18192,1505,171385,189577,7/27/2020
7/23/2020,117,26647,3945,306380,333027,6,2156,5,1775,0,311,70,7,7,0,1002,90,18282,1676,173061,191343,7/27/2020
7/24/2020,148,26795,5529,311909,338704,11,2167,10,1785,0,311,71,8,7,0,1002,102,18384,2049,175110,193494,7/27/2020
7/25/2020,119,26914,4066,315975,342889,7,2174,7,1792,0,311,71,8,6,1,1003,93,18477,1868,176978,195455,7/27/2020
7/26/2020,47,26961,2716,318691,345652,,,,,,,,,,1,1004,38,18515,1125,178103,196618,7/27/2020
2/27/2020,0,0,0,0,0,1,1,0,0,0,0,1,0,0,0,0,0,0,0,0,0,7/28/2020
2/28/2020,0,0,0,0,0,0,1,0,0,0,0,1,1,0,0,0,0,0,0,0,0,7/28/2020
2/29/2020,0,0,0,0,0,0,1,0,0,0,0,1,1,0,0,0,0,0,0,0,0,7/28/2020
3/1/2020,2,2,2,2,4,0,1,0,0,0,0,1,1,1,0,0,2,2,2,2,4,7/28/2020
3/2/2020,0,2,1,3,5,1,2,0,0,0,0,2,2,2,0,0,0,2,1,3,5,7/28/2020
3/3/2020,0,2,2,5,7,0,2,0,0,0,0,2,2,2,0,0,0,2,2,5,7,7/28/2020
3/4/2020,0,2,12,17,19,1,3,0,0,0,0,3,2,2,0,0,0,2,10,15,17,7/28/2020
3/5/2020,0,2,4,21,23,0,3,0,0,0,0,3,2,2,0,0,1,3,4,19,22,7/28/2020
3/6/2020,1,3,12,33,36,0,3,0,0,0,0,3,2,2,0,0,0,3,11,30,33,7/28/2020
3/7/2020,0,3,19,52,55,0,3,0,0,0,0,3,2,1,0,0,0,3,19,49,52,7/28/2020
3/8/2020,0,3,18,70,73,0,3,0,0,0,0,3,2,1,0,0,0,3,18,67,70,7/28/2020
3/9/2020,1,4,15,85,89,0,3,0,0,0,0,3,2,1,0,0,1,4,15,82,86,7/28/2020
3/10/2020,2,6,25,110,116,0,3,0,0,0,0,3,2,1,0,0,1,5,23,105,110,7/28/2020
3/11/2020,0,6,34,144,150,1,4,0,0,0,0,4,1,1,0,0,0,5,34,139,144,7/28/2020
3/12/2020,9,15,42,186,201,1,5,0,0,0,0,5,1,1,0,0,8,13,38,177,190,7/28/2020
3/13/2020,6,21,50,236,257,4,9,1,1,0,0,8,1,1,0,0,6,19,48,225,244,7/28/2020
3/14/2020,0,21,90,326,347,0,9,0,1,0,0,8,1,1,0,0,0,19,86,311,330,7/28/2020
3/15/2020,1,22,54,380,402,1,10,0,1,0,0,9,2,1,0,0,1,20,54,365,385,7/28/2020
3/16/2020,2,24,95,475,499,2,12,0,1,0,0,11,2,0,0,0,2,22,92,457,479,7/28/2020
3/17/2020,16,40,162,637,677,6,18,0,1,0,0,17,2,0,0,0,11,33,153,610,643,7/28/2020
3/18/2020,12,52,116,753,805,3,21,0,1,0,0,20,2,0,0,0,11,44,111,721,765,7/28/2020
3/19/2020,17,69,262,1015,1084,2,23,1,2,0,0,21,3,0,1,1,17,61,251,972,1033,7/28/2020
3/20/2020,15,84,197,1212,1296,5,28,0,2,0,0,26,4,0,0,1,13,74,193,1165,1239,7/28/2020
3/21/2020,21,105,126,1338,1443,3,31,2,4,0,0,27,5,0,0,1,14,88,123,1288,1376,7/28/2020
3/22/2020,30,135,282,1620,1755,2,33,0,4,0,0,29,5,0,0,1,25,113,265,1553,1666,7/28/2020
3/23/2020,14,149,169,1789,1938,15,48,1,5,0,0,43,9,3,0,1,16,129,165,1718,1847,7/28/2020
3/24/2020,20,169,243,2032,2201,7,55,0,5,0,0,50,10,4,0,1,19,148,238,1956,2104,7/28/2020
3/25/2020,26,195,183,2215,2410,5,60,1,6,0,0,54,11,3,0,1,28,176,173,2129,2305,7/28/2020
3/26/2020,35,230,181,2396,2626,10,70,5,11,0,0,59,14,5,0,1,41,217,176,2305,2522,7/28/2020
3/27/2020,27,257,215,2611,2868,9,79,1,12,1,1,66,17,6,2,3,31,248,202,2507,2755,7/28/2020
3/28/2020,59,316,260,2871,3187,13,92,3,15,2,3,74,15,6,1,4,63,311,242,2749,3060,7/28/2020
3/29/2020,106,422,356,3227,3649,8,100,4,19,1,4,77,18,8,2,6,105,416,314,3063,3479,7/28/2020
3/30/2020,62,484,222,3449,3933,20,120,5,24,0,4,92,20,11,3,9,78,494,192,3255,3749,7/28/2020
3/31/2020,71,555,369,3818,4373,11,131,7,31,1,5,95,22,13,2,11,73,567,299,3554,4121,7/28/2020
4/1/2020,99,654,699,4517,5171,18,149,7,38,0,5,106,30,15,1,12,100,667,649,4203,4870,7/28/2020
4/2/2020,52,706,477,4994,5700,21,170,6,44,2,7,119,36,21,4,16,62,729,436,4639,5368,7/28/2020
4/3/2020,108,814,775,5769,6583,23,193,7,51,0,7,135,43,25,3,19,100,829,718,5357,6186,7/28/2020
4/4/2020,143,957,660,6429,7386,22,215,4,55,5,12,148,41,30,9,28,137,966,623,5980,6946,7/28/2020
4/5/2020,187,1144,1156,7585,8729,20,235,9,64,1,13,158,44,36,2,30,182,1148,1072,7052,8200,7/28/2020
4/6/2020,218,1362,1707,9292,10654,26,261,7,71,0,13,177,48,40,7,37,206,1354,1580,8632,9986,7/28/2020
4/7/2020,285,1647,1631,10923,12570,20,281,3,74,2,15,192,49,42,5,42,260,1614,1491,10123,11737,7/28/2020
4/8/2020,290,1937,1723,12646,14583,19,300,7,81,6,21,198,49,38,10,52,272,1886,1572,11695,13581,7/28/2020
4/9/2020,284,2221,1521,14167,16388,32,332,9,90,4,25,217,52,40,7,59,278,2164,1366,13061,15225,7/28/2020
4/10/2020,420,2641,2577,16744,19385,29,361,17,107,5,30,224,58,41,11,70,404,2568,2381,15442,18010,7/28/2020
4/11/2020,299,2940,1911,18655,21595,29,390,11,118,2,32,240,61,48,12,82,280,2848,1731,17173,20021,7/28/2020
4/12/2020,315,3255,1674,20329,23584,35,425,13,131,5,37,257,59,49,10,92,289,3137,1451,18624,21761,7/28/2020
4/13/2020,162,3417,938,21267,24684,35,460,13,144,3,40,276,64,54,9,101,187,3324,845,19469,22793,7/28/2020
4/14/2020,289,3706,1788,23055,26761,27,487,17,161,5,45,281,72,53,8,109,265,3589,1557,21026,24615,7/28/2020
4/15/2020,353,4059,1803,24858,28917,31,518,19,180,3,48,290,72,54,17,126,307,3896,1579,22605,26501,7/28/2020
4/16/2020,449,4508,2500,27358,31866,36,554,25,205,6,54,295,72,53,14,140,392,4288,2097,24702,28990,7/28/2020
4/17/2020,308,4816,1823,29181,33997,32,586,20,225,7,61,300,66,45,21,161,291,4579,1476,26178,30757,7/28/2020
4/18/2020,322,5138,1728,30909,36047,26,612,18,243,4,65,304,63,49,15,176,284,4863,1362,27540,32403,7/28/2020
4/19/2020,382,5520,2059,32968,38488,23,635,26,269,1,66,300,65,55,11,187,338,5201,1762,29302,34503,7/28/2020
4/20/2020,396,5916,1909,34877,40793,46,681,29,298,2,68,315,75,56,10,197,377,5578,1595,30897,36475,7/28/2020
4/21/2020,445,6361,2114,36991,43352,45,726,31,329,5,73,324,72,56,18,215,388,5966,1727,32624,38590,7/28/2020
4/22/2020,420,6781,2398,39389,46170,41,767,32,361,5,78,328,73,58,18,233,382,6348,1925,34549,40897,7/28/2020
4/23/2020,482,7263,2471,41860,49123,30,797,28,389,5,83,325,76,62,15,248,420,6768,1891,36440,43208,7/28/2020
4/24/2020,494,7757,3292,45152,52909,35,832,27,416,4,87,329,85,63,15,263,414,7182,2652,39092,46274,7/28/2020
4/25/2020,394,8151,2210,47362,55513,34,866,17,433,5,92,341,85,62,14,277,305,7487,1787,40879,48366,7/28/2020
4/26/2020,316,8467,2314,49676,58143,33,899,15,448,3,95,356,86,59,14,291,277,7764,1891,42770,50534,7/28/2020
4/27/2020,250,8717,1624,51300,60017,29,928,21,469,4,99,360,86,61,10,301,204,7968,1171,43941,51909,7/28/2020
4/28/2020,411,9128,2268,53568,62696,44,972,24,493,3,102,377,88,59,22,323,324,8292,1778,45719,54011,7/28/2020
4/29/2020,476,9604,3351,56919,66523,36,1008,37,530,11,113,365,78,53,18,341,372,8664,2454,48173,56837,7/28/2020
4/30/2020,432,10036,2772,59691,69727,32,1040,38,568,6,119,353,83,57,24,365,348,9012,1964,50137,59149,7/28/2020
5/1/2020,457,10493,3089,62780,73273,51,1091,39,607,3,122,362,84,58,14,379,317,9329,2225,52362,61691,7/28/2020
5/2/2020,260,10753,1927,64707,75460,35,1126,39,646,5,127,353,90,61,24,403,190,9519,1299,53661,63180,7/28/2020
5/3/2020,284,11037,2168,66875,77912,31,1157,27,673,8,135,349,89,61,21,424,181,9700,1612,55273,64973,7/28/2020
5/4/2020,388,11425,2101,68976,80401,30,1187,31,704,5,140,343,87,57,18,442,293,9993,1581,56854,66847,7/28/2020
5/5/2020,436,11861,2878,71854,83715,28,1215,32,736,6,146,333,80,54,16,458,304,10297,1982,58836,69133,7/28/2020
5/6/2020,490,12351,2836,74690,87041,28,1243,44,780,9,155,308,78,54,21,479,341,10638,1936,60772,71410,7/28/2020
5/7/2020,425,12776,2975,77665,90441,36,1279,40,820,5,160,299,70,52,21,500,269,10907,1993,62765,73672,7/28/2020
5/8/2020,360,13136,2603,80268,93404,30,1309,29,849,5,165,295,70,53,22,522,231,11138,1788,64553,75691,7/28/2020
5/9/2020,457,13593,3356,83624,97217,22,1331,21,870,4,169,292,68,51,15,537,285,11423,2317,66870,78293,7/28/2020
5/10/2020,280,13873,2122,85746,99619,19,1350,23,893,6,175,282,69,49,13,550,186,11609,1531,68401,80010,7/28/2020
5/11/2020,259,14132,1861,87607,101739,31,1381,16,909,6,181,291,70,49,15,565,176,11785,1316,69717,81502,7/28/2020
5/12/2020,387,14519,2622,90229,104748,23,1404,18,927,4,185,292,68,48,22,587,217,12002,1724,71441,83443,7/28/2020
5/13/2020,352,14871,3634,93863,108734,22,1426,24,951,1,186,289,69,49,13,600,196,12198,2031,73472,85670,7/28/2020
5/14/2020,330,15201,3415,97278,112479,19,1445,27,978,3,189,278,64,45,15,615,227,12425,2025,75497,87922,7/28/2020
5/15/2020,382,15583,3470,100748,116331,24,1469,41,1019,5,194,256,62,45,13,628,234,12659,1824,77321,89980,7/28/2020
5/16/2020,438,16021,4168,104916,120937,25,1494,12,1031,5,199,264,61,46,15,643,252,12911,1979,79300,92211,7/28/2020
5/17/2020,231,16252,2775,107691,123943,17,1511,7,1038,5,204,269,59,45,10,653,124,13035,1572,80872,93907,7/28/2020
5/18/2020,251,16503,2007,109698,126201,19,1530,15,1053,5,209,268,57,40,18,671,139,13174,1376,82248,95422,7/28/2020
5/19/2020,416,16919,3178,112876,129795,23,1553,31,1084,5,214,255,56,38,11,682,214,13388,1946,84194,97582,7/28/2020
5/20/2020,328,17247,2774,115650,132897,19,1572,23,1107,7,221,244,52,33,22,704,187,13575,1527,85721,99296,7/28/2020
5/21/2020,374,17621,3764,119414,137035,26,1598,15,1122,3,224,252,53,29,20,724,170,13745,1956,87677,101422,7/28/2020
5/22/2020,351,17972,3172,122586,140558,20,1618,29,1151,5,229,238,52,29,10,734,205,13950,1622,89299,103249,7/28/2020
5/23/2020,240,18212,2748,125334,143546,19,1637,11,1162,3,232,243,52,32,13,747,109,14059,1292,90591,104650,7/28/2020
5/24/2020,153,18365,1372,126706,145071,12,1649,14,1176,2,234,239,53,36,8,755,84,14143,775,91366,105509,7/28/2020
5/25/2020,134,18499,1389,128095,146594,12,1661,14,1190,0,234,237,53,34,10,765,70,14213,765,92131,106344,7/28/2020
5/26/2020,284,18783,2624,130719,149502,24,1685,22,1212,5,239,234,48,33,15,780,154,14367,1791,93922,108289,7/28/2020
5/27/2020,276,19059,2134,132853,151912,20,1705,17,1229,3,242,234,50,33,10,790,132,14499,1147,95069,109568,7/28/2020
5/28/2020,346,19405,3384,136237,155642,17,1722,29,1258,4,246,218,47,32,8,798,132,14631,1134,96203,110834,7/28/2020
5/29/2020,419,19824,3989,140226,160050,18,1740,27,1285,6,252,203,43,31,12,810,179,14810,1597,97800,112610,7/28/2020
5/30/2020,211,20035,3973,144199,164234,15,1755,19,1304,4,256,195,40,29,12,822,104,14914,1828,99628,114542,7/28/2020
5/31/2020,148,20183,1753,145952,166135,10,1765,10,1314,0,256,195,43,26,3,825,76,14990,856,100484,115474,7/28/2020
6/1/2020,216,20399,2813,148765,169164,7,1772,13,1327,1,257,188,44,29,5,830,99,15089,1378,101862,116951,7/28/2020
6/2/2020,273,20672,3080,151845,172517,8,1780,9,1336,3,260,184,37,25,10,840,107,15196,1470,103332,118528,7/28/2020
6/3/2020,259,20931,3509,155354,176285,13,1793,18,1354,6,266,173,34,25,11,851,105,15301,1672,105004,120305,7/28/2020
6/4/2020,281,21212,4522,159876,181088,7,1800,25,1379,3,269,152,31,24,11,862,114,15415,2043,107047,122462,7/28/2020
6/5/2020,215,21427,3583,163459,184886,15,1815,12,1391,5,274,150,27,21,9,871,104,15519,1580,108627,124146,7/28/2020
6/6/2020,198,21625,2622,166081,187706,10,1825,7,1398,2,276,151,29,19,6,877,68,15587,1135,109762,125349,7/28/2020
6/7/2020,77,21702,1614,167695,189397,11,1836,7,1405,1,277,154,25,17,4,881,49,15636,777,110539,126175,7/28/2020
6/8/2020,122,21824,1847,169542,191366,15,1851,12,1417,2,279,155,27,18,4,885,44,15680,966,111505,127185,7/28/2020
6/9/2020,225,22049,2674,172216,194265,10,1861,18,1435,0,279,147,28,21,1,886,67,15747,1263,112768,128515,7/28/2020
6/10/2020,210,22259,2983,175199,197458,13,1874,12,1447,2,281,146,24,17,3,889,104,15851,1461,114229,130080,7/28/2020
6/11/2020,195,22454,3498,178697,201151,7,1881,15,1462,1,282,137,25,16,6,895,88,15939,1528,115757,131696,7/28/2020
6/12/2020,213,22667,4603,183300,205967,8,1889,15,1477,1,283,129,24,16,2,897,80,16019,2193,117950,133969,7/28/2020
6/13/2020,111,22778,3028,186328,209106,6,1895,4,1481,0,283,131,20,15,3,900,50,16069,1368,119318,135387,7/28/2020
6/14/2020,78,22856,2037,188365,211221,6,1901,8,1489,1,284,128,20,14,3,903,32,16101,966,120284,136385,7/28/2020
6/15/2020,189,23045,3105,191470,214515,14,1915,14,1503,0,284,128,20,16,4,907,78,16179,1790,122074,138253,7/28/2020
6/16/2020,115,23160,3010,194480,217640,10,1925,10,1513,1,285,127,22,16,8,915,52,16231,1583,123657,139888,7/28/2020
6/17/2020,123,23283,2826,197306,220589,15,1940,20,1533,4,289,118,18,14,6,921,52,16283,1314,124971,141254,7/28/2020
6/18/2020,150,23433,3039,200345,223778,9,1949,13,1546,1,290,113,19,16,7,928,70,16353,1331,126302,142655,7/28/2020
6/19/2020,141,23574,3761,204106,227680,12,1961,11,1557,1,291,113,20,17,3,931,59,16412,1375,127677,144089,7/28/2020
6/20/2020,80,23654,1883,205989,229643,7,1968,9,1566,0,291,111,20,18,4,935,36,16448,814,128491,144939,7/28/2020
6/21/2020,36,23690,1042,207031,230721,7,1975,5,1571,0,291,113,20,18,2,937,27,16475,679,129170,145645,7/28/2020
6/22/2020,142,23832,3713,210744,234576,12,1987,16,1587,0,291,109,19,18,1,938,70,16545,1703,130873,147418,7/28/2020
6/23/2020,162,23994,3850,214594,238588,3,1990,13,1600,3,294,96,18,18,6,944,83,16628,1795,132668,149296,7/28/2020
6/24/2020,121,24115,3508,218102,242217,8,1998,10,1610,1,295,93,17,18,5,949,47,16675,1694,134362,151037,7/28/2020
6/25/2020,102,24217,2885,220987,245204,5,2003,14,1624,1,296,83,16,17,1,950,53,16728,1508,135870,152598,7/28/2020
6/26/2020,94,24311,2454,223441,247752,2,2005,9,1633,0,296,76,17,18,1,951,63,16791,1305,137175,153966,7/28/2020
6/27/2020,84,24395,3212,226653,251048,5,2010,3,1636,1,297,77,16,17,5,956,37,16828,1214,138389,155217,7/28/2020
6/28/2020,37,24432,1452,228105,252537,4,2014,4,1640,4,301,73,14,14,6,962,18,16846,587,138976,155822,7/28/2020
6/29/2020,86,24518,3672,231777,256295,4,2018,5,1645,0,301,72,13,14,1,963,38,16884,1343,140319,157203,7/28/2020
6/30/2020,60,24578,1945,233722,258300,1,2019,5,1650,1,302,67,11,11,3,966,35,16919,994,141313,158232,7/28/2020
7/1/2020,145,24723,4106,237828,262551,7,2026,9,1659,0,302,65,10,11,1,967,80,16999,1955,143268,160267,7/28/2020
7/2/2020,101,24824,2778,240606,265430,5,2031,5,1664,1,303,64,8,9,1,968,56,17055,1075,144343,161398,7/28/2020
7/3/2020,47,24871,2013,242619,267490,7,2038,6,1670,0,303,65,7,8,3,971,23,17078,773,145116,162194,7/28/2020
7/4/2020,57,24928,2320,244939,269867,2,2040,4,1674,1,304,62,8,8,2,973,33,17111,991,146107,163218,7/28/2020
7/5/2020,47,24975,2924,247863,272838,1,2041,2,1676,1,305,60,6,7,2,975,22,17133,1444,147551,164684,7/28/2020
7/6/2020,103,25078,2790,250653,275731,6,2047,6,1682,0,305,60,8,9,4,979,61,17194,1543,149094,166288,7/28/2020
7/7/2020,80,25158,3438,254091,279249,5,2052,6,1688,0,305,59,7,8,1,980,45,17239,1532,150626,167865,7/28/2020
7/8/2020,104,25262,3381,257472,282734,4,2056,2,1690,0,305,61,8,8,0,980,64,17303,1418,152044,169347,7/28/2020
7/9/2020,94,25356,3658,261130,286486,7,2063,2,1692,0,305,66,8,8,0,980,50,17353,1596,153640,170993,7/28/2020
7/10/2020,129,25485,4387,265517,291002,5,2068,3,1695,2,307,66,7,7,3,983,79,17432,2079,155719,173151,7/28/2020
7/11/2020,63,25548,2881,268398,293946,6,2074,3,1698,1,308,68,6,6,3,986,36,17468,1279,156998,174466,7/28/2020
7/12/2020,45,25593,1764,270162,295755,1,2075,2,1700,1,309,66,6,5,3,989,30,17498,886,157884,175382,7/28/2020
7/13/2020,85,25678,3142,273304,298982,7,2082,10,1710,0,309,63,6,5,1,990,57,17555,1472,159356,176911,7/28/2020
7/14/2020,75,25753,3246,276550,302303,7,2089,4,1714,0,309,66,5,5,1,991,48,17603,1349,160705,178308,7/28/2020
7/15/2020,123,25876,4118,280668,306544,4,2093,6,1720,0,309,64,5,4,0,991,91,17694,1725,162430,180124,7/28/2020
7/16/2020,102,25978,3678,284346,310324,6,2099,8,1728,0,309,62,5,4,1,992,80,17774,1585,164015,181789,7/28/2020
7/17/2020,151,26129,4114,288460,314589,14,2113,3,1731,1,310,72,4,4,0,992,81,17855,1804,165819,183674,7/28/2020
7/18/2020,80,26209,3141,291601,317810,5,2118,9,1740,1,311,67,4,3,4,996,71,17926,1356,167175,185101,7/28/2020
7/19/2020,82,26291,2577,294178,320469,6,2124,3,1743,0,311,70,5,3,2,998,58,17984,1071,168246,186230,7/28/2020
7/20/2020,72,26363,2592,296770,323133,8,2132,7,1750,0,311,71,6,4,2,1000,62,18046,1444,169690,187736,7/28/2020
7/21/2020,128,26491,4212,300982,327473,9,2141,10,1760,0,311,70,8,5,1,1001,107,18153,1873,171563,189716,7/28/2020
7/22/2020,123,26614,3783,304765,331379,11,2152,11,1771,0,311,70,7,6,1,1002,84,18237,1577,173140,191377,7/28/2020
7/23/2020,123,26737,4055,308820,335557,6,2158,5,1776,0,311,71,8,7,0,1002,101,18338,1756,174896,193234,7/28/2020
7/24/2020,161,26898,5672,314492,341390,11,2169,12,1788,0,311,70,9,7,0,1002,115,18453,2150,177046,195499,7/28/2020
7/25/2020,126,27024,4244,318736,345760,7,2176,7,1795,0,311,70,10,7,1,1003,103,18556,1989,179035,197591,7/28/2020
7/26/2020,55,27079,2952,321688,348767,6,2182,8,1803,0,311,68,10,7,1,1004,50,18606,1300,180335,198941,7/28/2020
7/27/2020,168,27247,3565,325253,352500,,,,,,,,,,1,1005,119,18725,1900,182235,200960,7/28/2020
2/27/2020,0,0,0,0,0,1,1,0,0,0,0,1,0,0,0,0,0,0,0,0,0,7/29/2020
2/28/2020,0,0,0,0,0,0,1,0,0,0,0,1,1,0,0,0,0,0,0,0,0,7/29/2020
2/29/2020,0,0,0,0,0,0,1,0,0,0,0,1,1,0,0,0,0,0,0,0,0,7/29/2020
3/1/2020,2,2,2,2,4,0,1,0,0,0,0,1,1,1,0,0,2,2,2,2,4,7/29/2020
3/2/2020,0,2,1,3,5,1,2,0,0,0,0,2,2,2,0,0,0,2,1,3,5,7/29/2020
3/3/2020,0,2,2,5,7,0,2,0,0,0,0,2,2,2,0,0,0,2,2,5,7,7/29/2020
3/4/2020,0,2,12,17,19,1,3,0,0,0,0,3,2,2,0,0,0,2,10,15,17,7/29/2020
3/5/2020,0,2,4,21,23,0,3,0,0,0,0,3,2,2,0,0,1,3,4,19,22,7/29/2020
3/6/2020,1,3,12,33,36,0,3,0,0,0,0,3,2,2,0,0,0,3,11,30,33,7/29/2020
3/7/2020,0,3,19,52,55,0,3,0,0,0,0,3,2,1,0,0,0,3,19,49,52,7/29/2020
3/8/2020,0,3,18,70,73,0,3,0,0,0,0,3,2,1,0,0,0,3,18,67,70,7/29/2020
3/9/2020,1,4,15,85,89,0,3,0,0,0,0,3,2,1,0,0,1,4,15,82,86,7/29/2020
3/10/2020,2,6,25,110,116,0,3,0,0,0,0,3,2,1,0,0,1,5,23,105,110,7/29/2020
3/11/2020,0,6,34,144,150,1,4,0,0,0,0,4,1,1,0,0,0,5,34,139,144,7/29/2020
3/12/2020,9,15,42,186,201,1,5,0,0,0,0,5,1,1,0,0,8,13,38,177,190,7/29/2020
3/13/2020,6,21,50,236,257,4,9,1,1,0,0,8,1,1,0,0,6,19,48,225,244,7/29/2020
3/14/2020,0,21,90,326,347,0,9,0,1,0,0,8,1,1,0,0,0,19,86,311,330,7/29/2020
3/15/2020,1,22,54,380,402,1,10,0,1,0,0,9,2,1,0,0,1,20,54,365,385,7/29/2020
3/16/2020,2,24,95,475,499,2,12,0,1,0,0,11,2,0,0,0,2,22,92,457,479,7/29/2020
3/17/2020,16,40,162,637,677,6,18,0,1,0,0,17,2,0,0,0,11,33,153,610,643,7/29/2020
3/18/2020,12,52,116,753,805,3,21,0,1,0,0,20,2,0,0,0,11,44,111,721,765,7/29/2020
3/19/2020,17,69,262,1015,1084,2,23,1,2,0,0,21,3,0,1,1,17,61,251,972,1033,7/29/2020
3/20/2020,15,84,197,1212,1296,5,28,0,2,0,0,26,4,0,0,1,13,74,193,1165,1239,7/29/2020
3/21/2020,21,105,126,1338,1443,3,31,2,4,0,0,27,5,0,0,1,14,88,123,1288,1376,7/29/2020
3/22/2020,30,135,282,1620,1755,2,33,0,4,0,0,29,5,0,0,1,25,113,265,1553,1666,7/29/2020
3/23/2020,14,149,169,1789,1938,15,48,1,5,0,0,43,9,3,0,1,16,129,165,1718,1847,7/29/2020
3/24/2020,20,169,243,2032,2201,7,55,0,5,0,0,50,10,4,0,1,19,148,238,1956,2104,7/29/2020
3/25/2020,26,195,183,2215,2410,5,60,1,6,0,0,54,11,3,0,1,28,176,173,2129,2305,7/29/2020
3/26/2020,35,230,181,2396,2626,10,70,5,11,0,0,59,14,5,0,1,41,217,176,2305,2522,7/29/2020
3/27/2020,27,257,215,2611,2868,9,79,1,12,1,1,66,17,6,2,3,31,248,202,2507,2755,7/29/2020
3/28/2020,59,316,260,2871,3187,13,92,3,15,2,3,74,15,6,1,4,63,311,242,2749,3060,7/29/2020
3/29/2020,106,422,356,3227,3649,8,100,4,19,1,4,77,18,8,2,6,105,416,314,3063,3479,7/29/2020
3/30/2020,62,484,222,3449,3933,20,120,5,24,0,4,92,20,11,3,9,78,494,192,3255,3749,7/29/2020
3/31/2020,71,555,369,3818,4373,11,131,7,31,1,5,95,22,13,2,11,73,567,299,3554,4121,7/29/2020
4/1/2020,99,654,699,4517,5171,18,149,7,38,0,5,106,30,15,1,12,100,667,649,4203,4870,7/29/2020
4/2/2020,52,706,477,4994,5700,21,170,6,44,2,7,119,36,21,4,16,62,729,436,4639,5368,7/29/2020
4/3/2020,108,814,775,5769,6583,23,193,7,51,0,7,135,43,25,3,19,100,829,718,5357,6186,7/29/2020
4/4/2020,143,957,660,6429,7386,22,215,4,55,5,12,148,41,30,9,28,137,966,623,5980,6946,7/29/2020
4/5/2020,187,1144,1156,7585,8729,20,235,9,64,1,13,158,44,36,2,30,182,1148,1072,7052,8200,7/29/2020
4/6/2020,218,1362,1707,9292,10654,26,261,7,71,0,13,177,48,40,7,37,206,1354,1580,8632,9986,7/29/2020
4/7/2020,285,1647,1631,10923,12570,20,281,3,74,2,15,192,49,42,5,42,260,1614,1491,10123,11737,7/29/2020
4/8/2020,290,1937,1723,12646,14583,19,300,7,81,6,21,198,49,38,10,52,272,1886,1572,11695,13581,7/29/2020
4/9/2020,284,2221,1521,14167,16388,32,332,9,90,4,25,217,52,40,7,59,278,2164,1366,13061,15225,7/29/2020
4/10/2020,420,2641,2577,16744,19385,29,361,17,107,5,30,224,58,41,11,70,404,2568,2381,15442,18010,7/29/2020
4/11/2020,299,2940,1911,18655,21595,29,390,11,118,2,32,240,61,48,12,82,280,2848,1730,17172,20020,7/29/2020
4/12/2020,315,3255,1674,20329,23584,35,425,13,131,5,37,257,59,49,10,92,289,3137,1451,18623,21760,7/29/2020
4/13/2020,162,3417,938,21267,24684,35,460,13,144,3,40,276,64,54,9,101,187,3324,845,19468,22792,7/29/2020
4/14/2020,289,3706,1788,23055,26761,27,487,17,161,5,45,281,72,53,8,109,265,3589,1556,21024,24613,7/29/2020
4/15/2020,353,4059,1803,24858,28917,31,518,19,180,3,48,290,72,54,17,126,307,3896,1579,22603,26499,7/29/2020
4/16/2020,449,4508,2500,27358,31866,36,554,25,205,6,54,295,72,53,14,140,392,4288,2097,24700,28988,7/29/2020
4/17/2020,308,4816,1823,29181,33997,32,586,20,225,7,61,300,66,45,21,161,291,4579,1476,26176,30755,7/29/2020
4/18/2020,322,5138,1728,30909,36047,26,612,18,243,4,65,304,63,49,15,176,284,4863,1362,27538,32401,7/29/2020
4/19/2020,382,5520,2059,32968,38488,23,635,26,269,1,66,300,65,55,11,187,338,5201,1760,29298,34499,7/29/2020
4/20/2020,396,5916,1909,34877,40793,46,681,29,298,2,68,315,75,56,10,197,377,5578,1592,30890,36468,7/29/2020
4/21/2020,445,6361,2114,36991,43352,45,726,31,329,5,73,324,72,56,18,215,388,5966,1726,32616,38582,7/29/2020
4/22/2020,420,6781,2398,39389,46170,41,767,32,361,5,78,328,73,58,18,233,382,6348,1925,34541,40889,7/29/2020
4/23/2020,482,7263,2471,41860,49123,30,797,28,389,5,83,325,76,62,15,248,420,6768,1890,36431,43199,7/29/2020
4/24/2020,494,7757,3292,45152,52909,35,832,27,416,4,87,329,85,63,15,263,414,7182,2652,39083,46265,7/29/2020
4/25/2020,394,8151,2210,47362,55513,34,866,17,433,5,92,341,85,62,14,277,305,7487,1787,40870,48357,7/29/2020
4/26/2020,316,8467,2314,49676,58143,33,899,15,448,3,95,356,86,59,14,291,277,7764,1891,42761,50525,7/29/2020
4/27/2020,250,8717,1624,51300,60017,29,928,21,469,4,99,360,86,61,10,301,204,7968,1170,43931,51899,7/29/2020
4/28/2020,411,9128,2268,53568,62696,44,972,24,493,3,102,377,88,59,22,323,324,8292,1777,45708,54000,7/29/2020
4/29/2020,476,9604,3351,56919,66523,36,1008,37,530,11,113,365,78,53,18,341,372,8664,2454,48162,56826,7/29/2020
4/30/2020,432,10036,2772,59691,69727,32,1040,38,568,6,119,353,83,57,24,365,348,9012,1964,50126,59138,7/29/2020
5/1/2020,457,10493,3089,62780,73273,51,1091,39,607,3,122,362,84,58,14,379,317,9329,2225,52351,61680,7/29/2020
5/2/2020,260,10753,1927,64707,75460,35,1126,39,646,5,127,353,90,61,24,403,190,9519,1299,53650,63169,7/29/2020
5/3/2020,284,11037,2168,66875,77912,31,1157,27,673,8,135,349,89,61,21,424,181,9700,1612,55262,64962,7/29/2020
5/4/2020,388,11425,2101,68976,80401,30,1187,31,704,5,140,343,87,57,18,442,293,9993,1581,56843,66836,7/29/2020
5/5/2020,436,11861,2878,71854,83715,28,1215,32,736,6,146,333,80,54,16,458,304,10297,1982,58825,69122,7/29/2020
5/6/2020,490,12351,2836,74690,87041,28,1243,44,780,9,155,308,78,54,21,479,341,10638,1936,60761,71399,7/29/2020
5/7/2020,425,12776,2975,77665,90441,36,1279,40,820,5,160,299,70,52,21,500,269,10907,1993,62754,73661,7/29/2020
5/8/2020,360,13136,2603,80268,93404,30,1309,29,849,5,165,295,70,53,22,522,231,11138,1788,64542,75680,7/29/2020
5/9/2020,457,13593,3356,83624,97217,22,1331,21,870,4,169,292,68,51,15,537,285,11423,2317,66859,78282,7/29/2020
5/10/2020,280,13873,2122,85746,99619,19,1350,23,893,6,175,282,69,49,13,550,186,11609,1531,68390,79999,7/29/2020
5/11/2020,259,14132,1861,87607,101739,31,1381,16,909,6,181,291,70,49,15,565,176,11785,1316,69706,81491,7/29/2020
5/12/2020,387,14519,2622,90229,104748,23,1404,18,927,4,185,292,68,48,22,587,217,12002,1724,71430,83432,7/29/2020
5/13/2020,352,14871,3634,93863,108734,22,1426,24,951,1,186,289,69,49,13,600,196,12198,2031,73461,85659,7/29/2020
5/14/2020,330,15201,3415,97278,112479,19,1445,27,978,3,189,278,64,45,15,615,227,12425,2024,75485,87910,7/29/2020
5/15/2020,382,15583,3470,100748,116331,24,1469,41,1019,5,194,256,62,45,13,628,234,12659,1823,77308,89967,7/29/2020
5/16/2020,438,16021,4168,104916,120937,25,1494,12,1031,5,199,264,61,46,15,643,252,12911,1978,79286,92197,7/29/2020
5/17/2020,231,16252,2775,107691,123943,17,1511,7,1038,5,204,269,59,45,10,653,124,13035,1572,80858,93893,7/29/2020
5/18/2020,251,16503,2007,109698,126201,19,1530,15,1053,5,209,268,57,40,18,671,139,13174,1376,82234,95408,7/29/2020
5/19/2020,416,16919,3178,112876,129795,23,1553,31,1084,5,214,255,56,38,11,682,214,13388,1945,84179,97567,7/29/2020
5/20/2020,328,17247,2774,115650,132897,19,1572,23,1107,7,221,244,52,33,22,704,187,13575,1527,85706,99281,7/29/2020
5/21/2020,374,17621,3764,119414,137035,26,1598,15,1122,3,224,252,53,29,20,724,170,13745,1954,87660,101405,7/29/2020
5/22/2020,351,17972,3172,122586,140558,20,1618,29,1151,5,229,238,52,29,10,734,205,13950,1621,89281,103231,7/29/2020
5/23/2020,240,18212,2748,125334,143546,19,1637,11,1162,3,232,243,52,32,13,747,109,14059,1292,90573,104632,7/29/2020
5/24/2020,153,18365,1372,126706,145071,12,1649,14,1176,2,234,239,53,36,8,755,84,14143,775,91348,105491,7/29/2020
5/25/2020,134,18499,1389,128095,146594,12,1661,14,1190,0,234,237,53,34,10,765,70,14213,765,92113,106326,7/29/2020
5/26/2020,284,18783,2624,130719,149502,24,1685,22,1212,5,239,234,48,33,15,780,155,14368,1790,93903,108271,7/29/2020
5/27/2020,276,19059,2134,132853,151912,20,1705,17,1229,3,242,234,50,33,10,790,132,14500,1147,95050,109550,7/29/2020
5/28/2020,346,19405,3384,136237,155642,17,1722,29,1258,4,246,218,47,32,8,798,132,14632,1134,96184,110816,7/29/2020
5/29/2020,419,19824,3989,140226,160050,18,1740,27,1285,6,252,203,43,31,12,810,179,14811,1597,97781,112592,7/29/2020
5/30/2020,211,20035,3973,144199,164234,15,1755,19,1304,4,256,195,40,29,12,822,104,14915,1828,99609,114524,7/29/2020
5/31/2020,148,20183,1753,145952,166135,10,1765,10,1314,0,256,195,43,26,3,825,76,14991,856,100465,115456,7/29/2020
6/1/2020,216,20399,2813,148765,169164,7,1772,13,1327,1,257,188,44,29,5,830,99,15090,1378,101843,116933,7/29/2020
6/2/2020,273,20672,3080,151845,172517,8,1780,9,1336,3,260,184,37,25,10,840,107,15197,1470,103313,118510,7/29/2020
6/3/2020,259,20931,3509,155354,176285,13,1793,18,1354,6,266,173,34,25,11,851,105,15302,1672,104985,120287,7/29/2020
6/4/2020,281,21212,4522,159876,181088,7,1800,25,1379,3,269,152,31,24,11,862,114,15416,2042,107027,122443,7/29/2020
6/5/2020,215,21427,3583,163459,184886,15,1815,12,1391,5,274,150,27,21,9,871,104,15520,1580,108607,124127,7/29/2020
6/6/2020,198,21625,2622,166081,187706,10,1825,7,1398,2,276,151,29,19,6,877,68,15588,1135,109742,125330,7/29/2020
6/7/2020,77,21702,1614,167695,189397,11,1836,7,1405,1,277,154,25,17,4,881,49,15637,777,110519,126156,7/29/2020
6/8/2020,122,21824,1847,169542,191366,15,1851,12,1417,2,279,155,27,18,4,885,44,15681,965,111484,127165,7/29/2020
6/9/2020,225,22049,2674,172216,194265,10,1861,18,1435,0,279,147,28,21,1,886,67,15748,1263,112747,128495,7/29/2020
6/10/2020,210,22259,2983,175199,197458,13,1874,12,1447,2,281,146,24,17,3,889,104,15852,1460,114207,130059,7/29/2020
6/11/2020,195,22454,3499,178698,201152,7,1881,15,1462,1,282,137,25,16,6,895,88,15940,1529,115736,131676,7/29/2020
6/12/2020,213,22667,4603,183301,205968,8,1889,15,1477,1,283,129,24,16,2,897,80,16020,2192,117928,133948,7/29/2020
6/13/2020,111,22778,3028,186329,209107,6,1895,4,1481,0,283,131,20,15,3,900,50,16070,1368,119296,135366,7/29/2020
6/14/2020,78,22856,2037,188366,211222,6,1901,8,1489,1,284,128,20,14,3,903,32,16102,966,120262,136364,7/29/2020
6/15/2020,189,23045,3105,191471,214516,14,1915,14,1503,0,284,128,20,16,4,907,78,16180,1789,122051,138231,7/29/2020
6/16/2020,115,23160,3010,194481,217641,11,1926,10,1513,1,285,128,22,16,8,915,52,16232,1582,123633,139865,7/29/2020
6/17/2020,123,23283,2826,197307,220590,15,1941,20,1533,4,289,119,18,14,6,921,52,16284,1314,124947,141231,7/29/2020
6/18/2020,150,23433,3039,200346,223779,9,1950,13,1546,1,290,114,19,16,7,928,70,16354,1331,126278,142632,7/29/2020
6/19/2020,141,23574,3761,204107,227681,12,1962,11,1557,1,291,114,20,17,3,931,59,16413,1375,127653,144066,7/29/2020
6/20/2020,80,23654,1883,205990,229644,7,1969,9,1566,0,291,112,20,18,4,935,36,16449,814,128467,144916,7/29/2020
6/21/2020,36,23690,1042,207032,230722,7,1976,5,1571,0,291,114,20,18,2,937,27,16476,679,129146,145622,7/29/2020
6/22/2020,142,23832,3713,210745,234577,12,1988,16,1587,0,291,110,19,18,1,938,70,16546,1703,130849,147395,7/29/2020
6/23/2020,162,23994,3850,214595,238589,3,1991,13,1600,3,294,97,18,18,6,944,83,16629,1794,132643,149272,7/29/2020
6/24/2020,121,24115,3508,218103,242218,8,1999,10,1610,1,295,94,17,18,5,949,47,16676,1693,134336,151012,7/29/2020
6/25/2020,102,24217,2885,220988,245205,5,2004,14,1624,1,296,84,16,17,1,950,53,16729,1508,135844,152573,7/29/2020
6/26/2020,94,24311,2454,223442,247753,2,2006,9,1633,0,296,77,17,18,1,951,63,16792,1305,137149,153941,7/29/2020
6/27/2020,84,24395,3212,226654,251049,5,2011,3,1636,1,297,78,16,17,5,956,37,16829,1214,138363,155192,7/29/2020
6/28/2020,37,24432,1452,228106,252538,4,2015,4,1640,4,301,74,14,14,6,962,18,16847,586,138949,155796,7/29/2020
6/29/2020,86,24518,3673,231779,256297,4,2019,5,1645,0,301,73,13,14,1,963,38,16885,1343,140292,157177,7/29/2020
6/30/2020,60,24578,1945,233724,258302,1,2020,5,1650,1,302,68,11,11,3,966,35,16920,994,141286,158206,7/29/2020
7/1/2020,145,24723,4106,237830,262553,7,2027,9,1659,0,302,66,10,11,1,967,81,17001,1955,143241,160242,7/29/2020
7/2/2020,101,24824,2778,240608,265432,5,2032,5,1664,1,303,65,8,9,1,968,56,17057,1075,144316,161373,7/29/2020
7/3/2020,47,24871,2013,242621,267492,7,2039,6,1670,0,303,66,7,8,3,971,25,17082,772,145088,162170,7/29/2020
7/4/2020,57,24928,2320,244941,269869,2,2041,4,1674,1,304,63,8,8,2,973,34,17116,991,146079,163195,7/29/2020
7/5/2020,47,24975,2924,247865,272840,1,2042,2,1676,1,305,61,6,7,2,975,22,17138,1444,147523,164661,7/29/2020
7/6/2020,103,25078,2790,250655,275733,6,2048,6,1682,0,305,61,8,9,4,979,60,17198,1543,149066,166264,7/29/2020
7/7/2020,80,25158,3438,254093,279251,5,2053,6,1688,0,305,60,7,8,1,980,47,17245,1533,150599,167844,7/29/2020
7/8/2020,104,25262,3381,257474,282736,4,2057,2,1690,0,305,62,8,8,0,980,66,17311,1418,152017,169328,7/29/2020
7/9/2020,94,25356,3658,261132,286488,7,2064,2,1692,0,305,67,8,8,0,980,50,17361,1596,153613,170974,7/29/2020
7/10/2020,129,25485,4387,265519,291004,5,2069,3,1695,2,307,67,7,7,3,983,79,17440,2079,155692,173132,7/29/2020
7/11/2020,63,25548,2881,268400,293948,6,2075,3,1698,1,308,69,6,6,3,986,34,17474,1278,156970,174444,7/29/2020
7/12/2020,45,25593,1764,270164,295757,1,2076,2,1700,1,309,67,6,5,3,989,32,17506,887,157857,175363,7/29/2020
7/13/2020,85,25678,3142,273306,298984,7,2083,10,1710,0,309,64,6,5,1,990,57,17563,1469,159326,176889,7/29/2020
7/14/2020,75,25753,3246,276552,302305,7,2090,4,1714,0,309,67,5,5,1,991,49,17612,1349,160675,178287,7/29/2020
7/15/2020,123,25876,4118,280670,306546,4,2094,6,1720,0,309,65,5,4,0,991,91,17703,1726,162401,180104,7/29/2020
7/16/2020,102,25978,3678,284348,310326,6,2100,8,1728,0,309,63,5,4,1,992,80,17783,1585,163986,181769,7/29/2020
7/17/2020,151,26129,4114,288462,314591,14,2114,3,1731,1,310,73,4,4,1,993,79,17862,1804,165790,183652,7/29/2020
7/18/2020,80,26209,3141,291603,317812,5,2119,9,1740,1,311,68,4,3,4,997,69,17931,1356,167146,185077,7/29/2020
7/19/2020,82,26291,2577,294180,320471,6,2125,3,1743,0,311,71,5,3,2,999,58,17989,1071,168217,186206,7/29/2020
7/20/2020,72,26363,2592,296772,323135,9,2134,7,1750,0,311,73,6,4,2,1001,64,18053,1444,169661,187714,7/29/2020
7/21/2020,128,26491,4212,300984,327475,9,2143,10,1760,0,311,72,8,5,1,1002,106,18159,1872,171533,189692,7/29/2020
7/22/2020,123,26614,3783,304767,331381,11,2154,11,1771,0,311,72,7,6,1,1003,86,18245,1578,173111,191356,7/29/2020
7/23/2020,123,26737,4055,308822,335559,6,2160,5,1776,0,311,73,8,7,0,1003,103,18348,1756,174867,193215,7/29/2020
7/24/2020,161,26898,5672,314494,341392,11,2171,12,1788,0,311,72,9,7,0,1003,117,18465,2150,177017,195482,7/29/2020
7/25/2020,126,27024,4257,318751,345775,7,2178,7,1795,0,311,72,10,7,1,1004,104,18569,2000,179017,197586,7/29/2020
7/26/2020,56,27080,2957,321708,348788,7,2185,8,1803,0,311,71,11,5,1,1005,51,18620,1305,180322,198942,7/29/2020
7/27/2020,182,27262,3862,325570,352832,10,2195,7,1810,0,311,74,12,6,1,1006,119,18739,2105,182427,201166,7/29/2020
7/28/2020,86,27348,3268,328838,356186,,,,,,,,,,1,1007,61,18800,1238,183665,202465,7/29/2020
2/27/2020,0,0,0,0,0,1,1,0,0,0,0,1,0,0,0,0,0,0,0,0,0,7/30/2020
2/28/2020,0,0,0,0,0,0,1,0,0,0,0,1,1,0,0,0,0,0,0,0,0,7/30/2020
2/29/2020,0,0,0,0,0,0,1,0,0,0,0,1,1,0,0,0,0,0,0,0,0,7/30/2020
3/1/2020,2,2,2,2,4,0,1,0,0,0,0,1,1,1,0,0,2,2,2,2,4,7/30/2020
3/2/2020,0,2,1,3,5,1,2,0,0,0,0,2,2,2,0,0,0,2,1,3,5,7/30/2020
3/3/2020,0,2,2,5,7,0,2,0,0,0,0,2,2,2,0,0,0,2,2,5,7,7/30/2020
3/4/2020,0,2,12,17,19,1,3,0,0,0,0,3,2,2,0,0,0,2,10,15,17,7/30/2020
3/5/2020,0,2,4,21,23,0,3,0,0,0,0,3,2,2,0,0,1,3,4,19,22,7/30/2020
3/6/2020,1,3,12,33,36,0,3,0,0,0,0,3,2,2,0,0,0,3,11,30,33,7/30/2020
3/7/2020,0,3,19,52,55,0,3,0,0,0,0,3,2,1,0,0,0,3,19,49,52,7/30/2020
3/8/2020,0,3,18,70,73,0,3,0,0,0,0,3,2,1,0,0,0,3,18,67,70,7/30/2020
3/9/2020,1,4,15,85,89,0,3,0,0,0,0,3,2,1,0,0,1,4,15,82,86,7/30/2020
3/10/2020,2,6,25,110,116,0,3,0,0,0,0,3,2,1,0,0,1,5,23,105,110,7/30/2020
3/11/2020,0,6,34,144,150,1,4,0,0,0,0,4,1,1,0,0,0,5,34,139,144,7/30/2020
3/12/2020,9,15,42,186,201,1,5,0,0,0,0,5,1,1,0,0,8,13,38,177,190,7/30/2020
3/13/2020,6,21,50,236,257,4,9,1,1,0,0,8,1,1,0,0,6,19,48,225,244,7/30/2020
3/14/2020,0,21,90,326,347,0,9,0,1,0,0,8,1,1,0,0,0,19,86,311,330,7/30/2020
3/15/2020,1,22,54,380,402,1,10,0,1,0,0,9,2,1,0,0,1,20,54,365,385,7/30/2020
3/16/2020,2,24,95,475,499,2,12,0,1,0,0,11,2,0,0,0,2,22,92,457,479,7/30/2020
3/17/2020,16,40,162,637,677,6,18,0,1,0,0,17,2,0,0,0,11,33,153,610,643,7/30/2020
3/18/2020,12,52,116,753,805,3,21,0,1,0,0,20,2,0,0,0,11,44,111,721,765,7/30/2020
3/19/2020,17,69,262,1015,1084,2,23,1,2,0,0,21,3,0,1,1,17,61,251,972,1033,7/30/2020
3/20/2020,15,84,197,1212,1296,5,28,0,2,0,0,26,4,0,0,1,13,74,193,1165,1239,7/30/2020
3/21/2020,21,105,126,1338,1443,3,31,2,4,0,0,27,5,0,0,1,14,88,123,1288,1376,7/30/2020
3/22/2020,30,135,282,1620,1755,2,33,0,4,0,0,29,5,0,0,1,25,113,264,1552,1665,7/30/2020
3/23/2020,14,149,169,1789,1938,15,48,1,5,0,0,43,9,3,0,1,16,129,165,1717,1846,7/30/2020
3/24/2020,20,169,243,2032,2201,7,55,0,5,0,0,50,10,4,0,1,19,148,238,1955,2103,7/30/2020
3/25/2020,26,195,183,2215,2410,5,60,1,6,0,0,54,11,3,0,1,28,176,173,2128,2304,7/30/2020
3/26/2020,35,230,181,2396,2626,10,70,5,11,0,0,59,14,5,0,1,41,217,176,2304,2521,7/30/2020
3/27/2020,27,257,215,2611,2868,9,79,1,12,1,1,66,17,6,2,3,31,248,202,2506,2754,7/30/2020
3/28/2020,59,316,260,2871,3187,13,92,3,15,2,3,74,15,6,1,4,63,311,242,2748,3059,7/30/2020
3/29/2020,106,422,356,3227,3649,8,100,4,19,1,4,77,18,8,2,6,105,416,314,3062,3478,7/30/2020
3/30/2020,62,484,222,3449,3933,20,120,5,24,0,4,92,20,11,3,9,78,494,192,3254,3748,7/30/2020
3/31/2020,71,555,369,3818,4373,11,131,7,31,1,5,95,22,13,2,11,73,567,299,3553,4120,7/30/2020
4/1/2020,99,654,699,4517,5171,18,149,7,38,0,5,106,30,15,1,12,100,667,649,4202,4869,7/30/2020
4/2/2020,52,706,477,4994,5700,21,170,6,44,2,7,119,36,21,4,16,62,729,436,4638,5367,7/30/2020
4/3/2020,108,814,775,5769,6583,23,193,7,51,0,7,135,43,25,3,19,100,829,718,5356,6185,7/30/2020
4/4/2020,143,957,660,6429,7386,22,215,4,55,5,12,148,41,30,9,28,137,966,623,5979,6945,7/30/2020
4/5/2020,187,1144,1156,7585,8729,20,235,9,64,1,13,158,44,36,2,30,182,1148,1072,7051,8199,7/30/2020
4/6/2020,218,1362,1707,9292,10654,26,261,7,71,0,13,177,48,40,7,37,206,1354,1579,8630,9984,7/30/2020
4/7/2020,285,1647,1631,10923,12570,20,281,3,74,2,15,192,49,42,5,42,260,1614,1491,10121,11735,7/30/2020
4/8/2020,290,1937,1723,12646,14583,19,300,7,81,6,21,198,49,38,10,52,272,1886,1572,11693,13579,7/30/2020
4/9/2020,284,2221,1521,14167,16388,32,332,9,90,4,25,217,52,40,7,59,278,2164,1366,13059,15223,7/30/2020
4/10/2020,420,2641,2577,16744,19385,29,361,17,107,5,30,224,58,41,11,70,404,2568,2380,15439,18007,7/30/2020
4/11/2020,299,2940,1911,18655,21595,29,390,11,118,2,32,240,61,48,12,82,280,2848,1730,17169,20017,7/30/2020
4/12/2020,315,3255,1674,20329,23584,35,425,13,131,5,37,257,59,49,10,92,289,3137,1451,18620,21757,7/30/2020
4/13/2020,162,3417,938,21267,24684,35,460,13,144,3,40,276,64,54,9,101,187,3324,845,19465,22789,7/30/2020
4/14/2020,289,3706,1788,23055,26761,27,487,17,161,5,45,281,72,53,8,109,265,3589,1556,21021,24610,7/30/2020
4/15/2020,353,4059,1803,24858,28917,31,518,19,180,3,48,290,72,54,17,126,307,3896,1579,22600,26496,7/30/2020
4/16/2020,449,4508,2500,27358,31866,36,554,25,205,6,54,295,72,53,14,140,392,4288,2097,24697,28985,7/30/2020
4/17/2020,308,4816,1823,29181,33997,32,586,20,225,7,61,300,66,45,21,161,291,4579,1473,26170,30749,7/30/2020
4/18/2020,322,5138,1728,30909,36047,26,612,18,243,4,65,304,63,49,15,176,284,4863,1361,27531,32394,7/30/2020
4/19/2020,382,5520,2059,32968,38488,23,635,26,269,1,66,300,65,55,11,187,338,5201,1760,29291,34492,7/30/2020
4/20/2020,396,5916,1909,34877,40793,46,681,29,298,2,68,315,75,56,10,197,377,5578,1592,30883,36461,7/30/2020
4/21/2020,445,6361,2114,36991,43352,45,726,31,329,5,73,324,72,56,18,215,388,5966,1726,32609,38575,7/30/2020
4/22/2020,420,6781,2398,39389,46170,41,767,32,361,5,78,328,73,58,18,233,382,6348,1925,34534,40882,7/30/2020
4/23/2020,482,7263,2471,41860,49123,30,797,28,389,5,83,325,76,62,15,248,420,6768,1890,36424,43192,7/30/2020
4/24/2020,494,7757,3292,45152,52909,35,832,27,416,4,87,329,85,63,15,263,413,7181,2652,39076,46257,7/30/2020
4/25/2020,394,8151,2210,47362,55513,34,866,17,433,5,92,341,85,62,14,277,305,7486,1787,40863,48349,7/30/2020
4/26/2020,316,8467,2314,49676,58143,33,899,15,448,3,95,356,86,59,14,291,277,7763,1889,42752,50515,7/30/2020
4/27/2020,250,8717,1624,51300,60017,29,928,21,469,4,99,360,86,61,10,301,204,7967,1170,43922,51889,7/30/2020
4/28/2020,411,9128,2268,53568,62696,44,972,24,493,3,102,377,88,59,22,323,324,8291,1777,45699,53990,7/30/2020
4/29/2020,476,9604,3351,56919,66523,36,1008,37,530,11,113,365,78,53,18,341,372,8663,2454,48153,56816,7/30/2020
4/30/2020,432,10036,2772,59691,69727,32,1040,38,568,6,119,353,83,57,24,365,348,9011,1963,50116,59127,7/30/2020
5/1/2020,457,10493,3089,62780,73273,51,1091,39,607,3,122,362,84,58,14,379,317,9328,2224,52340,61668,7/30/2020
5/2/2020,260,10753,1927,64707,75460,35,1126,39,646,5,127,353,90,61,24,403,190,9518,1298,53638,63156,7/30/2020
5/3/2020,284,11037,2168,66875,77912,31,1157,27,673,8,135,349,89,61,21,424,181,9699,1612,55250,64949,7/30/2020
5/4/2020,388,11425,2101,68976,80401,30,1187,31,704,5,140,343,87,57,18,442,293,9992,1581,56831,66823,7/30/2020
5/5/2020,436,11861,2878,71854,83715,28,1215,32,736,6,146,333,80,54,16,458,304,10296,1981,58812,69108,7/30/2020
5/6/2020,490,12351,2836,74690,87041,28,1243,44,780,9,155,308,78,54,21,479,341,10637,1932,60744,71381,7/30/2020
5/7/2020,425,12776,2975,77665,90441,36,1279,40,820,5,160,299,70,52,21,500,269,10906,1993,62737,73643,7/30/2020
5/8/2020,360,13136,2603,80268,93404,30,1309,29,849,5,165,295,70,53,22,522,231,11137,1788,64525,75662,7/30/2020
5/9/2020,457,13593,3356,83624,97217,22,1331,21,870,4,169,292,68,51,15,537,285,11422,2317,66842,78264,7/30/2020
5/10/2020,280,13873,2122,85746,99619,19,1350,23,893,6,175,282,69,49,13,550,186,11608,1531,68373,79981,7/30/2020
5/11/2020,259,14132,1861,87607,101739,31,1381,16,909,6,181,291,70,49,15,565,176,11784,1315,69688,81472,7/30/2020
5/12/2020,387,14519,2622,90229,104748,23,1404,18,927,4,185,292,68,48,22,587,217,12001,1724,71412,83413,7/30/2020
5/13/2020,352,14871,3634,93863,108734,22,1426,24,951,1,186,289,69,49,13,600,196,12197,2030,73442,85639,7/30/2020
5/14/2020,330,15201,3415,97278,112479,19,1445,27,978,3,189,278,64,45,15,615,227,12424,2024,75466,87890,7/30/2020
5/15/2020,382,15583,3470,100748,116331,24,1469,41,1019,5,194,256,62,45,13,628,234,12658,1823,77289,89947,7/30/2020
5/16/2020,438,16021,4168,104916,120937,25,1494,12,1031,5,199,264,61,46,15,643,252,12910,1978,79267,92177,7/30/2020
5/17/2020,231,16252,2775,107691,123943,17,1511,7,1038,5,204,269,59,45,10,653,124,13034,1571,80838,93872,7/30/2020
5/18/2020,251,16503,2007,109698,126201,19,1530,15,1053,5,209,268,57,40,18,671,139,13173,1376,82214,95387,7/30/2020
5/19/2020,416,16919,3178,112876,129795,23,1553,31,1084,5,214,255,56,38,11,682,214,13387,1945,84159,97546,7/30/2020
5/20/2020,328,17247,2774,115650,132897,19,1572,23,1107,7,221,244,52,33,22,704,187,13574,1527,85686,99260,7/30/2020
5/21/2020,374,17621,3764,119414,137035,26,1598,15,1122,3,224,252,53,29,20,724,170,13744,1953,87639,101383,7/30/2020
5/22/2020,351,17972,3172,122586,140558,20,1618,29,1151,5,229,238,52,29,10,734,205,13949,1621,89260,103209,7/30/2020
5/23/2020,240,18212,2748,125334,143546,19,1637,11,1162,3,232,243,52,32,13,747,109,14058,1292,90552,104610,7/30/2020
5/24/2020,153,18365,1372,126706,145071,12,1649,14,1176,2,234,239,53,36,8,755,84,14142,774,91326,105468,7/30/2020
5/25/2020,134,18499,1389,128095,146594,12,1661,14,1190,0,234,237,53,34,10,765,70,14212,765,92091,106303,7/30/2020
5/26/2020,284,18783,2624,130719,149502,24,1685,22,1212,5,239,234,48,33,15,780,154,14366,1790,93881,108247,7/30/2020
5/27/2020,276,19059,2134,132853,151912,20,1705,17,1229,3,242,234,50,33,10,790,132,14498,1147,95028,109526,7/30/2020
5/28/2020,346,19405,3384,136237,155642,17,1722,29,1258,4,246,218,47,32,8,798,132,14630,1134,96162,110792,7/30/2020
5/29/2020,419,19824,3989,140226,160050,18,1740,27,1285,6,252,203,43,31,12,810,179,14809,1596,97758,112567,7/30/2020
5/30/2020,211,20035,3973,144199,164234,15,1755,19,1304,4,256,195,40,29,12,822,104,14913,1828,99586,114499,7/30/2020
5/31/2020,148,20183,1753,145952,166135,10,1765,10,1314,0,256,195,43,26,3,825,76,14989,856,100442,115431,7/30/2020
6/1/2020,216,20399,2813,148765,169164,7,1772,13,1327,1,257,188,44,29,5,830,99,15088,1378,101820,116908,7/30/2020
6/2/2020,273,20672,3080,151845,172517,8,1780,9,1336,3,260,184,37,25,10,840,107,15195,1470,103290,118485,7/30/2020
6/3/2020,259,20931,3509,155354,176285,13,1793,18,1354,6,266,173,34,25,11,851,105,15300,1671,104961,120261,7/30/2020
6/4/2020,281,21212,4522,159876,181088,7,1800,25,1379,3,269,152,31,24,11,862,114,15414,2042,107003,122417,7/30/2020
6/5/2020,215,21427,3583,163459,184886,15,1815,12,1391,5,274,150,27,21,9,871,104,15518,1580,108583,124101,7/30/2020
6/6/2020,198,21625,2622,166081,187706,10,1825,7,1398,2,276,151,29,19,6,877,68,15586,1135,109718,125304,7/30/2020
6/7/2020,77,21702,1614,167695,189397,11,1836,7,1405,1,277,154,25,17,4,881,49,15635,777,110495,126130,7/30/2020
6/8/2020,122,21824,1847,169542,191366,15,1851,12,1417,2,279,155,27,18,4,885,44,15679,965,111460,127139,7/30/2020
6/9/2020,225,22049,2674,172216,194265,10,1861,18,1435,0,279,147,28,21,1,886,67,15746,1263,112723,128469,7/30/2020
6/10/2020,210,22259,2983,175199,197458,13,1874,12,1447,2,281,146,24,17,3,889,104,15850,1460,114183,130033,7/30/2020
6/11/2020,195,22454,3499,178698,201152,7,1881,15,1462,1,282,137,25,16,6,895,88,15938,1529,115712,131650,7/30/2020
6/12/2020,213,22667,4603,183301,205968,8,1889,15,1477,1,283,129,24,16,2,897,80,16018,2192,117904,133922,7/30/2020
6/13/2020,111,22778,3028,186329,209107,6,1895,4,1481,0,283,131,20,15,3,900,50,16068,1368,119272,135340,7/30/2020
6/14/2020,78,22856,2037,188366,211222,6,1901,8,1489,1,284,128,20,14,3,903,32,16100,966,120238,136338,7/30/2020
6/15/2020,189,23045,3105,191471,214516,14,1915,14,1503,0,284,128,20,16,4,907,78,16178,1789,122027,138205,7/30/2020
6/16/2020,115,23160,3010,194481,217641,11,1926,10,1513,1,285,128,22,16,8,915,52,16230,1579,123606,139836,7/30/2020
6/17/2020,123,23283,2826,197307,220590,15,1941,20,1533,4,289,119,18,14,6,921,52,16282,1314,124920,141202,7/30/2020
6/18/2020,150,23433,3039,200346,223779,9,1950,13,1546,1,290,114,19,16,7,928,70,16352,1331,126251,142603,7/30/2020
6/19/2020,141,23574,3761,204107,227681,12,1962,11,1557,1,291,114,20,17,3,931,59,16411,1375,127626,144037,7/30/2020
6/20/2020,80,23654,1883,205990,229644,7,1969,9,1566,0,291,112,20,18,4,935,36,16447,814,128440,144887,7/30/2020
6/21/2020,36,23690,1042,207032,230722,7,1976,5,1571,0,291,114,20,18,2,937,27,16474,679,129119,145593,7/30/2020
6/22/2020,142,23832,3713,210745,234577,12,1988,16,1587,0,291,110,19,18,1,938,70,16544,1703,130822,147366,7/30/2020
6/23/2020,162,23994,3850,214595,238589,3,1991,13,1600,3,294,97,18,18,6,944,83,16627,1794,132616,149243,7/30/2020
6/24/2020,121,24115,3508,218103,242218,8,1999,10,1610,1,295,94,17,18,5,949,47,16674,1693,134309,150983,7/30/2020
6/25/2020,102,24217,2885,220988,245205,5,2004,14,1624,1,296,84,16,17,1,950,53,16727,1508,135817,152544,7/30/2020
6/26/2020,94,24311,2454,223442,247753,2,2006,9,1633,0,296,77,17,18,1,951,63,16790,1305,137122,153912,7/30/2020
6/27/2020,84,24395,3212,226654,251049,5,2011,3,1636,1,297,78,16,17,5,956,37,16827,1214,138336,155163,7/30/2020
6/28/2020,37,24432,1452,228106,252538,4,2015,4,1640,4,301,74,14,14,6,962,18,16845,586,138922,155767,7/30/2020
6/29/2020,86,24518,3673,231779,256297,4,2019,5,1645,0,301,73,13,14,1,963,38,16883,1343,140265,157148,7/30/2020
6/30/2020,60,24578,1945,233724,258302,1,2020,5,1650,1,302,68,11,11,3,966,35,16918,994,141259,158177,7/30/2020
7/1/2020,145,24723,4106,237830,262553,7,2027,9,1659,0,302,66,10,11,1,967,81,16999,1955,143214,160213,7/30/2020
7/2/2020,101,24824,2778,240608,265432,5,2032,5,1664,1,303,65,8,9,1,968,56,17055,1075,144289,161344,7/30/2020
7/3/2020,47,24871,2013,242621,267492,7,2039,6,1670,0,303,66,7,8,3,971,25,17080,772,145061,162141,7/30/2020
7/4/2020,57,24928,2320,244941,269869,2,2041,4,1674,1,304,63,8,8,2,973,34,17114,991,146052,163166,7/30/2020
7/5/2020,47,24975,2924,247865,272840,1,2042,2,1676,1,305,61,6,7,2,975,22,17136,1444,147496,164632,7/30/2020
7/6/2020,103,25078,2790,250655,275733,6,2048,6,1682,0,305,61,8,9,4,979,60,17196,1543,149039,166235,7/30/2020
7/7/2020,80,25158,3438,254093,279251,5,2053,6,1688,0,305,60,7,8,1,980,47,17243,1533,150572,167815,7/30/2020
7/8/2020,104,25262,3381,257474,282736,4,2057,2,1690,0,305,62,8,8,0,980,66,17309,1418,151990,169299,7/30/2020
7/9/2020,94,25356,3658,261132,286488,7,2064,2,1692,0,305,67,8,8,0,980,50,17359,1596,153586,170945,7/30/2020
7/10/2020,129,25485,4387,265519,291004,5,2069,3,1695,2,307,67,7,7,3,983,79,17438,2079,155665,173103,7/30/2020
7/11/2020,63,25548,2881,268400,293948,6,2075,3,1698,1,308,69,6,6,3,986,34,17472,1278,156943,174415,7/30/2020
7/12/2020,45,25593,1764,270164,295757,1,2076,2,1700,1,309,67,6,5,3,989,33,17505,887,157830,175335,7/30/2020
7/13/2020,85,25678,3142,273306,298984,7,2083,10,1710,0,309,64,6,5,1,990,57,17562,1469,159299,176861,7/30/2020
7/14/2020,75,25753,3246,276552,302305,7,2090,4,1714,0,309,67,5,5,1,991,49,17611,1349,160648,178259,7/30/2020
7/15/2020,123,25876,4118,280670,306546,5,2095,6,1720,0,309,66,5,4,0,991,93,17704,1726,162374,180078,7/30/2020
7/16/2020,102,25978,3678,284348,310326,6,2101,8,1728,0,309,64,6,5,1,992,80,17784,1585,163959,181743,7/30/2020
7/17/2020,151,26129,4114,288462,314591,14,2115,3,1731,1,310,74,5,5,1,993,79,17863,1798,165757,183620,7/30/2020
7/18/2020,80,26209,3141,291603,317812,5,2120,9,1740,1,311,69,5,4,4,997,69,17932,1343,167100,185032,7/30/2020
7/19/2020,82,26291,2577,294180,320471,6,2126,3,1743,0,311,72,6,4,2,999,58,17990,1071,168171,186161,7/30/2020
7/20/2020,72,26363,2592,296772,323135,9,2135,7,1750,0,311,74,7,5,2,1001,64,18054,1443,169614,187668,7/30/2020
7/21/2020,128,26491,4212,300984,327475,9,2144,10,1760,0,311,73,9,6,1,1002,106,18160,1872,171486,189646,7/30/2020
7/22/2020,123,26614,3783,304767,331381,11,2155,11,1771,1,312,72,7,6,1,1003,87,18247,1578,173064,191311,7/30/2020
7/23/2020,123,26737,4055,308822,335559,6,2161,5,1776,0,312,73,8,7,0,1003,103,18350,1756,174820,193170,7/30/2020
7/24/2020,161,26898,5672,314494,341392,11,2172,12,1788,0,312,72,9,7,0,1003,116,18466,2149,176969,195435,7/30/2020
7/25/2020,126,27024,4257,318751,345775,7,2179,7,1795,0,312,72,10,7,1,1004,105,18571,2000,178969,197540,7/30/2020
7/26/2020,56,27080,2957,321708,348788,7,2186,8,1803,0,312,71,11,5,1,1005,51,18622,1304,180273,198895,7/30/2020
7/27/2020,182,27262,3865,325573,352835,10,2196,7,1810,0,312,74,12,6,1,1006,139,18761,2108,182381,201142,7/30/2020
7/28/2020,93,27355,3556,329129,356484,6,2202,3,1813,0,312,77,13,5,1,1007,79,18840,1442,183823,202663,7/30/2020
7/29/2020,140,27495,4323,333452,360947,,,,,,,,,,0,1007,110,18950,1746,185569,204519,7/30/2020
2/27/2020,0,0,0,0,0,1,1,0,0,0,0,1,0,0,0,0,0,0,0,0,0,7/31/2020
2/28/2020,0,0,0,0,0,0,1,0,0,0,0,1,1,0,0,0,0,0,0,0,0,7/31/2020
2/29/2020,0,0,0,0,0,0,1,0,0,0,0,1,1,0,0,0,0,0,0,0,0,7/31/2020
3/1/2020,2,2,2,2,4,0,1,0,0,0,0,1,1,1,0,0,2,2,2,2,4,7/31/2020
3/2/2020,0,2,1,3,5,1,2,0,0,0,0,2,2,2,0,0,0,2,1,3,5,7/31/2020
3/3/2020,0,2,2,5,7,0,2,0,0,0,0,2,2,2,0,0,0,2,2,5,7,7/31/2020
3/4/2020,0,2,12,17,19,1,3,0,0,0,0,3,2,2,0,0,0,2,10,15,17,7/31/2020
3/5/2020,0,2,4,21,23,0,3,0,0,0,0,3,2,2,0,0,1,3,4,19,22,7/31/2020
3/6/2020,1,3,12,33,36,0,3,0,0,0,0,3,2,2,0,0,0,3,11,30,33,7/31/2020
3/7/2020,0,3,19,52,55,0,3,0,0,0,0,3,2,1,0,0,0,3,19,49,52,7/31/2020
3/8/2020,0,3,18,70,73,0,3,0,0,0,0,3,2,1,0,0,0,3,18,67,70,7/31/2020
3/9/2020,1,4,15,85,89,0,3,0,0,0,0,3,2,1,0,0,1,4,15,82,86,7/31/2020
3/10/2020,2,6,25,110,116,0,3,0,0,0,0,3,2,1,0,0,1,5,23,105,110,7/31/2020
3/11/2020,0,6,34,144,150,1,4,0,0,0,0,4,1,1,0,0,0,5,34,139,144,7/31/2020
3/12/2020,9,15,42,186,201,1,5,0,0,0,0,5,1,1,0,0,8,13,38,177,190,7/31/2020
3/13/2020,6,21,50,236,257,4,9,1,1,0,0,8,1,1,0,0,6,19,48,225,244,7/31/2020
3/14/2020,0,21,90,326,347,0,9,0,1,0,0,8,1,1,0,0,0,19,86,311,330,7/31/2020
3/15/2020,1,22,54,380,402,1,10,0,1,0,0,9,2,1,0,0,1,20,54,365,385,7/31/2020
3/16/2020,2,24,95,475,499,2,12,0,1,0,0,11,2,0,0,0,2,22,92,457,479,7/31/2020
3/17/2020,16,40,162,637,677,6,18,0,1,0,0,17,2,0,0,0,11,33,153,610,643,7/31/2020
3/18/2020,12,52,116,753,805,3,21,0,1,0,0,20,2,0,0,0,11,44,111,721,765,7/31/2020
3/19/2020,17,69,262,1015,1084,2,23,1,2,0,0,21,3,0,1,1,17,61,251,972,1033,7/31/2020
3/20/2020,15,84,197,1212,1296,5,28,0,2,0,0,26,4,0,0,1,13,74,193,1165,1239,7/31/2020
3/21/2020,21,105,126,1338,1443,3,31,2,4,0,0,27,5,0,0,1,14,88,123,1288,1376,7/31/2020
3/22/2020,30,135,282,1620,1755,2,33,0,4,0,0,29,5,0,0,1,25,113,264,1552,1665,7/31/2020
3/23/2020,14,149,169,1789,1938,15,48,1,5,0,0,43,9,3,0,1,16,129,165,1717,1846,7/31/2020
3/24/2020,20,169,243,2032,2201,7,55,0,5,0,0,50,10,4,0,1,19,148,238,1955,2103,7/31/2020
3/25/2020,26,195,183,2215,2410,5,60,1,6,0,0,54,11,3,0,1,28,176,173,2128,2304,7/31/2020
3/26/2020,35,230,181,2396,2626,10,70,5,11,0,0,59,14,5,0,1,41,217,176,2304,2521,7/31/2020
3/27/2020,27,257,215,2611,2868,9,79,1,12,1,1,66,17,6,2,3,31,248,202,2506,2754,7/31/2020
3/28/2020,59,316,260,2871,3187,13,92,3,15,2,3,74,15,6,1,4,63,311,242,2748,3059,7/31/2020
3/29/2020,106,422,356,3227,3649,8,100,4,19,1,4,77,18,8,2,6,105,416,314,3062,3478,7/31/2020
3/30/2020,62,484,222,3449,3933,20,120,5,24,0,4,92,20,11,3,9,78,494,192,3254,3748,7/31/2020
3/31/2020,71,555,369,3818,4373,11,131,7,31,1,5,95,22,13,2,11,73,567,299,3553,4120,7/31/2020
4/1/2020,99,654,699,4517,5171,18,149,7,38,0,5,106,30,15,1,12,100,667,648,4201,4868,7/31/2020
4/2/2020,52,706,477,4994,5700,21,170,6,44,2,7,119,36,21,4,16,62,729,436,4637,5366,7/31/2020
4/3/2020,108,814,775,5769,6583,23,193,7,51,0,7,135,43,25,3,19,100,829,718,5355,6184,7/31/2020
4/4/2020,143,957,660,6429,7386,22,215,4,55,5,12,148,41,30,9,28,137,966,623,5978,6944,7/31/2020
4/5/2020,187,1144,1156,7585,8729,20,235,9,64,1,13,158,44,36,2,30,182,1148,1072,7050,8198,7/31/2020
4/6/2020,218,1362,1707,9292,10654,26,261,7,71,0,13,177,48,40,7,37,206,1354,1579,8629,9983,7/31/2020
4/7/2020,285,1647,1631,10923,12570,20,281,3,74,2,15,192,49,42,5,42,260,1614,1491,10120,11734,7/31/2020
4/8/2020,290,1937,1723,12646,14583,19,300,7,81,6,21,198,49,38,10,52,272,1886,1571,11691,13577,7/31/2020
4/9/2020,284,2221,1521,14167,16388,32,332,9,90,4,25,217,52,40,7,59,278,2164,1366,13057,15221,7/31/2020
4/10/2020,420,2641,2577,16744,19385,29,361,17,107,5,30,224,58,41,11,70,404,2568,2380,15437,18005,7/31/2020
4/11/2020,299,2940,1911,18655,21595,29,390,11,118,2,32,240,61,48,12,82,280,2848,1730,17167,20015,7/31/2020
4/12/2020,315,3255,1674,20329,23584,35,425,13,131,5,37,257,59,49,10,92,289,3137,1451,18618,21755,7/31/2020
4/13/2020,162,3417,938,21267,24684,35,460,13,144,3,40,276,64,54,9,101,187,3324,845,19463,22787,7/31/2020
4/14/2020,289,3706,1788,23055,26761,27,487,17,161,5,45,281,72,53,8,109,265,3589,1555,21018,24607,7/31/2020
4/15/2020,353,4059,1803,24858,28917,31,518,19,180,3,48,290,72,54,17,126,307,3896,1579,22597,26493,7/31/2020
4/16/2020,449,4508,2500,27358,31866,36,554,25,205,6,54,295,72,53,14,140,392,4288,2097,24694,28982,7/31/2020
4/17/2020,308,4816,1823,29181,33997,32,586,20,225,7,61,300,66,45,21,161,291,4579,1473,26167,30746,7/31/2020
4/18/2020,322,5138,1728,30909,36047,26,612,18,243,4,65,304,63,49,15,176,284,4863,1361,27528,32391,7/31/2020
4/19/2020,382,5520,2059,32968,38488,23,635,26,269,1,66,300,65,55,11,187,338,5201,1759,29287,34488,7/31/2020
4/20/2020,396,5916,1909,34877,40793,46,681,29,298,2,68,315,75,56,10,197,377,5578,1591,30878,36456,7/31/2020
4/21/2020,445,6361,2114,36991,43352,45,726,31,329,5,73,324,72,56,18,215,388,5966,1726,32604,38570,7/31/2020
4/22/2020,420,6781,2398,39389,46170,41,767,32,361,5,78,328,73,58,18,233,382,6348,1925,34529,40877,7/31/2020
4/23/2020,482,7263,2471,41860,49123,30,797,28,389,5,83,325,76,62,15,248,420,6768,1890,36419,43187,7/31/2020
4/24/2020,494,7757,3292,45152,52909,35,832,27,416,4,87,329,85,63,15,263,413,7181,2652,39071,46252,7/31/2020
4/25/2020,394,8151,2210,47362,55513,34,866,17,433,5,92,341,85,62,14,277,305,7486,1787,40858,48344,7/31/2020
4/26/2020,316,8467,2314,49676,58143,33,899,15,448,3,95,356,86,59,14,291,277,7763,1889,42747,50510,7/31/2020
4/27/2020,250,8717,1624,51300,60017,29,928,21,469,4,99,360,86,61,10,301,204,7967,1170,43917,51884,7/31/2020
4/28/2020,411,9128,2268,53568,62696,44,972,24,493,3,102,377,88,59,22,323,324,8291,1776,45693,53984,7/31/2020
4/29/2020,476,9604,3351,56919,66523,36,1008,37,530,11,113,365,78,53,18,341,372,8663,2454,48147,56810,7/31/2020
4/30/2020,432,10036,2772,59691,69727,32,1040,38,568,6,119,353,83,57,24,365,348,9011,1963,50110,59121,7/31/2020
5/1/2020,457,10493,3089,62780,73273,51,1091,39,607,3,122,362,84,58,14,379,317,9328,2224,52334,61662,7/31/2020
5/2/2020,260,10753,1927,64707,75460,35,1126,39,646,5,127,353,90,61,24,403,190,9518,1298,53632,63150,7/31/2020
5/3/2020,284,11037,2168,66875,77912,31,1157,27,673,8,135,349,89,61,21,424,181,9699,1611,55243,64942,7/31/2020
5/4/2020,388,11425,2101,68976,80401,30,1187,31,704,5,140,343,87,57,18,442,293,9992,1581,56824,66816,7/31/2020
5/5/2020,436,11861,2878,71854,83715,28,1215,32,736,6,146,333,80,54,16,458,304,10296,1981,58805,69101,7/31/2020
5/6/2020,490,12351,2836,74690,87041,28,1243,44,780,9,155,308,78,54,21,479,341,10637,1932,60737,71374,7/31/2020
5/7/2020,425,12776,2975,77665,90441,36,1279,40,820,5,160,299,70,52,21,500,269,10906,1993,62730,73636,7/31/2020
5/8/2020,360,13136,2603,80268,93404,30,1309,29,849,5,165,295,70,53,22,522,231,11137,1788,64518,75655,7/31/2020
5/9/2020,457,13593,3356,83624,97217,22,1331,21,870,4,169,292,68,51,15,537,285,11422,2317,66835,78257,7/31/2020
5/10/2020,280,13873,2122,85746,99619,19,1350,23,893,6,175,282,69,49,13,550,186,11608,1531,68366,79974,7/31/2020
5/11/2020,259,14132,1861,87607,101739,31,1381,16,909,6,181,291,70,49,15,565,176,11784,1315,69681,81465,7/31/2020
5/12/2020,387,14519,2622,90229,104748,23,1404,18,927,4,185,292,68,48,22,587,217,12001,1724,71405,83406,7/31/2020
5/13/2020,352,14871,3634,93863,108734,22,1426,24,951,1,186,289,69,49,13,600,196,12197,2030,73435,85632,7/31/2020
5/14/2020,330,15201,3415,97278,112479,19,1445,27,978,3,189,278,64,45,15,615,227,12424,2024,75459,87883,7/31/2020
5/15/2020,382,15583,3470,100748,116331,24,1469,41,1019,5,194,256,62,45,13,628,234,12658,1823,77282,89940,7/31/2020
5/16/2020,438,16021,4168,104916,120937,25,1494,12,1031,5,199,264,61,46,15,643,252,12910,1978,79260,92170,7/31/2020
5/17/2020,231,16252,2775,107691,123943,17,1511,7,1038,5,204,269,59,45,10,653,124,13034,1571,80831,93865,7/31/2020
5/18/2020,251,16503,2007,109698,126201,19,1530,15,1053,5,209,268,57,40,18,671,139,13173,1376,82207,95380,7/31/2020
5/19/2020,416,16919,3178,112876,129795,23,1553,31,1084,5,214,255,56,38,11,682,214,13387,1945,84152,97539,7/31/2020
5/20/2020,328,17247,2774,115650,132897,19,1572,23,1107,7,221,244,52,33,22,704,187,13574,1527,85679,99253,7/31/2020
5/21/2020,374,17621,3764,119414,137035,26,1598,15,1122,3,224,252,53,29,20,724,170,13744,1953,87632,101376,7/31/2020
5/22/2020,351,17972,3172,122586,140558,20,1618,29,1151,5,229,238,52,29,10,734,205,13949,1621,89253,103202,7/31/2020
5/23/2020,240,18212,2748,125334,143546,19,1637,11,1162,3,232,243,52,32,13,747,109,14058,1292,90545,104603,7/31/2020
5/24/2020,153,18365,1372,126706,145071,12,1649,14,1176,2,234,239,53,36,8,755,84,14142,774,91319,105461,7/31/2020
5/25/2020,134,18499,1389,128095,146594,12,1661,14,1190,0,234,237,53,34,10,765,70,14212,765,92084,106296,7/31/2020
5/26/2020,284,18783,2624,130719,149502,24,1685,22,1212,5,239,234,48,33,15,780,154,14366,1790,93874,108240,7/31/2020
5/27/2020,276,19059,2134,132853,151912,20,1705,17,1229,3,242,234,50,33,10,790,132,14498,1146,95020,109518,7/31/2020
5/28/2020,346,19405,3384,136237,155642,17,1722,29,1258,4,246,218,47,32,8,798,132,14630,1134,96154,110784,7/31/2020
5/29/2020,419,19824,3989,140226,160050,18,1740,27,1285,6,252,203,43,31,12,810,179,14809,1596,97750,112559,7/31/2020
5/30/2020,211,20035,3973,144199,164234,15,1755,19,1304,4,256,195,40,29,12,822,104,14913,1828,99578,114491,7/31/2020
5/31/2020,148,20183,1753,145952,166135,10,1765,10,1314,0,256,195,43,26,3,825,76,14989,856,100434,115423,7/31/2020
6/1/2020,216,20399,2813,148765,169164,7,1772,13,1327,1,257,188,44,29,5,830,99,15088,1378,101812,116900,7/31/2020
6/2/2020,273,20672,3080,151845,172517,8,1780,9,1336,3,260,184,37,25,10,840,107,15195,1470,103282,118477,7/31/2020
6/3/2020,259,20931,3509,155354,176285,13,1793,18,1354,6,266,173,34,25,11,851,105,15300,1671,104953,120253,7/31/2020
6/4/2020,281,21212,4522,159876,181088,7,1800,25,1379,3,269,152,31,24,11,862,114,15414,2042,106995,122409,7/31/2020
6/5/2020,215,21427,3583,163459,184886,15,1815,12,1391,5,274,150,27,21,9,871,104,15518,1580,108575,124093,7/31/2020
6/6/2020,198,21625,2622,166081,187706,10,1825,7,1398,2,276,151,29,19,6,877,68,15586,1135,109710,125296,7/31/2020
6/7/2020,77,21702,1614,167695,189397,11,1836,7,1405,1,277,154,25,17,4,881,49,15635,777,110487,126122,7/31/2020
6/8/2020,122,21824,1847,169542,191366,15,1851,12,1417,2,279,155,27,18,4,885,44,15679,965,111452,127131,7/31/2020
6/9/2020,225,22049,2674,172216,194265,10,1861,18,1435,0,279,147,28,21,1,886,67,15746,1263,112715,128461,7/31/2020
6/10/2020,210,22259,2983,175199,197458,13,1874,12,1447,2,281,146,24,17,3,889,104,15850,1459,114174,130024,7/31/2020
6/11/2020,195,22454,3499,178698,201152,7,1881,15,1462,1,282,137,25,16,6,895,88,15938,1529,115703,131641,7/31/2020
6/12/2020,213,22667,4603,183301,205968,8,1889,15,1477,1,283,129,24,16,2,897,80,16018,2191,117894,133912,7/31/2020
6/13/2020,111,22778,3028,186329,209107,6,1895,4,1481,0,283,131,20,15,3,900,50,16068,1368,119262,135330,7/31/2020
6/14/2020,78,22856,2037,188366,211222,6,1901,8,1489,1,284,128,20,14,3,903,32,16100,965,120227,136327,7/31/2020
6/15/2020,189,23045,3105,191471,214516,14,1915,14,1503,0,284,128,20,16,4,907,78,16178,1789,122016,138194,7/31/2020
6/16/2020,115,23160,3010,194481,217641,11,1926,10,1513,1,285,128,22,16,8,915,52,16230,1579,123595,139825,7/31/2020
6/17/2020,123,23283,2826,197307,220590,15,1941,20,1533,4,289,119,18,14,6,921,52,16282,1314,124909,141191,7/31/2020
6/18/2020,150,23433,3039,200346,223779,9,1950,13,1546,1,290,114,19,16,7,928,70,16352,1331,126240,142592,7/31/2020
6/19/2020,141,23574,3761,204107,227681,12,1962,11,1557,1,291,114,20,17,3,931,59,16411,1375,127615,144026,7/31/2020
6/20/2020,80,23654,1883,205990,229644,7,1969,9,1566,0,291,112,20,18,4,935,36,16447,814,128429,144876,7/31/2020
6/21/2020,36,23690,1042,207032,230722,7,1976,5,1571,0,291,114,20,18,2,937,27,16474,679,129108,145582,7/31/2020
6/22/2020,142,23832,3713,210745,234577,12,1988,16,1587,0,291,110,19,18,1,938,70,16544,1703,130811,147355,7/31/2020
6/23/2020,162,23994,3850,214595,238589,3,1991,13,1600,3,294,97,18,18,6,944,83,16627,1794,132605,149232,7/31/2020
6/24/2020,121,24115,3508,218103,242218,8,1999,10,1610,1,295,94,17,18,5,949,47,16674,1692,134297,150971,7/31/2020
6/25/2020,102,24217,2885,220988,245205,5,2004,14,1624,1,296,84,16,17,1,950,52,16726,1507,135804,152530,7/31/2020
6/26/2020,94,24311,2454,223442,247753,2,2006,9,1633,0,296,77,17,18,1,951,63,16789,1305,137109,153898,7/31/2020
6/27/2020,84,24395,3212,226654,251049,5,2011,3,1636,1,297,78,16,17,5,956,37,16826,1214,138323,155149,7/31/2020
6/28/2020,37,24432,1452,228106,252538,4,2015,4,1640,4,301,74,14,14,6,962,18,16844,586,138909,155753,7/31/2020
6/29/2020,86,24518,3673,231779,256297,4,2019,5,1645,0,301,73,13,14,1,963,38,16882,1343,140252,157134,7/31/2020
6/30/2020,60,24578,1945,233724,258302,1,2020,5,1650,1,302,68,11,11,3,966,35,16917,994,141246,158163,7/31/2020
7/1/2020,145,24723,4106,237830,262553,7,2027,9,1659,0,302,66,10,11,1,967,81,16998,1955,143201,160199,7/31/2020
7/2/2020,101,24824,2778,240608,265432,5,2032,5,1664,1,303,65,8,9,1,968,56,17054,1075,144276,161330,7/31/2020
7/3/2020,47,24871,2013,242621,267492,7,2039,6,1670,0,303,66,7,8,3,971,25,17079,771,145047,162126,7/31/2020
7/4/2020,57,24928,2320,244941,269869,2,2041,4,1674,1,304,63,8,8,2,973,34,17113,991,146038,163151,7/31/2020
7/5/2020,47,24975,2924,247865,272840,1,2042,2,1676,1,305,61,6,7,2,975,22,17135,1443,147481,164616,7/31/2020
7/6/2020,103,25078,2790,250655,275733,6,2048,6,1682,0,305,61,8,9,4,979,60,17195,1543,149024,166219,7/31/2020
7/7/2020,80,25158,3438,254093,279251,5,2053,6,1688,0,305,60,7,8,1,980,47,17242,1533,150557,167799,7/31/2020
7/8/2020,104,25262,3381,257474,282736,4,2057,2,1690,0,305,62,8,8,0,980,66,17308,1418,151975,169283,7/31/2020
7/9/2020,94,25356,3658,261132,286488,7,2064,2,1692,0,305,67,8,8,0,980,50,17358,1596,153571,170929,7/31/2020
7/10/2020,129,25485,4387,265519,291004,5,2069,3,1695,2,307,67,7,7,3,983,79,17437,2079,155650,173087,7/31/2020
7/11/2020,63,25548,2881,268400,293948,6,2075,3,1698,1,308,69,6,6,3,986,34,17471,1278,156928,174399,7/31/2020
7/12/2020,45,25593,1764,270164,295757,1,2076,2,1700,1,309,67,6,5,3,989,32,17503,886,157814,175317,7/31/2020
7/13/2020,85,25678,3142,273306,298984,7,2083,10,1710,0,309,64,6,5,1,990,56,17559,1469,159283,176842,7/31/2020
7/14/2020,75,25753,3246,276552,302305,7,2090,4,1714,0,309,67,5,5,1,991,50,17609,1348,160631,178240,7/31/2020
7/15/2020,123,25876,4118,280670,306546,5,2095,6,1720,0,309,66,5,4,0,991,94,17703,1726,162357,180060,7/31/2020
7/16/2020,102,25978,3678,284348,310326,6,2101,8,1728,0,309,64,6,5,1,992,80,17783,1585,163942,181725,7/31/2020
7/17/2020,151,26129,4114,288462,314591,14,2115,3,1731,1,310,74,5,5,1,993,79,17862,1798,165740,183602,7/31/2020
7/18/2020,80,26209,3141,291603,317812,5,2120,9,1740,1,311,69,5,4,4,997,69,17931,1343,167083,185014,7/31/2020
7/19/2020,82,26291,2577,294180,320471,6,2126,3,1743,0,311,72,6,4,2,999,58,17989,1071,168154,186143,7/31/2020
7/20/2020,72,26363,2592,296772,323135,9,2135,7,1750,0,311,74,7,5,2,1001,65,18054,1443,169597,187651,7/31/2020
7/21/2020,128,26491,4212,300984,327475,9,2144,10,1760,0,311,73,9,6,1,1002,107,18161,1872,171469,189630,7/31/2020
7/22/2020,123,26614,3783,304767,331381,11,2155,11,1771,1,312,72,7,6,1,1003,87,18248,1578,173047,191295,7/31/2020
7/23/2020,123,26737,4055,308822,335559,6,2161,5,1776,0,312,73,8,7,0,1003,105,18353,1754,174801,193154,7/31/2020
7/24/2020,161,26898,5672,314494,341392,12,2173,12,1788,0,312,73,9,7,0,1003,117,18470,2149,176950,195420,7/31/2020
7/25/2020,126,27024,4257,318751,345775,7,2180,7,1795,0,312,73,10,7,1,1004,104,18574,2000,178950,197524,7/31/2020
7/26/2020,56,27080,2957,321708,348788,7,2187,8,1803,0,312,72,11,5,1,1005,52,18626,1302,180252,198878,7/31/2020
7/27/2020,182,27262,3867,325575,352837,10,2197,7,1810,0,312,75,13,6,1,1006,138,18764,2109,182361,201125,7/31/2020
7/28/2020,101,27363,3617,329192,356555,6,2203,3,1813,0,312,78,14,5,1,1007,90,18854,1489,183850,202704,7/31/2020
7/29/2020,154,27517,4670,333862,361379,8,2211,10,1823,0,312,76,15,5,0,1007,104,18958,2013,185863,204821,7/31/2020
7/30/2020,83,27600,3604,337466,365066,,,,,,,,,,0,1007,64,19022,1131,186994,206016,7/31/2020
2/27/2020,0,0,0,0,0,1,1,0,0,0,0,1,0,0,0,0,0,0,0,0,0,8/3/2020
2/28/2020,0,0,0,0,0,0,1,0,0,0,0,1,1,0,0,0,0,0,0,0,0,8/3/2020
2/29/2020,0,0,0,0,0,0,1,0,0,0,0,1,1,0,0,0,0,0,0,0,0,8/3/2020
3/1/2020,2,2,2,2,4,0,1,0,0,0,0,1,1,1,0,0,2,2,2,2,4,8/3/2020
3/2/2020,0,2,1,3,5,1,2,0,0,0,0,2,2,2,0,0,0,2,1,3,5,8/3/2020
3/3/2020,0,2,2,5,7,0,2,0,0,0,0,2,2,2,0,0,0,2,2,5,7,8/3/2020
3/4/2020,0,2,12,17,19,1,3,0,0,0,0,3,2,2,0,0,0,2,10,15,17,8/3/2020
3/5/2020,0,2,4,21,23,0,3,0,0,0,0,3,2,2,0,0,1,3,4,19,22,8/3/2020
3/6/2020,1,3,12,33,36,0,3,0,0,0,0,3,2,2,0,0,0,3,11,30,33,8/3/2020
3/7/2020,0,3,19,52,55,0,3,0,0,0,0,3,2,1,0,0,0,3,19,49,52,8/3/2020
3/8/2020,0,3,18,70,73,0,3,0,0,0,0,3,2,1,0,0,0,3,18,67,70,8/3/2020
3/9/2020,1,4,15,85,89,0,3,0,0,0,0,3,2,1,0,0,1,4,15,82,86,8/3/2020
3/10/2020,2,6,25,110,116,0,3,0,0,0,0,3,2,1,0,0,1,5,23,105,110,8/3/2020
3/11/2020,0,6,34,144,150,1,4,0,0,0,0,4,1,1,0,0,0,5,34,139,144,8/3/2020
3/12/2020,9,15,42,186,201,1,5,0,0,0,0,5,1,1,0,0,8,13,38,177,190,8/3/2020
3/13/2020,6,21,50,236,257,4,9,1,1,0,0,8,1,1,0,0,6,19,48,225,244,8/3/2020
3/14/2020,0,21,90,326,347,0,9,0,1,0,0,8,1,1,0,0,0,19,86,311,330,8/3/2020
3/15/2020,1,22,54,380,402,1,10,0,1,0,0,9,2,1,0,0,1,20,54,365,385,8/3/2020
3/16/2020,2,24,95,475,499,2,12,0,1,0,0,11,2,0,0,0,2,22,92,457,479,8/3/2020
3/17/2020,16,40,162,637,677,6,18,0,1,0,0,17,2,0,0,0,11,33,152,609,642,8/3/2020
3/18/2020,12,52,116,753,805,3,21,0,1,0,0,20,2,0,0,0,11,44,111,720,764,8/3/2020
3/19/2020,17,69,262,1015,1084,2,23,1,2,0,0,21,3,0,1,1,17,61,251,971,1032,8/3/2020
3/20/2020,15,84,197,1212,1296,5,28,0,2,0,0,26,4,0,0,1,13,74,193,1164,1238,8/3/2020
3/21/2020,21,105,126,1338,1443,3,31,2,4,0,0,27,5,0,0,1,14,88,123,1287,1375,8/3/2020
3/22/2020,30,135,282,1620,1755,2,33,0,4,0,0,29,5,0,0,1,25,113,264,1551,1664,8/3/2020
3/23/2020,14,149,169,1789,1938,15,48,1,5,0,0,43,9,3,0,1,16,129,165,1716,1845,8/3/2020
3/24/2020,20,169,243,2032,2201,7,55,0,5,0,0,50,10,4,0,1,19,148,238,1954,2102,8/3/2020
3/25/2020,26,195,183,2215,2410,5,60,1,6,0,0,54,11,3,0,1,28,176,173,2127,2303,8/3/2020
3/26/2020,35,230,181,2396,2626,10,70,5,11,0,0,59,14,5,0,1,41,217,176,2303,2520,8/3/2020
3/27/2020,27,257,215,2611,2868,9,79,1,12,1,1,66,17,6,2,3,31,248,202,2505,2753,8/3/2020
3/28/2020,59,316,260,2871,3187,13,92,3,15,2,3,74,15,6,1,4,63,311,242,2747,3058,8/3/2020
3/29/2020,106,422,356,3227,3649,8,100,4,19,1,4,77,18,8,2,6,105,416,314,3061,3477,8/3/2020
3/30/2020,62,484,222,3449,3933,20,120,5,24,0,4,92,20,11,3,9,78,494,192,3253,3747,8/3/2020
3/31/2020,71,555,369,3818,4373,11,131,7,31,1,5,95,22,13,2,11,73,567,299,3552,4119,8/3/2020
4/1/2020,99,654,699,4517,5171,18,149,7,38,0,5,106,30,15,1,12,100,667,648,4200,4867,8/3/2020
4/2/2020,52,706,477,4994,5700,21,170,6,44,2,7,119,36,21,4,16,62,729,436,4636,5365,8/3/2020
4/3/2020,108,814,775,5769,6583,23,193,7,51,0,7,135,43,25,3,19,100,829,718,5354,6183,8/3/2020
4/4/2020,143,957,660,6429,7386,22,215,4,55,5,12,148,41,30,9,28,137,966,622,5976,6942,8/3/2020
4/5/2020,187,1144,1156,7585,8729,20,235,9,64,1,13,158,44,36,2,30,182,1148,1071,7047,8195,8/3/2020
4/6/2020,218,1362,1707,9292,10654,26,261,7,71,0,13,177,48,40,7,37,206,1354,1579,8626,9980,8/3/2020
4/7/2020,285,1647,1631,10923,12570,20,281,3,74,2,15,192,49,42,5,42,260,1614,1491,10117,11731,8/3/2020
4/8/2020,290,1937,1723,12646,14583,19,300,7,81,6,21,198,49,38,10,52,272,1886,1570,11687,13573,8/3/2020
4/9/2020,284,2221,1521,14167,16388,32,332,9,90,4,25,217,52,40,7,59,278,2164,1365,13052,15216,8/3/2020
4/10/2020,420,2641,2577,16744,19385,29,361,17,107,5,30,224,58,41,11,70,404,2568,2380,15432,18000,8/3/2020
4/11/2020,299,2940,1911,18655,21595,29,390,11,118,2,32,240,61,48,12,82,280,2848,1730,17162,20010,8/3/2020
4/12/2020,315,3255,1674,20329,23584,35,425,13,131,5,37,257,59,49,10,92,289,3137,1449,18611,21748,8/3/2020
4/13/2020,162,3417,938,21267,24684,35,460,13,144,3,40,276,64,54,9,101,187,3324,845,19456,22780,8/3/2020
4/14/2020,289,3706,1788,23055,26761,27,487,17,161,5,45,281,72,53,8,109,265,3589,1553,21009,24598,8/3/2020
4/15/2020,353,4059,1803,24858,28917,31,518,19,180,3,48,290,72,54,17,126,307,3896,1577,22586,26482,8/3/2020
4/16/2020,449,4508,2500,27358,31866,36,554,25,205,6,54,295,72,53,14,140,392,4288,2097,24683,28971,8/3/2020
4/17/2020,308,4816,1823,29181,33997,32,586,20,225,7,61,300,66,45,21,161,291,4579,1472,26155,30734,8/3/2020
4/18/2020,322,5138,1728,30909,36047,26,612,18,243,4,65,304,63,49,15,176,284,4863,1360,27515,32378,8/3/2020
4/19/2020,382,5520,2059,32968,38488,23,635,26,269,1,66,300,65,55,11,187,338,5201,1759,29274,34475,8/3/2020
4/20/2020,396,5916,1909,34877,40793,46,681,29,298,2,68,315,75,56,10,197,377,5578,1591,30865,36443,8/3/2020
4/21/2020,445,6361,2114,36991,43352,45,726,31,329,5,73,324,72,56,18,215,388,5966,1726,32591,38557,8/3/2020
4/22/2020,420,6781,2398,39389,46170,41,767,32,361,5,78,328,73,58,18,233,382,6348,1923,34514,40862,8/3/2020
4/23/2020,482,7263,2471,41860,49123,30,797,28,389,5,83,325,76,62,15,248,419,6767,1890,36404,43171,8/3/2020
4/24/2020,494,7757,3292,45152,52909,35,832,27,416,4,87,329,85,63,15,263,413,7180,2650,39054,46234,8/3/2020
4/25/2020,394,8151,2210,47362,55513,34,866,17,433,5,92,341,85,62,14,277,305,7485,1786,40840,48325,8/3/2020
4/26/2020,316,8467,2314,49676,58143,33,899,15,448,3,95,356,86,59,14,291,276,7761,1889,42729,50490,8/3/2020
4/27/2020,250,8717,1624,51300,60017,29,928,21,469,4,99,360,86,61,10,301,204,7965,1169,43898,51863,8/3/2020
4/28/2020,411,9128,2268,53568,62696,44,972,24,493,3,102,377,88,59,22,323,325,8290,1774,45672,53962,8/3/2020
4/29/2020,476,9604,3351,56919,66523,36,1008,37,530,11,113,365,78,53,18,341,372,8662,2454,48126,56788,8/3/2020
4/30/2020,432,10036,2772,59691,69727,32,1040,38,568,6,119,353,83,57,24,365,348,9010,1963,50089,59099,8/3/2020
5/1/2020,457,10493,3089,62780,73273,51,1091,39,607,3,122,362,84,58,14,379,317,9327,2223,52312,61639,8/3/2020
5/2/2020,260,10753,1927,64707,75460,35,1126,39,646,5,127,353,90,61,24,403,190,9517,1298,53610,63127,8/3/2020
5/3/2020,284,11037,2168,66875,77912,31,1157,27,673,8,135,349,89,61,21,424,181,9698,1611,55221,64919,8/3/2020
5/4/2020,388,11425,2101,68976,80401,30,1187,31,704,5,140,343,87,57,18,442,293,9991,1578,56799,66790,8/3/2020
5/5/2020,436,11861,2878,71854,83715,28,1215,32,736,6,146,333,80,54,16,458,304,10295,1979,58778,69073,8/3/2020
5/6/2020,490,12351,2836,74690,87041,28,1243,44,780,9,155,308,78,54,21,479,341,10636,1932,60710,71346,8/3/2020
5/7/2020,425,12776,2975,77665,90441,36,1279,40,820,5,160,299,70,52,21,500,269,10905,1993,62703,73608,8/3/2020
5/8/2020,360,13136,2603,80268,93404,30,1309,29,849,5,165,295,70,53,22,522,231,11136,1788,64491,75627,8/3/2020
5/9/2020,457,13593,3356,83624,97217,22,1331,21,870,4,169,292,68,51,15,537,285,11421,2316,66807,78228,8/3/2020
5/10/2020,280,13873,2122,85746,99619,19,1350,23,893,6,175,282,69,49,13,550,186,11607,1530,68337,79944,8/3/2020
5/11/2020,259,14132,1861,87607,101739,31,1381,16,909,6,181,291,70,49,15,565,176,11783,1315,69652,81435,8/3/2020
5/12/2020,387,14519,2622,90229,104748,23,1404,18,927,4,185,292,68,48,22,587,217,12000,1722,71374,83374,8/3/2020
5/13/2020,352,14871,3634,93863,108734,22,1426,24,951,1,186,289,69,49,13,600,196,12196,2029,73403,85599,8/3/2020
5/14/2020,330,15201,3415,97278,112479,19,1445,27,978,3,189,278,64,45,15,615,227,12423,2023,75426,87849,8/3/2020
5/15/2020,382,15583,3470,100748,116331,24,1469,41,1019,5,194,256,62,45,13,628,234,12657,1822,77248,89905,8/3/2020
5/16/2020,438,16021,4168,104916,120937,25,1494,12,1031,5,199,264,61,46,15,643,252,12909,1977,79225,92134,8/3/2020
5/17/2020,231,16252,2775,107691,123943,17,1511,7,1038,5,204,269,59,45,10,653,124,13033,1571,80796,93829,8/3/2020
5/18/2020,251,16503,2007,109698,126201,19,1530,15,1053,5,209,268,57,40,18,671,139,13172,1376,82172,95344,8/3/2020
5/19/2020,416,16919,3178,112876,129795,23,1553,31,1084,5,214,255,56,38,11,682,214,13386,1944,84116,97502,8/3/2020
5/20/2020,328,17247,2774,115650,132897,19,1572,23,1107,7,221,244,52,33,22,704,187,13573,1526,85642,99215,8/3/2020
5/21/2020,374,17621,3764,119414,137035,26,1598,15,1122,3,224,252,53,29,20,724,170,13743,1953,87595,101338,8/3/2020
5/22/2020,351,17972,3172,122586,140558,20,1618,29,1151,5,229,238,52,29,10,734,205,13948,1618,89213,103161,8/3/2020
5/23/2020,240,18212,2748,125334,143546,19,1637,11,1162,3,232,243,52,32,13,747,109,14057,1291,90504,104561,8/3/2020
5/24/2020,153,18365,1372,126706,145071,12,1649,14,1176,2,234,239,53,36,8,755,84,14141,774,91278,105419,8/3/2020
5/25/2020,134,18499,1389,128095,146594,12,1661,14,1190,0,234,237,53,34,10,765,70,14211,765,92043,106254,8/3/2020
5/26/2020,284,18783,2624,130719,149502,24,1685,22,1212,5,239,234,48,33,15,780,155,14366,1790,93833,108199,8/3/2020
5/27/2020,276,19059,2134,132853,151912,20,1705,17,1229,3,242,234,50,33,10,790,132,14498,1146,94979,109477,8/3/2020
5/28/2020,346,19405,3384,136237,155642,17,1722,29,1258,4,246,218,47,32,8,798,132,14630,1133,96112,110742,8/3/2020
5/29/2020,419,19824,3989,140226,160050,18,1740,27,1285,6,252,203,43,31,12,810,179,14809,1596,97708,112517,8/3/2020
5/30/2020,211,20035,3973,144199,164234,15,1755,19,1304,4,256,195,40,29,12,822,104,14913,1828,99536,114449,8/3/2020
5/31/2020,148,20183,1753,145952,166135,10,1765,10,1314,0,256,195,43,26,3,825,76,14989,856,100392,115381,8/3/2020
6/1/2020,216,20399,2813,148765,169164,7,1772,13,1327,1,257,188,44,29,5,830,99,15088,1378,101770,116858,8/3/2020
6/2/2020,273,20672,3080,151845,172517,8,1780,9,1336,3,260,184,37,25,10,840,107,15195,1469,103239,118434,8/3/2020
6/3/2020,259,20931,3509,155354,176285,13,1793,18,1354,6,266,173,34,25,11,851,105,15300,1671,104910,120210,8/3/2020
6/4/2020,281,21212,4522,159876,181088,7,1800,25,1379,3,269,152,31,24,11,862,114,15414,2042,106952,122366,8/3/2020
6/5/2020,215,21427,3583,163459,184886,15,1815,12,1391,5,274,150,27,21,9,871,104,15518,1580,108532,124050,8/3/2020
6/6/2020,198,21625,2622,166081,187706,10,1825,7,1398,2,276,151,29,19,6,877,68,15586,1135,109667,125253,8/3/2020
6/7/2020,77,21702,1614,167695,189397,11,1836,7,1405,1,277,154,25,17,4,881,49,15635,777,110444,126079,8/3/2020
6/8/2020,122,21824,1847,169542,191366,15,1851,12,1417,2,279,155,27,18,4,885,44,15679,965,111409,127088,8/3/2020
6/9/2020,225,22049,2674,172216,194265,10,1861,18,1435,0,279,147,28,21,1,886,67,15746,1263,112672,128418,8/3/2020
6/10/2020,210,22259,2983,175199,197458,13,1874,12,1447,2,281,146,24,17,3,889,104,15850,1459,114131,129981,8/3/2020
6/11/2020,195,22454,3499,178698,201152,7,1881,15,1462,1,282,137,25,16,6,895,88,15938,1529,115660,131598,8/3/2020
6/12/2020,213,22667,4603,183301,205968,8,1889,15,1477,1,283,129,24,16,2,897,80,16018,2189,117849,133867,8/3/2020
6/13/2020,111,22778,3028,186329,209107,6,1895,4,1481,0,283,131,20,15,3,900,50,16068,1368,119217,135285,8/3/2020
6/14/2020,78,22856,2037,188366,211222,6,1901,8,1489,1,284,128,20,14,3,903,32,16100,965,120182,136282,8/3/2020
6/15/2020,189,23045,3105,191471,214516,14,1915,14,1503,0,284,128,20,16,4,907,78,16178,1786,121968,138146,8/3/2020
6/16/2020,115,23160,3010,194481,217641,11,1926,10,1513,1,285,128,22,16,8,915,52,16230,1579,123547,139777,8/3/2020
6/17/2020,123,23283,2826,197307,220590,15,1941,20,1533,4,289,119,18,14,6,921,52,16282,1314,124861,141143,8/3/2020
6/18/2020,150,23433,3039,200346,223779,9,1950,13,1546,1,290,114,19,16,7,928,70,16352,1331,126192,142544,8/3/2020
6/19/2020,141,23574,3761,204107,227681,12,1962,11,1557,1,291,114,20,17,3,931,59,16411,1374,127566,143977,8/3/2020
6/20/2020,80,23654,1883,205990,229644,7,1969,9,1566,0,291,112,20,18,4,935,36,16447,814,128380,144827,8/3/2020
6/21/2020,36,23690,1042,207032,230722,7,1976,5,1571,0,291,114,20,18,2,937,27,16474,679,129059,145533,8/3/2020
6/22/2020,142,23832,3713,210745,234577,12,1988,16,1587,0,291,110,19,18,1,938,70,16544,1703,130762,147306,8/3/2020
6/23/2020,162,23994,3850,214595,238589,3,1991,13,1600,3,294,97,18,18,6,944,83,16627,1793,132555,149182,8/3/2020
6/24/2020,121,24115,3508,218103,242218,8,1999,10,1610,1,295,94,17,18,5,949,47,16674,1692,134247,150921,8/3/2020
6/25/2020,102,24217,2885,220988,245205,5,2004,14,1624,1,296,84,16,17,1,950,52,16726,1507,135754,152480,8/3/2020
6/26/2020,94,24311,2454,223442,247753,2,2006,9,1633,0,296,77,17,18,1,951,64,16790,1304,137058,153848,8/3/2020
6/27/2020,84,24395,3212,226654,251049,5,2011,3,1636,1,297,78,16,17,5,956,37,16827,1214,138272,155099,8/3/2020
6/28/2020,37,24432,1452,228106,252538,4,2015,4,1640,4,301,74,14,14,6,962,18,16845,586,138858,155703,8/3/2020
6/29/2020,86,24518,3673,231779,256297,4,2019,5,1645,0,301,73,13,14,1,963,38,16883,1343,140201,157084,8/3/2020
6/30/2020,60,24578,1945,233724,258302,1,2020,5,1650,1,302,68,11,11,3,966,35,16918,994,141195,158113,8/3/2020
7/1/2020,145,24723,4106,237830,262553,7,2027,9,1659,0,302,66,10,11,1,967,81,16999,1954,143149,160148,8/3/2020
7/2/2020,101,24824,2778,240608,265432,5,2032,5,1664,1,303,65,8,9,1,968,56,17055,1075,144224,161279,8/3/2020
7/3/2020,47,24871,2013,242621,267492,7,2039,6,1670,0,303,66,7,8,3,971,25,17080,771,144995,162075,8/3/2020
7/4/2020,57,24928,2320,244941,269869,2,2041,4,1674,1,304,63,8,8,2,973,34,17114,991,145986,163100,8/3/2020
7/5/2020,47,24975,2924,247865,272840,1,2042,2,1676,1,305,61,6,7,2,975,23,17137,1442,147428,164565,8/3/2020
7/6/2020,103,25078,2790,250655,275733,6,2048,6,1682,0,305,61,8,9,4,979,60,17197,1543,148971,166168,8/3/2020
7/7/2020,80,25158,3438,254093,279251,5,2053,6,1688,0,305,60,7,8,1,980,47,17244,1532,150503,167747,8/3/2020
7/8/2020,104,25262,3381,257474,282736,4,2057,2,1690,0,305,62,8,8,0,980,66,17310,1418,151921,169231,8/3/2020
7/9/2020,94,25356,3658,261132,286488,7,2064,2,1692,0,305,67,8,8,0,980,50,17360,1595,153516,170876,8/3/2020
7/10/2020,129,25485,4387,265519,291004,5,2069,3,1695,2,307,67,7,7,3,983,79,17439,2077,155593,173032,8/3/2020
7/11/2020,63,25548,2881,268400,293948,6,2075,3,1698,1,308,69,6,6,3,986,34,17473,1278,156871,174344,8/3/2020
7/12/2020,45,25593,1764,270164,295757,1,2076,2,1700,1,309,67,6,5,3,989,33,17506,886,157757,175263,8/3/2020
7/13/2020,85,25678,3142,273306,298984,7,2083,10,1710,0,309,64,6,5,1,990,57,17563,1469,159226,176789,8/3/2020
7/14/2020,75,25753,3246,276552,302305,7,2090,4,1714,0,309,67,5,5,1,991,50,17613,1348,160574,178187,8/3/2020
7/15/2020,123,25876,4118,280670,306546,5,2095,6,1720,0,309,66,5,4,0,991,94,17707,1726,162300,180007,8/3/2020
7/16/2020,102,25978,3678,284348,310326,6,2101,8,1728,0,309,64,6,5,1,992,79,17786,1584,163884,181670,8/3/2020
7/17/2020,151,26129,4114,288462,314591,14,2115,3,1731,1,310,74,5,5,1,993,78,17864,1798,165682,183546,8/3/2020
7/18/2020,80,26209,3141,291603,317812,5,2120,9,1740,1,311,69,5,4,4,997,67,17931,1342,167024,184955,8/3/2020
7/19/2020,82,26291,2577,294180,320471,6,2126,3,1743,0,311,72,6,4,2,999,58,17989,1071,168095,186084,8/3/2020
7/20/2020,72,26363,2592,296772,323135,9,2135,7,1750,0,311,74,7,5,2,1001,64,18053,1443,169538,187591,8/3/2020
7/21/2020,128,26491,4212,300984,327475,9,2144,10,1760,0,311,73,9,6,1,1002,105,18158,1872,171410,189568,8/3/2020
7/22/2020,123,26614,3783,304767,331381,11,2155,11,1771,1,312,72,7,6,1,1003,88,18246,1578,172988,191234,8/3/2020
7/23/2020,123,26737,4055,308822,335559,6,2161,5,1776,0,312,73,8,7,0,1003,107,18353,1754,174742,193095,8/3/2020
7/24/2020,161,26898,5672,314494,341392,12,2173,12,1788,0,312,73,9,7,0,1003,116,18469,2148,176890,195359,8/3/2020
7/25/2020,126,27024,4258,318752,345776,7,2180,7,1795,0,312,73,10,7,1,1004,106,18575,2000,178890,197465,8/3/2020
7/26/2020,56,27080,2957,321709,348789,7,2187,8,1803,0,312,72,11,5,1,1005,52,18627,1302,180192,198819,8/3/2020
7/27/2020,182,27262,3867,325576,352838,11,2198,7,1810,0,312,76,13,6,1,1006,138,18765,2108,182300,201065,8/3/2020
7/28/2020,101,27363,3617,329193,356556,5,2203,3,1813,0,312,78,14,5,1,1007,94,18859,1488,183788,202647,8/3/2020
7/29/2020,154,27517,4673,333866,361383,10,2213,12,1825,0,312,76,15,5,0,1007,128,18987,2015,185803,204790,8/3/2020
7/30/2020,95,27612,3882,337748,365360,5,2218,2,1827,1,313,78,15,4,0,1007,75,19062,1299,187102,206164,8/3/2020
7/31/2020,114,27726,4949,342697,370423,8,2226,9,1836,0,313,77,15,5,0,1007,81,19143,1527,188629,207772,8/3/2020
8/1/2020,83,27809,3689,346386,374195,5,2231,2,1838,0,313,80,14,5,1,1008,50,19193,1179,189808,209001,8/3/2020
8/2/2020,69,27878,2407,348793,376671,,,,,,,,,,2,1010,53,19246,1012,190820,210066,8/3/2020
2/27/2020,0,0,0,0,0,1,1,0,0,0,0,1,0,0,0,0,0,0,0,0,0,8/4/2020
2/28/2020,0,0,0,0,0,0,1,0,0,0,0,1,1,0,0,0,0,0,0,0,0,8/4/2020
2/29/2020,0,0,0,0,0,0,1,0,0,0,0,1,1,0,0,0,0,0,0,0,0,8/4/2020
3/1/2020,2,2,2,2,4,0,1,0,0,0,0,1,1,1,0,0,2,2,2,2,4,8/4/2020
3/2/2020,0,2,1,3,5,1,2,0,0,0,0,2,2,2,0,0,0,2,1,3,5,8/4/2020
3/3/2020,0,2,2,5,7,0,2,0,0,0,0,2,2,2,0,0,0,2,2,5,7,8/4/2020
3/4/2020,0,2,12,17,19,1,3,0,0,0,0,3,2,2,0,0,0,2,10,15,17,8/4/2020
3/5/2020,0,2,4,21,23,0,3,0,0,0,0,3,2,2,0,0,1,3,4,19,22,8/4/2020
3/6/2020,1,3,12,33,36,0,3,0,0,0,0,3,2,2,0,0,0,3,11,30,33,8/4/2020
3/7/2020,0,3,19,52,55,0,3,0,0,0,0,3,2,1,0,0,0,3,19,49,52,8/4/2020
3/8/2020,0,3,18,70,73,0,3,0,0,0,0,3,2,1,0,0,0,3,18,67,70,8/4/2020
3/9/2020,1,4,15,85,89,0,3,0,0,0,0,3,2,1,0,0,1,4,15,82,86,8/4/2020
3/10/2020,2,6,25,110,116,0,3,0,0,0,0,3,2,1,0,0,1,5,23,105,110,8/4/2020
3/11/2020,0,6,34,144,150,1,4,0,0,0,0,4,1,1,0,0,0,5,34,139,144,8/4/2020
3/12/2020,9,15,42,186,201,1,5,0,0,0,0,5,1,1,0,0,8,13,38,177,190,8/4/2020
3/13/2020,6,21,50,236,257,4,9,1,1,0,0,8,1,1,0,0,6,19,48,225,244,8/4/2020
3/14/2020,0,21,90,326,347,0,9,0,1,0,0,8,1,1,0,0,0,19,86,311,330,8/4/2020
3/15/2020,1,22,54,380,402,1,10,0,1,0,0,9,2,1,0,0,1,20,54,365,385,8/4/2020
3/16/2020,2,24,95,475,499,2,12,0,1,0,0,11,2,0,0,0,2,22,92,457,479,8/4/2020
3/17/2020,16,40,162,637,677,6,18,0,1,0,0,17,2,0,0,0,11,33,152,609,642,8/4/2020
3/18/2020,12,52,116,753,805,3,21,0,1,0,0,20,2,0,0,0,11,44,111,720,764,8/4/2020
3/19/2020,17,69,262,1015,1084,2,23,1,2,0,0,21,3,0,1,1,17,61,251,971,1032,8/4/2020
3/20/2020,15,84,197,1212,1296,5,28,0,2,0,0,26,4,0,0,1,13,74,192,1163,1237,8/4/2020
3/21/2020,21,105,126,1338,1443,3,31,2,4,0,0,27,5,0,0,1,14,88,123,1286,1374,8/4/2020
3/22/2020,30,135,282,1620,1755,2,33,0,4,0,0,29,5,0,0,1,25,113,264,1550,1663,8/4/2020
3/23/2020,14,149,169,1789,1938,15,48,1,5,0,0,43,9,3,0,1,16,129,165,1715,1844,8/4/2020
3/24/2020,20,169,243,2032,2201,7,55,0,5,0,0,50,10,4,0,1,19,148,238,1953,2101,8/4/2020
3/25/2020,26,195,183,2215,2410,5,60,1,6,0,0,54,11,3,0,1,28,176,173,2126,2302,8/4/2020
3/26/2020,35,230,181,2396,2626,10,70,5,11,0,0,59,14,5,0,1,41,217,176,2302,2519,8/4/2020
3/27/2020,27,257,215,2611,2868,9,79,1,12,1,1,66,17,6,2,3,31,248,202,2504,2752,8/4/2020
3/28/2020,59,316,260,2871,3187,13,92,3,15,2,3,74,15,6,1,4,63,311,242,2746,3057,8/4/2020
3/29/2020,106,422,356,3227,3649,8,100,4,19,1,4,77,18,8,2,6,105,416,314,3060,3476,8/4/2020
3/30/2020,62,484,222,3449,3933,20,120,5,24,0,4,92,20,11,3,9,78,494,192,3252,3746,8/4/2020
3/31/2020,71,555,369,3818,4373,11,131,7,31,1,5,95,22,13,2,11,73,567,299,3551,4118,8/4/2020
4/1/2020,99,654,699,4517,5171,18,149,7,38,0,5,106,30,15,1,12,100,667,648,4199,4866,8/4/2020
4/2/2020,52,706,477,4994,5700,21,170,6,44,2,7,119,36,21,4,16,62,729,436,4635,5364,8/4/2020
4/3/2020,108,814,775,5769,6583,23,193,7,51,0,7,135,43,25,3,19,100,829,718,5353,6182,8/4/2020
4/4/2020,143,957,660,6429,7386,22,215,4,55,5,12,148,41,30,9,28,137,966,622,5975,6941,8/4/2020
4/5/2020,187,1144,1156,7585,8729,20,235,9,64,1,13,158,44,36,2,30,182,1148,1071,7046,8194,8/4/2020
4/6/2020,218,1362,1707,9292,10654,26,261,7,71,0,13,177,48,40,7,37,206,1354,1578,8624,9978,8/4/2020
4/7/2020,285,1647,1631,10923,12570,20,281,3,74,2,15,192,49,42,5,42,260,1614,1490,10114,11728,8/4/2020
4/8/2020,290,1937,1723,12646,14583,19,300,7,81,6,21,198,49,38,10,52,272,1886,1570,11684,13570,8/4/2020
4/9/2020,284,2221,1521,14167,16388,32,332,9,90,4,25,217,52,40,7,59,278,2164,1365,13049,15213,8/4/2020
4/10/2020,420,2641,2577,16744,19385,29,361,17,107,5,30,224,58,41,11,70,404,2568,2380,15429,17997,8/4/2020
4/11/2020,299,2940,1911,18655,21595,29,390,11,118,2,32,240,61,48,12,82,280,2848,1728,17157,20005,8/4/2020
4/12/2020,315,3255,1674,20329,23584,35,425,13,131,5,37,257,59,49,10,92,289,3137,1448,18605,21742,8/4/2020
4/13/2020,162,3417,938,21267,24684,35,460,13,144,3,40,276,64,54,9,101,187,3324,844,19449,22773,8/4/2020
4/14/2020,289,3706,1788,23055,26761,27,487,17,161,5,45,281,72,53,8,109,265,3589,1553,21002,24591,8/4/2020
4/15/2020,353,4059,1803,24858,28917,31,518,19,180,3,48,290,72,54,17,126,307,3896,1577,22579,26475,8/4/2020
4/16/2020,449,4508,2500,27358,31866,36,554,25,205,6,54,295,72,53,14,140,392,4288,2097,24676,28964,8/4/2020
4/17/2020,308,4816,1823,29181,33997,32,586,20,225,7,61,300,66,45,21,161,291,4579,1472,26148,30727,8/4/2020
4/18/2020,322,5138,1728,30909,36047,26,612,18,243,4,65,304,63,49,15,176,284,4863,1360,27508,32371,8/4/2020
4/19/2020,382,5520,2059,32968,38488,23,635,26,269,1,66,300,65,55,11,187,338,5201,1759,29267,34468,8/4/2020
4/20/2020,396,5916,1909,34877,40793,46,681,29,298,2,68,315,75,56,10,197,377,5578,1590,30857,36435,8/4/2020
4/21/2020,445,6361,2114,36991,43352,45,726,31,329,5,73,324,72,56,18,215,388,5966,1725,32582,38548,8/4/2020
4/22/2020,420,6781,2398,39389,46170,41,767,32,361,5,78,328,73,58,18,233,382,6348,1923,34505,40853,8/4/2020
4/23/2020,482,7263,2471,41860,49123,30,797,28,389,5,83,325,76,62,15,248,419,6767,1889,36394,43161,8/4/2020
4/24/2020,494,7757,3292,45152,52909,35,832,27,416,4,87,329,85,63,15,263,413,7180,2650,39044,46224,8/4/2020
4/25/2020,394,8151,2210,47362,55513,34,866,17,433,5,92,341,85,62,14,277,305,7485,1786,40830,48315,8/4/2020
4/26/2020,316,8467,2314,49676,58143,33,899,15,448,3,95,356,86,59,14,291,276,7761,1889,42719,50480,8/4/2020
4/27/2020,250,8717,1624,51300,60017,29,928,21,469,4,99,360,86,61,10,301,204,7965,1169,43888,51853,8/4/2020
4/28/2020,411,9128,2268,53568,62696,44,972,24,493,3,102,377,88,59,22,323,325,8290,1774,45662,53952,8/4/2020
4/29/2020,476,9604,3351,56919,66523,36,1008,37,530,11,113,365,78,53,18,341,372,8662,2454,48116,56778,8/4/2020
4/30/2020,432,10036,2772,59691,69727,32,1040,38,568,6,119,353,83,57,24,365,347,9009,1963,50079,59088,8/4/2020
5/1/2020,457,10493,3089,62780,73273,51,1091,39,607,3,122,362,84,58,14,379,317,9326,2222,52301,61627,8/4/2020
5/2/2020,260,10753,1927,64707,75460,35,1126,39,646,5,127,353,90,61,24,403,189,9515,1298,53599,63114,8/4/2020
5/3/2020,284,11037,2168,66875,77912,31,1157,27,673,8,135,349,89,61,21,424,181,9696,1611,55210,64906,8/4/2020
5/4/2020,388,11425,2101,68976,80401,30,1187,31,704,5,140,343,87,57,18,442,293,9989,1578,56788,66777,8/4/2020
5/5/2020,436,11861,2878,71854,83715,28,1215,32,736,6,146,333,80,54,16,458,304,10293,1979,58767,69060,8/4/2020
5/6/2020,490,12351,2836,74690,87041,28,1243,44,780,9,155,308,78,54,21,479,341,10634,1932,60699,71333,8/4/2020
5/7/2020,425,12776,2975,77665,90441,36,1279,40,820,5,160,299,70,52,21,500,269,10903,1993,62692,73595,8/4/2020
5/8/2020,360,13136,2603,80268,93404,30,1309,29,849,5,165,295,70,53,22,522,231,11134,1787,64479,75613,8/4/2020
5/9/2020,457,13593,3356,83624,97217,22,1331,21,870,4,169,292,68,51,15,537,285,11419,2315,66794,78213,8/4/2020
5/10/2020,280,13873,2122,85746,99619,19,1350,23,893,6,175,282,69,49,13,550,186,11605,1530,68324,79929,8/4/2020
5/11/2020,259,14132,1861,87607,101739,31,1381,16,909,6,181,291,70,49,15,565,176,11781,1315,69639,81420,8/4/2020
5/12/2020,387,14519,2622,90229,104748,23,1404,18,927,4,185,292,68,48,22,587,217,11998,1722,71361,83359,8/4/2020
5/13/2020,352,14871,3634,93863,108734,22,1426,24,951,1,186,289,69,49,13,600,196,12194,2028,73389,85583,8/4/2020
5/14/2020,330,15201,3415,97278,112479,19,1445,27,978,3,189,278,64,45,15,615,227,12421,2023,75412,87833,8/4/2020
5/15/2020,382,15583,3470,100748,116331,24,1469,41,1019,5,194,256,62,45,13,628,234,12655,1821,77233,89888,8/4/2020
5/16/2020,438,16021,4168,104916,120937,25,1494,12,1031,5,199,264,61,46,15,643,252,12907,1976,79209,92116,8/4/2020
5/17/2020,231,16252,2775,107691,123943,17,1511,7,1038,5,204,269,59,45,10,653,124,13031,1570,80779,93810,8/4/2020
5/18/2020,251,16503,2007,109698,126201,19,1530,15,1053,5,209,268,57,40,18,671,139,13170,1375,82154,95324,8/4/2020
5/19/2020,416,16919,3178,112876,129795,23,1553,31,1084,5,214,255,56,38,11,682,214,13384,1944,84098,97482,8/4/2020
5/20/2020,328,17247,2774,115650,132897,19,1572,23,1107,7,221,244,52,33,22,704,187,13571,1525,85623,99194,8/4/2020
5/21/2020,374,17621,3764,119414,137035,26,1598,15,1122,3,224,252,53,29,20,724,170,13741,1953,87576,101317,8/4/2020
5/22/2020,351,17972,3172,122586,140558,20,1618,29,1151,5,229,238,52,29,10,734,205,13946,1617,89193,103139,8/4/2020
5/23/2020,240,18212,2748,125334,143546,19,1637,11,1162,3,232,243,52,32,13,747,109,14055,1291,90484,104539,8/4/2020
5/24/2020,153,18365,1372,126706,145071,12,1649,14,1176,2,234,239,53,36,8,755,84,14139,774,91258,105397,8/4/2020
5/25/2020,134,18499,1389,128095,146594,12,1661,14,1190,0,234,237,53,34,10,765,70,14209,765,92023,106232,8/4/2020
5/26/2020,284,18783,2624,130719,149502,24,1685,22,1212,5,239,234,48,33,15,780,155,14364,1790,93813,108177,8/4/2020
5/27/2020,276,19059,2134,132853,151912,20,1705,17,1229,3,242,234,50,33,10,790,132,14496,1145,94958,109454,8/4/2020
5/28/2020,346,19405,3384,136237,155642,17,1722,29,1258,4,246,218,47,32,8,798,132,14628,1133,96091,110719,8/4/2020
5/29/2020,419,19824,3989,140226,160050,18,1740,27,1285,6,252,203,43,31,12,810,179,14807,1596,97687,112494,8/4/2020
5/30/2020,211,20035,3973,144199,164234,15,1755,19,1304,4,256,195,40,29,12,822,104,14911,1828,99515,114426,8/4/2020
5/31/2020,148,20183,1753,145952,166135,10,1765,10,1314,0,256,195,43,26,3,825,76,14987,856,100371,115358,8/4/2020
6/1/2020,216,20399,2813,148765,169164,7,1772,13,1327,1,257,188,44,29,5,830,99,15086,1378,101749,116835,8/4/2020
6/2/2020,273,20672,3080,151845,172517,8,1780,9,1336,3,260,184,37,25,10,840,107,15193,1469,103218,118411,8/4/2020
6/3/2020,259,20931,3509,155354,176285,13,1793,18,1354,6,266,173,34,25,11,851,105,15298,1671,104889,120187,8/4/2020
6/4/2020,281,21212,4522,159876,181088,7,1800,25,1379,3,269,152,31,24,11,862,114,15412,2042,106931,122343,8/4/2020
6/5/2020,215,21427,3583,163459,184886,15,1815,12,1391,5,274,150,27,21,9,871,104,15516,1580,108511,124027,8/4/2020
6/6/2020,198,21625,2622,166081,187706,10,1825,7,1398,2,276,151,29,19,6,877,68,15584,1135,109646,125230,8/4/2020
6/7/2020,77,21702,1614,167695,189397,11,1836,7,1405,1,277,154,25,17,4,881,49,15633,777,110423,126056,8/4/2020
6/8/2020,122,21824,1847,169542,191366,15,1851,12,1417,2,279,155,27,18,4,885,44,15677,965,111388,127065,8/4/2020
6/9/2020,225,22049,2674,172216,194265,10,1861,18,1435,0,279,147,28,21,1,886,67,15744,1263,112651,128395,8/4/2020
6/10/2020,210,22259,2983,175199,197458,13,1874,12,1447,2,281,146,24,17,3,889,104,15848,1459,114110,129958,8/4/2020
6/11/2020,195,22454,3499,178698,201152,7,1881,15,1462,1,282,137,25,16,6,895,88,15936,1529,115639,131575,8/4/2020
6/12/2020,213,22667,4603,183301,205968,8,1889,15,1477,1,283,129,24,16,2,897,80,16016,2189,117828,133844,8/4/2020
6/13/2020,111,22778,3028,186329,209107,6,1895,4,1481,0,283,131,20,15,3,900,50,16066,1368,119196,135262,8/4/2020
6/14/2020,78,22856,2037,188366,211222,6,1901,8,1489,1,284,128,20,14,3,903,32,16098,965,120161,136259,8/4/2020
6/15/2020,189,23045,3105,191471,214516,14,1915,14,1503,0,284,128,20,16,4,907,78,16176,1785,121946,138122,8/4/2020
6/16/2020,115,23160,3010,194481,217641,11,1926,10,1513,1,285,128,22,16,8,915,52,16228,1578,123524,139752,8/4/2020
6/17/2020,123,23283,2826,197307,220590,15,1941,20,1533,4,289,119,18,14,6,921,52,16280,1314,124838,141118,8/4/2020
6/18/2020,150,23433,3039,200346,223779,9,1950,13,1546,1,290,114,19,16,7,928,70,16350,1331,126169,142519,8/4/2020
6/19/2020,141,23574,3761,204107,227681,12,1962,11,1557,1,291,114,20,17,3,931,59,16409,1373,127542,143951,8/4/2020
6/20/2020,80,23654,1883,205990,229644,7,1969,9,1566,0,291,112,20,18,4,935,36,16445,814,128356,144801,8/4/2020
6/21/2020,36,23690,1042,207032,230722,7,1976,5,1571,0,291,114,20,18,2,937,27,16472,679,129035,145507,8/4/2020
6/22/2020,142,23832,3713,210745,234577,12,1988,16,1587,0,291,110,19,18,1,938,70,16542,1703,130738,147280,8/4/2020
6/23/2020,162,23994,3850,214595,238589,3,1991,13,1600,3,294,97,18,18,6,944,83,16625,1792,132530,149155,8/4/2020
6/24/2020,121,24115,3508,218103,242218,9,2000,10,1610,1,295,95,18,18,5,949,47,16672,1692,134222,150894,8/4/2020
6/25/2020,102,24217,2885,220988,245205,5,2005,14,1624,1,296,85,17,17,1,950,52,16724,1507,135729,152453,8/4/2020
6/26/2020,94,24311,2454,223442,247753,2,2007,9,1633,0,296,78,18,18,1,951,64,16788,1304,137033,153821,8/4/2020
6/27/2020,84,24395,3212,226654,251049,5,2012,3,1636,1,297,79,17,17,5,956,37,16825,1214,138247,155072,8/4/2020
6/28/2020,37,24432,1452,228106,252538,4,2016,4,1640,4,301,75,15,14,6,962,18,16843,586,138833,155676,8/4/2020
6/29/2020,86,24518,3673,231779,256297,4,2020,5,1645,0,301,74,14,14,1,963,38,16881,1343,140176,157057,8/4/2020
6/30/2020,60,24578,1945,233724,258302,1,2021,5,1650,1,302,69,12,11,3,966,35,16916,994,141170,158086,8/4/2020
7/1/2020,145,24723,4106,237830,262553,7,2028,9,1659,0,302,67,11,11,1,967,81,16997,1952,143122,160119,8/4/2020
7/2/2020,101,24824,2778,240608,265432,5,2033,5,1664,1,303,66,9,9,1,968,56,17053,1075,144197,161250,8/4/2020
7/3/2020,47,24871,2013,242621,267492,7,2040,6,1670,0,303,67,8,8,3,971,25,17078,771,144968,162046,8/4/2020
7/4/2020,57,24928,2320,244941,269869,2,2042,4,1674,1,304,64,9,8,2,973,34,17112,991,145959,163071,8/4/2020
7/5/2020,47,24975,2924,247865,272840,1,2043,2,1676,1,305,62,7,7,2,975,23,17135,1442,147401,164536,8/4/2020
7/6/2020,103,25078,2790,250655,275733,6,2049,6,1682,0,305,62,8,9,4,979,60,17195,1543,148944,166139,8/4/2020
7/7/2020,80,25158,3438,254093,279251,5,2054,6,1688,0,305,61,7,8,1,980,47,17242,1532,150476,167718,8/4/2020
7/8/2020,104,25262,3381,257474,282736,4,2058,2,1690,0,305,63,8,8,0,980,66,17308,1418,151894,169202,8/4/2020
7/9/2020,94,25356,3658,261132,286488,7,2065,2,1692,0,305,68,8,8,0,980,50,17358,1595,153489,170847,8/4/2020
7/10/2020,129,25485,4387,265519,291004,5,2070,3,1695,2,307,68,7,7,3,983,79,17437,2076,155565,173002,8/4/2020
7/11/2020,63,25548,2881,268400,293948,6,2076,3,1698,1,308,70,6,6,3,986,34,17471,1278,156843,174314,8/4/2020
7/12/2020,45,25593,1764,270164,295757,1,2077,2,1700,1,309,68,6,5,3,989,33,17504,885,157728,175232,8/4/2020
7/13/2020,85,25678,3142,273306,298984,7,2084,10,1710,0,309,65,6,5,1,990,57,17561,1469,159197,176758,8/4/2020
7/14/2020,75,25753,3246,276552,302305,7,2091,4,1714,0,309,68,5,5,1,991,50,17611,1348,160545,178156,8/4/2020
7/15/2020,123,25876,4118,280670,306546,5,2096,6,1720,0,309,67,5,4,0,991,94,17705,1726,162271,179976,8/4/2020
7/16/2020,102,25978,3678,284348,310326,6,2102,8,1728,0,309,65,6,5,1,992,78,17783,1584,163855,181638,8/4/2020
7/17/2020,151,26129,4114,288462,314591,14,2116,3,1731,1,310,75,5,5,1,993,78,17861,1798,165653,183514,8/4/2020
7/18/2020,80,26209,3141,291603,317812,5,2121,9,1740,1,311,70,5,4,4,997,67,17928,1342,166995,184923,8/4/2020
7/19/2020,82,26291,2577,294180,320471,6,2127,3,1743,0,311,73,6,4,2,999,58,17986,1071,168066,186052,8/4/2020
7/20/2020,72,26363,2592,296772,323135,9,2136,7,1750,0,311,75,7,5,2,1001,63,18049,1443,169509,187558,8/4/2020
7/21/2020,128,26491,4212,300984,327475,9,2145,10,1760,0,311,74,9,6,1,1002,105,18154,1872,171381,189535,8/4/2020
7/22/2020,123,26614,3783,304767,331381,11,2156,11,1771,1,312,73,7,6,1,1003,87,18241,1578,172959,191200,8/4/2020
7/23/2020,123,26737,4054,308821,335558,6,2162,5,1776,0,312,74,8,7,0,1003,106,18347,1753,174712,193059,8/4/2020
7/24/2020,161,26898,5672,314493,341391,12,2174,12,1788,0,312,74,9,7,0,1003,116,18463,2147,176859,195322,8/4/2020
7/25/2020,126,27024,4258,318751,345775,7,2181,7,1795,0,312,74,10,7,1,1004,104,18567,2000,178859,197426,8/4/2020
7/26/2020,56,27080,2957,321708,348788,7,2188,8,1803,0,312,73,11,5,1,1005,52,18619,1302,180161,198780,8/4/2020
7/27/2020,182,27262,3867,325575,352837,11,2199,7,1810,0,312,77,13,6,1,1006,138,18757,2108,182269,201026,8/4/2020
7/28/2020,101,27363,3617,329192,356555,5,2204,3,1813,0,312,79,14,5,1,1007,92,18849,1488,183757,202606,8/4/2020
7/29/2020,154,27517,4674,333866,361383,10,2214,12,1825,0,312,77,15,5,0,1007,124,18973,2016,185773,204746,8/4/2020
7/30/2020,95,27612,3883,337749,365361,5,2219,2,1827,1,313,79,15,4,0,1007,78,19051,1300,187073,206124,8/4/2020
7/31/2020,114,27726,5004,342753,370479,8,2227,9,1836,0,313,78,15,5,0,1007,87,19138,1561,188634,207772,8/4/2020
8/1/2020,83,27809,3727,346480,374289,7,2234,2,1838,0,313,83,14,5,1,1008,70,19208,1201,189835,209043,8/4/2020
8/2/2020,72,27881,2559,349039,376920,8,2242,10,1848,1,314,80,14,6,2,1010,59,19267,1115,190950,210217,8/4/2020
8/3/2020,148,28029,4410,353449,381478,,,,,,,,,,1,1011,123,19390,1613,192563,211953,8/4/2020
2/27/2020,0,0,0,0,0,1,1,0,0,0,0,1,0,0,0,0,0,0,0,0,0,8/5/2020
2/28/2020,0,0,0,0,0,0,1,0,0,0,0,1,1,0,0,0,0,0,0,0,0,8/5/2020
2/29/2020,0,0,0,0,0,0,1,0,0,0,0,1,1,0,0,0,0,0,0,0,0,8/5/2020
3/1/2020,2,2,2,2,4,0,1,0,0,0,0,1,1,1,0,0,2,2,2,2,4,8/5/2020
3/2/2020,0,2,1,3,5,1,2,0,0,0,0,2,2,2,0,0,0,2,1,3,5,8/5/2020
3/3/2020,0,2,2,5,7,0,2,0,0,0,0,2,2,2,0,0,0,2,2,5,7,8/5/2020
3/4/2020,0,2,12,17,19,1,3,0,0,0,0,3,2,2,0,0,0,2,10,15,17,8/5/2020
3/5/2020,0,2,4,21,23,0,3,0,0,0,0,3,2,2,0,0,1,3,4,19,22,8/5/2020
3/6/2020,1,3,12,33,36,0,3,0,0,0,0,3,2,2,0,0,0,3,11,30,33,8/5/2020
3/7/2020,0,3,19,52,55,0,3,0,0,0,0,3,2,1,0,0,0,3,19,49,52,8/5/2020
3/8/2020,0,3,18,70,73,0,3,0,0,0,0,3,2,1,0,0,0,3,18,67,70,8/5/2020
3/9/2020,1,4,15,85,89,0,3,0,0,0,0,3,2,1,0,0,1,4,15,82,86,8/5/2020
3/10/2020,2,6,25,110,116,0,3,0,0,0,0,3,2,1,0,0,1,5,23,105,110,8/5/2020
3/11/2020,0,6,34,144,150,1,4,0,0,0,0,4,1,1,0,0,0,5,34,139,144,8/5/2020
3/12/2020,9,15,42,186,201,1,5,0,0,0,0,5,1,1,0,0,8,13,38,177,190,8/5/2020
3/13/2020,6,21,50,236,257,4,9,1,1,0,0,8,1,1,0,0,6,19,48,225,244,8/5/2020
3/14/2020,0,21,90,326,347,0,9,0,1,0,0,8,1,1,0,0,0,19,86,311,330,8/5/2020
3/15/2020,1,22,54,380,402,1,10,0,1,0,0,9,2,1,0,0,1,20,54,365,385,8/5/2020
3/16/2020,2,24,95,475,499,2,12,0,1,0,0,11,2,0,0,0,2,22,92,457,479,8/5/2020
3/17/2020,16,40,162,637,677,6,18,0,1,0,0,17,2,0,0,0,11,33,152,609,642,8/5/2020
3/18/2020,12,52,116,753,805,3,21,0,1,0,0,20,2,0,0,0,11,44,111,720,764,8/5/2020
3/19/2020,17,69,262,1015,1084,2,23,1,2,0,0,21,3,0,1,1,17,61,251,971,1032,8/5/2020
3/20/2020,15,84,197,1212,1296,5,28,0,2,0,0,26,4,0,0,1,13,74,192,1163,1237,8/5/2020
3/21/2020,21,105,126,1338,1443,3,31,2,4,0,0,27,5,0,0,1,14,88,123,1286,1374,8/5/2020
3/22/2020,30,135,282,1620,1755,2,33,0,4,0,0,29,5,0,0,1,25,113,264,1550,1663,8/5/2020
3/23/2020,14,149,169,1789,1938,15,48,1,5,0,0,43,9,3,0,1,16,129,165,1715,1844,8/5/2020
3/24/2020,20,169,243,2032,2201,7,55,0,5,0,0,50,10,4,0,1,19,148,238,1953,2101,8/5/2020
3/25/2020,26,195,183,2215,2410,5,60,1,6,0,0,54,11,3,0,1,28,176,173,2126,2302,8/5/2020
3/26/2020,35,230,181,2396,2626,10,70,5,11,0,0,59,14,5,0,1,41,217,176,2302,2519,8/5/2020
3/27/2020,27,257,215,2611,2868,9,79,1,12,1,1,66,17,6,2,3,31,248,202,2504,2752,8/5/2020
3/28/2020,59,316,260,2871,3187,13,92,3,15,2,3,74,15,6,1,4,63,311,242,2746,3057,8/5/2020
3/29/2020,106,422,356,3227,3649,8,100,4,19,1,4,77,18,8,2,6,105,416,314,3060,3476,8/5/2020
3/30/2020,62,484,222,3449,3933,20,120,5,24,0,4,92,20,11,3,9,78,494,192,3252,3746,8/5/2020
3/31/2020,71,555,369,3818,4373,11,131,7,31,1,5,95,22,13,2,11,73,567,299,3551,4118,8/5/2020
4/1/2020,99,654,699,4517,5171,18,149,7,38,0,5,106,30,15,1,12,100,667,648,4199,4866,8/5/2020
4/2/2020,52,706,477,4994,5700,21,170,6,44,2,7,119,36,21,4,16,62,729,436,4635,5364,8/5/2020
4/3/2020,108,814,775,5769,6583,23,193,7,51,0,7,135,43,25,3,19,100,829,718,5353,6182,8/5/2020
4/4/2020,143,957,660,6429,7386,22,215,4,55,5,12,148,41,30,9,28,137,966,622,5975,6941,8/5/2020
4/5/2020,187,1144,1156,7585,8729,20,235,9,64,1,13,158,44,36,2,30,182,1148,1071,7046,8194,8/5/2020
4/6/2020,218,1362,1707,9292,10654,26,261,7,71,0,13,177,48,40,7,37,206,1354,1578,8624,9978,8/5/2020
4/7/2020,285,1647,1631,10923,12570,20,281,3,74,2,15,192,49,42,5,42,260,1614,1490,10114,11728,8/5/2020
4/8/2020,290,1937,1723,12646,14583,19,300,7,81,6,21,198,49,38,10,52,272,1886,1570,11684,13570,8/5/2020
4/9/2020,284,2221,1521,14167,16388,32,332,9,90,4,25,217,52,40,7,59,278,2164,1365,13049,15213,8/5/2020
4/10/2020,420,2641,2577,16744,19385,29,361,17,107,5,30,224,58,41,11,70,404,2568,2380,15429,17997,8/5/2020
4/11/2020,299,2940,1911,18655,21595,29,390,11,118,2,32,240,61,48,12,82,280,2848,1727,17156,20004,8/5/2020
4/12/2020,315,3255,1674,20329,23584,35,425,13,131,5,37,257,59,49,10,92,289,3137,1448,18604,21741,8/5/2020
4/13/2020,162,3417,938,21267,24684,35,460,13,144,3,40,276,64,54,9,101,187,3324,844,19448,22772,8/5/2020
4/14/2020,289,3706,1788,23055,26761,27,487,17,161,5,45,281,72,53,8,109,265,3589,1547,20995,24584,8/5/2020
4/15/2020,353,4059,1803,24858,28917,31,518,19,180,3,48,290,72,54,17,126,307,3896,1577,22572,26468,8/5/2020
4/16/2020,449,4508,2500,27358,31866,36,554,25,205,6,54,295,72,53,14,140,392,4288,2097,24669,28957,8/5/2020
4/17/2020,308,4816,1823,29181,33997,32,586,20,225,7,61,300,66,45,21,161,291,4579,1472,26141,30720,8/5/2020
4/18/2020,322,5138,1728,30909,36047,26,612,18,243,4,65,304,63,49,15,176,284,4863,1359,27500,32363,8/5/2020
4/19/2020,382,5520,2059,32968,38488,23,635,26,269,1,66,300,65,55,11,187,338,5201,1758,29258,34459,8/5/2020
4/20/2020,396,5916,1909,34877,40793,46,681,29,298,2,68,315,75,56,10,197,377,5578,1590,30848,36426,8/5/2020
4/21/2020,445,6361,2114,36991,43352,45,726,31,329,5,73,324,72,56,18,215,388,5966,1725,32573,38539,8/5/2020
4/22/2020,420,6781,2398,39389,46170,41,767,32,361,5,78,328,73,58,18,233,382,6348,1923,34496,40844,8/5/2020
4/23/2020,482,7263,2471,41860,49123,30,797,28,389,5,83,325,76,62,15,248,419,6767,1889,36385,43152,8/5/2020
4/24/2020,494,7757,3292,45152,52909,35,832,27,416,4,87,329,85,63,15,263,413,7180,2650,39035,46215,8/5/2020
4/25/2020,394,8151,2210,47362,55513,34,866,17,433,5,92,341,85,62,14,277,305,7485,1785,40820,48305,8/5/2020
4/26/2020,316,8467,2314,49676,58143,33,899,15,448,3,95,356,86,59,14,291,276,7761,1889,42709,50470,8/5/2020
4/27/2020,250,8717,1624,51300,60017,29,928,21,469,4,99,360,86,61,10,301,204,7965,1169,43878,51843,8/5/2020
4/28/2020,411,9128,2268,53568,62696,44,972,24,493,3,102,377,88,59,22,323,325,8290,1774,45652,53942,8/5/2020
4/29/2020,476,9604,3351,56919,66523,36,1008,37,530,11,113,365,78,53,18,341,372,8662,2454,48106,56768,8/5/2020
4/30/2020,432,10036,2772,59691,69727,32,1040,38,568,6,119,353,83,57,24,365,347,9009,1963,50069,59078,8/5/2020
5/1/2020,457,10493,3089,62780,73273,51,1091,39,607,3,122,362,84,58,14,379,317,9326,2222,52291,61617,8/5/2020
5/2/2020,260,10753,1927,64707,75460,35,1126,39,646,5,127,353,90,61,24,403,189,9515,1297,53588,63103,8/5/2020
5/3/2020,284,11037,2168,66875,77912,31,1157,27,673,8,135,349,89,61,21,424,181,9696,1611,55199,64895,8/5/2020
5/4/2020,388,11425,2101,68976,80401,30,1187,31,704,5,140,343,87,57,18,442,293,9989,1578,56777,66766,8/5/2020
5/5/2020,436,11861,2878,71854,83715,28,1215,32,736,6,146,333,80,54,16,458,304,10293,1979,58756,69049,8/5/2020
5/6/2020,490,12351,2836,74690,87041,28,1243,44,780,9,155,308,78,54,21,479,341,10634,1932,60688,71322,8/5/2020
5/7/2020,425,12776,2975,77665,90441,36,1279,40,820,5,160,299,70,52,21,500,269,10903,1993,62681,73584,8/5/2020
5/8/2020,360,13136,2603,80268,93404,30,1309,29,849,5,165,295,70,53,22,522,231,11134,1786,64467,75601,8/5/2020
5/9/2020,457,13593,3356,83624,97217,22,1331,21,870,4,169,292,68,51,15,537,285,11419,2313,66780,78199,8/5/2020
5/10/2020,280,13873,2122,85746,99619,19,1350,23,893,6,175,282,69,49,13,550,186,11605,1530,68310,79915,8/5/2020
5/11/2020,259,14132,1861,87607,101739,31,1381,16,909,6,181,291,70,49,15,565,176,11781,1314,69624,81405,8/5/2020
5/12/2020,387,14519,2622,90229,104748,23,1404,18,927,4,185,292,68,48,22,587,217,11998,1721,71345,83343,8/5/2020
5/13/2020,352,14871,3634,93863,108734,22,1426,24,951,1,186,289,69,49,13,600,196,12194,2028,73373,85567,8/5/2020
5/14/2020,330,15201,3415,97278,112479,19,1445,27,978,3,189,278,64,45,15,615,227,12421,2023,75396,87817,8/5/2020
5/15/2020,382,15583,3470,100748,116331,24,1469,41,1019,5,194,256,62,45,13,628,234,12655,1821,77217,89872,8/5/2020
5/16/2020,438,16021,4168,104916,120937,25,1494,12,1031,5,199,264,61,46,15,643,252,12907,1975,79192,92099,8/5/2020
5/17/2020,231,16252,2775,107691,123943,17,1511,7,1038,5,204,269,59,45,10,653,124,13031,1569,80761,93792,8/5/2020
5/18/2020,251,16503,2007,109698,126201,19,1530,15,1053,5,209,268,57,40,18,671,139,13170,1375,82136,95306,8/5/2020
5/19/2020,416,16919,3178,112876,129795,23,1553,31,1084,5,214,255,56,38,11,682,214,13384,1944,84080,97464,8/5/2020
5/20/2020,328,17247,2774,115650,132897,19,1572,23,1107,7,221,244,52,33,22,704,187,13571,1525,85605,99176,8/5/2020
5/21/2020,374,17621,3764,119414,137035,26,1598,15,1122,3,224,252,53,29,20,724,170,13741,1953,87558,101299,8/5/2020
5/22/2020,351,17972,3172,122586,140558,20,1618,29,1151,5,229,238,52,29,10,734,205,13946,1616,89174,103120,8/5/2020
5/23/2020,240,18212,2748,125334,143546,19,1637,11,1162,3,232,243,52,32,13,747,109,14055,1289,90463,104518,8/5/2020
5/24/2020,153,18365,1372,126706,145071,12,1649,14,1176,2,234,239,53,36,8,755,84,14139,774,91237,105376,8/5/2020
5/25/2020,134,18499,1389,128095,146594,12,1661,14,1190,0,234,237,53,34,10,765,70,14209,765,92002,106211,8/5/2020
5/26/2020,284,18783,2624,130719,149502,24,1685,22,1212,5,239,234,48,33,15,780,155,14364,1790,93792,108156,8/5/2020
5/27/2020,276,19059,2134,132853,151912,20,1705,17,1229,3,242,234,50,33,10,790,132,14496,1145,94937,109433,8/5/2020
5/28/2020,346,19405,3384,136237,155642,17,1722,29,1258,4,246,218,47,32,8,798,132,14628,1133,96070,110698,8/5/2020
5/29/2020,419,19824,3989,140226,160050,18,1740,27,1285,6,252,203,43,31,12,810,179,14807,1596,97666,112473,8/5/2020
5/30/2020,211,20035,3973,144199,164234,15,1755,19,1304,4,256,195,40,29,12,822,104,14911,1828,99494,114405,8/5/2020
5/31/2020,148,20183,1753,145952,166135,10,1765,10,1314,0,256,195,43,26,3,825,76,14987,856,100350,115337,8/5/2020
6/1/2020,216,20399,2813,148765,169164,7,1772,13,1327,1,257,188,44,29,5,830,99,15086,1378,101728,116814,8/5/2020
6/2/2020,273,20672,3080,151845,172517,8,1780,9,1336,3,260,184,37,25,10,840,107,15193,1469,103197,118390,8/5/2020
6/3/2020,259,20931,3509,155354,176285,13,1793,18,1354,6,266,173,34,25,11,851,105,15298,1671,104868,120166,8/5/2020
6/4/2020,281,21212,4522,159876,181088,7,1800,25,1379,3,269,152,31,24,11,862,114,15412,2041,106909,122321,8/5/2020
6/5/2020,215,21427,3583,163459,184886,15,1815,12,1391,5,274,150,27,21,9,871,104,15516,1580,108489,124005,8/5/2020
6/6/2020,198,21625,2622,166081,187706,10,1825,7,1398,2,276,151,29,19,6,877,68,15584,1134,109623,125207,8/5/2020
6/7/2020,77,21702,1614,167695,189397,11,1836,7,1405,1,277,154,25,17,4,881,49,15633,777,110400,126033,8/5/2020
6/8/2020,122,21824,1847,169542,191366,15,1851,12,1417,2,279,155,27,18,4,885,44,15677,965,111365,127042,8/5/2020
6/9/2020,225,22049,2674,172216,194265,10,1861,18,1435,0,279,147,28,21,1,886,67,15744,1263,112628,128372,8/5/2020
6/10/2020,210,22259,2983,175199,197458,13,1874,12,1447,2,281,146,24,17,3,889,104,15848,1459,114087,129935,8/5/2020
6/11/2020,195,22454,3499,178698,201152,7,1881,15,1462,1,282,137,25,16,6,895,88,15936,1529,115616,131552,8/5/2020
6/12/2020,213,22667,4605,183303,205970,8,1889,15,1477,1,283,129,24,16,2,897,80,16016,2189,117805,133821,8/5/2020
6/13/2020,111,22778,3028,186331,209109,6,1895,4,1481,0,283,131,20,15,3,900,50,16066,1368,119173,135239,8/5/2020
6/14/2020,78,22856,2037,188368,211224,6,1901,8,1489,1,284,128,20,14,3,903,32,16098,965,120138,136236,8/5/2020
6/15/2020,189,23045,3105,191473,214518,14,1915,14,1503,0,284,128,20,16,4,907,78,16176,1785,121923,138099,8/5/2020
6/16/2020,115,23160,3010,194483,217643,11,1926,10,1513,1,285,128,22,16,8,915,52,16228,1578,123501,139729,8/5/2020
6/17/2020,123,23283,2826,197309,220592,15,1941,20,1533,4,289,119,18,14,6,921,52,16280,1314,124815,141095,8/5/2020
6/18/2020,150,23433,3039,200348,223781,9,1950,13,1546,1,290,114,19,16,7,928,70,16350,1331,126146,142496,8/5/2020
6/19/2020,141,23574,3761,204109,227683,12,1962,11,1557,1,291,114,20,17,3,931,59,16409,1373,127519,143928,8/5/2020
6/20/2020,80,23654,1883,205992,229646,7,1969,9,1566,0,291,112,20,18,4,935,36,16445,813,128332,144777,8/5/2020
6/21/2020,36,23690,1042,207034,230724,7,1976,5,1571,0,291,114,20,18,2,937,27,16472,679,129011,145483,8/5/2020
6/22/2020,142,23832,3713,210747,234579,12,1988,16,1587,0,291,110,19,18,1,938,70,16542,1703,130714,147256,8/5/2020
6/23/2020,162,23994,3850,214597,238591,3,1991,13,1600,3,294,97,18,18,6,944,83,16625,1792,132506,149131,8/5/2020
6/24/2020,121,24115,3508,218105,242220,9,2000,10,1610,1,295,95,18,18,5,949,47,16672,1692,134198,150870,8/5/2020
6/25/2020,102,24217,2885,220990,245207,5,2005,14,1624,1,296,85,17,17,1,950,52,16724,1507,135705,152429,8/5/2020
6/26/2020,94,24311,2454,223444,247755,2,2007,9,1633,0,296,78,18,18,1,951,64,16788,1304,137009,153797,8/5/2020
6/27/2020,84,24395,3212,226656,251051,5,2012,3,1636,1,297,79,17,17,5,956,37,16825,1214,138223,155048,8/5/2020
6/28/2020,37,24432,1452,228108,252540,4,2016,4,1640,4,301,75,15,14,6,962,18,16843,586,138809,155652,8/5/2020
6/29/2020,86,24518,3673,231781,256299,4,2020,5,1645,0,301,74,14,14,1,963,38,16881,1343,140152,157033,8/5/2020
6/30/2020,60,24578,1945,233726,258304,1,2021,5,1650,1,302,69,12,11,3,966,35,16916,994,141146,158062,8/5/2020
7/1/2020,145,24723,4106,237832,262555,7,2028,9,1659,0,302,67,11,11,1,967,81,16997,1952,143098,160095,8/5/2020
7/2/2020,101,24824,2778,240610,265434,5,2033,5,1664,1,303,66,9,9,1,968,56,17053,1075,144173,161226,8/5/2020
7/3/2020,47,24871,2013,242623,267494,7,2040,6,1670,0,303,67,8,8,3,971,25,17078,771,144944,162022,8/5/2020
7/4/2020,57,24928,2320,244943,269871,2,2042,4,1674,1,304,64,9,8,2,973,34,17112,991,145935,163047,8/5/2020
7/5/2020,47,24975,2924,247867,272842,1,2043,2,1676,1,305,62,7,7,2,975,23,17135,1442,147377,164512,8/5/2020
7/6/2020,103,25078,2790,250657,275735,6,2049,6,1682,0,305,62,8,9,4,979,60,17195,1543,148920,166115,8/5/2020
7/7/2020,80,25158,3438,254095,279253,5,2054,6,1688,0,305,61,7,8,1,980,47,17242,1532,150452,167694,8/5/2020
7/8/2020,104,25262,3381,257476,282738,4,2058,2,1690,0,305,63,8,8,0,980,66,17308,1418,151870,169178,8/5/2020
7/9/2020,94,25356,3658,261134,286490,7,2065,2,1692,0,305,68,8,8,0,980,50,17358,1595,153465,170823,8/5/2020
7/10/2020,129,25485,4387,265521,291006,5,2070,3,1695,2,307,68,7,7,3,983,79,17437,2076,155541,172978,8/5/2020
7/11/2020,63,25548,2881,268402,293950,6,2076,3,1698,1,308,70,6,6,3,986,34,17471,1278,156819,174290,8/5/2020
7/12/2020,45,25593,1764,270166,295759,1,2077,2,1700,1,309,68,6,5,3,989,33,17504,885,157704,175208,8/5/2020
7/13/2020,85,25678,3142,273308,298986,7,2084,10,1710,0,309,65,6,5,1,990,57,17561,1469,159173,176734,8/5/2020
7/14/2020,75,25753,3246,276554,302307,7,2091,4,1714,0,309,68,5,5,1,991,50,17611,1348,160521,178132,8/5/2020
7/15/2020,123,25876,4118,280672,306548,5,2096,6,1720,0,309,67,5,4,0,991,94,17705,1725,162246,179951,8/5/2020
7/16/2020,102,25978,3678,284350,310328,6,2102,8,1728,0,309,65,6,5,1,992,78,17783,1584,163830,181613,8/5/2020
7/17/2020,151,26129,4114,288464,314593,14,2116,3,1731,1,310,75,5,5,1,993,78,17861,1797,165627,183488,8/5/2020
7/18/2020,80,26209,3141,291605,317814,5,2121,9,1740,1,311,70,5,4,4,997,67,17928,1341,166968,184896,8/5/2020
7/19/2020,82,26291,2577,294182,320473,6,2127,3,1743,0,311,73,6,4,2,999,58,17986,1071,168039,186025,8/5/2020
7/20/2020,72,26363,2592,296774,323137,9,2136,7,1750,0,311,75,7,5,2,1001,63,18049,1443,169482,187531,8/5/2020
7/21/2020,128,26491,4212,300986,327477,9,2145,10,1760,0,311,74,9,6,1,1002,105,18154,1872,171354,189508,8/5/2020
7/22/2020,123,26614,3783,304769,331383,11,2156,11,1771,1,312,73,7,6,1,1003,87,18241,1577,172931,191172,8/5/2020
7/23/2020,123,26737,4054,308823,335560,6,2162,5,1776,0,312,74,8,7,0,1003,106,18347,1753,174684,193031,8/5/2020
7/24/2020,161,26898,5672,314495,341393,12,2174,12,1788,0,312,74,9,7,0,1003,116,18463,2147,176831,195294,8/5/2020
7/25/2020,126,27024,4258,318753,345777,7,2181,7,1795,0,312,74,10,7,1,1004,104,18567,2000,178831,197398,8/5/2020
7/26/2020,56,27080,2957,321710,348790,7,2188,8,1803,0,312,73,11,5,1,1005,52,18619,1302,180133,198752,8/5/2020
7/27/2020,182,27262,3867,325577,352839,11,2199,7,1810,0,312,77,13,6,1,1006,139,18758,2108,182241,200999,8/5/2020
7/28/2020,101,27363,3618,329195,356558,5,2204,3,1813,0,312,79,14,5,1,1007,90,18848,1489,183730,202578,8/5/2020
7/29/2020,154,27517,4674,333869,361386,10,2214,12,1825,0,312,77,15,5,0,1007,124,18972,2016,185746,204718,8/5/2020
7/30/2020,95,27612,3883,337752,365364,5,2219,2,1827,1,313,79,15,4,0,1007,78,19050,1300,187046,206096,8/5/2020
7/31/2020,114,27726,5005,342757,370483,8,2227,9,1836,0,313,78,15,5,0,1007,86,19136,1562,188608,207744,8/5/2020
8/1/2020,83,27809,3760,346517,374326,7,2234,2,1838,0,313,83,14,5,1,1008,70,19206,1227,189835,209041,8/5/2020
8/2/2020,73,27882,2586,349103,376985,8,2242,10,1848,1,314,80,14,6,2,1010,61,19267,1134,190969,210236,8/5/2020
8/3/2020,157,28039,4637,353740,381779,6,2248,7,1855,0,314,79,14,5,1,1011,130,19397,1773,192742,212139,8/5/2020
8/4/2020,106,28145,3017,356757,384902,,,,,,,,,,1,1012,84,19481,1312,194054,213535,8/5/2020
2/27/2020,0,0,0,0,0,1,1,0,0,0,0,1,0,0,0,0,0,0,0,0,0,8/6/2020
2/28/2020,0,0,0,0,0,0,1,0,0,0,0,1,1,0,0,0,0,0,0,0,0,8/6/2020
2/29/2020,0,0,0,0,0,0,1,0,0,0,0,1,1,0,0,0,0,0,0,0,0,8/6/2020
3/1/2020,2,2,2,2,4,0,1,0,0,0,0,1,1,1,0,0,2,2,2,2,4,8/6/2020
3/2/2020,0,2,1,3,5,1,2,0,0,0,0,2,2,2,0,0,0,2,1,3,5,8/6/2020
3/3/2020,0,2,2,5,7,0,2,0,0,0,0,2,2,2,0,0,0,2,2,5,7,8/6/2020
3/4/2020,0,2,12,17,19,1,3,0,0,0,0,3,2,2,0,0,0,2,10,15,17,8/6/2020
3/5/2020,0,2,4,21,23,0,3,0,0,0,0,3,2,2,0,0,1,3,4,19,22,8/6/2020
3/6/2020,1,3,12,33,36,0,3,0,0,0,0,3,2,2,0,0,0,3,11,30,33,8/6/2020
3/7/2020,0,3,19,52,55,0,3,0,0,0,0,3,2,1,0,0,0,3,19,49,52,8/6/2020
3/8/2020,0,3,18,70,73,0,3,0,0,0,0,3,2,1,0,0,0,3,18,67,70,8/6/2020
3/9/2020,1,4,15,85,89,0,3,0,0,0,0,3,2,1,0,0,1,4,15,82,86,8/6/2020
3/10/2020,2,6,25,110,116,0,3,0,0,0,0,3,2,1,0,0,1,5,23,105,110,8/6/2020
3/11/2020,0,6,34,144,150,1,4,0,0,0,0,4,1,1,0,0,0,5,34,139,144,8/6/2020
3/12/2020,9,15,42,186,201,1,5,0,0,0,0,5,1,1,0,0,8,13,38,177,190,8/6/2020
3/13/2020,6,21,50,236,257,4,9,1,1,0,0,8,1,1,0,0,6,19,48,225,244,8/6/2020
3/14/2020,0,21,90,326,347,0,9,0,1,0,0,8,1,1,0,0,0,19,86,311,330,8/6/2020
3/15/2020,1,22,54,380,402,1,10,0,1,0,0,9,2,1,0,0,1,20,54,365,385,8/6/2020
3/16/2020,2,24,95,475,499,2,12,0,1,0,0,11,2,0,0,0,2,22,92,457,479,8/6/2020
3/17/2020,16,40,162,637,677,6,18,0,1,0,0,17,2,0,0,0,11,33,152,609,642,8/6/2020
3/18/2020,12,52,116,753,805,3,21,0,1,0,0,20,2,0,0,0,11,44,111,720,764,8/6/2020
3/19/2020,17,69,262,1015,1084,2,23,1,2,0,0,21,3,0,1,1,17,61,251,971,1032,8/6/2020
3/20/2020,15,84,197,1212,1296,5,28,0,2,0,0,26,4,0,0,1,13,74,192,1163,1237,8/6/2020
3/21/2020,21,105,126,1338,1443,3,31,2,4,0,0,27,5,0,0,1,14,88,123,1286,1374,8/6/2020
3/22/2020,30,135,282,1620,1755,2,33,0,4,0,0,29,5,0,0,1,25,113,264,1550,1663,8/6/2020
3/23/2020,14,149,169,1789,1938,15,48,1,5,0,0,43,9,3,0,1,16,129,165,1715,1844,8/6/2020
3/24/2020,20,169,243,2032,2201,7,55,0,5,0,0,50,10,4,0,1,19,148,238,1953,2101,8/6/2020
3/25/2020,26,195,183,2215,2410,5,60,1,6,0,0,54,11,3,0,1,28,176,173,2126,2302,8/6/2020
3/26/2020,35,230,181,2396,2626,10,70,5,11,0,0,59,14,5,0,1,41,217,176,2302,2519,8/6/2020
3/27/2020,27,257,215,2611,2868,9,79,1,12,1,1,66,17,6,2,3,31,248,202,2504,2752,8/6/2020
3/28/2020,59,316,260,2871,3187,13,92,3,15,2,3,74,15,6,1,4,63,311,242,2746,3057,8/6/2020
3/29/2020,106,422,356,3227,3649,8,100,4,19,1,4,77,18,8,2,6,105,416,314,3060,3476,8/6/2020
3/30/2020,62,484,222,3449,3933,20,120,5,24,0,4,92,20,11,3,9,78,494,192,3252,3746,8/6/2020
3/31/2020,71,555,369,3818,4373,11,131,7,31,1,5,95,22,13,2,11,73,567,299,3551,4118,8/6/2020
4/1/2020,99,654,699,4517,5171,18,149,7,38,0,5,106,30,15,1,12,100,667,648,4199,4866,8/6/2020
4/2/2020,52,706,477,4994,5700,21,170,6,44,2,7,119,36,21,4,16,62,729,436,4635,5364,8/6/2020
4/3/2020,108,814,775,5769,6583,23,193,7,51,0,7,135,43,25,3,19,100,829,718,5353,6182,8/6/2020
4/4/2020,143,957,660,6429,7386,22,215,4,55,5,12,148,41,30,9,28,137,966,621,5974,6940,8/6/2020
4/5/2020,187,1144,1156,7585,8729,20,235,9,64,1,13,158,44,36,2,30,182,1148,1071,7045,8193,8/6/2020
4/6/2020,218,1362,1707,9292,10654,26,261,7,71,0,13,177,48,40,7,37,206,1354,1578,8623,9977,8/6/2020
4/7/2020,285,1647,1631,10923,12570,20,281,3,74,2,15,192,49,42,5,42,260,1614,1490,10113,11727,8/6/2020
4/8/2020,290,1937,1723,12646,14583,19,300,7,81,6,21,198,49,38,10,52,272,1886,1569,11682,13568,8/6/2020
4/9/2020,284,2221,1521,14167,16388,32,332,9,90,4,25,217,52,40,7,59,278,2164,1365,13047,15211,8/6/2020
4/10/2020,420,2641,2577,16744,19385,29,361,17,107,5,30,224,58,41,11,70,404,2568,2380,15427,17995,8/6/2020
4/11/2020,299,2940,1911,18655,21595,29,390,11,118,2,32,240,61,48,12,82,280,2848,1727,17154,20002,8/6/2020
4/12/2020,315,3255,1674,20329,23584,35,425,13,131,5,37,257,59,49,10,92,289,3137,1447,18601,21738,8/6/2020
4/13/2020,162,3417,938,21267,24684,35,460,13,144,3,40,276,64,54,9,101,187,3324,844,19445,22769,8/6/2020
4/14/2020,289,3706,1788,23055,26761,27,487,17,161,5,45,281,72,53,8,109,265,3589,1547,20992,24581,8/6/2020
4/15/2020,353,4059,1803,24858,28917,31,518,19,180,3,48,290,72,54,17,126,307,3896,1575,22567,26463,8/6/2020
4/16/2020,449,4508,2500,27358,31866,36,554,25,205,6,54,295,72,53,14,140,392,4288,2096,24663,28951,8/6/2020
4/17/2020,308,4816,1823,29181,33997,32,586,20,225,7,61,300,66,45,21,161,291,4579,1471,26134,30713,8/6/2020
4/18/2020,322,5138,1728,30909,36047,26,612,18,243,4,65,304,63,49,15,176,284,4863,1359,27493,32356,8/6/2020
4/19/2020,382,5520,2059,32968,38488,23,635,26,269,1,66,300,65,55,11,187,338,5201,1757,29250,34451,8/6/2020
4/20/2020,396,5916,1909,34877,40793,46,681,29,298,2,68,315,75,56,10,197,377,5578,1590,30840,36418,8/6/2020
4/21/2020,445,6361,2114,36991,43352,45,726,31,329,5,73,324,72,56,18,215,388,5966,1725,32565,38531,8/6/2020
4/22/2020,420,6781,2398,39389,46170,41,767,32,361,5,78,328,73,58,18,233,382,6348,1922,34487,40835,8/6/2020
4/23/2020,482,7263,2471,41860,49123,30,797,28,389,5,83,325,76,62,15,248,419,6767,1888,36375,43142,8/6/2020
4/24/2020,494,7757,3292,45152,52909,35,832,27,416,4,87,329,85,63,15,263,413,7180,2649,39024,46204,8/6/2020
4/25/2020,394,8151,2210,47362,55513,34,866,17,433,5,92,341,85,62,14,277,305,7485,1785,40809,48294,8/6/2020
4/26/2020,316,8467,2314,49676,58143,33,899,15,448,3,95,356,86,59,14,291,276,7761,1889,42698,50459,8/6/2020
4/27/2020,250,8717,1624,51300,60017,29,928,21,469,4,99,360,86,61,10,301,204,7965,1169,43867,51832,8/6/2020
4/28/2020,411,9128,2268,53568,62696,44,972,24,493,3,102,377,88,59,22,323,325,8290,1774,45641,53931,8/6/2020
4/29/2020,476,9604,3351,56919,66523,36,1008,37,530,11,113,365,78,53,18,341,372,8662,2454,48095,56757,8/6/2020
4/30/2020,432,10036,2772,59691,69727,32,1040,38,568,6,119,353,83,57,24,365,347,9009,1963,50058,59067,8/6/2020
5/1/2020,457,10493,3089,62780,73273,51,1091,39,607,3,122,362,84,58,14,379,317,9326,2222,52280,61606,8/6/2020
5/2/2020,260,10753,1927,64707,75460,35,1126,39,646,5,127,353,90,61,24,403,189,9515,1296,53576,63091,8/6/2020
5/3/2020,284,11037,2168,66875,77912,31,1157,27,673,8,135,349,89,61,21,424,181,9696,1611,55187,64883,8/6/2020
5/4/2020,388,11425,2101,68976,80401,30,1187,31,704,5,140,343,87,57,18,442,293,9989,1577,56764,66753,8/6/2020
5/5/2020,436,11861,2878,71854,83715,28,1215,32,736,6,146,333,80,54,16,458,304,10293,1979,58743,69036,8/6/2020
5/6/2020,490,12351,2836,74690,87041,28,1243,44,780,9,155,308,78,54,21,479,341,10634,1931,60674,71308,8/6/2020
5/7/2020,425,12776,2975,77665,90441,36,1279,40,820,5,160,299,70,52,21,500,269,10903,1992,62666,73569,8/6/2020
5/8/2020,360,13136,2603,80268,93404,30,1309,29,849,5,165,295,70,53,22,522,231,11134,1781,64447,75581,8/6/2020
5/9/2020,457,13593,3356,83624,97217,22,1331,21,870,4,169,292,68,51,15,537,285,11419,2312,66759,78178,8/6/2020
5/10/2020,280,13873,2122,85746,99619,19,1350,23,893,6,175,282,69,49,13,550,186,11605,1528,68287,79892,8/6/2020
5/11/2020,259,14132,1861,87607,101739,31,1381,16,909,6,181,291,70,49,15,565,176,11781,1313,69600,81381,8/6/2020
5/12/2020,387,14519,2622,90229,104748,23,1404,18,927,4,185,292,68,48,22,587,217,11998,1721,71321,83319,8/6/2020
5/13/2020,352,14871,3634,93863,108734,22,1426,24,951,1,186,289,69,49,13,600,196,12194,2028,73349,85543,8/6/2020
5/14/2020,330,15201,3415,97278,112479,19,1445,27,978,3,189,278,64,45,15,615,227,12421,2023,75372,87793,8/6/2020
5/15/2020,382,15583,3470,100748,116331,24,1469,41,1019,5,194,256,62,45,13,628,234,12655,1821,77193,89848,8/6/2020
5/16/2020,438,16021,4168,104916,120937,25,1494,12,1031,5,199,264,61,46,15,643,252,12907,1975,79168,92075,8/6/2020
5/17/2020,231,16252,2775,107691,123943,17,1511,7,1038,5,204,269,59,45,10,653,124,13031,1569,80737,93768,8/6/2020
5/18/2020,251,16503,2007,109698,126201,19,1530,15,1053,5,209,268,57,40,18,671,139,13170,1375,82112,95282,8/6/2020
5/19/2020,416,16919,3178,112876,129795,23,1553,31,1084,5,214,255,56,38,11,682,214,13384,1944,84056,97440,8/6/2020
5/20/2020,328,17247,2774,115650,132897,19,1572,23,1107,7,221,244,52,33,22,704,187,13571,1525,85581,99152,8/6/2020
5/21/2020,374,17621,3764,119414,137035,26,1598,15,1122,3,224,252,53,29,20,724,170,13741,1953,87534,101275,8/6/2020
5/22/2020,351,17972,3172,122586,140558,20,1618,29,1151,5,229,238,52,29,10,734,205,13946,1616,89150,103096,8/6/2020
5/23/2020,240,18212,2748,125334,143546,19,1637,11,1162,3,232,243,52,32,13,747,109,14055,1289,90439,104494,8/6/2020
5/24/2020,153,18365,1372,126706,145071,12,1649,14,1176,2,234,239,53,36,8,755,84,14139,774,91213,105352,8/6/2020
5/25/2020,134,18499,1389,128095,146594,12,1661,14,1190,0,234,237,53,34,10,765,70,14209,765,91978,106187,8/6/2020
5/26/2020,284,18783,2624,130719,149502,24,1685,22,1212,5,239,234,48,33,15,780,155,14364,1789,93767,108131,8/6/2020
5/27/2020,276,19059,2134,132853,151912,20,1705,17,1229,3,242,234,50,33,10,790,132,14496,1144,94911,109407,8/6/2020
5/28/2020,346,19405,3384,136237,155642,17,1722,29,1258,4,246,218,47,32,8,798,132,14628,1133,96044,110672,8/6/2020
5/29/2020,419,19824,3989,140226,160050,18,1740,27,1285,6,252,203,43,31,12,810,179,14807,1595,97639,112446,8/6/2020
5/30/2020,211,20035,3973,144199,164234,15,1755,19,1304,4,256,195,40,29,12,822,104,14911,1828,99467,114378,8/6/2020
5/31/2020,148,20183,1753,145952,166135,10,1765,10,1314,0,256,195,43,26,3,825,76,14987,856,100323,115310,8/6/2020
6/1/2020,216,20399,2813,148765,169164,7,1772,13,1327,1,257,188,44,29,5,830,99,15086,1377,101700,116786,8/6/2020
6/2/2020,273,20672,3080,151845,172517,8,1780,9,1336,3,260,184,37,25,10,840,107,15193,1469,103169,118362,8/6/2020
6/3/2020,259,20931,3509,155354,176285,13,1793,18,1354,6,266,173,34,25,11,851,105,15298,1671,104840,120138,8/6/2020
6/4/2020,281,21212,4522,159876,181088,7,1800,25,1379,3,269,152,31,24,11,862,114,15412,2041,106881,122293,8/6/2020
6/5/2020,215,21427,3583,163459,184886,15,1815,12,1391,5,274,150,27,21,9,871,104,15516,1580,108461,123977,8/6/2020
6/6/2020,198,21625,2622,166081,187706,10,1825,7,1398,2,276,151,29,19,6,877,68,15584,1134,109595,125179,8/6/2020
6/7/2020,77,21702,1614,167695,189397,11,1836,7,1405,1,277,154,25,17,4,881,49,15633,777,110372,126005,8/6/2020
6/8/2020,122,21824,1847,169542,191366,15,1851,12,1417,2,279,155,27,18,4,885,44,15677,965,111337,127014,8/6/2020
6/9/2020,225,22049,2674,172216,194265,10,1861,18,1435,0,279,147,28,21,1,886,67,15744,1263,112600,128344,8/6/2020
6/10/2020,210,22259,2983,175199,197458,13,1874,12,1447,2,281,146,24,17,3,889,104,15848,1459,114059,129907,8/6/2020
6/11/2020,195,22454,3499,178698,201152,7,1881,15,1462,1,282,137,25,16,6,895,88,15936,1529,115588,131524,8/6/2020
6/12/2020,213,22667,4605,183303,205970,8,1889,15,1477,1,283,129,24,16,2,897,80,16016,2189,117777,133793,8/6/2020
6/13/2020,111,22778,3028,186331,209109,6,1895,4,1481,0,283,131,20,15,3,900,50,16066,1368,119145,135211,8/6/2020
6/14/2020,78,22856,2037,188368,211224,6,1901,8,1489,1,284,128,20,14,3,903,32,16098,965,120110,136208,8/6/2020
6/15/2020,189,23045,3105,191473,214518,14,1915,14,1503,0,284,128,20,16,4,907,78,16176,1785,121895,138071,8/6/2020
6/16/2020,115,23160,3010,194483,217643,11,1926,10,1513,1,285,128,22,16,8,915,52,16228,1578,123473,139701,8/6/2020
6/17/2020,123,23283,2826,197309,220592,15,1941,20,1533,4,289,119,18,14,6,921,52,16280,1314,124787,141067,8/6/2020
6/18/2020,150,23433,3039,200348,223781,9,1950,13,1546,1,290,114,19,16,7,928,70,16350,1331,126118,142468,8/6/2020
6/19/2020,141,23574,3761,204109,227683,12,1962,11,1557,1,291,114,20,17,3,931,59,16409,1373,127491,143900,8/6/2020
6/20/2020,80,23654,1883,205992,229646,7,1969,9,1566,0,291,112,20,18,4,935,36,16445,812,128303,144748,8/6/2020
6/21/2020,36,23690,1042,207034,230724,7,1976,5,1571,0,291,114,20,18,2,937,27,16472,677,128980,145452,8/6/2020
6/22/2020,142,23832,3713,210747,234579,12,1988,16,1587,0,291,110,19,18,1,938,70,16542,1703,130683,147225,8/6/2020
6/23/2020,162,23994,3850,214597,238591,3,1991,13,1600,3,294,97,18,18,6,944,83,16625,1792,132475,149100,8/6/2020
6/24/2020,121,24115,3508,218105,242220,9,2000,10,1610,1,295,95,18,18,5,949,47,16672,1692,134167,150839,8/6/2020
6/25/2020,102,24217,2885,220990,245207,5,2005,14,1624,1,296,85,17,17,1,950,52,16724,1507,135674,152398,8/6/2020
6/26/2020,94,24311,2454,223444,247755,2,2007,9,1633,0,296,78,18,18,1,951,64,16788,1304,136978,153766,8/6/2020
6/27/2020,84,24395,3212,226656,251051,5,2012,3,1636,1,297,79,17,17,5,956,37,16825,1214,138192,155017,8/6/2020
6/28/2020,37,24432,1452,228108,252540,4,2016,4,1640,4,301,75,15,14,6,962,18,16843,586,138778,155621,8/6/2020
6/29/2020,86,24518,3673,231781,256299,4,2020,5,1645,0,301,74,14,14,1,963,38,16881,1343,140121,157002,8/6/2020
6/30/2020,60,24578,1945,233726,258304,1,2021,5,1650,1,302,69,12,11,3,966,35,16916,994,141115,158031,8/6/2020
7/1/2020,145,24723,4106,237832,262555,7,2028,9,1659,0,302,67,11,11,1,967,81,16997,1952,143067,160064,8/6/2020
7/2/2020,101,24824,2778,240610,265434,5,2033,5,1664,1,303,66,9,9,1,968,56,17053,1075,144142,161195,8/6/2020
7/3/2020,47,24871,2013,242623,267494,7,2040,6,1670,0,303,67,8,8,3,971,25,17078,771,144913,161991,8/6/2020
7/4/2020,57,24928,2320,244943,269871,2,2042,4,1674,1,304,64,9,8,2,973,34,17112,991,145904,163016,8/6/2020
7/5/2020,47,24975,2924,247867,272842,1,2043,2,1676,1,305,62,7,7,2,975,23,17135,1442,147346,164481,8/6/2020
7/6/2020,103,25078,2790,250657,275735,6,2049,6,1682,0,305,62,8,9,4,979,60,17195,1543,148889,166084,8/6/2020
7/7/2020,80,25158,3438,254095,279253,5,2054,6,1688,0,305,61,7,8,1,980,47,17242,1532,150421,167663,8/6/2020
7/8/2020,104,25262,3381,257476,282738,4,2058,2,1690,0,305,63,8,8,0,980,66,17308,1418,151839,169147,8/6/2020
7/9/2020,94,25356,3658,261134,286490,7,2065,2,1692,0,305,68,8,8,0,980,50,17358,1595,153434,170792,8/6/2020
7/10/2020,129,25485,4387,265521,291006,5,2070,3,1695,2,307,68,7,7,3,983,79,17437,2075,155509,172946,8/6/2020
7/11/2020,63,25548,2881,268402,293950,6,2076,3,1698,1,308,70,6,6,3,986,34,17471,1278,156787,174258,8/6/2020
7/12/2020,45,25593,1764,270166,295759,1,2077,2,1700,1,309,68,6,5,3,989,33,17504,885,157672,175176,8/6/2020
7/13/2020,85,25678,3142,273308,298986,7,2084,10,1710,0,309,65,6,5,1,990,57,17561,1469,159141,176702,8/6/2020
7/14/2020,75,25753,3246,276554,302307,7,2091,4,1714,0,309,68,5,5,1,991,50,17611,1348,160489,178100,8/6/2020
7/15/2020,123,25876,4118,280672,306548,5,2096,6,1720,0,309,67,5,4,0,991,94,17705,1725,162214,179919,8/6/2020
7/16/2020,102,25978,3678,284350,310328,6,2102,8,1728,0,309,65,6,5,1,992,78,17783,1584,163798,181581,8/6/2020
7/17/2020,151,26129,4114,288464,314593,14,2116,3,1731,1,310,75,5,5,1,993,78,17861,1797,165595,183456,8/6/2020
7/18/2020,80,26209,3141,291605,317814,5,2121,9,1740,1,311,70,5,4,4,997,67,17928,1341,166936,184864,8/6/2020
7/19/2020,82,26291,2577,294182,320473,6,2127,3,1743,0,311,73,6,4,2,999,58,17986,1071,168007,185993,8/6/2020
7/20/2020,72,26363,2592,296774,323137,9,2136,7,1750,0,311,75,7,5,2,1001,63,18049,1443,169450,187499,8/6/2020
7/21/2020,128,26491,4212,300986,327477,9,2145,10,1760,0,311,74,9,6,1,1002,105,18154,1872,171322,189476,8/6/2020
7/22/2020,123,26614,3783,304769,331383,11,2156,11,1771,1,312,73,7,6,1,1003,87,18241,1577,172899,191140,8/6/2020
7/23/2020,123,26737,4054,308823,335560,6,2162,5,1776,0,312,74,8,7,0,1003,106,18347,1752,174651,192998,8/6/2020
7/24/2020,161,26898,5672,314495,341393,12,2174,12,1788,0,312,74,9,7,0,1003,117,18464,2146,176797,195261,8/6/2020
7/25/2020,126,27024,4258,318753,345777,7,2181,7,1795,0,312,74,10,8,1,1004,103,18567,1999,178796,197363,8/6/2020
7/26/2020,56,27080,2957,321710,348790,7,2188,8,1803,0,312,73,11,6,1,1005,53,18620,1302,180098,198718,8/6/2020
7/27/2020,182,27262,3867,325577,352839,11,2199,7,1810,0,312,77,13,7,1,1006,138,18758,2107,182205,200963,8/6/2020
7/28/2020,101,27363,3618,329195,356558,5,2204,3,1813,0,312,79,14,6,1,1007,89,18847,1488,183693,202540,8/6/2020
7/29/2020,154,27517,4674,333869,361386,10,2214,12,1825,0,312,77,15,6,0,1007,123,18970,2015,185708,204678,8/6/2020
7/30/2020,95,27612,3883,337752,365364,5,2219,2,1827,1,313,79,15,5,0,1007,78,19048,1300,187008,206056,8/6/2020
7/31/2020,114,27726,5006,342758,370484,8,2227,9,1836,0,313,78,15,6,0,1007,88,19136,1563,188571,207707,8/6/2020
8/1/2020,87,27813,3797,346555,374368,7,2234,2,1838,0,313,83,14,6,1,1008,71,19207,1252,189823,209030,8/6/2020
8/2/2020,75,27888,2633,349188,377076,10,2244,11,1849,1,314,81,14,7,2,1010,62,19269,1174,190997,210266,8/6/2020
8/3/2020,163,28051,4749,353937,381988,13,2257,12,1861,0,314,82,15,6,1,1011,139,19408,1856,192853,212261,8/6/2020
8/4/2020,115,28166,3288,357225,385391,7,2264,5,1866,1,315,83,11,4,1,1012,93,19501,1498,194351,213852,8/6/2020
8/5/2020,133,28299,4954,362179,390478,,,,,,,,,,2,1014,110,19611,1761,196112,215723,8/6/2020
2/27/2020,0,0,0,0,0,1,1,0,0,0,0,1,0,0,0,0,0,0,0,0,0,8/7/2020
2/28/2020,0,0,0,0,0,0,1,0,0,0,0,1,1,0,0,0,0,0,0,0,0,8/7/2020
2/29/2020,0,0,0,0,0,0,1,0,0,0,0,1,1,0,0,0,0,0,0,0,0,8/7/2020
3/1/2020,2,2,2,2,4,0,1,0,0,0,0,1,1,1,0,0,2,2,2,2,4,8/7/2020
3/2/2020,0,2,1,3,5,1,2,0,0,0,0,2,2,2,0,0,0,2,1,3,5,8/7/2020
3/3/2020,0,2,2,5,7,0,2,0,0,0,0,2,2,2,0,0,0,2,2,5,7,8/7/2020
3/4/2020,0,2,12,17,19,1,3,0,0,0,0,3,2,2,0,0,0,2,10,15,17,8/7/2020
3/5/2020,0,2,4,21,23,0,3,0,0,0,0,3,2,2,0,0,1,3,4,19,22,8/7/2020
3/6/2020,1,3,12,33,36,0,3,0,0,0,0,3,2,2,0,0,0,3,11,30,33,8/7/2020
3/7/2020,0,3,19,52,55,0,3,0,0,0,0,3,2,1,0,0,0,3,19,49,52,8/7/2020
3/8/2020,0,3,18,70,73,0,3,0,0,0,0,3,2,1,0,0,0,3,18,67,70,8/7/2020
3/9/2020,1,4,15,85,89,0,3,0,0,0,0,3,2,1,0,0,1,4,15,82,86,8/7/2020
3/10/2020,2,6,25,110,116,0,3,0,0,0,0,3,2,1,0,0,1,5,23,105,110,8/7/2020
3/11/2020,0,6,34,144,150,1,4,0,0,0,0,4,1,1,0,0,0,5,34,139,144,8/7/2020
3/12/2020,9,15,42,186,201,1,5,0,0,0,0,5,1,1,0,0,8,13,38,177,190,8/7/2020
3/13/2020,6,21,50,236,257,4,9,1,1,0,0,8,1,1,0,0,6,19,48,225,244,8/7/2020
3/14/2020,0,21,90,326,347,0,9,0,1,0,0,8,1,1,0,0,0,19,86,311,330,8/7/2020
3/15/2020,1,22,54,380,402,1,10,0,1,0,0,9,2,1,0,0,1,20,54,365,385,8/7/2020
3/16/2020,2,24,95,475,499,2,12,0,1,0,0,11,2,0,0,0,2,22,92,457,479,8/7/2020
3/17/2020,16,40,162,637,677,6,18,0,1,0,0,17,2,0,0,0,11,33,152,609,642,8/7/2020
3/18/2020,12,52,116,753,805,3,21,0,1,0,0,20,2,0,0,0,11,44,111,720,764,8/7/2020
3/19/2020,17,69,262,1015,1084,2,23,1,2,0,0,21,3,0,1,1,17,61,251,971,1032,8/7/2020
3/20/2020,15,84,197,1212,1296,5,28,0,2,0,0,26,4,0,0,1,13,74,192,1163,1237,8/7/2020
3/21/2020,21,105,126,1338,1443,3,31,2,4,0,0,27,5,0,0,1,14,88,123,1286,1374,8/7/2020
3/22/2020,30,135,282,1620,1755,2,33,0,4,0,0,29,5,0,0,1,25,113,264,1550,1663,8/7/2020
3/23/2020,14,149,169,1789,1938,15,48,1,5,0,0,43,9,3,0,1,16,129,165,1715,1844,8/7/2020
3/24/2020,20,169,243,2032,2201,7,55,0,5,0,0,50,10,4,0,1,19,148,238,1953,2101,8/7/2020
3/25/2020,26,195,183,2215,2410,5,60,1,6,0,0,54,11,3,0,1,28,176,173,2126,2302,8/7/2020
3/26/2020,35,230,181,2396,2626,10,70,5,11,0,0,59,14,5,0,1,41,217,176,2302,2519,8/7/2020
3/27/2020,27,257,215,2611,2868,9,79,1,12,1,1,66,17,6,2,3,31,248,202,2504,2752,8/7/2020
3/28/2020,59,316,260,2871,3187,13,92,3,15,2,3,74,15,6,1,4,63,311,242,2746,3057,8/7/2020
3/29/2020,106,422,356,3227,3649,8,100,4,19,1,4,77,18,8,2,6,105,416,314,3060,3476,8/7/2020
3/30/2020,62,484,222,3449,3933,20,120,5,24,0,4,92,20,11,3,9,78,494,192,3252,3746,8/7/2020
3/31/2020,71,555,369,3818,4373,11,131,7,31,1,5,95,22,13,2,11,73,567,299,3551,4118,8/7/2020
4/1/2020,99,654,699,4517,5171,18,149,7,38,0,5,106,30,15,1,12,100,667,648,4199,4866,8/7/2020
4/2/2020,52,706,477,4994,5700,21,170,6,44,2,7,119,36,21,4,16,62,729,436,4635,5364,8/7/2020
4/3/2020,108,814,775,5769,6583,23,193,7,51,0,7,135,43,25,3,19,100,829,717,5352,6181,8/7/2020
4/4/2020,143,957,660,6429,7386,22,215,4,55,5,12,148,41,30,9,28,137,966,621,5973,6939,8/7/2020
4/5/2020,187,1144,1156,7585,8729,20,235,9,64,1,13,158,44,36,2,30,182,1148,1071,7044,8192,8/7/2020
4/6/2020,218,1362,1707,9292,10654,26,261,7,71,0,13,177,48,40,7,37,206,1354,1578,8622,9976,8/7/2020
4/7/2020,285,1647,1631,10923,12570,20,281,3,74,2,15,192,49,42,5,42,260,1614,1490,10112,11726,8/7/2020
4/8/2020,290,1937,1723,12646,14583,19,300,7,81,6,21,198,49,38,10,52,272,1886,1569,11681,13567,8/7/2020
4/9/2020,284,2221,1521,14167,16388,32,332,9,90,4,25,217,52,40,7,59,278,2164,1364,13045,15209,8/7/2020
4/10/2020,420,2641,2577,16744,19385,29,361,17,107,5,30,224,58,41,11,70,404,2568,2380,15425,17993,8/7/2020
4/11/2020,299,2940,1911,18655,21595,29,390,11,118,2,32,240,61,48,12,82,280,2848,1727,17152,20000,8/7/2020
4/12/2020,315,3255,1674,20329,23584,35,425,13,131,5,37,257,59,49,9,91,289,3137,1447,18599,21736,8/7/2020
4/13/2020,162,3417,938,21267,24684,35,460,13,144,3,40,276,64,54,9,100,187,3324,844,19443,22767,8/7/2020
4/14/2020,289,3706,1788,23055,26761,27,487,17,161,5,45,281,72,53,8,108,265,3589,1547,20990,24579,8/7/2020
4/15/2020,353,4059,1803,24858,28917,31,518,19,180,3,48,290,72,54,17,125,307,3896,1575,22565,26461,8/7/2020
4/16/2020,449,4508,2500,27358,31866,36,554,25,205,6,54,295,72,53,14,139,392,4288,2096,24661,28949,8/7/2020
4/17/2020,308,4816,1823,29181,33997,32,586,20,225,7,61,300,66,45,21,160,291,4579,1468,26129,30708,8/7/2020
4/18/2020,322,5138,1728,30909,36047,26,612,18,243,4,65,304,63,49,15,175,284,4863,1359,27488,32351,8/7/2020
4/19/2020,382,5520,2059,32968,38488,23,635,26,269,1,66,300,65,55,11,186,338,5201,1757,29245,34446,8/7/2020
4/20/2020,396,5916,1909,34877,40793,46,681,29,298,2,68,315,75,56,10,196,377,5578,1589,30834,36412,8/7/2020
4/21/2020,445,6361,2114,36991,43352,45,726,31,329,5,73,324,72,56,18,214,388,5966,1725,32559,38525,8/7/2020
4/22/2020,420,6781,2398,39389,46170,41,767,32,361,5,78,328,73,58,18,232,382,6348,1922,34481,40829,8/7/2020
4/23/2020,482,7263,2471,41860,49123,30,797,28,389,5,83,325,76,62,15,247,419,6767,1885,36366,43133,8/7/2020
4/24/2020,494,7757,3292,45152,52909,35,832,27,416,4,87,329,85,63,15,262,413,7180,2648,39014,46194,8/7/2020
4/25/2020,394,8151,2210,47362,55513,34,866,17,433,5,92,341,85,62,14,276,305,7485,1785,40799,48284,8/7/2020
4/26/2020,316,8467,2314,49676,58143,33,899,15,448,3,95,356,86,59,14,290,276,7761,1889,42688,50449,8/7/2020
4/27/2020,250,8717,1624,51300,60017,29,928,21,469,4,99,360,86,61,10,300,204,7965,1169,43857,51822,8/7/2020
4/28/2020,411,9128,2268,53568,62696,44,972,24,493,3,102,377,88,59,22,322,325,8290,1774,45631,53921,8/7/2020
4/29/2020,476,9604,3351,56919,66523,36,1008,37,530,11,113,365,78,53,18,340,372,8662,2454,48085,56747,8/7/2020
4/30/2020,432,10036,2772,59691,69727,32,1040,38,568,6,119,353,83,57,24,364,347,9009,1962,50047,59056,8/7/2020
5/1/2020,457,10493,3089,62780,73273,51,1091,40,608,3,122,361,84,58,14,378,317,9326,2222,52269,61595,8/7/2020
5/2/2020,260,10753,1927,64707,75460,35,1126,38,646,5,127,353,90,61,24,402,189,9515,1296,53565,63080,8/7/2020
5/3/2020,284,11037,2168,66875,77912,31,1157,27,673,8,135,349,89,61,21,423,181,9696,1611,55176,64872,8/7/2020
5/4/2020,388,11425,2101,68976,80401,30,1187,31,704,5,140,343,87,57,18,441,293,9989,1577,56753,66742,8/7/2020
5/5/2020,436,11861,2878,71854,83715,28,1215,32,736,6,146,333,80,54,16,457,304,10293,1978,58731,69024,8/7/2020
5/6/2020,490,12351,2836,74690,87041,28,1243,44,780,9,155,308,78,54,21,478,341,10634,1930,60661,71295,8/7/2020
5/7/2020,425,12776,2975,77665,90441,36,1279,40,820,5,160,299,70,52,21,499,269,10903,1992,62653,73556,8/7/2020
5/8/2020,360,13136,2603,80268,93404,30,1309,29,849,5,165,295,70,53,22,521,231,11134,1779,64432,75566,8/7/2020
5/9/2020,457,13593,3356,83624,97217,22,1331,21,870,4,169,292,68,51,15,536,285,11419,2312,66744,78163,8/7/2020
5/10/2020,280,13873,2122,85746,99619,19,1350,23,893,6,175,282,69,49,13,549,186,11605,1528,68272,79877,8/7/2020
5/11/2020,259,14132,1861,87607,101739,31,1381,16,909,6,181,291,70,49,15,564,176,11781,1313,69585,81366,8/7/2020
5/12/2020,387,14519,2622,90229,104748,23,1404,18,927,4,185,292,68,48,22,586,217,11998,1720,71305,83303,8/7/2020
5/13/2020,352,14871,3634,93863,108734,22,1426,24,951,1,186,289,69,49,13,599,196,12194,2028,73333,85527,8/7/2020
5/14/2020,330,15201,3415,97278,112479,19,1445,27,978,3,189,278,64,45,15,614,227,12421,2022,75355,87776,8/7/2020
5/15/2020,382,15583,3470,100748,116331,24,1469,41,1019,5,194,256,62,45,13,627,234,12655,1820,77175,89830,8/7/2020
5/16/2020,438,16021,4168,104916,120937,25,1494,12,1031,5,199,264,61,46,15,642,252,12907,1975,79150,92057,8/7/2020
5/17/2020,231,16252,2775,107691,123943,17,1511,7,1038,5,204,269,59,45,10,652,124,13031,1569,80719,93750,8/7/2020
5/18/2020,251,16503,2007,109698,126201,19,1530,15,1053,5,209,268,57,40,18,670,139,13170,1375,82094,95264,8/7/2020
5/19/2020,416,16919,3178,112876,129795,23,1553,31,1084,5,214,255,56,38,11,681,214,13384,1944,84038,97422,8/7/2020
5/20/2020,328,17247,2774,115650,132897,19,1572,23,1107,7,221,244,52,33,22,703,187,13571,1525,85563,99134,8/7/2020
5/21/2020,374,17621,3764,119414,137035,26,1598,15,1122,3,224,252,53,29,20,723,170,13741,1953,87516,101257,8/7/2020
5/22/2020,351,17972,3172,122586,140558,20,1618,29,1151,5,229,238,52,29,10,733,205,13946,1616,89132,103078,8/7/2020
5/23/2020,240,18212,2748,125334,143546,19,1637,11,1162,3,232,243,52,32,13,746,109,14055,1289,90421,104476,8/7/2020
5/24/2020,153,18365,1372,126706,145071,12,1649,14,1176,2,234,239,53,36,8,754,84,14139,774,91195,105334,8/7/2020
5/25/2020,134,18499,1389,128095,146594,12,1661,14,1190,0,234,237,53,34,10,764,70,14209,765,91960,106169,8/7/2020
5/26/2020,284,18783,2624,130719,149502,24,1685,22,1212,5,239,234,48,33,15,779,155,14364,1789,93749,108113,8/7/2020
5/27/2020,276,19059,2134,132853,151912,20,1705,17,1229,3,242,234,50,33,10,789,133,14497,1144,94893,109390,8/7/2020
5/28/2020,346,19405,3384,136237,155642,17,1722,29,1258,4,246,218,47,32,8,797,132,14629,1133,96026,110655,8/7/2020
5/29/2020,419,19824,3989,140226,160050,18,1740,27,1285,6,252,203,43,31,12,809,179,14808,1595,97621,112429,8/7/2020
5/30/2020,211,20035,3973,144199,164234,15,1755,19,1304,4,256,195,40,29,12,821,104,14912,1828,99449,114361,8/7/2020
5/31/2020,148,20183,1753,145952,166135,10,1765,10,1314,0,256,195,43,26,3,824,76,14988,856,100305,115293,8/7/2020
6/1/2020,216,20399,2813,148765,169164,7,1772,13,1327,1,257,188,44,29,5,829,99,15087,1377,101682,116769,8/7/2020
6/2/2020,273,20672,3080,151845,172517,8,1780,9,1336,3,260,184,37,25,10,839,107,15194,1469,103151,118345,8/7/2020
6/3/2020,259,20931,3509,155354,176285,13,1793,18,1354,6,266,173,34,25,11,850,105,15299,1671,104822,120121,8/7/2020
6/4/2020,281,21212,4522,159876,181088,7,1800,25,1379,3,269,152,31,24,11,861,114,15413,2041,106863,122276,8/7/2020
6/5/2020,215,21427,3583,163459,184886,15,1815,12,1391,5,274,150,27,21,9,870,104,15517,1579,108442,123959,8/7/2020
6/6/2020,198,21625,2622,166081,187706,10,1825,7,1398,2,276,151,29,19,6,876,68,15585,1134,109576,125161,8/7/2020
6/7/2020,77,21702,1614,167695,189397,11,1836,7,1405,1,277,154,25,17,4,880,49,15634,777,110353,125987,8/7/2020
6/8/2020,122,21824,1847,169542,191366,15,1851,12,1417,2,279,155,27,18,4,884,44,15678,965,111318,126996,8/7/2020
6/9/2020,225,22049,2674,172216,194265,10,1861,18,1435,0,279,147,28,21,1,885,67,15745,1263,112581,128326,8/7/2020
6/10/2020,210,22259,2983,175199,197458,13,1874,12,1447,2,281,146,24,17,3,888,104,15849,1459,114040,129889,8/7/2020
6/11/2020,195,22454,3499,178698,201152,7,1881,15,1462,1,282,137,25,16,6,894,88,15937,1529,115569,131506,8/7/2020
6/12/2020,213,22667,4605,183303,205970,8,1889,15,1477,1,283,129,24,16,2,896,80,16017,2189,117758,133775,8/7/2020
6/13/2020,111,22778,3028,186331,209109,6,1895,4,1481,0,283,131,20,15,3,899,50,16067,1368,119126,135193,8/7/2020
6/14/2020,78,22856,2037,188368,211224,6,1901,8,1489,1,284,128,20,14,3,902,32,16099,965,120091,136190,8/7/2020
6/15/2020,189,23045,3105,191473,214518,14,1915,14,1503,0,284,128,20,16,4,906,78,16177,1785,121876,138053,8/7/2020
6/16/2020,115,23160,3010,194483,217643,11,1926,10,1513,1,285,128,22,16,8,914,52,16229,1577,123453,139682,8/7/2020
6/17/2020,123,23283,2826,197309,220592,15,1941,20,1533,4,289,119,18,14,6,920,52,16281,1314,124767,141048,8/7/2020
6/18/2020,150,23433,3039,200348,223781,9,1950,13,1546,1,290,114,19,16,7,927,70,16351,1330,126097,142448,8/7/2020
6/19/2020,141,23574,3761,204109,227683,12,1962,11,1557,1,291,114,20,17,3,930,59,16410,1373,127470,143880,8/7/2020
6/20/2020,80,23654,1883,205992,229646,7,1969,9,1566,0,291,112,20,18,4,934,36,16446,812,128282,144728,8/7/2020
6/21/2020,36,23690,1042,207034,230724,7,1976,5,1571,0,291,114,20,18,2,936,27,16473,677,128959,145432,8/7/2020
6/22/2020,142,23832,3713,210747,234579,12,1988,16,1587,0,291,110,19,18,1,937,70,16543,1703,130662,147205,8/7/2020
6/23/2020,162,23994,3850,214597,238591,3,1991,13,1600,3,294,97,18,18,6,943,83,16626,1792,132454,149080,8/7/2020
6/24/2020,121,24115,3508,218105,242220,9,2000,10,1610,1,295,95,18,18,5,948,47,16673,1692,134146,150819,8/7/2020
6/25/2020,102,24217,2885,220990,245207,5,2005,14,1624,1,296,85,17,17,1,949,52,16725,1507,135653,152378,8/7/2020
6/26/2020,94,24311,2454,223444,247755,2,2007,9,1633,0,296,78,18,18,1,950,64,16789,1303,136956,153745,8/7/2020
6/27/2020,84,24395,3212,226656,251051,5,2012,3,1636,1,297,79,17,17,5,955,37,16826,1213,138169,154995,8/7/2020
6/28/2020,37,24432,1452,228108,252540,4,2016,4,1640,4,301,75,15,14,6,961,18,16844,586,138755,155599,8/7/2020
6/29/2020,86,24518,3673,231781,256299,4,2020,5,1645,0,301,74,14,14,1,962,38,16882,1343,140098,156980,8/7/2020
6/30/2020,60,24578,1945,233726,258304,1,2021,5,1650,1,302,69,12,11,3,965,35,16917,993,141091,158008,8/7/2020
7/1/2020,145,24723,4106,237832,262555,7,2028,9,1659,0,302,67,11,11,1,966,81,16998,1951,143042,160040,8/7/2020
7/2/2020,101,24824,2778,240610,265434,5,2033,5,1664,1,303,66,9,9,1,967,56,17054,1075,144117,161171,8/7/2020
7/3/2020,47,24871,2013,242623,267494,7,2040,6,1670,0,303,67,8,8,3,970,25,17079,771,144888,161967,8/7/2020
7/4/2020,57,24928,2320,244943,269871,2,2042,4,1674,1,304,64,9,8,2,972,34,17113,991,145879,162992,8/7/2020
7/5/2020,47,24975,2924,247867,272842,1,2043,2,1676,1,305,62,7,7,2,974,23,17136,1442,147321,164457,8/7/2020
7/6/2020,103,25078,2790,250657,275735,6,2049,6,1682,0,305,62,8,9,4,978,60,17196,1543,148864,166060,8/7/2020
7/7/2020,80,25158,3438,254095,279253,5,2054,6,1688,0,305,61,7,8,1,979,47,17243,1532,150396,167639,8/7/2020
7/8/2020,104,25262,3381,257476,282738,4,2058,2,1690,0,305,63,8,8,0,979,66,17309,1418,151814,169123,8/7/2020
7/9/2020,94,25356,3658,261134,286490,7,2065,2,1692,0,305,68,8,8,0,979,50,17359,1594,153408,170767,8/7/2020
7/10/2020,129,25485,4387,265521,291006,5,2070,3,1695,2,307,68,7,7,3,982,79,17438,2075,155483,172921,8/7/2020
7/11/2020,63,25548,2881,268402,293950,6,2076,3,1698,1,308,70,6,6,3,985,34,17472,1278,156761,174233,8/7/2020
7/12/2020,45,25593,1764,270166,295759,1,2077,2,1700,1,309,68,6,5,3,988,33,17505,885,157646,175151,8/7/2020
7/13/2020,85,25678,3142,273308,298986,7,2084,10,1710,0,309,65,6,5,1,989,57,17562,1469,159115,176677,8/7/2020
7/14/2020,75,25753,3246,276554,302307,7,2091,4,1714,0,309,68,5,5,1,990,50,17612,1347,160462,178074,8/7/2020
7/15/2020,123,25876,4118,280672,306548,5,2096,6,1720,0,309,67,5,4,0,990,94,17706,1724,162186,179892,8/7/2020
7/16/2020,102,25978,3678,284350,310328,6,2102,8,1728,0,309,65,6,5,1,991,78,17784,1584,163770,181554,8/7/2020
7/17/2020,151,26129,4115,288465,314594,14,2116,3,1731,1,310,75,5,5,1,992,78,17862,1793,165563,183425,8/7/2020
7/18/2020,80,26209,3141,291606,317815,5,2121,9,1740,1,311,70,5,4,4,996,67,17929,1327,166890,184819,8/7/2020
7/19/2020,82,26291,2577,294183,320474,6,2127,3,1743,0,311,73,6,4,2,998,58,17987,1070,167960,185947,8/7/2020
7/20/2020,72,26363,2592,296775,323138,9,2136,7,1750,0,311,75,7,5,2,1000,63,18050,1443,169403,187453,8/7/2020
7/21/2020,128,26491,4212,300987,327478,9,2145,10,1760,0,311,74,9,6,1,1001,104,18154,1870,171273,189427,8/7/2020
7/22/2020,123,26614,3783,304770,331384,11,2156,11,1771,1,312,73,7,6,1,1002,87,18241,1577,172850,191091,8/7/2020
7/23/2020,123,26737,4055,308825,335562,7,2163,5,1776,0,312,75,8,7,0,1002,105,18346,1753,174603,192949,8/7/2020
7/24/2020,161,26898,5673,314498,341396,12,2175,12,1788,0,312,75,9,7,0,1002,117,18463,2146,176749,195212,8/7/2020
7/25/2020,126,27024,4258,318756,345780,7,2182,7,1795,0,312,75,10,8,1,1003,103,18566,1999,178748,197314,8/7/2020
7/26/2020,56,27080,2957,321713,348793,7,2189,8,1803,0,312,74,11,6,1,1004,53,18619,1297,180045,198664,8/7/2020
7/27/2020,182,27262,3872,325585,352847,12,2201,7,1810,0,312,79,13,7,1,1005,138,18757,2111,182156,200913,8/7/2020
7/28/2020,101,27363,3636,329221,356584,5,2206,3,1813,0,312,81,14,6,1,1006,89,18846,1501,183657,202503,8/7/2020
7/29/2020,159,27522,4751,333972,361494,10,2216,12,1825,0,312,79,15,6,0,1006,142,18988,2075,185732,204720,8/7/2020
7/30/2020,96,27618,3948,337920,365538,5,2221,2,1827,1,313,81,15,5,0,1006,73,19061,1352,187084,206145,8/7/2020
7/31/2020,116,27734,5065,342985,370719,8,2229,9,1836,0,313,80,15,6,0,1006,88,19149,1610,188694,207843,8/7/2020
8/1/2020,89,27823,3887,346872,374695,7,2236,2,1838,0,313,85,14,6,1,1007,76,19225,1321,190015,209240,8/7/2020
8/2/2020,77,27900,2659,349531,377431,10,2246,11,1849,1,314,83,14,7,2,1009,65,19290,1197,191212,210502,8/7/2020
8/3/2020,166,28066,4805,354336,382402,13,2259,12,1861,0,314,84,15,6,1,1010,145,19435,1904,193116,212551,8/7/2020
8/4/2020,117,28183,3402,357738,385921,7,2266,6,1867,1,315,84,11,4,2,1012,99,19534,1593,194709,214243,8/7/2020
8/5/2020,138,28321,5313,363051,391372,10,2276,9,1876,1,316,84,10,4,2,1014,104,19638,2013,196722,216360,8/7/2020
8/6/2020,150,28471,4276,367327,395798,,,,,,,,,,0,1014,100,19738,1513,198235,217973,8/7/2020
2/27/2020,0,0,0,0,0,1,1,0,0,0,0,1,0,0,0,0,0,0,0,0,0,8/10/2020
2/28/2020,0,0,0,0,0,0,1,0,0,0,0,1,1,0,0,0,0,0,0,0,0,8/10/2020
2/29/2020,0,0,0,0,0,0,1,0,0,0,0,1,1,0,0,0,0,0,0,0,0,8/10/2020
3/1/2020,2,2,2,2,4,0,1,0,0,0,0,1,1,1,0,0,2,2,2,2,4,8/10/2020
3/2/2020,0,2,1,3,5,1,2,0,0,0,0,2,2,2,0,0,0,2,1,3,5,8/10/2020
3/3/2020,0,2,2,5,7,0,2,0,0,0,0,2,2,2,0,0,0,2,2,5,7,8/10/2020
3/4/2020,0,2,12,17,19,1,3,0,0,0,0,3,2,2,0,0,0,2,10,15,17,8/10/2020
3/5/2020,0,2,4,21,23,0,3,0,0,0,0,3,2,2,0,0,1,3,4,19,22,8/10/2020
3/6/2020,1,3,12,33,36,0,3,0,0,0,0,3,2,2,0,0,0,3,11,30,33,8/10/2020
3/7/2020,0,3,19,52,55,0,3,0,0,0,0,3,2,1,0,0,0,3,19,49,52,8/10/2020
3/8/2020,0,3,18,70,73,0,3,0,0,0,0,3,2,1,0,0,0,3,18,67,70,8/10/2020
3/9/2020,1,4,15,85,89,0,3,0,0,0,0,3,2,1,0,0,1,4,15,82,86,8/10/2020
3/10/2020,2,6,25,110,116,0,3,0,0,0,0,3,2,1,0,0,1,5,23,105,110,8/10/2020
3/11/2020,0,6,34,144,150,1,4,0,0,0,0,4,1,1,0,0,0,5,34,139,144,8/10/2020
3/12/2020,9,15,42,186,201,1,5,0,0,0,0,5,1,1,0,0,8,13,38,177,190,8/10/2020
3/13/2020,6,21,50,236,257,4,9,1,1,0,0,8,1,1,0,0,6,19,48,225,244,8/10/2020
3/14/2020,0,21,90,326,347,0,9,0,1,0,0,8,1,1,0,0,0,19,86,311,330,8/10/2020
3/15/2020,1,22,54,380,402,1,10,0,1,0,0,9,2,1,0,0,1,20,54,365,385,8/10/2020
3/16/2020,2,24,95,475,499,2,12,0,1,0,0,11,2,0,0,0,2,22,92,457,479,8/10/2020
3/17/2020,16,40,162,637,677,6,18,0,1,0,0,17,2,0,0,0,11,33,152,609,642,8/10/2020
3/18/2020,12,52,116,753,805,3,21,0,1,0,0,20,2,0,0,0,11,44,111,720,764,8/10/2020
3/19/2020,17,69,262,1015,1084,2,23,1,2,0,0,21,3,0,1,1,17,61,251,971,1032,8/10/2020
3/20/2020,15,84,197,1212,1296,5,28,0,2,0,0,26,4,0,0,1,13,74,192,1163,1237,8/10/2020
3/21/2020,21,105,126,1338,1443,3,31,2,4,0,0,27,5,0,0,1,14,88,123,1286,1374,8/10/2020
3/22/2020,30,135,282,1620,1755,2,33,0,4,0,0,29,5,0,0,1,25,113,264,1550,1663,8/10/2020
3/23/2020,14,149,169,1789,1938,15,48,1,5,0,0,43,9,3,0,1,16,129,165,1715,1844,8/10/2020
3/24/2020,20,169,243,2032,2201,7,55,0,5,0,0,50,10,4,0,1,19,148,238,1953,2101,8/10/2020
3/25/2020,26,195,183,2215,2410,5,60,1,6,0,0,54,11,3,0,1,28,176,173,2126,2302,8/10/2020
3/26/2020,35,230,181,2396,2626,10,70,5,11,0,0,59,14,5,0,1,41,217,176,2302,2519,8/10/2020
3/27/2020,27,257,215,2611,2868,9,79,1,12,1,1,66,17,6,2,3,31,248,202,2504,2752,8/10/2020
3/28/2020,59,316,260,2871,3187,13,92,3,15,2,3,74,15,6,1,4,63,311,242,2746,3057,8/10/2020
3/29/2020,106,422,356,3227,3649,8,100,4,19,1,4,77,18,8,2,6,105,416,314,3060,3476,8/10/2020
3/30/2020,62,484,222,3449,3933,20,120,5,24,0,4,92,20,11,3,9,78,494,192,3252,3746,8/10/2020
3/31/2020,71,555,369,3818,4373,11,131,7,31,1,5,95,22,13,2,11,73,567,299,3551,4118,8/10/2020
4/1/2020,99,654,699,4517,5171,18,149,7,38,0,5,106,30,15,1,12,100,667,648,4199,4866,8/10/2020
4/2/2020,52,706,477,4994,5700,21,170,6,44,2,7,119,36,21,4,16,62,729,436,4635,5364,8/10/2020
4/3/2020,108,814,775,5769,6583,23,193,7,51,0,7,135,43,25,3,19,100,829,717,5352,6181,8/10/2020
4/4/2020,143,957,660,6429,7386,22,215,4,55,5,12,148,41,30,9,28,137,966,621,5973,6939,8/10/2020
4/5/2020,187,1144,1156,7585,8729,20,235,9,64,1,13,158,44,36,2,30,182,1148,1071,7044,8192,8/10/2020
4/6/2020,218,1362,1707,9292,10654,26,261,7,71,0,13,177,48,40,7,37,206,1354,1577,8621,9975,8/10/2020
4/7/2020,285,1647,1631,10923,12570,20,281,3,74,2,15,192,49,42,5,42,260,1614,1490,10111,11725,8/10/2020
4/8/2020,290,1937,1723,12646,14583,19,300,7,81,6,21,198,49,38,10,52,272,1886,1569,11680,13566,8/10/2020
4/9/2020,284,2221,1521,14167,16388,32,332,9,90,4,25,217,52,40,7,59,278,2164,1364,13044,15208,8/10/2020
4/10/2020,420,2641,2577,16744,19385,29,361,17,107,5,30,224,58,41,11,70,404,2568,2380,15424,17992,8/10/2020
4/11/2020,299,2940,1911,18655,21595,29,390,11,118,2,32,240,61,48,12,82,280,2848,1727,17151,19999,8/10/2020
4/12/2020,315,3255,1674,20329,23584,35,425,13,131,5,37,257,59,49,9,91,289,3137,1446,18597,21734,8/10/2020
4/13/2020,162,3417,938,21267,24684,35,460,13,144,3,40,276,64,54,9,100,187,3324,844,19441,22765,8/10/2020
4/14/2020,289,3706,1788,23055,26761,27,487,17,161,5,45,281,72,53,8,108,265,3589,1546,20987,24576,8/10/2020
4/15/2020,353,4059,1803,24858,28917,31,518,19,180,3,48,290,72,54,17,125,307,3896,1574,22561,26457,8/10/2020
4/16/2020,449,4508,2500,27358,31866,36,554,25,205,6,54,295,72,53,14,139,392,4288,2096,24657,28945,8/10/2020
4/17/2020,308,4816,1823,29181,33997,32,586,20,225,7,61,300,66,45,21,160,291,4579,1468,26125,30704,8/10/2020
4/18/2020,322,5138,1728,30909,36047,26,612,18,243,4,65,304,63,49,15,175,284,4863,1357,27482,32345,8/10/2020
4/19/2020,382,5520,2059,32968,38488,23,635,26,269,1,66,300,65,55,11,186,338,5201,1756,29238,34439,8/10/2020
4/20/2020,396,5916,1909,34877,40793,46,681,29,298,2,68,315,75,56,10,196,377,5578,1589,30827,36405,8/10/2020
4/21/2020,445,6361,2114,36991,43352,45,726,31,329,5,73,324,72,56,18,214,389,5967,1724,32551,38518,8/10/2020
4/22/2020,420,6781,2398,39389,46170,41,767,32,361,5,78,328,73,58,18,232,382,6349,1922,34473,40822,8/10/2020
4/23/2020,482,7263,2471,41860,49123,30,797,28,389,5,83,325,76,62,15,247,419,6768,1883,36356,43124,8/10/2020
4/24/2020,494,7757,3292,45152,52909,35,832,27,416,4,87,329,85,63,15,262,413,7181,2646,39002,46183,8/10/2020
4/25/2020,394,8151,2210,47362,55513,34,866,17,433,5,92,341,85,62,14,276,305,7486,1784,40786,48272,8/10/2020
4/26/2020,316,8467,2314,49676,58143,33,899,15,448,3,95,356,86,59,14,290,276,7762,1889,42675,50437,8/10/2020
4/27/2020,250,8717,1624,51300,60017,29,928,21,469,4,99,360,86,61,10,300,204,7966,1166,43841,51807,8/10/2020
4/28/2020,411,9128,2268,53568,62696,44,972,24,493,3,102,377,88,59,22,322,325,8291,1774,45615,53906,8/10/2020
4/29/2020,476,9604,3351,56919,66523,36,1008,37,530,11,113,365,78,53,18,340,372,8663,2453,48068,56731,8/10/2020
4/30/2020,432,10036,2772,59691,69727,32,1040,38,568,6,119,353,83,57,24,364,347,9010,1962,50030,59040,8/10/2020
5/1/2020,457,10493,3089,62780,73273,51,1091,39,607,3,122,362,84,58,14,378,317,9327,2222,52252,61579,8/10/2020
5/2/2020,260,10753,1927,64707,75460,35,1126,39,646,5,127,353,90,61,24,402,189,9516,1295,53547,63063,8/10/2020
5/3/2020,284,11037,2168,66875,77912,31,1157,27,673,8,135,349,89,61,21,423,181,9697,1610,55157,64854,8/10/2020
5/4/2020,388,11425,2101,68976,80401,30,1187,31,704,5,140,343,87,57,18,441,293,9990,1575,56732,66722,8/10/2020
5/5/2020,436,11861,2878,71854,83715,28,1215,32,736,6,146,333,80,54,16,457,304,10294,1975,58707,69001,8/10/2020
5/6/2020,490,12351,2836,74690,87041,28,1243,44,780,9,155,308,78,54,21,478,341,10635,1930,60637,71272,8/10/2020
5/7/2020,425,12776,2975,77665,90441,36,1279,40,820,5,160,299,70,52,21,499,269,10904,1990,62627,73531,8/10/2020
5/8/2020,360,13136,2603,80268,93404,30,1309,29,849,5,165,295,70,53,22,521,231,11135,1777,64404,75539,8/10/2020
5/9/2020,457,13593,3356,83624,97217,22,1331,21,870,4,169,292,68,51,15,536,285,11420,2311,66715,78135,8/10/2020
5/10/2020,280,13873,2122,85746,99619,19,1350,23,893,6,175,282,69,49,13,549,186,11606,1528,68243,79849,8/10/2020
5/11/2020,259,14132,1861,87607,101739,31,1381,16,909,6,181,291,70,49,15,564,176,11782,1313,69556,81338,8/10/2020
5/12/2020,387,14519,2622,90229,104748,23,1404,18,927,4,185,292,68,48,22,586,217,11999,1720,71276,83275,8/10/2020
5/13/2020,352,14871,3634,93863,108734,22,1426,24,951,1,186,289,69,49,13,599,196,12195,2028,73304,85499,8/10/2020
5/14/2020,330,15201,3415,97278,112479,19,1445,27,978,3,189,278,64,45,15,614,227,12422,2022,75326,87748,8/10/2020
5/15/2020,382,15583,3470,100748,116331,24,1469,41,1019,5,194,256,62,45,13,627,234,12656,1819,77145,89801,8/10/2020
5/16/2020,438,16021,4168,104916,120937,25,1494,12,1031,5,199,264,61,46,15,642,252,12908,1972,79117,92025,8/10/2020
5/17/2020,231,16252,2775,107691,123943,17,1511,7,1038,5,204,269,59,45,10,652,124,13032,1568,80685,93717,8/10/2020
5/18/2020,251,16503,2007,109698,126201,19,1530,15,1053,5,209,268,57,40,18,670,139,13171,1374,82059,95230,8/10/2020
5/19/2020,416,16919,3178,112876,129795,23,1553,31,1084,5,214,255,56,38,11,681,214,13385,1944,84003,97388,8/10/2020
5/20/2020,328,17247,2774,115650,132897,19,1572,23,1107,7,221,244,52,33,22,703,187,13572,1524,85527,99099,8/10/2020
5/21/2020,374,17621,3764,119414,137035,26,1598,15,1122,3,224,252,53,29,20,723,170,13742,1952,87479,101221,8/10/2020
5/22/2020,351,17972,3172,122586,140558,20,1618,29,1151,5,229,238,52,29,10,733,205,13947,1616,89095,103042,8/10/2020
5/23/2020,240,18212,2748,125334,143546,19,1637,11,1162,3,232,243,52,32,13,746,109,14056,1289,90384,104440,8/10/2020
5/24/2020,153,18365,1372,126706,145071,12,1649,14,1176,2,234,239,53,36,8,754,84,14140,774,91158,105298,8/10/2020
5/25/2020,134,18499,1389,128095,146594,12,1661,14,1190,0,234,237,53,34,10,764,70,14210,765,91923,106133,8/10/2020
5/26/2020,284,18783,2624,130719,149502,24,1685,22,1212,5,239,234,48,33,15,779,155,14365,1789,93712,108077,8/10/2020
5/27/2020,276,19059,2134,132853,151912,20,1705,17,1229,3,242,234,50,33,10,789,133,14498,1144,94856,109354,8/10/2020
5/28/2020,346,19405,3384,136237,155642,17,1722,29,1258,4,246,218,47,32,8,797,132,14630,1133,95989,110619,8/10/2020
5/29/2020,419,19824,3989,140226,160050,18,1740,27,1285,6,252,203,43,31,12,809,179,14809,1594,97583,112392,8/10/2020
5/30/2020,211,20035,3973,144199,164234,15,1755,19,1304,4,256,195,40,29,12,821,104,14913,1828,99411,114324,8/10/2020
5/31/2020,148,20183,1753,145952,166135,10,1765,10,1314,0,256,195,43,26,3,824,76,14989,855,100266,115255,8/10/2020
6/1/2020,216,20399,2813,148765,169164,7,1772,13,1327,1,257,188,44,29,5,829,99,15088,1377,101643,116731,8/10/2020
6/2/2020,273,20672,3080,151845,172517,8,1780,9,1336,3,260,184,37,25,10,839,107,15195,1469,103112,118307,8/10/2020
6/3/2020,259,20931,3510,155355,176286,13,1793,18,1354,6,266,173,34,25,11,850,105,15300,1672,104784,120084,8/10/2020
6/4/2020,281,21212,4522,159877,181089,7,1800,25,1379,3,269,152,31,24,11,861,114,15414,2041,106825,122239,8/10/2020
6/5/2020,215,21427,3584,163461,184888,15,1815,12,1391,5,274,150,27,21,9,870,104,15518,1580,108405,123923,8/10/2020
6/6/2020,198,21625,2622,166083,187708,10,1825,7,1398,2,276,151,29,19,6,876,68,15586,1134,109539,125125,8/10/2020
6/7/2020,77,21702,1614,167697,189399,11,1836,7,1405,1,277,154,25,17,4,880,49,15635,777,110316,125951,8/10/2020
6/8/2020,122,21824,1847,169544,191368,15,1851,12,1417,2,279,155,27,18,4,884,44,15679,965,111281,126960,8/10/2020
6/9/2020,225,22049,2675,172219,194268,10,1861,18,1435,0,279,147,28,21,1,885,67,15746,1263,112544,128290,8/10/2020
6/10/2020,210,22259,2983,175202,197461,13,1874,12,1447,2,281,146,24,17,3,888,104,15850,1458,114002,129852,8/10/2020
6/11/2020,195,22454,3499,178701,201155,7,1881,15,1462,1,282,137,25,16,6,894,88,15938,1529,115531,131469,8/10/2020
6/12/2020,213,22667,4605,183306,205973,8,1889,15,1477,1,283,129,24,16,2,896,80,16018,2188,117719,133737,8/10/2020
6/13/2020,111,22778,3028,186334,209112,6,1895,4,1481,0,283,131,20,15,3,899,50,16068,1368,119087,135155,8/10/2020
6/14/2020,78,22856,2037,188371,211227,6,1901,8,1489,1,284,128,20,14,3,902,32,16100,965,120052,136152,8/10/2020
6/15/2020,189,23045,3105,191476,214521,14,1915,14,1503,0,284,128,20,16,4,906,78,16178,1785,121837,138015,8/10/2020
6/16/2020,115,23160,3010,194486,217646,11,1926,10,1513,1,285,128,22,16,8,914,52,16230,1576,123413,139643,8/10/2020
6/17/2020,123,23283,2827,197313,220596,15,1941,20,1533,4,289,119,18,14,6,920,52,16282,1315,124728,141010,8/10/2020
6/18/2020,150,23433,3039,200352,223785,9,1950,13,1546,1,290,114,19,16,7,927,70,16352,1329,126057,142409,8/10/2020
6/19/2020,141,23574,3762,204114,227688,12,1962,11,1557,1,291,114,20,17,3,930,59,16411,1374,127431,143842,8/10/2020
6/20/2020,80,23654,1883,205997,229651,7,1969,9,1566,0,291,112,20,18,4,934,36,16447,811,128242,144689,8/10/2020
6/21/2020,36,23690,1042,207039,230729,7,1976,5,1571,0,291,114,20,18,2,936,27,16474,677,128919,145393,8/10/2020
6/22/2020,142,23832,3713,210752,234584,12,1988,16,1587,0,291,110,19,18,1,937,70,16544,1703,130622,147166,8/10/2020
6/23/2020,162,23994,3850,214602,238596,3,1991,13,1600,3,294,97,18,18,6,943,83,16627,1792,132414,149041,8/10/2020
6/24/2020,121,24115,3508,218110,242225,9,2000,10,1610,1,295,95,18,18,5,948,47,16674,1692,134106,150780,8/10/2020
6/25/2020,102,24217,2885,220995,245212,5,2005,14,1624,1,296,85,17,17,1,949,52,16726,1507,135613,152339,8/10/2020
6/26/2020,94,24311,2454,223449,247760,2,2007,9,1633,0,296,78,18,18,1,950,64,16790,1302,136915,153705,8/10/2020
6/27/2020,84,24395,3212,226661,251056,5,2012,3,1636,1,297,79,17,17,5,955,37,16827,1213,138128,154955,8/10/2020
6/28/2020,37,24432,1452,228113,252545,4,2016,4,1640,4,301,75,15,14,6,961,18,16845,586,138714,155559,8/10/2020
6/29/2020,86,24518,3674,231787,256305,4,2020,5,1645,0,301,74,14,14,1,962,38,16883,1344,140058,156941,8/10/2020
6/30/2020,60,24578,1945,233732,258310,1,2021,5,1650,1,302,69,12,11,3,965,35,16918,993,141051,157969,8/10/2020
7/1/2020,145,24723,4106,237838,262561,7,2028,9,1659,0,302,67,11,11,1,966,81,16999,1951,143002,160001,8/10/2020
7/2/2020,101,24824,2778,240616,265440,5,2033,5,1664,1,303,66,9,9,1,967,56,17055,1075,144077,161132,8/10/2020
7/3/2020,47,24871,2014,242630,267501,7,2040,6,1670,0,303,67,8,8,3,970,25,17080,771,144848,161928,8/10/2020
7/4/2020,57,24928,2320,244950,269878,2,2042,4,1674,1,304,64,9,8,2,972,34,17114,990,145838,162952,8/10/2020
7/5/2020,47,24975,2924,247874,272849,1,2043,2,1676,1,305,62,7,7,2,974,23,17137,1442,147280,164417,8/10/2020
7/6/2020,103,25078,2790,250664,275742,6,2049,6,1682,0,305,62,8,9,4,978,60,17197,1542,148822,166019,8/10/2020
7/7/2020,80,25158,3438,254102,279260,5,2054,6,1688,0,305,61,7,8,1,979,47,17244,1531,150353,167597,8/10/2020
7/8/2020,104,25262,3381,257483,282745,4,2058,2,1690,0,305,63,8,8,0,979,66,17310,1417,151770,169080,8/10/2020
7/9/2020,94,25356,3658,261141,286497,7,2065,2,1692,0,305,68,8,8,0,979,50,17360,1594,153364,170724,8/10/2020
7/10/2020,129,25485,4391,265532,291017,5,2070,3,1695,2,307,68,7,7,3,982,79,17439,2079,155443,172882,8/10/2020
7/11/2020,63,25548,2881,268413,293961,6,2076,3,1698,1,308,70,6,6,3,985,34,17473,1278,156721,174194,8/10/2020
7/12/2020,45,25593,1764,270177,295770,1,2077,2,1700,1,309,68,6,5,3,988,33,17506,885,157606,175112,8/10/2020
7/13/2020,85,25678,3142,273319,298997,7,2084,10,1710,0,309,65,6,5,1,989,57,17563,1469,159075,176638,8/10/2020
7/14/2020,75,25753,3246,276565,302318,7,2091,4,1714,0,309,68,5,5,1,990,50,17613,1347,160422,178035,8/10/2020
7/15/2020,123,25876,4118,280683,306559,5,2096,6,1720,0,309,67,5,4,0,990,94,17707,1724,162146,179853,8/10/2020
7/16/2020,102,25978,3685,284368,310346,6,2102,8,1728,0,309,65,6,5,1,991,78,17785,1590,163736,181521,8/10/2020
7/17/2020,151,26129,4116,288484,314613,14,2116,3,1731,1,310,75,5,5,1,992,78,17863,1794,165530,183393,8/10/2020
7/18/2020,80,26209,3141,291625,317834,5,2121,9,1740,1,311,70,5,4,4,996,67,17930,1327,166857,184787,8/10/2020
7/19/2020,82,26291,2577,294202,320493,6,2127,3,1743,0,311,73,6,4,2,998,58,17988,1070,167927,185915,8/10/2020
7/20/2020,72,26363,2592,296794,323157,9,2136,7,1750,0,311,75,7,5,2,1000,63,18051,1443,169370,187421,8/10/2020
7/21/2020,128,26491,4212,301006,327497,9,2145,10,1760,0,311,74,9,6,1,1001,104,18155,1869,171239,189394,8/10/2020
7/22/2020,123,26614,3784,304790,331404,11,2156,11,1771,1,312,73,7,6,1,1002,87,18242,1578,172817,191059,8/10/2020
7/23/2020,123,26737,4055,308845,335582,6,2162,5,1776,0,312,74,8,7,0,1002,105,18347,1752,174569,192916,8/10/2020
7/24/2020,161,26898,5673,314518,341416,12,2174,12,1788,0,312,74,9,7,0,1002,117,18464,2143,176712,195176,8/10/2020
7/25/2020,126,27024,4258,318776,345800,7,2181,7,1795,0,312,74,10,8,1,1003,104,18568,1999,178711,197279,8/10/2020
7/26/2020,56,27080,2957,321733,348813,7,2188,8,1803,0,312,73,11,6,1,1004,53,18621,1297,180008,198629,8/10/2020
7/27/2020,182,27262,3872,325605,352867,12,2200,7,1810,0,312,78,13,7,1,1005,138,18759,2111,182119,200878,8/10/2020
7/28/2020,101,27363,3636,329241,356604,5,2205,3,1813,0,312,80,14,6,1,1006,90,18849,1500,183619,202468,8/10/2020
7/29/2020,159,27522,4751,333992,361514,10,2215,12,1825,0,312,78,15,6,0,1006,143,18992,2074,185693,204685,8/10/2020
7/30/2020,96,27618,3948,337940,365558,5,2220,2,1827,1,313,80,15,5,0,1006,74,19066,1352,187045,206111,8/10/2020
7/31/2020,116,27734,5069,343009,370743,8,2228,9,1836,0,313,79,15,6,0,1006,87,19153,1611,188656,207809,8/10/2020
8/1/2020,89,27823,3891,346900,374723,7,2235,2,1838,0,313,84,14,6,1,1007,77,19230,1322,189978,209208,8/10/2020
8/2/2020,77,27900,2659,349559,377459,11,2246,11,1849,1,314,83,14,7,2,1009,65,19295,1196,191174,210469,8/10/2020
8/3/2020,166,28066,4807,354366,382432,13,2259,12,1861,0,314,84,16,6,1,1010,145,19440,1903,193077,212517,8/10/2020
8/4/2020,117,28183,3403,357769,385952,7,2266,6,1867,1,315,84,12,4,2,1012,98,19538,1594,194671,214209,8/10/2020
8/5/2020,139,28322,5363,363132,391454,11,2277,9,1876,1,316,85,10,4,2,1014,110,19648,2050,196721,216369,8/10/2020
8/6/2020,154,28476,4634,367766,396242,5,2282,9,1885,0,316,81,9,3,0,1014,110,19758,1787,198508,218266,8/10/2020
8/7/2020,100,28576,4065,371831,400407,12,2294,10,1895,1,317,82,9,2,1,1015,74,19832,1625,200133,219965,8/10/2020
8/8/2020,98,28674,3241,375072,403746,17,2311,5,1900,1,318,93,8,2,0,1015,74,19906,1451,201584,221490,8/10/2020
8/9/2020,33,28707,1373,376445,405152,,,,,,,,,,0,1015,28,19934,829,202413,222347,8/10/2020
2/27/2020,0,0,0,0,0,1,1,0,0,0,0,1,0,0,0,0,0,0,0,0,0,8/11/2020
2/28/2020,0,0,0,0,0,0,1,0,0,0,0,1,1,0,0,0,0,0,0,0,0,8/11/2020
2/29/2020,0,0,0,0,0,0,1,0,0,0,0,1,1,0,0,0,0,0,0,0,0,8/11/2020
3/1/2020,2,2,2,2,4,0,1,0,0,0,0,1,1,1,0,0,2,2,2,2,4,8/11/2020
3/2/2020,0,2,1,3,5,1,2,0,0,0,0,2,2,2,0,0,0,2,1,3,5,8/11/2020
3/3/2020,0,2,2,5,7,0,2,0,0,0,0,2,2,2,0,0,0,2,2,5,7,8/11/2020
3/4/2020,0,2,12,17,19,1,3,0,0,0,0,3,2,2,0,0,0,2,10,15,17,8/11/2020
3/5/2020,0,2,4,21,23,0,3,0,0,0,0,3,2,2,0,0,1,3,4,19,22,8/11/2020
3/6/2020,1,3,12,33,36,0,3,0,0,0,0,3,2,2,0,0,0,3,11,30,33,8/11/2020
3/7/2020,0,3,19,52,55,0,3,0,0,0,0,3,2,1,0,0,0,3,19,49,52,8/11/2020
3/8/2020,0,3,18,70,73,0,3,0,0,0,0,3,2,1,0,0,0,3,18,67,70,8/11/2020
3/9/2020,1,4,15,85,89,0,3,0,0,0,0,3,2,1,0,0,1,4,15,82,86,8/11/2020
3/10/2020,2,6,25,110,116,0,3,0,0,0,0,3,2,1,0,0,1,5,23,105,110,8/11/2020
3/11/2020,0,6,34,144,150,1,4,0,0,0,0,4,1,1,0,0,0,5,34,139,144,8/11/2020
3/12/2020,9,15,42,186,201,1,5,0,0,0,0,5,1,1,0,0,8,13,38,177,190,8/11/2020
3/13/2020,6,21,50,236,257,4,9,1,1,0,0,8,1,1,0,0,6,19,48,225,244,8/11/2020
3/14/2020,0,21,90,326,347,0,9,0,1,0,0,8,1,1,0,0,0,19,86,311,330,8/11/2020
3/15/2020,1,22,54,380,402,1,10,0,1,0,0,9,2,1,0,0,1,20,54,365,385,8/11/2020
3/16/2020,2,24,95,475,499,2,12,0,1,0,0,11,2,0,0,0,2,22,92,457,479,8/11/2020
3/17/2020,16,40,162,637,677,6,18,0,1,0,0,17,2,0,0,0,11,33,152,609,642,8/11/2020
3/18/2020,12,52,116,753,805,3,21,0,1,0,0,20,2,0,0,0,11,44,111,720,764,8/11/2020
3/19/2020,17,69,262,1015,1084,2,23,1,2,0,0,21,3,0,1,1,17,61,251,971,1032,8/11/2020
3/20/2020,15,84,197,1212,1296,5,28,0,2,0,0,26,4,0,0,1,13,74,192,1163,1237,8/11/2020
3/21/2020,21,105,126,1338,1443,3,31,2,4,0,0,27,5,0,0,1,14,88,123,1286,1374,8/11/2020
3/22/2020,30,135,282,1620,1755,2,33,0,4,0,0,29,5,0,0,1,25,113,264,1550,1663,8/11/2020
3/23/2020,14,149,169,1789,1938,15,48,1,5,0,0,43,9,3,0,1,16,129,165,1715,1844,8/11/2020
3/24/2020,20,169,243,2032,2201,7,55,0,5,0,0,50,10,4,0,1,19,148,238,1953,2101,8/11/2020
3/25/2020,26,195,183,2215,2410,5,60,1,6,0,0,54,11,3,0,1,28,176,173,2126,2302,8/11/2020
3/26/2020,35,230,181,2396,2626,10,70,5,11,0,0,59,14,5,0,1,41,217,176,2302,2519,8/11/2020
3/27/2020,27,257,215,2611,2868,9,79,1,12,1,1,66,17,6,2,3,31,248,202,2504,2752,8/11/2020
3/28/2020,59,316,260,2871,3187,13,92,3,15,2,3,74,15,6,1,4,63,311,242,2746,3057,8/11/2020
3/29/2020,106,422,356,3227,3649,8,100,4,19,1,4,77,18,8,2,6,105,416,314,3060,3476,8/11/2020
3/30/2020,62,484,222,3449,3933,20,120,5,24,0,4,92,20,11,3,9,78,494,192,3252,3746,8/11/2020
3/31/2020,71,555,369,3818,4373,11,131,7,31,1,5,95,22,13,2,11,73,567,298,3550,4117,8/11/2020
4/1/2020,99,654,699,4517,5171,18,149,7,38,0,5,106,30,15,1,12,100,667,648,4198,4865,8/11/2020
4/2/2020,52,706,477,4994,5700,21,170,6,44,2,7,119,36,21,4,16,62,729,436,4634,5363,8/11/2020
4/3/2020,108,814,775,5769,6583,23,193,7,51,0,7,135,43,25,3,19,100,829,716,5350,6179,8/11/2020
4/4/2020,143,957,660,6429,7386,22,215,4,55,5,12,148,41,30,9,28,137,966,620,5970,6936,8/11/2020
4/5/2020,187,1144,1156,7585,8729,20,235,9,64,1,13,158,44,36,2,30,182,1148,1071,7041,8189,8/11/2020
4/6/2020,218,1362,1707,9292,10654,26,261,7,71,0,13,177,48,40,7,37,206,1354,1577,8618,9972,8/11/2020
4/7/2020,285,1647,1631,10923,12570,20,281,3,74,2,15,192,49,42,5,42,260,1614,1489,10107,11721,8/11/2020
4/8/2020,290,1937,1723,12646,14583,19,300,7,81,6,21,198,49,38,10,52,272,1886,1569,11676,13562,8/11/2020
4/9/2020,284,2221,1521,14167,16388,32,332,9,90,4,25,217,52,40,7,59,278,2164,1364,13040,15204,8/11/2020
4/10/2020,420,2641,2577,16744,19385,29,361,17,107,5,30,224,58,41,11,70,404,2568,2380,15420,17988,8/11/2020
4/11/2020,299,2940,1911,18655,21595,29,390,11,118,2,32,240,61,48,12,82,280,2848,1727,17147,19995,8/11/2020
4/12/2020,315,3255,1674,20329,23584,35,425,13,131,5,37,257,59,49,9,91,289,3137,1446,18593,21730,8/11/2020
4/13/2020,162,3417,938,21267,24684,35,460,13,144,3,40,276,64,54,9,100,187,3324,844,19437,22761,8/11/2020
4/14/2020,289,3706,1788,23055,26761,27,487,17,161,5,45,281,72,53,8,108,265,3589,1546,20983,24572,8/11/2020
4/15/2020,353,4059,1803,24858,28917,31,518,19,180,3,48,290,72,54,17,125,307,3896,1574,22557,26453,8/11/2020
4/16/2020,449,4508,2500,27358,31866,36,554,25,205,6,54,295,72,53,14,139,392,4288,2096,24653,28941,8/11/2020
4/17/2020,308,4816,1823,29181,33997,32,586,20,225,7,61,300,66,45,21,160,291,4579,1468,26121,30700,8/11/2020
4/18/2020,322,5138,1728,30909,36047,26,612,18,243,4,65,304,63,49,15,175,284,4863,1357,27478,32341,8/11/2020
4/19/2020,382,5520,2059,32968,38488,23,635,26,269,1,66,300,65,55,11,186,338,5201,1755,29233,34434,8/11/2020
4/20/2020,396,5916,1909,34877,40793,46,681,29,298,2,68,315,75,56,10,196,377,5578,1588,30821,36399,8/11/2020
4/21/2020,445,6361,2114,36991,43352,45,726,31,329,5,73,324,72,56,18,214,389,5967,1724,32545,38512,8/11/2020
4/22/2020,420,6781,2398,39389,46170,41,767,32,361,5,78,328,73,58,18,232,382,6349,1922,34467,40816,8/11/2020
4/23/2020,482,7263,2471,41860,49123,30,797,28,389,5,83,325,76,62,15,247,419,6768,1883,36350,43118,8/11/2020
4/24/2020,494,7757,3292,45152,52909,35,832,27,416,4,87,329,85,63,15,262,413,7181,2646,38996,46177,8/11/2020
4/25/2020,394,8151,2210,47362,55513,34,866,17,433,5,92,341,85,62,14,276,305,7486,1784,40780,48266,8/11/2020
4/26/2020,316,8467,2314,49676,58143,33,899,15,448,3,95,356,86,59,14,290,276,7762,1889,42669,50431,8/11/2020
4/27/2020,250,8717,1624,51300,60017,29,928,21,469,4,99,360,86,61,10,300,204,7966,1166,43835,51801,8/11/2020
4/28/2020,411,9128,2268,53568,62696,44,972,24,493,3,102,377,88,59,22,322,325,8291,1774,45609,53900,8/11/2020
4/29/2020,476,9604,3351,56919,66523,36,1008,37,530,11,113,365,78,53,18,340,372,8663,2453,48062,56725,8/11/2020
4/30/2020,432,10036,2772,59691,69727,32,1040,38,568,6,119,353,83,57,24,364,347,9010,1962,50024,59034,8/11/2020
5/1/2020,457,10493,3089,62780,73273,51,1091,39,607,3,122,362,84,58,14,378,317,9327,2222,52246,61573,8/11/2020
5/2/2020,260,10753,1927,64707,75460,35,1126,39,646,5,127,353,90,61,24,402,189,9516,1295,53541,63057,8/11/2020
5/3/2020,284,11037,2168,66875,77912,31,1157,27,673,8,135,349,89,61,21,423,181,9697,1609,55150,64847,8/11/2020
5/4/2020,388,11425,2101,68976,80401,30,1187,31,704,5,140,343,87,57,18,441,293,9990,1575,56725,66715,8/11/2020
5/5/2020,436,11861,2878,71854,83715,29,1216,32,736,6,146,334,81,54,16,457,304,10294,1975,58700,68994,8/11/2020
5/6/2020,490,12351,2836,74690,87041,28,1244,44,780,9,155,309,79,54,21,478,341,10635,1930,60630,71265,8/11/2020
5/7/2020,425,12776,2975,77665,90441,36,1280,40,820,5,160,300,71,52,21,499,269,10904,1989,62619,73523,8/11/2020
5/8/2020,360,13136,2603,80268,93404,30,1310,29,849,5,165,296,71,53,22,521,231,11135,1773,64392,75527,8/11/2020
5/9/2020,457,13593,3356,83624,97217,22,1332,21,870,4,169,293,69,51,15,536,285,11420,2311,66703,78123,8/11/2020
5/10/2020,280,13873,2122,85746,99619,19,1351,23,893,6,175,283,70,49,13,549,186,11606,1528,68231,79837,8/11/2020
5/11/2020,259,14132,1861,87607,101739,31,1382,16,909,6,181,292,71,49,15,564,176,11782,1313,69544,81326,8/11/2020
5/12/2020,387,14519,2622,90229,104748,23,1405,18,927,4,185,293,69,48,22,586,217,11999,1720,71264,83263,8/11/2020
5/13/2020,352,14871,3634,93863,108734,22,1427,24,951,1,186,290,69,49,13,599,196,12195,2028,73292,85487,8/11/2020
5/14/2020,330,15201,3415,97278,112479,19,1446,27,978,3,189,279,64,45,15,614,227,12422,2022,75314,87736,8/11/2020
5/15/2020,382,15583,3470,100748,116331,24,1470,41,1019,5,194,257,62,45,13,627,234,12656,1818,77132,89788,8/11/2020
5/16/2020,438,16021,4168,104916,120937,25,1495,12,1031,5,199,265,61,46,15,642,252,12908,1970,79102,92010,8/11/2020
5/17/2020,231,16252,2775,107691,123943,17,1512,7,1038,5,204,270,59,45,10,652,124,13032,1568,80670,93702,8/11/2020
5/18/2020,251,16503,2007,109698,126201,19,1531,15,1053,5,209,269,57,40,18,670,139,13171,1374,82044,95215,8/11/2020
5/19/2020,416,16919,3178,112876,129795,23,1554,32,1085,5,214,255,56,38,11,681,214,13385,1944,83988,97373,8/11/2020
5/20/2020,328,17247,2774,115650,132897,19,1573,23,1108,7,221,244,52,33,22,703,187,13572,1522,85510,99082,8/11/2020
5/21/2020,374,17621,3764,119414,137035,26,1599,15,1123,3,224,252,53,29,20,723,170,13742,1952,87462,101204,8/11/2020
5/22/2020,351,17972,3172,122586,140558,20,1619,29,1152,5,229,238,52,29,10,733,205,13947,1615,89077,103024,8/11/2020
5/23/2020,240,18212,2748,125334,143546,19,1638,11,1163,3,232,243,52,32,13,746,109,14056,1287,90364,104420,8/11/2020
5/24/2020,153,18365,1372,126706,145071,12,1650,14,1177,2,234,239,53,36,8,754,84,14140,774,91138,105278,8/11/2020
5/25/2020,134,18499,1389,128095,146594,12,1662,14,1191,0,234,237,53,34,10,764,70,14210,765,91903,106113,8/11/2020
5/26/2020,284,18783,2624,130719,149502,24,1686,22,1213,5,239,234,48,33,15,779,155,14365,1789,93692,108057,8/11/2020
5/27/2020,276,19059,2134,132853,151912,20,1706,17,1230,3,242,234,50,33,10,789,133,14498,1143,94835,109333,8/11/2020
5/28/2020,346,19405,3384,136237,155642,17,1723,29,1259,4,246,218,47,32,8,797,132,14630,1133,95968,110598,8/11/2020
5/29/2020,419,19824,3989,140226,160050,18,1741,27,1286,6,252,203,43,31,12,809,179,14809,1592,97560,112369,8/11/2020
5/30/2020,211,20035,3973,144199,164234,15,1756,19,1305,4,256,195,40,29,12,821,104,14913,1828,99388,114301,8/11/2020
5/31/2020,148,20183,1753,145952,166135,10,1766,10,1315,0,256,195,43,26,3,824,76,14989,855,100243,115232,8/11/2020
6/1/2020,216,20399,2813,148765,169164,7,1773,13,1328,1,257,188,44,29,5,829,99,15088,1377,101620,116708,8/11/2020
6/2/2020,273,20672,3080,151845,172517,8,1781,9,1337,3,260,184,37,25,10,839,107,15195,1468,103088,118283,8/11/2020
6/3/2020,259,20931,3510,155355,176286,13,1794,18,1355,6,266,173,34,25,11,850,105,15300,1672,104760,120060,8/11/2020
6/4/2020,281,21212,4522,159877,181089,7,1801,25,1380,3,269,152,31,24,11,861,114,15414,2041,106801,122215,8/11/2020
6/5/2020,215,21427,3584,163461,184888,15,1816,12,1392,5,274,150,27,21,9,870,104,15518,1580,108381,123899,8/11/2020
6/6/2020,198,21625,2622,166083,187708,10,1826,7,1399,2,276,151,29,19,6,876,68,15586,1134,109515,125101,8/11/2020
6/7/2020,77,21702,1614,167697,189399,11,1837,7,1406,1,277,154,25,17,4,880,49,15635,777,110292,125927,8/11/2020
6/8/2020,122,21824,1847,169544,191368,15,1852,12,1418,2,279,155,27,18,4,884,44,15679,965,111257,126936,8/11/2020
6/9/2020,225,22049,2675,172219,194268,10,1862,18,1436,0,279,147,28,21,1,885,67,15746,1263,112520,128266,8/11/2020
6/10/2020,210,22259,2983,175202,197461,13,1875,12,1448,2,281,146,24,17,3,888,104,15850,1458,113978,129828,8/11/2020
6/11/2020,195,22454,3499,178701,201155,7,1882,15,1463,1,282,137,25,16,6,894,88,15938,1529,115507,131445,8/11/2020
6/12/2020,213,22667,4605,183306,205973,8,1890,15,1478,1,283,129,24,16,2,896,80,16018,2188,117695,133713,8/11/2020
6/13/2020,111,22778,3028,186334,209112,6,1896,4,1482,0,283,131,20,15,3,899,50,16068,1368,119063,135131,8/11/2020
6/14/2020,78,22856,2037,188371,211227,6,1902,8,1490,1,284,128,20,14,3,902,32,16100,965,120028,136128,8/11/2020
6/15/2020,189,23045,3105,191476,214521,14,1916,14,1504,0,284,128,20,16,4,906,78,16178,1785,121813,137991,8/11/2020
6/16/2020,115,23160,3010,194486,217646,11,1927,10,1514,1,285,128,22,16,8,914,52,16230,1576,123389,139619,8/11/2020
6/17/2020,123,23283,2827,197313,220596,15,1942,20,1534,4,289,119,18,14,6,920,52,16282,1315,124704,140986,8/11/2020
6/18/2020,150,23433,3039,200352,223785,9,1951,13,1547,1,290,114,19,16,7,927,70,16352,1329,126033,142385,8/11/2020
6/19/2020,141,23574,3762,204114,227688,12,1963,11,1558,1,291,114,20,17,3,930,59,16411,1373,127406,143817,8/11/2020
6/20/2020,80,23654,1883,205997,229651,7,1970,9,1567,0,291,112,20,18,4,934,36,16447,811,128217,144664,8/11/2020
6/21/2020,36,23690,1042,207039,230729,7,1977,5,1572,0,291,114,20,18,2,936,27,16474,677,128894,145368,8/11/2020
6/22/2020,142,23832,3713,210752,234584,12,1989,16,1588,0,291,110,19,18,1,937,70,16544,1703,130597,147141,8/11/2020
6/23/2020,162,23994,3850,214602,238596,3,1992,13,1601,3,294,97,18,18,6,943,83,16627,1792,132389,149016,8/11/2020
6/24/2020,121,24115,3508,218110,242225,9,2001,10,1611,1,295,95,18,18,5,948,47,16674,1692,134081,150755,8/11/2020
6/25/2020,102,24217,2885,220995,245212,5,2006,14,1625,1,296,85,17,17,1,949,52,16726,1507,135588,152314,8/11/2020
6/26/2020,94,24311,2454,223449,247760,2,2008,9,1634,0,296,78,18,18,1,950,64,16790,1302,136890,153680,8/11/2020
6/27/2020,84,24395,3212,226661,251056,5,2013,3,1637,1,297,79,17,17,5,955,37,16827,1213,138103,154930,8/11/2020
6/28/2020,37,24432,1452,228113,252545,4,2017,4,1641,4,301,75,15,14,6,961,18,16845,586,138689,155534,8/11/2020
6/29/2020,86,24518,3674,231787,256305,4,2021,5,1646,0,301,74,14,14,1,962,38,16883,1344,140033,156916,8/11/2020
6/30/2020,60,24578,1945,233732,258310,1,2022,5,1651,1,302,69,12,11,3,965,35,16918,993,141026,157944,8/11/2020
7/1/2020,145,24723,4106,237838,262561,7,2029,9,1660,0,302,67,11,11,1,966,81,16999,1951,142977,159976,8/11/2020
7/2/2020,101,24824,2778,240616,265440,5,2034,5,1665,1,303,66,9,9,1,967,56,17055,1075,144052,161107,8/11/2020
7/3/2020,47,24871,2014,242630,267501,7,2041,6,1671,0,303,67,8,8,3,970,25,17080,771,144823,161903,8/11/2020
7/4/2020,57,24928,2320,244950,269878,2,2043,4,1675,1,304,64,9,8,2,972,34,17114,990,145813,162927,8/11/2020
7/5/2020,47,24975,2924,247874,272849,1,2044,2,1677,1,305,62,7,7,2,974,23,17137,1442,147255,164392,8/11/2020
7/6/2020,103,25078,2790,250664,275742,6,2050,6,1683,0,305,62,8,9,4,978,60,17197,1542,148797,165994,8/11/2020
7/7/2020,80,25158,3438,254102,279260,5,2055,6,1689,0,305,61,7,8,1,979,47,17244,1531,150328,167572,8/11/2020
7/8/2020,104,25262,3381,257483,282745,4,2059,2,1691,0,305,63,8,8,0,979,66,17310,1417,151745,169055,8/11/2020
7/9/2020,94,25356,3658,261141,286497,7,2066,2,1693,0,305,68,8,8,0,979,50,17360,1594,153339,170699,8/11/2020
7/10/2020,129,25485,4391,265532,291017,5,2071,3,1696,2,307,68,7,7,3,982,79,17439,2079,155418,172857,8/11/2020
7/11/2020,63,25548,2881,268413,293961,6,2077,3,1699,1,308,70,6,6,3,985,34,17473,1278,156696,174169,8/11/2020
7/12/2020,45,25593,1764,270177,295770,1,2078,2,1701,1,309,68,6,5,3,988,33,17506,885,157581,175087,8/11/2020
7/13/2020,85,25678,3142,273319,298997,7,2085,10,1711,0,309,65,6,5,1,989,57,17563,1469,159050,176613,8/11/2020
7/14/2020,75,25753,3246,276565,302318,7,2092,4,1715,0,309,68,5,5,1,990,50,17613,1347,160397,178010,8/11/2020
7/15/2020,123,25876,4118,280683,306559,5,2097,6,1721,0,309,67,5,4,0,990,94,17707,1724,162121,179828,8/11/2020
7/16/2020,102,25978,3685,284368,310346,6,2103,8,1729,0,309,65,6,5,1,991,78,17785,1590,163711,181496,8/11/2020
7/17/2020,151,26129,4116,288484,314613,14,2117,3,1732,1,310,75,5,5,1,992,78,17863,1794,165505,183368,8/11/2020
7/18/2020,80,26209,3141,291625,317834,5,2122,9,1741,1,311,70,5,4,4,996,67,17930,1326,166831,184761,8/11/2020
7/19/2020,82,26291,2577,294202,320493,6,2128,3,1744,0,311,73,6,4,2,998,58,17988,1070,167901,185889,8/11/2020
7/20/2020,72,26363,2592,296794,323157,9,2137,7,1751,0,311,75,7,5,2,1000,63,18051,1443,169344,187395,8/11/2020
7/21/2020,128,26491,4212,301006,327497,9,2146,10,1761,0,311,74,9,6,1,1001,104,18155,1869,171213,189368,8/11/2020
7/22/2020,123,26614,3784,304790,331404,11,2157,11,1772,1,312,73,7,6,1,1002,87,18242,1578,172791,191033,8/11/2020
7/23/2020,123,26737,4055,308845,335582,7,2164,5,1777,0,312,75,8,7,0,1002,105,18347,1752,174543,192890,8/11/2020
7/24/2020,161,26898,5673,314518,341416,13,2177,13,1790,0,312,75,9,7,0,1002,118,18465,2143,176686,195151,8/11/2020
7/25/2020,126,27024,4258,318776,345800,7,2184,7,1797,0,312,75,10,8,1,1003,104,18569,1999,178685,197254,8/11/2020
7/26/2020,56,27080,2957,321733,348813,7,2191,8,1805,0,312,74,11,6,1,1004,53,18622,1295,179980,198602,8/11/2020
7/27/2020,182,27262,3872,325605,352867,12,2203,7,1812,0,312,79,13,7,1,1005,137,18759,2110,182090,200849,8/11/2020
7/28/2020,101,27363,3636,329241,356604,5,2208,3,1815,0,312,81,14,6,1,1006,89,18848,1500,183590,202438,8/11/2020
7/29/2020,159,27522,4751,333992,361514,10,2218,12,1827,0,312,79,15,6,0,1006,143,18991,2074,185664,204655,8/11/2020
7/30/2020,96,27618,3948,337940,365558,5,2223,2,1829,1,313,81,15,5,0,1006,74,19065,1352,187016,206081,8/11/2020
7/31/2020,116,27734,5068,343008,370742,8,2231,9,1838,0,313,80,15,6,0,1006,87,19152,1611,188627,207779,8/11/2020
8/1/2020,89,27823,3891,346899,374722,7,2238,2,1840,0,313,85,14,6,1,1007,77,19229,1321,189948,209177,8/11/2020
8/2/2020,77,27900,2659,349558,377458,11,2249,11,1851,1,314,84,14,7,2,1009,65,19294,1195,191143,210437,8/11/2020
8/3/2020,166,28066,4807,354365,382431,13,2262,12,1863,0,314,85,16,6,1,1010,146,19440,1903,193046,212486,8/11/2020
8/4/2020,117,28183,3403,357768,385951,7,2269,6,1869,1,315,85,12,4,2,1012,99,19539,1594,194640,214179,8/11/2020
8/5/2020,139,28322,5363,363131,391453,11,2280,9,1878,1,316,86,10,4,2,1014,110,19649,2049,196689,216338,8/11/2020
8/6/2020,154,28476,4634,367765,396241,5,2285,9,1887,0,316,82,9,3,0,1014,110,19759,1787,198476,218235,8/11/2020
8/7/2020,101,28577,4135,371900,400477,12,2297,10,1897,1,317,83,9,2,1,1015,80,19839,1661,200137,219976,8/11/2020
8/8/2020,100,28677,3280,375180,403857,17,2314,5,1902,1,318,94,8,2,0,1015,86,19925,1474,201611,221536,8/11/2020
8/9/2020,35,28712,1523,376703,405415,3,2317,9,1911,0,318,88,9,2,0,1015,29,19954,942,202553,222507,8/11/2020
8/10/2020,124,28836,3896,380599,409435,,,,,,,,,,1,1016,99,20053,1564,204117,224170,8/11/2020
2/27/2020,0,0,0,0,0,1,1,0,0,0,0,1,0,0,0,0,0,0,0,0,0,8/12/2020
2/28/2020,0,0,0,0,0,0,1,0,0,0,0,1,1,0,0,0,0,0,0,0,0,8/12/2020
2/29/2020,0,0,0,0,0,0,1,0,0,0,0,1,1,0,0,0,0,0,0,0,0,8/12/2020
3/1/2020,2,2,2,2,4,0,1,0,0,0,0,1,1,1,0,0,2,2,2,2,4,8/12/2020
3/2/2020,0,2,1,3,5,1,2,0,0,0,0,2,2,2,0,0,0,2,1,3,5,8/12/2020
3/3/2020,0,2,2,5,7,0,2,0,0,0,0,2,2,2,0,0,0,2,2,5,7,8/12/2020
3/4/2020,0,2,12,17,19,1,3,0,0,0,0,3,2,2,0,0,0,2,10,15,17,8/12/2020
3/5/2020,0,2,4,21,23,0,3,0,0,0,0,3,2,2,0,0,1,3,4,19,22,8/12/2020
3/6/2020,1,3,12,33,36,0,3,0,0,0,0,3,2,2,0,0,0,3,11,30,33,8/12/2020
3/7/2020,0,3,19,52,55,0,3,0,0,0,0,3,2,1,0,0,0,3,19,49,52,8/12/2020
3/8/2020,0,3,18,70,73,0,3,0,0,0,0,3,2,1,0,0,0,3,18,67,70,8/12/2020
3/9/2020,1,4,15,85,89,0,3,0,0,0,0,3,2,1,0,0,1,4,15,82,86,8/12/2020
3/10/2020,2,6,25,110,116,0,3,0,0,0,0,3,2,1,0,0,1,5,23,105,110,8/12/2020
3/11/2020,0,6,34,144,150,1,4,0,0,0,0,4,1,1,0,0,0,5,34,139,144,8/12/2020
3/12/2020,9,15,42,186,201,1,5,0,0,0,0,5,1,1,0,0,8,13,38,177,190,8/12/2020
3/13/2020,6,21,50,236,257,4,9,1,1,0,0,8,1,1,0,0,6,19,48,225,244,8/12/2020
3/14/2020,0,21,90,326,347,0,9,0,1,0,0,8,1,1,0,0,0,19,86,311,330,8/12/2020
3/15/2020,1,22,54,380,402,1,10,0,1,0,0,9,2,1,0,0,1,20,54,365,385,8/12/2020
3/16/2020,2,24,95,475,499,2,12,0,1,0,0,11,2,0,0,0,2,22,92,457,479,8/12/2020
3/17/2020,12,36,162,637,673,6,18,0,1,0,0,17,2,0,0,0,11,33,152,609,642,8/12/2020
3/18/2020,9,45,116,753,798,3,21,0,1,0,0,20,2,0,0,0,11,44,111,720,764,8/12/2020
3/19/2020,15,60,262,1015,1075,2,23,1,2,0,0,21,3,0,1,1,17,61,251,971,1032,8/12/2020
3/20/2020,14,74,197,1212,1286,5,28,0,2,0,0,26,4,0,0,1,13,74,192,1163,1237,8/12/2020
3/21/2020,12,86,126,1338,1424,3,31,2,4,0,0,27,5,0,0,1,14,88,123,1286,1374,8/12/2020
3/22/2020,27,113,282,1620,1733,2,33,0,4,0,0,29,5,0,0,1,25,113,264,1550,1663,8/12/2020
3/23/2020,14,127,169,1789,1916,15,48,1,5,0,0,43,9,3,0,1,16,129,165,1715,1844,8/12/2020
3/24/2020,20,147,243,2032,2179,7,55,0,5,0,0,50,10,4,0,1,19,148,238,1953,2101,8/12/2020
3/25/2020,26,173,182,2214,2387,5,60,1,6,0,0,54,11,3,0,1,28,176,173,2126,2302,8/12/2020
3/26/2020,35,208,181,2395,2603,10,70,5,11,0,0,59,14,5,0,1,41,217,176,2302,2519,8/12/2020
3/27/2020,27,235,214,2609,2844,9,79,1,12,1,1,66,17,6,2,3,31,248,202,2504,2752,8/12/2020
3/28/2020,59,294,260,2869,3163,13,92,3,15,2,3,74,15,6,1,4,63,311,242,2746,3057,8/12/2020
3/29/2020,100,394,350,3219,3613,8,100,4,19,1,4,77,18,8,2,6,105,416,314,3060,3476,8/12/2020
3/30/2020,62,456,222,3441,3897,20,120,5,24,0,4,92,20,11,3,9,78,494,192,3252,3746,8/12/2020
3/31/2020,71,527,369,3810,4337,11,131,7,31,1,5,95,22,13,2,11,73,567,298,3550,4117,8/12/2020
4/1/2020,99,626,698,4508,5134,18,149,7,38,0,5,106,30,15,1,12,100,667,648,4198,4865,8/12/2020
4/2/2020,52,678,477,4985,5663,21,170,6,44,2,7,119,36,21,4,16,62,729,436,4634,5363,8/12/2020
4/3/2020,108,786,774,5759,6545,23,193,7,51,0,7,135,43,25,3,19,100,829,716,5350,6179,8/12/2020
4/4/2020,143,929,660,6419,7348,22,215,4,55,5,12,148,41,30,9,28,137,966,620,5970,6936,8/12/2020
4/5/2020,187,1116,1156,7575,8691,20,235,9,64,1,13,158,44,36,2,30,182,1148,1071,7041,8189,8/12/2020
4/6/2020,218,1334,1706,9281,10615,26,261,7,71,0,13,177,48,40,7,37,206,1354,1576,8617,9971,8/12/2020
4/7/2020,284,1618,1629,10910,12528,20,281,4,75,2,15,191,49,42,5,42,260,1614,1489,10106,11720,8/12/2020
4/8/2020,290,1908,1720,12630,14538,19,300,7,82,6,21,197,49,38,10,52,272,1886,1568,11674,13560,8/12/2020
4/9/2020,283,2191,1516,14146,16337,32,332,9,91,4,25,216,52,40,7,59,278,2164,1364,13038,15202,8/12/2020
4/10/2020,419,2610,2574,16720,19330,29,361,16,107,5,30,224,58,41,11,70,404,2568,2380,15418,17986,8/12/2020
4/11/2020,297,2907,1905,18625,21532,29,390,11,118,2,32,240,61,48,12,82,280,2848,1727,17145,19993,8/12/2020
4/12/2020,314,3221,1670,20295,23516,35,425,13,131,5,37,257,59,49,9,91,289,3137,1444,18589,21726,8/12/2020
4/13/2020,161,3382,935,21230,24612,35,460,13,144,3,40,276,64,54,9,100,187,3324,844,19433,22757,8/12/2020
4/14/2020,289,3671,1787,23017,26688,27,487,17,161,5,45,281,72,53,8,108,265,3589,1545,20978,24567,8/12/2020
4/15/2020,351,4022,1799,24816,28838,31,518,19,180,3,48,290,72,54,17,125,307,3896,1574,22552,26448,8/12/2020
4/16/2020,447,4469,2494,27310,31779,36,554,25,205,6,54,295,72,53,14,139,392,4288,2096,24648,28936,8/12/2020
4/17/2020,304,4773,1821,29131,33904,32,586,20,225,7,61,300,66,45,21,160,291,4579,1468,26116,30695,8/12/2020
4/18/2020,321,5094,1725,30856,35950,26,612,18,243,4,65,304,63,49,15,175,284,4863,1357,27473,32336,8/12/2020
4/19/2020,381,5475,2047,32903,38378,23,635,26,269,1,66,300,65,55,11,186,338,5201,1755,29228,34429,8/12/2020
4/20/2020,394,5869,1907,34810,40679,46,681,29,298,2,68,315,75,56,10,196,377,5578,1588,30816,36394,8/12/2020
4/21/2020,444,6313,2110,36920,43233,45,726,31,329,5,73,324,72,56,18,214,389,5967,1724,32540,38507,8/12/2020
4/22/2020,418,6731,2390,39310,46041,41,767,32,361,5,78,328,73,58,18,232,382,6349,1922,34462,40811,8/12/2020
4/23/2020,480,7211,2469,41779,48990,30,797,28,389,5,83,325,76,62,15,247,419,6768,1881,36343,43111,8/12/2020
4/24/2020,491,7702,3284,45063,52765,35,832,27,416,4,87,329,85,63,15,262,413,7181,2645,38988,46169,8/12/2020
4/25/2020,393,8095,2206,47269,55364,34,866,17,433,5,92,341,85,62,14,276,305,7486,1783,40771,48257,8/12/2020
4/26/2020,316,8411,2309,49578,57989,33,899,15,448,3,95,356,86,59,14,290,276,7762,1889,42660,50422,8/12/2020
4/27/2020,249,8660,1620,51198,59858,29,928,21,469,4,99,360,86,61,10,300,204,7966,1166,43826,51792,8/12/2020
4/28/2020,410,9070,2263,53461,62531,44,972,24,493,3,102,377,88,59,22,322,325,8291,1774,45600,53891,8/12/2020
4/29/2020,476,9546,3343,56804,66350,36,1008,37,530,11,113,365,78,53,18,340,372,8663,2450,48050,56713,8/12/2020
4/30/2020,432,9978,2769,59573,69551,33,1041,38,568,6,119,354,83,57,24,364,347,9010,1962,50012,59022,8/12/2020
5/1/2020,454,10432,3086,62659,73091,51,1092,39,607,3,122,363,84,58,14,378,317,9327,2222,52234,61561,8/12/2020
5/2/2020,257,10689,1926,64585,75274,36,1128,39,646,5,127,355,91,62,24,402,189,9516,1295,53529,63045,8/12/2020
5/3/2020,283,10972,2160,66745,77717,31,1159,27,673,8,135,351,90,61,21,423,181,9697,1609,55138,64835,8/12/2020
5/4/2020,387,11359,2098,68843,80202,30,1189,31,704,5,140,345,88,57,18,441,293,9990,1574,56712,66702,8/12/2020
5/5/2020,433,11792,2873,71716,83508,29,1218,32,736,6,146,336,82,54,16,457,304,10294,1975,58687,68981,8/12/2020
5/6/2020,488,12280,2829,74545,86825,28,1246,44,780,9,155,311,79,54,21,478,341,10635,1930,60617,71252,8/12/2020
5/7/2020,425,12705,2969,77514,90219,36,1282,42,822,5,160,300,71,52,21,499,269,10904,1989,62606,73510,8/12/2020
5/8/2020,359,13064,2598,80112,93176,30,1312,29,851,5,165,296,71,53,22,521,231,11135,1773,64379,75514,8/12/2020
5/9/2020,454,13518,3346,83458,96976,22,1334,21,872,4,169,293,69,51,15,536,285,11420,2311,66690,78110,8/12/2020
5/10/2020,280,13798,2117,85575,99373,19,1353,23,895,6,175,283,70,49,13,549,186,11606,1528,68218,79824,8/12/2020
5/11/2020,257,14055,1857,87432,101487,31,1384,16,911,6,181,292,71,49,15,564,176,11782,1313,69531,81313,8/12/2020
5/12/2020,387,14442,2611,90043,104485,23,1407,18,929,4,185,293,69,48,22,586,217,11999,1719,71250,83249,8/12/2020
5/13/2020,351,14793,3630,93673,108466,22,1429,24,953,1,186,290,69,49,13,599,196,12195,2025,73275,85470,8/12/2020
5/14/2020,329,15122,3408,97081,112203,19,1448,27,980,3,189,279,64,45,15,614,227,12422,2022,75297,87719,8/12/2020
5/15/2020,381,15503,3458,100539,116042,24,1472,41,1021,5,194,257,62,45,13,627,234,12656,1818,77115,89771,8/12/2020
5/16/2020,434,15937,4156,104695,120632,25,1497,12,1033,5,199,265,61,46,15,642,252,12908,1970,79085,91993,8/12/2020
5/17/2020,231,16168,2768,107463,123631,17,1514,7,1040,5,204,270,59,45,10,652,124,13032,1568,80653,93685,8/12/2020
5/18/2020,250,16418,2001,109464,125882,19,1533,15,1055,5,209,269,57,40,18,670,139,13171,1374,82027,95198,8/12/2020
5/19/2020,415,16833,3168,112632,129465,23,1556,32,1087,5,214,255,56,38,11,681,214,13385,1944,83971,97356,8/12/2020
5/20/2020,326,17159,2770,115402,132561,19,1575,23,1110,7,221,244,52,33,22,703,187,13572,1522,85493,99065,8/12/2020
5/21/2020,374,17533,3757,119159,136692,26,1601,15,1125,3,224,252,53,29,20,723,170,13742,1951,87444,101186,8/12/2020
5/22/2020,349,17882,3161,122320,140202,20,1621,29,1154,5,229,238,52,29,10,733,205,13947,1615,89059,103006,8/12/2020
5/23/2020,240,18122,2742,125062,143184,19,1640,11,1165,3,232,243,52,32,13,746,109,14056,1286,90345,104401,8/12/2020
5/24/2020,151,18273,1370,126432,144705,12,1652,14,1179,2,234,239,53,36,8,754,84,14140,774,91119,105259,8/12/2020
5/25/2020,134,18407,1385,127817,146224,12,1664,14,1193,0,234,237,53,34,10,764,70,14210,765,91884,106094,8/12/2020
5/26/2020,284,18691,2620,130437,149128,24,1688,22,1215,5,239,234,48,33,15,779,155,14365,1787,93671,108036,8/12/2020
5/27/2020,276,18967,2065,132502,151469,20,1708,17,1232,3,242,234,50,33,10,789,133,14498,1143,94814,109312,8/12/2020
5/28/2020,345,19312,3371,135873,155185,17,1725,29,1261,4,246,218,47,32,8,797,132,14630,1133,95947,110577,8/12/2020
5/29/2020,412,19724,3928,139801,159525,18,1743,27,1288,6,252,203,43,31,12,809,179,14809,1592,97539,112348,8/12/2020
5/30/2020,208,19932,3915,143716,163648,15,1758,19,1307,4,256,195,40,29,12,821,104,14913,1828,99367,114280,8/12/2020
5/31/2020,144,20076,1682,145398,165474,10,1768,10,1317,0,256,195,43,26,3,824,76,14989,855,100222,115211,8/12/2020
6/1/2020,213,20289,2781,148179,168468,7,1775,13,1330,1,257,188,44,29,5,829,98,15087,1377,101599,116686,8/12/2020
6/2/2020,273,20562,3025,151204,171766,8,1783,9,1339,3,260,184,37,25,10,839,107,15194,1468,103067,118261,8/12/2020
6/3/2020,253,20815,3482,154686,175501,13,1796,18,1357,6,266,173,34,25,11,850,105,15299,1672,104739,120038,8/12/2020
6/4/2020,276,21091,4458,159144,180235,7,1803,25,1382,3,269,152,31,24,11,861,114,15413,2041,106780,122193,8/12/2020
6/5/2020,214,21305,3513,162657,183962,15,1818,12,1394,5,274,150,27,21,9,870,104,15517,1580,108360,123877,8/12/2020
6/6/2020,196,21501,2608,165265,186766,10,1828,7,1401,2,276,151,29,19,6,876,68,15585,1134,109494,125079,8/12/2020
6/7/2020,77,21578,1610,166875,188453,11,1839,7,1408,1,277,154,25,17,4,880,49,15634,777,110271,125905,8/12/2020
6/8/2020,121,21699,1845,168720,190419,15,1854,12,1420,2,279,155,27,18,4,884,44,15678,965,111236,126914,8/12/2020
6/9/2020,225,21924,2665,171385,193309,10,1864,18,1438,0,279,147,28,21,1,885,67,15745,1262,112498,128243,8/12/2020
6/10/2020,209,22133,2970,174355,196488,13,1877,12,1450,2,281,146,24,17,3,888,104,15849,1458,113956,129805,8/12/2020
6/11/2020,195,22328,3492,177847,200175,7,1884,15,1465,1,282,137,25,16,6,894,88,15937,1529,115485,131422,8/12/2020
6/12/2020,213,22541,4592,182439,204980,8,1892,15,1480,1,283,129,24,16,2,896,80,16017,2188,117673,133690,8/12/2020
6/13/2020,110,22651,3020,185459,208110,6,1898,4,1484,0,283,131,20,15,3,899,50,16067,1368,119041,135108,8/12/2020
6/14/2020,77,22728,2033,187492,210220,6,1904,8,1492,1,284,128,20,14,3,902,32,16099,965,120006,136105,8/12/2020
6/15/2020,188,22916,3096,190588,213504,14,1918,14,1506,0,284,128,20,16,4,906,78,16177,1785,121791,137968,8/12/2020
6/16/2020,114,23030,3004,193592,216622,11,1929,10,1516,1,285,128,22,16,8,914,52,16229,1576,123367,139596,8/12/2020
6/17/2020,122,23152,2819,196411,219563,15,1944,20,1536,4,289,119,18,14,6,920,52,16281,1315,124682,140963,8/12/2020
6/18/2020,150,23302,3030,199441,222743,9,1953,13,1549,1,290,114,19,16,7,927,70,16351,1329,126011,142362,8/12/2020
6/19/2020,141,23443,3758,203199,226642,12,1965,11,1560,1,291,114,20,17,3,930,59,16410,1373,127384,143794,8/12/2020
6/20/2020,80,23523,1878,205077,228600,8,1973,10,1570,0,291,112,20,18,4,934,36,16446,811,128195,144641,8/12/2020
6/21/2020,36,23559,1036,206113,229672,7,1980,5,1575,0,291,114,20,18,2,936,27,16473,677,128872,145345,8/12/2020
6/22/2020,142,23701,3704,209817,233518,12,1992,16,1591,0,291,110,19,18,1,937,70,16543,1703,130575,147118,8/12/2020
6/23/2020,162,23863,3826,213643,237506,3,1995,13,1604,3,294,97,18,18,6,943,83,16626,1792,132367,148993,8/12/2020
6/24/2020,121,23984,3493,217136,241120,9,2004,10,1614,1,295,95,18,18,5,948,47,16673,1692,134059,150732,8/12/2020
6/25/2020,102,24086,2869,220005,244091,5,2009,14,1628,1,296,85,17,17,1,949,52,16725,1507,135566,152291,8/12/2020
6/26/2020,94,24180,2443,222448,246628,2,2011,9,1637,0,296,78,18,18,1,950,64,16789,1301,136867,153656,8/12/2020
6/27/2020,84,24264,3200,225648,249912,5,2016,3,1640,1,297,79,17,17,5,955,37,16826,1213,138080,154906,8/12/2020
6/28/2020,36,24300,1450,227098,251398,4,2020,4,1644,4,301,75,15,14,6,961,18,16844,586,138666,155510,8/12/2020
6/29/2020,86,24386,3670,230768,255154,4,2024,5,1649,0,301,74,14,14,1,962,39,16883,1343,140009,156892,8/12/2020
6/30/2020,60,24446,1937,232705,257151,1,2025,5,1654,1,302,69,12,11,3,965,35,16918,993,141002,157920,8/12/2020
7/1/2020,144,24590,4094,236799,261389,7,2032,9,1663,0,302,67,11,11,1,966,81,16999,1950,142952,159951,8/12/2020
7/2/2020,101,24691,2775,239574,264265,5,2037,5,1668,1,303,66,9,9,1,967,56,17055,1075,144027,161082,8/12/2020
7/3/2020,47,24738,2010,241584,266322,7,2044,6,1674,0,303,67,8,8,3,970,25,17080,771,144798,161878,8/12/2020
7/4/2020,57,24795,2317,243901,268696,2,2046,4,1678,1,304,64,9,8,2,972,34,17114,990,145788,162902,8/12/2020
7/5/2020,45,24840,2917,246818,271658,1,2047,2,1680,1,305,62,7,7,2,974,23,17137,1442,147230,164367,8/12/2020
7/6/2020,103,24943,2784,249602,274545,6,2053,6,1686,0,305,62,8,9,4,978,60,17197,1542,148772,165969,8/12/2020
7/7/2020,80,25023,3433,253035,278058,5,2058,6,1692,0,305,61,7,8,1,979,47,17244,1530,150302,167546,8/12/2020
7/8/2020,104,25127,3373,256408,281535,4,2062,2,1694,0,305,63,8,8,0,979,66,17310,1417,151719,169029,8/12/2020
7/9/2020,93,25220,3654,260062,285282,8,2070,2,1696,0,305,69,8,8,0,979,50,17360,1594,153313,170673,8/12/2020
7/10/2020,129,25349,4378,264440,289789,5,2075,3,1699,2,307,69,7,7,3,982,79,17439,2079,155392,172831,8/12/2020
7/11/2020,62,25411,2872,267312,292723,6,2081,3,1702,1,308,71,6,6,3,985,34,17473,1278,156670,174143,8/12/2020
7/12/2020,45,25456,1759,269071,294527,1,2082,2,1704,1,309,69,6,5,3,988,33,17506,885,157555,175061,8/12/2020
7/13/2020,85,25541,3137,272208,297749,7,2089,10,1714,0,309,66,6,5,1,989,57,17563,1469,159024,176587,8/12/2020
7/14/2020,74,25615,3239,275447,301062,7,2096,4,1718,0,309,69,5,5,1,990,50,17613,1347,160371,177984,8/12/2020
7/15/2020,123,25738,4109,279556,305294,5,2101,6,1724,0,309,68,5,4,0,990,94,17707,1724,162095,179802,8/12/2020
7/16/2020,102,25840,3672,283228,309068,6,2107,8,1732,0,309,66,6,5,1,991,78,17785,1590,163685,181470,8/12/2020
7/17/2020,150,25990,4109,287337,313327,14,2121,3,1735,1,310,76,5,5,1,992,78,17863,1794,165479,183342,8/12/2020
7/18/2020,80,26070,3133,290470,316540,5,2126,9,1744,1,311,71,5,4,4,996,67,17930,1326,166805,184735,8/12/2020
7/19/2020,81,26151,2566,293036,319187,6,2132,3,1747,0,311,74,6,4,2,998,58,17988,1070,167875,185863,8/12/2020
7/20/2020,72,26223,2590,295626,321849,9,2141,7,1754,0,311,76,7,5,2,1000,63,18051,1443,169318,187369,8/12/2020
7/21/2020,127,26350,4201,299827,326177,9,2150,10,1764,0,311,75,9,6,1,1001,104,18155,1869,171187,189342,8/12/2020
7/22/2020,123,26473,3772,303599,330072,11,2161,11,1775,1,312,74,7,6,1,1002,86,18241,1578,172765,191006,8/12/2020
7/23/2020,123,26596,4043,307642,334238,8,2169,5,1780,0,312,77,8,7,0,1002,105,18346,1752,174517,192863,8/12/2020
7/24/2020,160,26756,5665,313307,340063,13,2182,14,1794,0,312,76,9,7,0,1002,118,18464,2143,176660,195124,8/12/2020
7/25/2020,125,26881,4246,317553,344434,7,2189,7,1801,0,312,76,10,8,1,1003,104,18568,1999,178659,197227,8/12/2020
7/26/2020,56,26937,2945,320498,347435,7,2196,8,1809,0,312,75,11,6,1,1004,53,18621,1295,179954,198575,8/12/2020
7/27/2020,182,27119,3855,324353,351472,12,2208,7,1816,0,312,80,13,7,1,1005,137,18758,2110,182064,200822,8/12/2020
7/28/2020,101,27220,3623,327976,355196,5,2213,4,1820,0,312,81,14,6,1,1006,89,18847,1500,183564,202411,8/12/2020
7/29/2020,159,27379,4740,332716,360095,10,2223,12,1832,0,312,79,15,6,0,1006,143,18990,2074,185638,204628,8/12/2020
7/30/2020,96,27475,3935,336651,364126,5,2228,2,1834,1,313,81,15,5,0,1006,74,19064,1352,186990,206054,8/12/2020
7/31/2020,115,27590,5061,341712,369302,8,2236,9,1843,0,313,80,15,6,0,1006,85,19149,1611,188601,207750,8/12/2020
8/1/2020,88,27678,3886,345598,373276,7,2243,2,1845,0,313,85,14,6,1,1007,77,19226,1321,189922,209148,8/12/2020
8/2/2020,77,27755,2656,348254,376009,11,2254,11,1856,1,314,84,14,7,2,1009,65,19291,1195,191117,210408,8/12/2020
8/3/2020,166,27921,4798,353052,380973,13,2267,12,1868,0,314,85,16,6,1,1010,146,19437,1903,193020,212457,8/12/2020
8/4/2020,117,28038,3397,356449,384487,7,2274,6,1874,1,315,85,12,4,2,1012,99,19536,1594,194614,214150,8/12/2020
8/5/2020,138,28176,5344,361793,389969,11,2285,9,1883,1,316,86,10,4,2,1014,110,19646,2049,196663,216309,8/12/2020
8/6/2020,154,28330,4626,366419,394749,5,2290,9,1892,0,316,82,9,3,0,1014,110,19756,1787,198450,218206,8/12/2020
8/7/2020,101,28431,4126,370545,398976,12,2302,10,1902,1,317,83,9,2,1,1015,81,19837,1662,200112,219949,8/12/2020
8/8/2020,102,28533,3289,373834,402367,19,2321,6,1908,1,318,95,8,2,1,1016,89,19926,1492,201604,221530,8/12/2020
8/9/2020,35,28568,1520,375354,403922,6,2327,11,1919,0,318,90,9,3,0,1016,30,19956,945,202549,222505,8/12/2020
8/10/2020,127,28695,3994,379348,408043,9,2336,10,1929,0,318,89,9,3,1,1017,99,20055,1633,204182,224237,8/12/2020
8/11/2020,81,28776,3603,382951,411727,,,,,,,,,,1,1018,74,20129,1822,206004,226133,8/12/2020
2/27/2020,0,0,0,0,0,1,1,0,0,0,0,1,0,0,0,0,0,0,0,0,0,8/13/2020
2/28/2020,0,0,0,0,0,0,1,0,0,0,0,1,1,0,0,0,0,0,0,0,0,8/13/2020
2/29/2020,0,0,0,0,0,0,1,0,0,0,0,1,1,0,0,0,0,0,0,0,0,8/13/2020
3/1/2020,2,2,2,2,4,0,1,0,0,0,0,1,1,1,0,0,2,2,2,2,4,8/13/2020
3/2/2020,0,2,1,3,5,1,2,0,0,0,0,2,2,2,0,0,0,2,1,3,5,8/13/2020
3/3/2020,0,2,2,5,7,0,2,0,0,0,0,2,2,2,0,0,0,2,2,5,7,8/13/2020
3/4/2020,0,2,12,17,19,1,3,0,0,0,0,3,2,2,0,0,0,2,10,15,17,8/13/2020
3/5/2020,0,2,4,21,23,0,3,0,0,0,0,3,2,2,0,0,1,3,4,19,22,8/13/2020
3/6/2020,1,3,12,33,36,0,3,0,0,0,0,3,2,2,0,0,0,3,11,30,33,8/13/2020
3/7/2020,0,3,19,52,55,0,3,0,0,0,0,3,2,1,0,0,0,3,19,49,52,8/13/2020
3/8/2020,0,3,18,70,73,0,3,0,0,0,0,3,2,1,0,0,0,3,18,67,70,8/13/2020
3/9/2020,1,4,15,85,89,0,3,0,0,0,0,3,2,1,0,0,1,4,15,82,86,8/13/2020
3/10/2020,2,6,25,110,116,0,3,0,0,0,0,3,2,1,0,0,1,5,23,105,110,8/13/2020
3/11/2020,0,6,34,144,150,1,4,0,0,0,0,4,1,1,0,0,0,5,34,139,144,8/13/2020
3/12/2020,9,15,42,186,201,1,5,0,0,0,0,5,1,1,0,0,8,13,38,177,190,8/13/2020
3/13/2020,6,21,50,236,257,4,9,1,1,0,0,8,1,1,0,0,6,19,48,225,244,8/13/2020
3/14/2020,0,21,90,326,347,0,9,0,1,0,0,8,1,1,0,0,0,19,86,311,330,8/13/2020
3/15/2020,1,22,54,380,402,1,10,0,1,0,0,9,2,1,0,0,1,20,54,365,385,8/13/2020
3/16/2020,2,24,95,475,499,2,12,0,1,0,0,11,2,0,0,0,2,22,92,457,479,8/13/2020
3/17/2020,12,36,162,637,673,6,18,0,1,0,0,17,2,0,0,0,11,33,152,609,642,8/13/2020
3/18/2020,9,45,116,753,798,3,21,0,1,0,0,20,2,0,0,0,11,44,111,720,764,8/13/2020
3/19/2020,15,60,262,1015,1075,2,23,1,2,0,0,21,3,0,1,1,17,61,251,971,1032,8/13/2020
3/20/2020,14,74,197,1212,1286,5,28,0,2,0,0,26,4,0,0,1,13,74,192,1163,1237,8/13/2020
3/21/2020,12,86,126,1338,1424,3,31,2,4,0,0,27,5,0,0,1,14,88,123,1286,1374,8/13/2020
3/22/2020,27,113,282,1620,1733,2,33,0,4,0,0,29,5,0,0,1,25,113,264,1550,1663,8/13/2020
3/23/2020,14,127,169,1789,1916,15,48,1,5,0,0,43,9,3,0,1,16,129,165,1715,1844,8/13/2020
3/24/2020,20,147,243,2032,2179,7,55,0,5,0,0,50,10,4,0,1,19,148,238,1953,2101,8/13/2020
3/25/2020,26,173,182,2214,2387,5,60,1,6,0,0,54,11,3,0,1,28,176,173,2126,2302,8/13/2020
3/26/2020,35,208,181,2395,2603,10,70,5,11,0,0,59,14,5,0,1,41,217,176,2302,2519,8/13/2020
3/27/2020,27,235,214,2609,2844,9,79,1,12,1,1,66,17,6,2,3,31,248,202,2504,2752,8/13/2020
3/28/2020,59,294,260,2869,3163,13,92,3,15,2,3,74,15,6,1,4,63,311,242,2746,3057,8/13/2020
3/29/2020,100,394,350,3219,3613,8,100,4,19,1,4,77,18,8,2,6,105,416,314,3060,3476,8/13/2020
3/30/2020,62,456,222,3441,3897,20,120,5,24,0,4,92,20,11,3,9,78,494,191,3251,3745,8/13/2020
3/31/2020,71,527,369,3810,4337,11,131,7,31,1,5,95,22,13,2,11,73,567,298,3549,4116,8/13/2020
4/1/2020,99,626,698,4508,5134,18,149,7,38,0,5,106,30,15,1,12,100,667,648,4197,4864,8/13/2020
4/2/2020,52,678,477,4985,5663,21,170,6,44,2,7,119,36,21,4,16,62,729,436,4633,5362,8/13/2020
4/3/2020,108,786,774,5759,6545,23,193,7,51,0,7,135,43,25,3,19,100,829,716,5349,6178,8/13/2020
4/4/2020,143,929,660,6419,7348,22,215,4,55,5,12,148,41,30,9,28,137,966,620,5969,6935,8/13/2020
4/5/2020,187,1116,1156,7575,8691,20,235,9,64,1,13,158,44,36,2,30,182,1148,1071,7040,8188,8/13/2020
4/6/2020,218,1334,1706,9281,10615,26,261,7,71,0,13,177,48,40,7,37,206,1354,1576,8616,9970,8/13/2020
4/7/2020,284,1618,1629,10910,12528,20,281,4,75,2,15,191,49,42,5,42,260,1614,1489,10105,11719,8/13/2020
4/8/2020,290,1908,1720,12630,14538,19,300,7,82,6,21,197,49,38,10,52,272,1886,1568,11673,13559,8/13/2020
4/9/2020,283,2191,1516,14146,16337,32,332,9,91,4,25,216,52,40,7,59,278,2164,1364,13037,15201,8/13/2020
4/10/2020,419,2610,2574,16720,19330,29,361,16,107,5,30,224,58,41,11,70,404,2568,2380,15417,17985,8/13/2020
4/11/2020,297,2907,1905,18625,21532,29,390,11,118,2,32,240,61,48,12,82,280,2848,1727,17144,19992,8/13/2020
4/12/2020,314,3221,1670,20295,23516,35,425,13,131,5,37,257,59,49,9,91,289,3137,1444,18588,21725,8/13/2020
4/13/2020,161,3382,935,21230,24612,35,460,13,144,3,40,276,64,54,9,100,187,3324,844,19432,22756,8/13/2020
4/14/2020,289,3671,1787,23017,26688,27,487,17,161,5,45,281,72,53,8,108,265,3589,1545,20977,24566,8/13/2020
4/15/2020,351,4022,1799,24816,28838,31,518,19,180,3,48,290,72,54,17,125,307,3896,1574,22551,26447,8/13/2020
4/16/2020,447,4469,2494,27310,31779,36,554,25,205,6,54,295,72,53,14,139,392,4288,2096,24647,28935,8/13/2020
4/17/2020,304,4773,1821,29131,33904,32,586,20,225,7,61,300,66,45,21,160,291,4579,1468,26115,30694,8/13/2020
4/18/2020,321,5094,1725,30856,35950,26,612,18,243,4,65,304,63,49,15,175,284,4863,1355,27470,32333,8/13/2020
4/19/2020,381,5475,2047,32903,38378,23,635,26,269,1,66,300,65,55,11,186,338,5201,1755,29225,34426,8/13/2020
4/20/2020,394,5869,1907,34810,40679,46,681,29,298,2,68,315,75,56,10,196,377,5578,1585,30810,36388,8/13/2020
4/21/2020,444,6313,2110,36920,43233,45,726,31,329,5,73,324,72,56,18,214,389,5967,1724,32534,38501,8/13/2020
4/22/2020,418,6731,2390,39310,46041,41,767,32,361,5,78,328,73,58,18,232,382,6349,1922,34456,40805,8/13/2020
4/23/2020,480,7211,2469,41779,48990,30,797,28,389,5,83,325,76,62,15,247,419,6768,1882,36338,43106,8/13/2020
4/24/2020,491,7702,3284,45063,52765,35,832,27,416,4,87,329,85,63,15,262,413,7181,2645,38983,46164,8/13/2020
4/25/2020,393,8095,2206,47269,55364,34,866,17,433,5,92,341,85,62,14,276,305,7486,1783,40766,48252,8/13/2020
4/26/2020,316,8411,2309,49578,57989,33,899,15,448,3,95,356,86,59,14,290,276,7762,1889,42655,50417,8/13/2020
4/27/2020,249,8660,1620,51198,59858,29,928,21,469,4,99,360,86,61,10,300,204,7966,1166,43821,51787,8/13/2020
4/28/2020,410,9070,2263,53461,62531,44,972,24,493,3,102,377,88,59,22,322,325,8291,1773,45594,53885,8/13/2020
4/29/2020,476,9546,3343,56804,66350,36,1008,37,530,11,113,365,78,53,18,340,372,8663,2450,48044,56707,8/13/2020
4/30/2020,432,9978,2769,59573,69551,33,1041,38,568,6,119,354,83,57,24,364,347,9010,1961,50005,59015,8/13/2020
5/1/2020,454,10432,3086,62659,73091,51,1092,39,607,3,122,363,84,58,14,378,317,9327,2222,52227,61554,8/13/2020
5/2/2020,257,10689,1926,64585,75274,36,1128,39,646,5,127,355,91,62,24,402,189,9516,1295,53522,63038,8/13/2020
5/3/2020,283,10972,2160,66745,77717,31,1159,27,673,8,135,351,90,61,21,423,181,9697,1608,55130,64827,8/13/2020
5/4/2020,387,11359,2098,68843,80202,30,1189,31,704,5,140,345,88,57,18,441,293,9990,1574,56704,66694,8/13/2020
5/5/2020,433,11792,2873,71716,83508,29,1218,32,736,6,146,336,82,54,16,457,304,10294,1971,58675,68969,8/13/2020
5/6/2020,488,12280,2829,74545,86825,28,1246,44,780,9,155,311,79,54,21,478,341,10635,1928,60603,71238,8/13/2020
5/7/2020,425,12705,2969,77514,90219,36,1282,42,822,5,160,300,71,52,21,499,269,10904,1989,62592,73496,8/13/2020
5/8/2020,359,13064,2598,80112,93176,30,1312,29,851,5,165,296,71,53,22,521,231,11135,1773,64365,75500,8/13/2020
5/9/2020,454,13518,3346,83458,96976,22,1334,21,872,4,169,293,69,51,15,536,285,11420,2311,66676,78096,8/13/2020
5/10/2020,280,13798,2117,85575,99373,19,1353,23,895,6,175,283,70,49,13,549,186,11606,1528,68204,79810,8/13/2020
5/11/2020,257,14055,1857,87432,101487,31,1384,16,911,6,181,292,71,49,15,564,176,11782,1313,69517,81299,8/13/2020
5/12/2020,387,14442,2611,90043,104485,23,1407,18,929,4,185,293,69,48,22,586,217,11999,1719,71236,83235,8/13/2020
5/13/2020,351,14793,3630,93673,108466,22,1429,24,953,1,186,290,69,49,13,599,196,12195,2025,73261,85456,8/13/2020
5/14/2020,329,15122,3408,97081,112203,19,1448,27,980,3,189,279,64,45,15,614,227,12422,2022,75283,87705,8/13/2020
5/15/2020,381,15503,3458,100539,116042,24,1472,41,1021,5,194,257,62,45,13,627,234,12656,1817,77100,89756,8/13/2020
5/16/2020,434,15937,4156,104695,120632,25,1497,12,1033,5,199,265,61,46,15,642,252,12908,1969,79069,91977,8/13/2020
5/17/2020,231,16168,2768,107463,123631,17,1514,7,1040,5,204,270,59,45,10,652,124,13032,1568,80637,93669,8/13/2020
5/18/2020,250,16418,2001,109464,125882,19,1533,15,1055,5,209,269,57,40,18,670,139,13171,1374,82011,95182,8/13/2020
5/19/2020,415,16833,3168,112632,129465,23,1556,32,1087,5,214,255,56,38,11,681,214,13385,1944,83955,97340,8/13/2020
5/20/2020,326,17159,2770,115402,132561,19,1575,23,1110,7,221,244,52,33,22,703,187,13572,1522,85477,99049,8/13/2020
5/21/2020,374,17533,3757,119159,136692,26,1601,15,1125,3,224,252,53,29,20,723,170,13742,1952,87429,101171,8/13/2020
5/22/2020,349,17882,3161,122320,140202,20,1621,29,1154,5,229,238,52,29,10,733,205,13947,1615,89044,102991,8/13/2020
5/23/2020,240,18122,2742,125062,143184,19,1640,11,1165,3,232,243,52,32,13,746,109,14056,1286,90330,104386,8/13/2020
5/24/2020,151,18273,1370,126432,144705,12,1652,14,1179,2,234,239,53,36,8,754,84,14140,774,91104,105244,8/13/2020
5/25/2020,134,18407,1385,127817,146224,12,1664,14,1193,0,234,237,53,34,10,764,70,14210,765,91869,106079,8/13/2020
5/26/2020,284,18691,2620,130437,149128,24,1688,22,1215,5,239,234,48,33,15,779,155,14365,1787,93656,108021,8/13/2020
5/27/2020,276,18967,2065,132502,151469,20,1708,17,1232,3,242,234,50,33,10,789,133,14498,1143,94799,109297,8/13/2020
5/28/2020,345,19312,3371,135873,155185,17,1725,29,1261,4,246,218,47,32,8,797,132,14630,1132,95931,110561,8/13/2020
5/29/2020,412,19724,3928,139801,159525,18,1743,27,1288,6,252,203,43,31,12,809,179,14809,1592,97523,112332,8/13/2020
5/30/2020,208,19932,3915,143716,163648,15,1758,19,1307,4,256,195,40,29,12,821,104,14913,1828,99351,114264,8/13/2020
5/31/2020,144,20076,1682,145398,165474,10,1768,10,1317,0,256,195,43,26,3,824,76,14989,855,100206,115195,8/13/2020
6/1/2020,213,20289,2781,148179,168468,7,1775,13,1330,1,257,188,44,29,5,829,98,15087,1376,101582,116669,8/13/2020
6/2/2020,273,20562,3025,151204,171766,8,1783,9,1339,3,260,184,37,25,10,839,107,15194,1466,103048,118242,8/13/2020
6/3/2020,253,20815,3482,154686,175501,13,1796,18,1357,6,266,173,34,25,11,850,105,15299,1672,104720,120019,8/13/2020
6/4/2020,276,21091,4458,159144,180235,7,1803,25,1382,3,269,152,31,24,11,861,114,15413,2041,106761,122174,8/13/2020
6/5/2020,214,21305,3513,162657,183962,15,1818,12,1394,5,274,150,27,21,9,870,104,15517,1579,108340,123857,8/13/2020
6/6/2020,196,21501,2608,165265,186766,10,1828,7,1401,2,276,151,29,19,6,876,68,15585,1134,109474,125059,8/13/2020
6/7/2020,77,21578,1610,166875,188453,11,1839,7,1408,1,277,154,25,17,4,880,49,15634,777,110251,125885,8/13/2020
6/8/2020,121,21699,1845,168720,190419,15,1854,12,1420,2,279,155,27,18,4,884,44,15678,964,111215,126893,8/13/2020
6/9/2020,225,21924,2665,171385,193309,10,1864,18,1438,0,279,147,28,21,1,885,67,15745,1262,112477,128222,8/13/2020
6/10/2020,209,22133,2970,174355,196488,13,1877,12,1450,2,281,146,24,17,3,888,104,15849,1458,113935,129784,8/13/2020
6/11/2020,195,22328,3492,177847,200175,7,1884,15,1465,1,282,137,25,16,6,894,88,15937,1528,115463,131400,8/13/2020
6/12/2020,213,22541,4592,182439,204980,8,1892,15,1480,1,283,129,24,16,2,896,80,16017,2188,117651,133668,8/13/2020
6/13/2020,110,22651,3020,185459,208110,6,1898,4,1484,0,283,131,20,15,3,899,50,16067,1368,119019,135086,8/13/2020
6/14/2020,77,22728,2033,187492,210220,6,1904,8,1492,1,284,128,20,14,3,902,32,16099,965,119984,136083,8/13/2020
6/15/2020,188,22916,3096,190588,213504,14,1918,14,1506,0,284,128,20,16,4,906,78,16177,1785,121769,137946,8/13/2020
6/16/2020,114,23030,3004,193592,216622,11,1929,10,1516,1,285,128,22,16,8,914,52,16229,1576,123345,139574,8/13/2020
6/17/2020,122,23152,2819,196411,219563,15,1944,20,1536,4,289,119,18,14,6,920,52,16281,1315,124660,140941,8/13/2020
6/18/2020,150,23302,3030,199441,222743,9,1953,13,1549,1,290,114,19,16,7,927,70,16351,1329,125989,142340,8/13/2020
6/19/2020,141,23443,3758,203199,226642,12,1965,11,1560,1,291,114,20,17,3,930,59,16410,1373,127362,143772,8/13/2020
6/20/2020,80,23523,1878,205077,228600,8,1973,10,1570,0,291,112,20,18,4,934,36,16446,811,128173,144619,8/13/2020
6/21/2020,36,23559,1036,206113,229672,7,1980,5,1575,0,291,114,20,18,2,936,27,16473,677,128850,145323,8/13/2020
6/22/2020,142,23701,3704,209817,233518,12,1992,16,1591,0,291,110,19,18,1,937,70,16543,1703,130553,147096,8/13/2020
6/23/2020,162,23863,3826,213643,237506,3,1995,13,1604,3,294,97,18,18,6,943,83,16626,1792,132345,148971,8/13/2020
6/24/2020,121,23984,3493,217136,241120,9,2004,10,1614,1,295,95,18,18,5,948,47,16673,1692,134037,150710,8/13/2020
6/25/2020,102,24086,2869,220005,244091,5,2009,14,1628,1,296,85,17,17,1,949,52,16725,1507,135544,152269,8/13/2020
6/26/2020,94,24180,2443,222448,246628,2,2011,9,1637,0,296,78,18,18,1,950,64,16789,1301,136845,153634,8/13/2020
6/27/2020,84,24264,3200,225648,249912,5,2016,3,1640,1,297,79,17,17,5,955,37,16826,1213,138058,154884,8/13/2020
6/28/2020,36,24300,1450,227098,251398,4,2020,4,1644,4,301,75,15,14,6,961,18,16844,586,138644,155488,8/13/2020
6/29/2020,86,24386,3670,230768,255154,4,2024,5,1649,0,301,74,14,14,1,962,39,16883,1344,139988,156871,8/13/2020
6/30/2020,60,24446,1937,232705,257151,1,2025,5,1654,1,302,69,12,11,3,965,35,16918,993,140981,157899,8/13/2020
7/1/2020,144,24590,4094,236799,261389,7,2032,9,1663,0,302,67,11,11,1,966,81,16999,1950,142931,159930,8/13/2020
7/2/2020,101,24691,2775,239574,264265,5,2037,5,1668,1,303,66,9,9,1,967,56,17055,1075,144006,161061,8/13/2020
7/3/2020,47,24738,2010,241584,266322,7,2044,6,1674,0,303,67,8,8,3,970,25,17080,771,144777,161857,8/13/2020
7/4/2020,57,24795,2317,243901,268696,2,2046,4,1678,1,304,64,9,8,2,972,34,17114,990,145767,162881,8/13/2020
7/5/2020,45,24840,2917,246818,271658,1,2047,2,1680,1,305,62,7,7,2,974,23,17137,1442,147209,164346,8/13/2020
7/6/2020,103,24943,2784,249602,274545,6,2053,6,1686,0,305,62,8,9,4,978,60,17197,1542,148751,165948,8/13/2020
7/7/2020,80,25023,3433,253035,278058,5,2058,6,1692,0,305,61,7,8,1,979,47,17244,1530,150281,167525,8/13/2020
7/8/2020,104,25127,3373,256408,281535,4,2062,2,1694,0,305,63,8,8,0,979,66,17310,1417,151698,169008,8/13/2020
7/9/2020,93,25220,3654,260062,285282,8,2070,2,1696,0,305,69,8,8,0,979,50,17360,1594,153292,170652,8/13/2020
7/10/2020,129,25349,4378,264440,289789,5,2075,3,1699,2,307,69,7,7,3,982,79,17439,2078,155370,172809,8/13/2020
7/11/2020,62,25411,2872,267312,292723,6,2081,3,1702,1,308,71,6,6,3,985,34,17473,1278,156648,174121,8/13/2020
7/12/2020,45,25456,1759,269071,294527,1,2082,2,1704,1,309,69,6,5,3,988,33,17506,885,157533,175039,8/13/2020
7/13/2020,85,25541,3137,272208,297749,8,2090,10,1714,0,309,67,6,5,1,989,57,17563,1469,159002,176565,8/13/2020
7/14/2020,74,25615,3239,275447,301062,7,2097,4,1718,0,309,70,5,5,1,990,50,17613,1347,160349,177962,8/13/2020
7/15/2020,123,25738,4109,279556,305294,5,2102,6,1724,0,309,69,5,4,0,990,94,17707,1724,162073,179780,8/13/2020
7/16/2020,102,25840,3672,283228,309068,6,2108,9,1733,0,309,66,6,5,1,991,78,17785,1590,163663,181448,8/13/2020
7/17/2020,150,25990,4109,287337,313327,14,2122,3,1736,1,310,76,5,5,1,992,78,17863,1794,165457,183320,8/13/2020
7/18/2020,80,26070,3133,290470,316540,5,2127,9,1745,1,311,71,5,4,4,996,67,17930,1326,166783,184713,8/13/2020
7/19/2020,81,26151,2566,293036,319187,6,2133,3,1748,0,311,74,6,4,2,998,58,17988,1069,167852,185840,8/13/2020
7/20/2020,72,26223,2590,295626,321849,9,2142,7,1755,0,311,76,7,5,2,1000,62,18050,1443,169295,187345,8/13/2020
7/21/2020,127,26350,4201,299827,326177,9,2151,10,1765,0,311,75,9,6,1,1001,104,18154,1869,171164,189318,8/13/2020
7/22/2020,123,26473,3772,303599,330072,11,2162,11,1776,1,312,74,7,6,1,1002,86,18240,1578,172742,190982,8/13/2020
7/23/2020,123,26596,4043,307642,334238,8,2170,5,1781,0,312,77,8,7,0,1002,105,18345,1752,174494,192839,8/13/2020
7/24/2020,160,26756,5665,313307,340063,13,2183,14,1795,0,312,76,9,7,0,1002,118,18463,2143,176637,195100,8/13/2020
7/25/2020,125,26881,4246,317553,344434,7,2190,7,1802,0,312,76,10,8,1,1003,104,18567,1999,178636,197203,8/13/2020
7/26/2020,56,26937,2945,320498,347435,7,2197,8,1810,0,312,75,11,6,1,1004,53,18620,1295,179931,198551,8/13/2020
7/27/2020,182,27119,3855,324353,351472,12,2209,7,1817,0,312,80,13,7,1,1005,137,18757,2110,182041,200798,8/13/2020
7/28/2020,101,27220,3623,327976,355196,5,2214,4,1821,0,312,81,14,6,1,1006,89,18846,1498,183539,202385,8/13/2020
7/29/2020,159,27379,4740,332716,360095,10,2224,12,1833,0,312,79,15,6,0,1006,143,18989,2073,185612,204601,8/13/2020
7/30/2020,96,27475,3935,336651,364126,5,2229,2,1835,1,313,81,15,5,0,1006,74,19063,1352,186964,206027,8/13/2020
7/31/2020,115,27590,5061,341712,369302,8,2237,9,1844,0,313,80,15,6,0,1006,85,19148,1611,188575,207723,8/13/2020
8/1/2020,88,27678,3886,345598,373276,7,2244,2,1846,0,313,85,14,6,1,1007,77,19225,1321,189896,209121,8/13/2020
8/2/2020,77,27755,2656,348254,376009,11,2255,11,1857,1,314,84,14,7,2,1009,65,19290,1194,191090,210380,8/13/2020
8/3/2020,166,27921,4798,353052,380973,13,2268,12,1869,0,314,85,16,6,1,1010,146,19436,1903,192993,212429,8/13/2020
8/4/2020,117,28038,3397,356449,384487,7,2275,6,1875,1,315,85,12,4,2,1012,100,19536,1594,194587,214123,8/13/2020
8/5/2020,138,28176,5344,361793,389969,11,2286,9,1884,1,316,86,10,4,2,1014,110,19646,2047,196634,216280,8/13/2020
8/6/2020,154,28330,4626,366419,394749,5,2291,9,1893,0,316,82,9,3,0,1014,110,19756,1786,198420,218176,8/13/2020
8/7/2020,101,28431,4126,370545,398976,12,2303,10,1903,1,317,83,9,2,1,1015,83,19839,1661,200081,219920,8/13/2020
8/8/2020,102,28533,3297,373842,402375,19,2322,6,1909,1,318,95,8,2,1,1016,91,19930,1494,201575,221505,8/13/2020
8/9/2020,35,28568,1522,375364,403932,7,2329,11,1920,0,318,91,9,3,0,1016,32,19962,947,202522,222484,8/13/2020
8/10/2020,127,28695,4015,379379,408074,9,2338,10,1930,0,318,90,9,3,1,1017,103,20065,1649,204171,224236,8/13/2020
8/11/2020,99,28794,3876,383255,412049,3,2341,13,1943,0,318,80,10,4,1,1018,78,20143,2005,206176,226319,8/13/2020
8/12/2020,115,28909,4039,387294,416203,,,,,,,,,,1,1019,97,20240,2058,208234,228474,8/13/2020
2/27/2020,0,0,0,0,0,1,1,0,0,0,0,1,0,0,0,0,0,0,0,0,0,8/14/2020
2/28/2020,0,0,0,0,0,0,1,0,0,0,0,1,1,0,0,0,0,0,0,0,0,8/14/2020
2/29/2020,0,0,0,0,0,0,1,0,0,0,0,1,1,0,0,0,0,0,0,0,0,8/14/2020
3/1/2020,2,2,2,2,4,0,1,0,0,0,0,1,1,1,0,0,2,2,2,2,4,8/14/2020
3/2/2020,0,2,1,3,5,1,2,0,0,0,0,2,2,2,0,0,0,2,1,3,5,8/14/2020
3/3/2020,0,2,2,5,7,0,2,0,0,0,0,2,2,2,0,0,0,2,2,5,7,8/14/2020
3/4/2020,0,2,12,17,19,1,3,0,0,0,0,3,2,2,0,0,0,2,10,15,17,8/14/2020
3/5/2020,0,2,4,21,23,0,3,0,0,0,0,3,2,2,0,0,1,3,4,19,22,8/14/2020
3/6/2020,1,3,12,33,36,0,3,0,0,0,0,3,2,2,0,0,0,3,11,30,33,8/14/2020
3/7/2020,0,3,19,52,55,0,3,0,0,0,0,3,2,1,0,0,0,3,19,49,52,8/14/2020
3/8/2020,0,3,18,70,73,0,3,0,0,0,0,3,2,1,0,0,0,3,18,67,70,8/14/2020
3/9/2020,1,4,15,85,89,0,3,0,0,0,0,3,2,1,0,0,1,4,15,82,86,8/14/2020
3/10/2020,2,6,25,110,116,0,3,0,0,0,0,3,2,1,0,0,1,5,23,105,110,8/14/2020
3/11/2020,0,6,34,144,150,1,4,0,0,0,0,4,1,1,0,0,0,5,34,139,144,8/14/2020
3/12/2020,9,15,41,185,200,1,5,0,0,0,0,5,1,1,0,0,8,13,38,177,190,8/14/2020
3/13/2020,6,21,50,235,256,4,9,1,1,0,0,8,1,1,0,0,6,19,48,225,244,8/14/2020
3/14/2020,0,21,90,325,346,0,9,0,1,0,0,8,1,1,0,0,0,19,86,311,330,8/14/2020
3/15/2020,1,22,54,379,401,1,10,0,1,0,0,9,2,1,0,0,1,20,54,365,385,8/14/2020
3/16/2020,2,24,95,474,498,2,12,0,1,0,0,11,2,0,0,0,2,22,92,457,479,8/14/2020
3/17/2020,12,36,162,636,672,6,18,0,1,0,0,17,2,0,0,0,11,33,152,609,642,8/14/2020
3/18/2020,9,45,116,752,797,3,21,0,1,0,0,20,2,0,0,0,11,44,111,720,764,8/14/2020
3/19/2020,15,60,262,1014,1074,2,23,1,2,0,0,21,3,0,1,1,17,61,251,971,1032,8/14/2020
3/20/2020,13,73,197,1211,1284,5,28,0,2,0,0,26,4,0,0,1,13,74,192,1163,1237,8/14/2020
3/21/2020,12,85,126,1337,1422,3,31,2,4,0,0,27,5,0,0,1,14,88,123,1286,1374,8/14/2020
3/22/2020,27,112,282,1619,1731,2,33,0,4,0,0,29,5,0,0,1,25,113,264,1550,1663,8/14/2020
3/23/2020,14,126,169,1788,1914,15,48,1,5,0,0,43,9,3,0,1,16,129,165,1715,1844,8/14/2020
3/24/2020,20,146,242,2030,2176,7,55,0,5,0,0,50,10,4,0,1,19,148,238,1953,2101,8/14/2020
3/25/2020,26,172,182,2212,2384,5,60,1,6,0,0,54,11,3,0,1,28,176,173,2126,2302,8/14/2020
3/26/2020,35,207,181,2393,2600,10,70,5,11,0,0,59,14,5,0,1,41,217,176,2302,2519,8/14/2020
3/27/2020,27,234,214,2607,2841,9,79,1,12,1,1,66,17,6,2,3,31,248,202,2504,2752,8/14/2020
3/28/2020,59,293,260,2867,3160,13,92,3,15,2,3,74,15,6,1,4,63,311,242,2746,3057,8/14/2020
3/29/2020,100,393,350,3217,3610,8,100,4,19,1,4,77,18,8,2,6,105,416,314,3060,3476,8/14/2020
3/30/2020,62,455,222,3439,3894,20,120,5,24,0,4,92,20,11,3,9,78,494,191,3251,3745,8/14/2020
3/31/2020,71,526,369,3808,4334,11,131,7,31,1,5,95,22,13,2,11,73,567,298,3549,4116,8/14/2020
4/1/2020,99,625,698,4506,5131,18,149,7,38,0,5,106,30,15,1,12,100,667,648,4197,4864,8/14/2020
4/2/2020,52,677,477,4983,5660,21,170,6,44,2,7,119,36,21,4,16,62,729,436,4633,5362,8/14/2020
4/3/2020,108,785,774,5757,6542,23,193,7,51,0,7,135,43,25,3,19,100,829,716,5349,6178,8/14/2020
4/4/2020,143,928,660,6417,7345,22,215,4,55,5,12,148,41,30,9,28,137,966,620,5969,6935,8/14/2020
4/5/2020,187,1115,1156,7573,8688,20,235,9,64,1,13,158,44,36,2,30,182,1148,1071,7040,8188,8/14/2020
4/6/2020,218,1333,1706,9279,10612,26,261,7,71,0,13,177,48,40,7,37,206,1354,1576,8616,9970,8/14/2020
4/7/2020,284,1617,1629,10908,12525,20,281,3,74,2,15,192,49,42,5,42,260,1614,1488,10104,11718,8/14/2020
4/8/2020,290,1907,1720,12628,14535,19,300,7,81,6,21,198,49,38,10,52,272,1886,1568,11672,13558,8/14/2020
4/9/2020,283,2190,1516,14144,16334,32,332,9,90,4,25,217,52,40,7,59,278,2164,1364,13036,15200,8/14/2020
4/10/2020,419,2609,2574,16718,19327,28,360,17,107,5,30,223,58,41,11,70,403,2567,2380,15416,17983,8/14/2020
4/11/2020,297,2906,1905,18623,21529,29,389,11,118,2,32,239,61,48,12,82,281,2848,1727,17143,19991,8/14/2020
4/12/2020,314,3220,1670,20293,23513,35,424,13,131,5,37,256,59,49,9,91,289,3137,1443,18586,21723,8/14/2020
4/13/2020,161,3381,935,21228,24609,35,459,13,144,3,40,275,64,54,9,100,187,3324,844,19430,22754,8/14/2020
4/14/2020,289,3670,1787,23015,26685,27,486,16,160,5,45,281,72,53,8,108,265,3589,1544,20974,24563,8/14/2020
4/15/2020,351,4021,1799,24814,28835,31,517,19,179,3,48,290,72,54,17,125,307,3896,1572,22546,26442,8/14/2020
4/16/2020,447,4468,2494,27308,31776,36,553,25,204,6,54,295,72,53,14,139,392,4288,2095,24641,28929,8/14/2020
4/17/2020,304,4772,1821,29129,33901,32,585,20,224,7,61,300,66,45,21,160,291,4579,1466,26107,30686,8/14/2020
4/18/2020,321,5093,1725,30854,35947,26,611,18,242,4,65,304,63,49,15,175,284,4863,1354,27461,32324,8/14/2020
4/19/2020,381,5474,2047,32901,38375,23,634,26,268,1,66,300,65,55,11,186,338,5201,1754,29215,34416,8/14/2020
4/20/2020,394,5868,1907,34808,40676,46,680,29,297,2,68,315,75,56,10,196,377,5578,1585,30800,36378,8/14/2020
4/21/2020,444,6312,2110,36918,43230,45,725,31,328,5,73,324,72,56,18,214,389,5967,1724,32524,38491,8/14/2020
4/22/2020,418,6730,2390,39308,46038,41,766,32,360,5,78,328,73,58,18,232,382,6349,1922,34446,40795,8/14/2020
4/23/2020,479,7209,2469,41777,48986,30,796,28,388,5,83,325,76,62,15,247,418,6767,1880,36326,43093,8/14/2020
4/24/2020,491,7700,3284,45061,52761,35,831,27,415,4,87,329,85,63,15,262,413,7180,2645,38971,46151,8/14/2020
4/25/2020,393,8093,2206,47267,55360,34,865,17,432,5,92,341,85,62,14,276,305,7485,1783,40754,48239,8/14/2020
4/26/2020,316,8409,2309,49576,57985,33,898,15,447,3,95,356,86,59,14,290,276,7761,1888,42642,50403,8/14/2020
4/27/2020,249,8658,1620,51196,59854,29,927,21,468,4,99,360,86,61,10,300,204,7965,1166,43808,51773,8/14/2020
4/28/2020,410,9068,2263,53459,62527,44,971,24,492,3,102,377,88,59,22,322,325,8290,1772,45580,53870,8/14/2020
4/29/2020,476,9544,3343,56802,66346,36,1007,37,529,11,113,365,78,53,18,340,372,8662,2449,48029,56691,8/14/2020
4/30/2020,432,9976,2769,59571,69547,33,1040,38,567,6,119,354,83,57,24,364,347,9009,1961,49990,58999,8/14/2020
5/1/2020,454,10430,3086,62657,73087,51,1091,39,606,3,122,363,84,58,14,378,317,9326,2221,52211,61537,8/14/2020
5/2/2020,257,10687,1926,64583,75270,36,1127,39,645,5,127,355,91,62,24,402,189,9515,1295,53506,63021,8/14/2020
5/3/2020,283,10970,2160,66743,77713,31,1158,27,672,8,135,351,90,61,21,423,182,9697,1608,55114,64811,8/14/2020
5/4/2020,387,11357,2098,68841,80198,30,1188,31,703,5,140,345,88,57,18,441,293,9990,1574,56688,66678,8/14/2020
5/5/2020,433,11790,2873,71714,83504,29,1217,32,735,6,146,336,82,54,16,457,304,10294,1971,58659,68953,8/14/2020
5/6/2020,488,12278,2829,74543,86821,28,1245,44,779,9,155,311,79,54,21,478,341,10635,1928,60587,71222,8/14/2020
5/7/2020,425,12703,2969,77512,90215,36,1281,42,821,5,160,300,71,52,21,499,269,10904,1989,62576,73480,8/14/2020
5/8/2020,359,13062,2598,80110,93172,30,1311,29,850,5,165,296,71,53,22,521,231,11135,1773,64349,75484,8/14/2020
5/9/2020,454,13516,3346,83456,96972,22,1333,21,871,4,169,293,69,51,15,536,285,11420,2309,66658,78078,8/14/2020
5/10/2020,280,13796,2117,85573,99369,19,1352,23,894,6,175,283,70,49,13,549,186,11606,1528,68186,79792,8/14/2020
5/11/2020,257,14053,1857,87430,101483,31,1383,16,910,6,181,292,71,49,15,564,176,11782,1313,69499,81281,8/14/2020
5/12/2020,387,14440,2611,90041,104481,23,1406,18,928,4,185,293,69,48,22,586,217,11999,1718,71217,83216,8/14/2020
5/13/2020,351,14791,3630,93671,108462,22,1428,24,952,1,186,290,69,49,13,599,196,12195,2025,73242,85437,8/14/2020
5/14/2020,329,15120,3408,97079,112199,19,1447,27,979,3,189,279,64,45,15,614,227,12422,2022,75264,87686,8/14/2020
5/15/2020,381,15501,3458,100537,116038,24,1471,41,1020,5,194,257,62,45,13,627,234,12656,1817,77081,89737,8/14/2020
5/16/2020,434,15935,4156,104693,120628,25,1496,12,1032,5,199,265,61,46,15,642,252,12908,1969,79050,91958,8/14/2020
5/17/2020,231,16166,2768,107461,123627,17,1513,7,1039,5,204,270,59,45,10,652,124,13032,1568,80618,93650,8/14/2020
5/18/2020,250,16416,2001,109462,125878,19,1532,15,1054,5,209,269,57,40,18,670,139,13171,1374,81992,95163,8/14/2020
5/19/2020,415,16831,3168,112630,129461,23,1555,32,1086,5,214,255,56,38,11,681,214,13385,1944,83936,97321,8/14/2020
5/20/2020,326,17157,2770,115400,132557,19,1574,23,1109,7,221,244,52,33,22,703,187,13572,1522,85458,99030,8/14/2020
5/21/2020,374,17531,3757,119157,136688,26,1600,15,1124,3,224,252,53,29,20,723,170,13742,1952,87410,101152,8/14/2020
5/22/2020,349,17880,3161,122318,140198,20,1620,29,1153,5,229,238,52,29,10,733,205,13947,1615,89025,102972,8/14/2020
5/23/2020,240,18120,2742,125060,143180,19,1639,11,1164,3,232,243,52,32,13,746,109,14056,1286,90311,104367,8/14/2020
5/24/2020,151,18271,1370,126430,144701,12,1651,14,1178,2,234,239,53,36,8,754,84,14140,774,91085,105225,8/14/2020
5/25/2020,134,18405,1385,127815,146220,12,1663,14,1192,0,234,237,53,34,10,764,70,14210,765,91850,106060,8/14/2020
5/26/2020,284,18689,2620,130435,149124,24,1687,22,1214,5,239,234,48,33,15,779,155,14365,1787,93637,108002,8/14/2020
5/27/2020,276,18965,2065,132500,151465,20,1707,17,1231,3,242,234,50,33,10,789,133,14498,1143,94780,109278,8/14/2020
5/28/2020,345,19310,3371,135871,155181,17,1724,29,1260,4,246,218,47,32,8,797,133,14631,1131,95911,110542,8/14/2020
5/29/2020,412,19722,3928,139799,159521,18,1742,27,1287,6,252,203,43,31,12,809,179,14810,1592,97503,112313,8/14/2020
5/30/2020,208,19930,3915,143714,163644,15,1757,19,1306,4,256,195,40,29,12,821,104,14914,1827,99330,114244,8/14/2020
5/31/2020,144,20074,1682,145396,165470,10,1767,10,1316,0,256,195,43,26,3,824,76,14990,855,100185,115175,8/14/2020
6/1/2020,213,20287,2781,148177,168464,7,1774,13,1329,1,257,188,44,29,5,829,98,15088,1376,101561,116649,8/14/2020
6/2/2020,273,20560,3025,151202,171762,8,1782,9,1338,3,260,184,37,25,10,839,107,15195,1466,103027,118222,8/14/2020
6/3/2020,253,20813,3482,154684,175497,13,1795,18,1356,6,266,173,34,25,11,850,105,15300,1672,104699,119999,8/14/2020
6/4/2020,276,21089,4458,159142,180231,7,1802,25,1381,3,269,152,31,24,11,861,114,15414,2041,106740,122154,8/14/2020
6/5/2020,214,21303,3513,162655,183958,15,1817,12,1393,5,274,150,27,21,9,870,104,15518,1579,108319,123837,8/14/2020
6/6/2020,196,21499,2608,165263,186762,10,1827,7,1400,2,276,151,29,19,6,876,68,15586,1134,109453,125039,8/14/2020
6/7/2020,77,21576,1610,166873,188449,11,1838,7,1407,1,277,154,25,17,4,880,49,15635,777,110230,125865,8/14/2020
6/8/2020,121,21697,1845,168718,190415,15,1853,12,1419,2,279,155,27,18,4,884,44,15679,964,111194,126873,8/14/2020
6/9/2020,225,21922,2665,171383,193305,10,1863,18,1437,0,279,147,28,21,1,885,67,15746,1262,112456,128202,8/14/2020
6/10/2020,209,22131,2970,174353,196484,13,1876,12,1449,2,281,146,24,17,3,888,104,15850,1458,113914,129764,8/14/2020
6/11/2020,195,22326,3492,177845,200171,7,1883,15,1464,1,282,137,25,16,6,894,88,15938,1528,115442,131380,8/14/2020
6/12/2020,213,22539,4592,182437,204976,8,1891,15,1479,1,283,129,24,16,2,896,80,16018,2188,117630,133648,8/14/2020
6/13/2020,110,22649,3020,185457,208106,6,1897,4,1483,0,283,131,20,15,3,899,50,16068,1368,118998,135066,8/14/2020
6/14/2020,77,22726,2033,187490,210216,6,1903,8,1491,1,284,128,20,14,3,902,32,16100,965,119963,136063,8/14/2020
6/15/2020,188,22914,3096,190586,213500,14,1917,14,1505,0,284,128,20,16,4,906,78,16178,1785,121748,137926,8/14/2020
6/16/2020,114,23028,3004,193590,216618,11,1928,10,1515,1,285,128,22,16,8,914,52,16230,1576,123324,139554,8/14/2020
6/17/2020,122,23150,2819,196409,219559,15,1943,20,1535,4,289,119,18,14,6,920,52,16282,1315,124639,140921,8/14/2020
6/18/2020,150,23300,3030,199439,222739,9,1952,13,1548,1,290,114,19,16,7,927,70,16352,1329,125968,142320,8/14/2020
6/19/2020,141,23441,3758,203197,226638,12,1964,11,1559,1,291,114,20,17,3,930,59,16411,1373,127341,143752,8/14/2020
6/20/2020,80,23521,1878,205075,228596,8,1972,10,1569,0,291,112,20,18,4,934,36,16447,811,128152,144599,8/14/2020
6/21/2020,36,23557,1036,206111,229668,7,1979,5,1574,0,291,114,20,18,2,936,27,16474,677,128829,145303,8/14/2020
6/22/2020,142,23699,3704,209815,233514,12,1991,16,1590,0,291,110,19,18,1,937,70,16544,1703,130532,147076,8/14/2020
6/23/2020,162,23861,3826,213641,237502,3,1994,13,1603,3,294,97,18,18,6,943,83,16627,1792,132324,148951,8/14/2020
6/24/2020,121,23982,3493,217134,241116,9,2003,10,1613,1,295,95,18,18,5,948,47,16674,1692,134016,150690,8/14/2020
6/25/2020,102,24084,2869,220003,244087,5,2008,14,1627,1,296,85,17,17,1,949,52,16726,1507,135523,152249,8/14/2020
6/26/2020,94,24178,2443,222446,246624,2,2010,9,1636,0,296,78,18,18,1,950,64,16790,1301,136824,153614,8/14/2020
6/27/2020,84,24262,3200,225646,249908,5,2015,3,1639,1,297,79,17,17,5,955,37,16827,1213,138037,154864,8/14/2020
6/28/2020,36,24298,1450,227096,251394,4,2019,4,1643,4,301,75,15,14,6,961,18,16845,586,138623,155468,8/14/2020
6/29/2020,86,24384,3670,230766,255150,4,2023,5,1648,0,301,74,14,14,1,962,39,16884,1344,139967,156851,8/14/2020
6/30/2020,60,24444,1937,232703,257147,1,2024,5,1653,1,302,69,12,11,3,965,35,16919,993,140960,157879,8/14/2020
7/1/2020,144,24588,4094,236797,261385,7,2031,9,1662,0,302,67,11,11,1,966,81,17000,1950,142910,159910,8/14/2020
7/2/2020,101,24689,2775,239572,264261,5,2036,5,1667,1,303,66,9,9,1,967,56,17056,1074,143984,161040,8/14/2020
7/3/2020,47,24736,2010,241582,266318,7,2043,6,1673,0,303,67,8,8,3,970,25,17081,770,144754,161835,8/14/2020
7/4/2020,57,24793,2317,243899,268692,2,2045,4,1677,1,304,64,9,8,2,972,34,17115,990,145744,162859,8/14/2020
7/5/2020,45,24838,2917,246816,271654,1,2046,2,1679,1,305,62,7,7,2,974,23,17138,1442,147186,164324,8/14/2020
7/6/2020,103,24941,2784,249600,274541,6,2052,6,1685,0,305,62,8,9,4,978,60,17198,1542,148728,165926,8/14/2020
7/7/2020,80,25021,3433,253033,278054,5,2057,6,1691,0,305,61,7,8,1,979,47,17245,1530,150258,167503,8/14/2020
7/8/2020,104,25125,3373,256406,281531,4,2061,2,1693,0,305,63,8,8,0,979,66,17311,1417,151675,168986,8/14/2020
7/9/2020,93,25218,3654,260060,285278,8,2069,2,1695,0,305,69,8,8,0,979,50,17361,1594,153269,170630,8/14/2020
7/10/2020,129,25347,4378,264438,289785,5,2074,3,1698,2,307,69,7,7,3,982,79,17440,2078,155347,172787,8/14/2020
7/11/2020,62,25409,2872,267310,292719,6,2080,3,1701,1,308,71,6,6,3,985,34,17474,1278,156625,174099,8/14/2020
7/12/2020,45,25454,1759,269069,294523,1,2081,2,1703,1,309,69,6,5,3,988,33,17507,885,157510,175017,8/14/2020
7/13/2020,85,25539,3137,272206,297745,8,2089,10,1713,0,309,67,6,5,1,989,57,17564,1469,158979,176543,8/14/2020
7/14/2020,74,25613,3239,275445,301058,7,2096,4,1717,0,309,70,5,5,1,990,49,17613,1347,160326,177939,8/14/2020
7/15/2020,123,25736,4109,279554,305290,5,2101,6,1723,0,309,69,5,4,0,990,94,17707,1724,162050,179757,8/14/2020
7/16/2020,102,25838,3672,283226,309064,6,2107,9,1732,0,309,66,6,5,1,991,78,17785,1590,163640,181425,8/14/2020
7/17/2020,150,25988,4109,287335,313323,14,2121,3,1735,1,310,76,5,5,1,992,78,17863,1794,165434,183297,8/14/2020
7/18/2020,80,26068,3133,290468,316536,5,2126,9,1744,1,311,71,5,4,4,996,67,17930,1326,166760,184690,8/14/2020
7/19/2020,81,26149,2566,293034,319183,6,2132,3,1747,0,311,74,6,4,2,998,58,17988,1069,167829,185817,8/14/2020
7/20/2020,72,26221,2590,295624,321845,9,2141,7,1754,0,311,76,7,5,2,1000,62,18050,1443,169272,187322,8/14/2020
7/21/2020,127,26348,4201,299825,326173,9,2150,10,1764,0,311,75,9,6,1,1001,104,18154,1869,171141,189295,8/14/2020
7/22/2020,123,26471,3772,303597,330068,11,2161,11,1775,1,312,74,7,6,1,1002,86,18240,1578,172719,190959,8/14/2020
7/23/2020,123,26594,4043,307640,334234,8,2169,5,1780,0,312,77,8,7,0,1002,105,18345,1752,174471,192816,8/14/2020
7/24/2020,160,26754,5665,313305,340059,13,2182,14,1794,0,312,76,9,7,0,1002,118,18463,2143,176614,195077,8/14/2020
7/25/2020,125,26879,4246,317551,344430,7,2189,7,1801,0,312,76,10,8,1,1003,104,18567,1998,178612,197179,8/14/2020
7/26/2020,56,26935,2945,320496,347431,7,2196,8,1809,0,312,75,11,6,1,1004,52,18619,1295,179907,198526,8/14/2020
7/27/2020,182,27117,3855,324351,351468,12,2208,7,1816,0,312,80,13,7,1,1005,137,18756,2109,182016,200772,8/14/2020
7/28/2020,101,27218,3623,327974,355192,5,2213,4,1820,0,312,81,14,6,1,1006,89,18845,1498,183514,202359,8/14/2020
7/29/2020,159,27377,4740,332714,360091,10,2223,12,1832,0,312,79,15,6,0,1006,144,18989,2072,185586,204575,8/14/2020
7/30/2020,96,27473,3935,336649,364122,5,2228,2,1834,1,313,81,15,5,0,1006,75,19064,1351,186937,206001,8/14/2020
7/31/2020,115,27588,5062,341711,369299,8,2236,9,1843,0,313,80,15,6,0,1006,85,19149,1612,188549,207698,8/14/2020
8/1/2020,88,27676,3886,345597,373273,7,2243,2,1845,0,313,85,14,6,1,1007,77,19226,1321,189870,209096,8/14/2020
8/2/2020,77,27753,2656,348253,376006,12,2255,12,1857,1,314,84,14,7,2,1009,66,19292,1194,191064,210356,8/14/2020
8/3/2020,166,27919,4798,353051,380970,13,2268,12,1869,0,314,85,16,6,1,1010,146,19438,1903,192967,212405,8/14/2020
8/4/2020,117,28036,3397,356448,384484,7,2275,6,1875,1,315,85,12,4,2,1012,99,19537,1593,194560,214097,8/14/2020
8/5/2020,138,28174,5344,361792,389966,12,2287,9,1884,1,316,87,10,4,2,1014,111,19648,2047,196607,216255,8/14/2020
8/6/2020,154,28328,4626,366418,394746,5,2292,9,1893,0,316,83,9,3,0,1014,111,19759,1786,198393,218152,8/14/2020
8/7/2020,101,28429,4126,370544,398973,12,2304,10,1903,1,317,84,9,2,1,1015,83,19842,1660,200053,219895,8/14/2020
8/8/2020,102,28531,3298,373842,402373,19,2323,6,1909,1,318,96,8,2,1,1016,91,19933,1495,201548,221481,8/14/2020
8/9/2020,35,28566,1522,375364,403930,7,2330,11,1920,0,318,92,9,3,0,1016,32,19965,947,202495,222460,8/14/2020
8/10/2020,127,28693,4015,379379,408072,9,2339,10,1930,0,318,91,9,3,1,1017,107,20072,1649,204144,224216,8/14/2020
8/11/2020,99,28792,3879,383258,412050,4,2343,14,1944,0,318,81,9,3,2,1019,93,20165,2008,206152,226317,8/14/2020
8/12/2020,115,28907,4123,387381,416288,7,2350,9,1953,0,318,79,8,3,2,1021,100,20265,2102,208254,228519,8/14/2020
8/13/2020,100,29007,3085,390466,419473,,,,,,,,,,0,1021,70,20335,1276,209530,229865,8/14/2020
2/27/2020,0,0,0,0,0,1,1,0,0,0,0,1,0,0,0,0,0,0,0,0,0,8/17/2020
2/28/2020,0,0,0,0,0,0,1,0,0,0,0,1,1,0,0,0,0,0,0,0,0,8/17/2020
2/29/2020,0,0,0,0,0,0,1,0,0,0,0,1,1,0,0,0,0,0,0,0,0,8/17/2020
3/1/2020,2,2,2,2,4,0,1,0,0,0,0,1,1,1,0,0,2,2,2,2,4,8/17/2020
3/2/2020,0,2,1,3,5,1,2,0,0,0,0,2,2,2,0,0,0,2,1,3,5,8/17/2020
3/3/2020,0,2,2,5,7,0,2,0,0,0,0,2,2,2,0,0,0,2,2,5,7,8/17/2020
3/4/2020,0,2,12,17,19,1,3,0,0,0,0,3,2,2,0,0,0,2,10,15,17,8/17/2020
3/5/2020,0,2,4,21,23,0,3,0,0,0,0,3,2,2,0,0,1,3,4,19,22,8/17/2020
3/6/2020,1,3,12,33,36,0,3,0,0,0,0,3,2,2,0,0,0,3,11,30,33,8/17/2020
3/7/2020,0,3,19,52,55,0,3,0,0,0,0,3,2,1,0,0,0,3,19,49,52,8/17/2020
3/8/2020,0,3,18,70,73,0,3,0,0,0,0,3,2,1,0,0,0,3,18,67,70,8/17/2020
3/9/2020,1,4,15,85,89,0,3,0,0,0,0,3,2,1,0,0,1,4,15,82,86,8/17/2020
3/10/2020,2,6,25,110,116,0,3,0,0,0,0,3,2,1,0,0,1,5,23,105,110,8/17/2020
3/11/2020,0,6,34,144,150,1,4,0,0,0,0,4,1,1,0,0,0,5,34,139,144,8/17/2020
3/12/2020,9,15,41,185,200,1,5,0,0,0,0,5,1,1,0,0,8,13,38,177,190,8/17/2020
3/13/2020,6,21,50,235,256,4,9,1,1,0,0,8,1,1,0,0,6,19,48,225,244,8/17/2020
3/14/2020,0,21,90,325,346,0,9,0,1,0,0,8,1,1,0,0,0,19,86,311,330,8/17/2020
3/15/2020,1,22,54,379,401,1,10,0,1,0,0,9,2,1,0,0,1,20,54,365,385,8/17/2020
3/16/2020,2,24,95,474,498,2,12,0,1,0,0,11,2,0,0,0,2,22,92,457,479,8/17/2020
3/17/2020,12,36,162,636,672,6,18,0,1,0,0,17,2,0,0,0,11,33,152,609,642,8/17/2020
3/18/2020,9,45,116,752,797,3,21,0,1,0,0,20,2,0,0,0,11,44,111,720,764,8/17/2020
3/19/2020,15,60,262,1014,1074,2,23,1,2,0,0,21,3,0,1,1,17,61,251,971,1032,8/17/2020
3/20/2020,13,73,197,1211,1284,5,28,0,2,0,0,26,4,0,0,1,13,74,192,1163,1237,8/17/2020
3/21/2020,12,85,126,1337,1422,3,31,2,4,0,0,27,5,0,0,1,14,88,123,1286,1374,8/17/2020
3/22/2020,27,112,282,1619,1731,2,33,0,4,0,0,29,5,0,0,1,25,113,263,1549,1662,8/17/2020
3/23/2020,14,126,169,1788,1914,15,48,1,5,0,0,43,9,3,0,1,16,129,165,1714,1843,8/17/2020
3/24/2020,20,146,242,2030,2176,7,55,0,5,0,0,50,10,4,0,1,19,148,238,1952,2100,8/17/2020
3/25/2020,26,172,182,2212,2384,5,60,1,6,0,0,54,11,3,0,1,28,176,173,2125,2301,8/17/2020
3/26/2020,35,207,181,2393,2600,10,70,5,11,0,0,59,14,5,0,1,41,217,176,2301,2518,8/17/2020
3/27/2020,27,234,214,2607,2841,9,79,1,12,1,1,66,17,6,2,3,31,248,202,2503,2751,8/17/2020
3/28/2020,59,293,260,2867,3160,13,92,3,15,2,3,74,15,6,1,4,63,311,242,2745,3056,8/17/2020
3/29/2020,100,393,350,3217,3610,8,100,4,19,1,4,77,18,8,2,6,105,416,314,3059,3475,8/17/2020
3/30/2020,62,455,222,3439,3894,20,120,5,24,0,4,92,20,11,3,9,78,494,191,3250,3744,8/17/2020
3/31/2020,71,526,369,3808,4334,11,131,7,31,1,5,95,22,13,2,11,73,567,298,3548,4115,8/17/2020
4/1/2020,99,625,698,4506,5131,18,149,7,38,0,5,106,30,15,1,12,100,667,648,4196,4863,8/17/2020
4/2/2020,52,677,477,4983,5660,21,170,6,44,2,7,119,36,21,4,16,62,729,436,4632,5361,8/17/2020
4/3/2020,108,785,774,5757,6542,23,193,7,51,0,7,135,43,25,3,19,100,829,716,5348,6177,8/17/2020
4/4/2020,143,928,660,6417,7345,22,215,4,55,5,12,148,41,30,9,28,138,967,620,5968,6935,8/17/2020
4/5/2020,187,1115,1156,7573,8688,20,235,9,64,1,13,158,44,36,2,30,182,1149,1071,7039,8188,8/17/2020
4/6/2020,218,1333,1706,9279,10612,26,261,7,71,0,13,177,48,40,7,37,206,1355,1576,8615,9970,8/17/2020
4/7/2020,284,1617,1629,10908,12525,20,281,3,74,2,15,192,49,42,5,42,260,1615,1487,10102,11717,8/17/2020
4/8/2020,290,1907,1720,12628,14535,19,300,7,81,6,21,198,49,38,10,52,272,1887,1568,11670,13557,8/17/2020
4/9/2020,283,2190,1516,14144,16334,32,332,9,90,4,25,217,52,40,7,59,278,2165,1364,13034,15199,8/17/2020
4/10/2020,419,2609,2574,16718,19327,28,360,17,107,5,30,223,58,41,11,70,403,2568,2379,15413,17981,8/17/2020
4/11/2020,297,2906,1905,18623,21529,29,389,11,118,2,32,239,61,48,12,82,281,2849,1726,17139,19988,8/17/2020
4/12/2020,314,3220,1670,20293,23513,35,424,13,131,5,37,256,59,49,9,91,289,3138,1441,18580,21718,8/17/2020
4/13/2020,161,3381,935,21228,24609,35,459,13,144,3,40,275,64,54,9,100,187,3325,844,19424,22749,8/17/2020
4/14/2020,289,3670,1787,23015,26685,27,486,16,160,5,45,281,72,53,8,108,265,3590,1533,20957,24547,8/17/2020
4/15/2020,351,4021,1799,24814,28835,31,517,19,179,3,48,290,72,54,17,125,307,3897,1569,22526,26423,8/17/2020
4/16/2020,447,4468,2494,27308,31776,36,553,25,204,6,54,295,72,53,14,139,392,4289,2093,24619,28908,8/17/2020
4/17/2020,304,4772,1821,29129,33901,32,585,20,224,7,61,300,66,45,21,160,291,4580,1466,26085,30665,8/17/2020
4/18/2020,321,5093,1725,30854,35947,26,611,18,242,4,65,304,63,49,15,175,284,4864,1354,27439,32303,8/17/2020
4/19/2020,381,5474,2047,32901,38375,23,634,26,268,1,66,300,65,55,11,186,338,5202,1753,29192,34394,8/17/2020
4/20/2020,394,5868,1907,34808,40676,46,680,29,297,2,68,315,75,56,10,196,377,5579,1584,30776,36355,8/17/2020
4/21/2020,444,6312,2110,36918,43230,45,725,31,328,5,73,324,72,56,18,214,390,5969,1722,32498,38467,8/17/2020
4/22/2020,418,6730,2390,39308,46038,41,766,32,360,5,78,328,73,58,18,232,382,6351,1922,34420,40771,8/17/2020
4/23/2020,479,7209,2469,41777,48986,30,796,28,388,5,83,325,76,62,15,247,418,6769,1878,36298,43067,8/17/2020
4/24/2020,491,7700,3284,45061,52761,35,831,27,415,4,87,329,85,63,15,262,413,7182,2644,38942,46124,8/17/2020
4/25/2020,393,8093,2206,47267,55360,34,865,17,432,5,92,341,85,62,14,276,305,7487,1783,40725,48212,8/17/2020
4/26/2020,316,8409,2309,49576,57985,33,898,15,447,3,95,356,86,59,14,290,276,7763,1887,42612,50375,8/17/2020
4/27/2020,249,8658,1620,51196,59854,29,927,21,468,4,99,360,86,61,10,300,204,7967,1165,43777,51744,8/17/2020
4/28/2020,410,9068,2263,53459,62527,44,971,24,492,3,102,377,88,59,22,322,325,8292,1772,45549,53841,8/17/2020
4/29/2020,476,9544,3343,56802,66346,36,1007,37,529,11,113,365,78,53,18,340,372,8664,2447,47996,56660,8/17/2020
4/30/2020,432,9976,2769,59571,69547,33,1040,38,567,6,119,354,83,57,24,364,347,9011,1959,49955,58966,8/17/2020
5/1/2020,454,10430,3086,62657,73087,51,1091,39,606,3,122,363,84,58,14,378,317,9328,2221,52176,61504,8/17/2020
5/2/2020,257,10687,1926,64583,75270,36,1127,39,645,5,127,355,91,62,24,402,189,9517,1295,53471,62988,8/17/2020
5/3/2020,283,10970,2160,66743,77713,31,1158,27,672,8,135,351,90,61,21,423,182,9699,1608,55079,64778,8/17/2020
5/4/2020,387,11357,2098,68841,80198,30,1188,31,703,5,140,345,88,57,18,441,293,9992,1574,56653,66645,8/17/2020
5/5/2020,433,11790,2873,71714,83504,29,1217,32,735,6,146,336,82,54,16,457,304,10296,1971,58624,68920,8/17/2020
5/6/2020,488,12278,2829,74543,86821,28,1245,44,779,9,155,311,79,54,21,478,341,10637,1927,60551,71188,8/17/2020
5/7/2020,425,12703,2969,77512,90215,36,1281,42,821,5,160,300,71,52,21,499,269,10906,1989,62540,73446,8/17/2020
5/8/2020,359,13062,2598,80110,93172,30,1311,29,850,5,165,296,71,53,22,521,231,11137,1772,64312,75449,8/17/2020
5/9/2020,454,13516,3346,83456,96972,22,1333,21,871,4,169,293,69,51,15,536,285,11422,2305,66617,78039,8/17/2020
5/10/2020,280,13796,2117,85573,99369,19,1352,23,894,6,175,283,70,49,13,549,186,11608,1527,68144,79752,8/17/2020
5/11/2020,257,14053,1857,87430,101483,31,1383,16,910,6,181,292,71,49,15,564,176,11784,1312,69456,81240,8/17/2020
5/12/2020,387,14440,2611,90041,104481,23,1406,18,928,4,185,293,69,48,22,586,217,12001,1717,71173,83174,8/17/2020
5/13/2020,351,14791,3630,93671,108462,22,1428,24,952,1,186,290,69,49,13,599,196,12197,2023,73196,85393,8/17/2020
5/14/2020,329,15120,3408,97079,112199,19,1447,27,979,3,189,279,64,45,15,614,227,12424,2022,75218,87642,8/17/2020
5/15/2020,381,15501,3458,100537,116038,24,1471,41,1020,5,194,257,62,45,13,627,234,12658,1817,77035,89693,8/17/2020
5/16/2020,434,15935,4156,104693,120628,25,1496,12,1032,5,199,265,61,46,15,642,251,12909,1969,79004,91913,8/17/2020
5/17/2020,231,16166,2768,107461,123627,17,1513,7,1039,5,204,270,59,45,10,652,124,13033,1568,80572,93605,8/17/2020
5/18/2020,250,16416,2001,109462,125878,19,1532,15,1054,5,209,269,57,40,18,670,139,13172,1374,81946,95118,8/17/2020
5/19/2020,415,16831,3168,112630,129461,23,1555,32,1086,5,214,255,56,38,11,681,212,13384,1943,83889,97273,8/17/2020
5/20/2020,326,17157,2770,115400,132557,19,1574,23,1109,7,221,244,52,33,22,703,187,13571,1522,85411,98982,8/17/2020
5/21/2020,374,17531,3757,119157,136688,26,1600,15,1124,3,224,252,53,29,20,723,170,13741,1952,87363,101104,8/17/2020
5/22/2020,349,17880,3161,122318,140198,20,1620,29,1153,5,229,238,52,29,10,733,204,13945,1615,88978,102923,8/17/2020
5/23/2020,240,18120,2742,125060,143180,19,1639,11,1164,3,232,243,52,32,13,746,109,14054,1284,90262,104316,8/17/2020
5/24/2020,151,18271,1370,126430,144701,12,1651,14,1178,2,234,239,53,36,8,754,84,14138,774,91036,105174,8/17/2020
5/25/2020,134,18405,1385,127815,146220,12,1663,14,1192,0,234,237,53,34,10,764,70,14208,765,91801,106009,8/17/2020
5/26/2020,284,18689,2620,130435,149124,24,1687,22,1214,5,239,234,48,33,15,779,155,14363,1785,93586,107949,8/17/2020
5/27/2020,276,18965,2065,132500,151465,20,1707,17,1231,3,242,234,50,33,10,789,133,14496,1143,94729,109225,8/17/2020
5/28/2020,345,19310,3371,135871,155181,17,1724,29,1260,4,246,218,47,32,8,797,133,14629,1131,95860,110489,8/17/2020
5/29/2020,412,19722,3928,139799,159521,18,1742,27,1287,6,252,203,43,31,12,809,179,14808,1590,97450,112258,8/17/2020
5/30/2020,208,19930,3915,143714,163644,15,1757,19,1306,4,256,195,40,29,12,821,104,14912,1827,99277,114189,8/17/2020
5/31/2020,144,20074,1682,145396,165470,10,1767,10,1316,0,256,195,43,26,3,824,76,14988,855,100132,115120,8/17/2020
6/1/2020,213,20287,2781,148177,168464,7,1774,13,1329,1,257,188,44,29,5,829,98,15086,1376,101508,116594,8/17/2020
6/2/2020,273,20560,3025,151202,171762,8,1782,9,1338,3,260,184,37,25,10,839,107,15193,1466,102974,118167,8/17/2020
6/3/2020,253,20813,3482,154684,175497,13,1795,18,1356,6,266,173,34,25,11,850,105,15298,1672,104646,119944,8/17/2020
6/4/2020,276,21089,4458,159142,180231,7,1802,25,1381,3,269,152,31,24,11,861,114,15412,2041,106687,122099,8/17/2020
6/5/2020,214,21303,3513,162655,183958,15,1817,12,1393,5,274,150,27,21,9,870,105,15517,1578,108265,123782,8/17/2020
6/6/2020,196,21499,2608,165263,186762,10,1827,7,1400,2,276,151,29,19,6,876,68,15585,1134,109399,124984,8/17/2020
6/7/2020,77,21576,1610,166873,188449,11,1838,7,1407,1,277,154,25,17,4,880,49,15634,777,110176,125810,8/17/2020
6/8/2020,121,21697,1845,168718,190415,15,1853,12,1419,2,279,155,27,18,4,884,44,15678,964,111140,126818,8/17/2020
6/9/2020,225,21922,2665,171383,193305,10,1863,18,1437,0,279,147,28,21,1,885,67,15745,1262,112402,128147,8/17/2020
6/10/2020,209,22131,2970,174353,196484,13,1876,12,1449,2,281,146,24,17,3,888,104,15849,1456,113858,129707,8/17/2020
6/11/2020,195,22326,3492,177845,200171,7,1883,15,1464,1,282,137,25,16,6,894,88,15937,1528,115386,131323,8/17/2020
6/12/2020,213,22539,4592,182437,204976,8,1891,15,1479,1,283,129,24,16,2,896,80,16017,2187,117573,133590,8/17/2020
6/13/2020,110,22649,3020,185457,208106,6,1897,4,1483,0,283,131,20,15,3,899,50,16067,1368,118941,135008,8/17/2020
6/14/2020,77,22726,2033,187490,210216,6,1903,8,1491,1,284,128,20,14,3,902,32,16099,964,119905,136004,8/17/2020
6/15/2020,188,22914,3096,190586,213500,14,1917,14,1505,0,284,128,20,16,4,906,78,16177,1785,121690,137867,8/17/2020
6/16/2020,114,23028,3004,193590,216618,11,1928,10,1515,1,285,128,22,16,8,914,52,16229,1575,123265,139494,8/17/2020
6/17/2020,122,23150,2819,196409,219559,15,1943,20,1535,4,289,119,18,14,6,920,52,16281,1315,124580,140861,8/17/2020
6/18/2020,150,23300,3030,199439,222739,9,1952,13,1548,1,290,114,19,16,7,927,70,16351,1329,125909,142260,8/17/2020
6/19/2020,141,23441,3758,203197,226638,12,1964,11,1559,1,291,114,20,17,3,930,59,16410,1372,127281,143691,8/17/2020
6/20/2020,80,23521,1878,205075,228596,8,1972,10,1569,0,291,112,20,18,4,934,36,16446,811,128092,144538,8/17/2020
6/21/2020,36,23557,1036,206111,229668,7,1979,5,1574,0,291,114,20,18,2,936,27,16473,677,128769,145242,8/17/2020
6/22/2020,142,23699,3704,209815,233514,12,1991,16,1590,0,291,110,19,18,1,937,70,16543,1703,130472,147015,8/17/2020
6/23/2020,162,23861,3826,213641,237502,3,1994,13,1603,3,294,97,18,18,6,943,83,16626,1792,132264,148890,8/17/2020
6/24/2020,121,23982,3493,217134,241116,9,2003,10,1613,1,295,95,18,18,5,948,47,16673,1692,133956,150629,8/17/2020
6/25/2020,102,24084,2869,220003,244087,5,2008,14,1627,1,296,85,17,17,1,949,52,16725,1507,135463,152188,8/17/2020
6/26/2020,94,24178,2443,222446,246624,2,2010,9,1636,0,296,78,18,18,1,950,64,16789,1301,136764,153553,8/17/2020
6/27/2020,84,24262,3200,225646,249908,5,2015,3,1639,1,297,79,17,17,5,955,37,16826,1213,137977,154803,8/17/2020
6/28/2020,36,24298,1450,227096,251394,4,2019,4,1643,4,301,75,15,14,6,961,18,16844,586,138563,155407,8/17/2020
6/29/2020,86,24384,3670,230766,255150,4,2023,5,1648,0,301,74,14,14,1,962,39,16883,1344,139907,156790,8/17/2020
6/30/2020,60,24444,1937,232703,257147,1,2024,5,1653,1,302,69,12,11,3,965,35,16918,993,140900,157818,8/17/2020
7/1/2020,144,24588,4094,236797,261385,7,2031,9,1662,0,302,67,11,11,1,966,81,16999,1949,142849,159848,8/17/2020
7/2/2020,101,24689,2775,239572,264261,5,2036,5,1667,1,303,66,9,9,1,967,56,17055,1074,143923,160978,8/17/2020
7/3/2020,47,24736,2010,241582,266318,7,2043,6,1673,0,303,67,8,8,3,970,25,17080,770,144693,161773,8/17/2020
7/4/2020,57,24793,2317,243899,268692,2,2045,4,1677,1,304,64,9,8,2,972,34,17114,989,145682,162796,8/17/2020
7/5/2020,45,24838,2917,246816,271654,1,2046,2,1679,1,305,62,7,7,2,974,23,17137,1442,147124,164261,8/17/2020
7/6/2020,103,24941,2784,249600,274541,6,2052,6,1685,0,305,62,8,9,4,978,60,17197,1542,148666,165863,8/17/2020
7/7/2020,80,25021,3433,253033,278054,5,2057,6,1691,0,305,61,7,8,1,979,47,17244,1530,150196,167440,8/17/2020
7/8/2020,104,25125,3373,256406,281531,4,2061,2,1693,0,305,63,8,8,0,979,66,17310,1417,151613,168923,8/17/2020
7/9/2020,93,25218,3654,260060,285278,8,2069,2,1695,0,305,69,8,8,0,979,49,17359,1593,153206,170565,8/17/2020
7/10/2020,129,25347,4378,264438,289785,5,2074,3,1698,2,307,69,7,7,3,982,79,17438,2078,155284,172722,8/17/2020
7/11/2020,62,25409,2872,267310,292719,6,2080,3,1701,1,308,71,6,6,3,985,34,17472,1278,156562,174034,8/17/2020
7/12/2020,45,25454,1759,269069,294523,1,2081,2,1703,1,309,69,6,5,3,988,33,17505,885,157447,174952,8/17/2020
7/13/2020,85,25539,3137,272206,297745,8,2089,10,1713,0,309,67,6,5,1,989,57,17562,1469,158916,176478,8/17/2020
7/14/2020,74,25613,3239,275445,301058,7,2096,4,1717,0,309,70,5,5,1,990,49,17611,1347,160263,177874,8/17/2020
7/15/2020,123,25736,4109,279554,305290,5,2101,6,1723,0,309,69,5,4,0,990,94,17705,1724,161987,179692,8/17/2020
7/16/2020,102,25838,3672,283226,309064,6,2107,9,1732,0,309,66,6,5,1,991,78,17783,1590,163577,181360,8/17/2020
7/17/2020,150,25988,4113,287339,313327,14,2121,3,1735,1,310,76,5,5,1,992,78,17861,1795,165372,183233,8/17/2020
7/18/2020,80,26068,3152,290491,316559,5,2126,9,1744,1,311,71,5,4,4,996,67,17928,1329,166701,184629,8/17/2020
7/19/2020,81,26149,2570,293061,319210,6,2132,3,1747,0,311,74,6,4,2,998,59,17987,1068,167769,185756,8/17/2020
7/20/2020,72,26221,2621,295682,321903,9,2141,7,1754,0,311,76,7,5,2,1000,62,18049,1445,169214,187263,8/17/2020
7/21/2020,127,26348,4208,299890,326238,9,2150,10,1764,0,311,75,9,6,1,1001,104,18153,1869,171083,189236,8/17/2020
7/22/2020,123,26471,3777,303667,330138,11,2161,11,1775,1,312,74,7,6,1,1002,86,18239,1580,172663,190902,8/17/2020
7/23/2020,123,26594,4066,307733,334327,8,2169,5,1780,0,312,77,8,7,0,1002,104,18343,1762,174425,192768,8/17/2020
7/24/2020,160,26754,5673,313406,340160,14,2183,14,1794,0,312,77,9,7,0,1002,119,18462,2144,176569,195031,8/17/2020
7/25/2020,125,26879,4247,317653,344532,7,2190,7,1801,0,312,77,10,8,1,1003,104,18566,1996,178565,197131,8/17/2020
7/26/2020,56,26935,2955,320608,347543,8,2198,9,1810,0,312,76,11,6,1,1004,52,18618,1294,179859,198477,8/17/2020
7/27/2020,182,27117,3864,324472,351589,12,2210,7,1817,0,312,81,13,7,1,1005,138,18756,2110,181969,200725,8/17/2020
7/28/2020,105,27222,3655,328127,355349,5,2215,5,1822,0,312,81,14,6,1,1006,88,18844,1519,183488,202332,8/17/2020
7/29/2020,161,27383,4766,332893,360276,10,2225,12,1834,0,312,79,15,6,0,1006,144,18988,2083,185571,204559,8/17/2020
7/30/2020,96,27479,3935,336828,364307,6,2231,2,1836,1,313,82,15,5,0,1006,76,19064,1351,186922,205986,8/17/2020
7/31/2020,115,27594,5064,341892,369486,8,2239,9,1845,0,313,81,15,6,0,1006,86,19150,1613,188535,207685,8/17/2020
8/1/2020,88,27682,3886,345778,373460,7,2246,2,1847,0,313,86,14,6,1,1007,77,19227,1319,189854,209081,8/17/2020
8/2/2020,77,27759,2656,348434,376193,12,2258,12,1859,1,314,85,14,7,2,1009,65,19292,1181,191035,210327,8/17/2020
8/3/2020,166,27925,4798,353232,381157,13,2271,12,1871,0,314,86,16,6,1,1010,146,19438,1900,192935,212373,8/17/2020
8/4/2020,117,28042,3398,356630,384672,7,2278,6,1877,1,315,86,12,4,2,1012,99,19537,1591,194526,214063,8/17/2020
8/5/2020,138,28180,5343,361973,390153,12,2290,10,1887,1,316,87,10,4,2,1014,112,19649,2046,196572,216221,8/17/2020
8/6/2020,154,28334,4627,366600,394934,5,2295,9,1896,0,316,83,9,3,0,1014,113,19762,1780,198352,218114,8/17/2020
8/7/2020,102,28436,4125,370725,399161,13,2308,10,1906,1,317,85,9,2,1,1015,83,19845,1660,200012,219857,8/17/2020
8/8/2020,103,28539,3659,374384,402923,19,2327,6,1912,1,318,97,8,2,1,1016,90,19935,1507,201519,221454,8/17/2020
8/9/2020,35,28574,1522,375906,404480,7,2334,11,1923,0,318,93,9,3,0,1016,32,19967,947,202466,222433,8/17/2020
8/10/2020,133,28707,4026,379932,408639,10,2344,11,1934,0,318,92,9,3,1,1017,109,20076,1652,204118,224194,8/17/2020
8/11/2020,99,28806,3896,383828,412634,5,2349,14,1948,0,318,83,10,3,2,1019,94,20170,2011,206129,226299,8/17/2020
8/12/2020,115,28921,4492,388320,417241,7,2356,10,1958,0,318,80,9,2,2,1021,103,20273,2167,208296,228569,8/17/2020
8/13/2020,109,29030,3383,391703,420733,8,2364,7,1965,0,318,81,11,2,0,1021,85,20358,1488,209784,230142,8/17/2020
8/14/2020,124,29154,4458,396161,425315,11,2375,7,1972,0,318,85,11,2,1,1022,81,20439,1543,211327,231766,8/17/2020
8/15/2020,92,29246,3570,399731,428977,5,2380,10,1982,0,318,80,11,3,0,1022,75,20514,1237,212564,233078,8/17/2020
8/16/2020,71,29317,1957,401688,431005,,,,,,,,,,1,1023,58,20572,686,213250,233822,8/17/2020
2/27/2020,0,0,0,0,0,1,1,0,0,0,0,1,0,0,0,0,0,0,0,0,0,8/18/2020
2/28/2020,0,0,0,0,0,0,1,0,0,0,0,1,1,0,0,0,0,0,0,0,0,8/18/2020
2/29/2020,0,0,0,0,0,0,1,0,0,0,0,1,1,0,0,0,0,0,0,0,0,8/18/2020
3/1/2020,2,2,2,2,4,0,1,0,0,0,0,1,1,1,0,0,2,2,2,2,4,8/18/2020
3/2/2020,0,2,1,3,5,1,2,0,0,0,0,2,2,2,0,0,0,2,1,3,5,8/18/2020
3/3/2020,0,2,2,5,7,0,2,0,0,0,0,2,2,2,0,0,0,2,2,5,7,8/18/2020
3/4/2020,0,2,12,17,19,1,3,0,0,0,0,3,2,2,0,0,0,2,10,15,17,8/18/2020
3/5/2020,0,2,4,21,23,0,3,0,0,0,0,3,2,2,0,0,1,3,4,19,22,8/18/2020
3/6/2020,1,3,12,33,36,0,3,0,0,0,0,3,2,2,0,0,0,3,11,30,33,8/18/2020
3/7/2020,0,3,19,52,55,0,3,0,0,0,0,3,2,1,0,0,0,3,19,49,52,8/18/2020
3/8/2020,0,3,18,70,73,0,3,0,0,0,0,3,2,1,0,0,0,3,18,67,70,8/18/2020
3/9/2020,1,4,15,85,89,0,3,0,0,0,0,3,2,1,0,0,1,4,15,82,86,8/18/2020
3/10/2020,2,6,25,110,116,0,3,0,0,0,0,3,2,1,0,0,1,5,23,105,110,8/18/2020
3/11/2020,0,6,34,144,150,1,4,0,0,0,0,4,1,1,0,0,0,5,34,139,144,8/18/2020
3/12/2020,9,15,41,185,200,1,5,0,0,0,0,5,1,1,0,0,8,13,38,177,190,8/18/2020
3/13/2020,6,21,50,235,256,4,9,1,1,0,0,8,1,1,0,0,6,19,48,225,244,8/18/2020
3/14/2020,0,21,90,325,346,0,9,0,1,0,0,8,1,1,0,0,0,19,86,311,330,8/18/2020
3/15/2020,1,22,54,379,401,1,10,0,1,0,0,9,2,1,0,0,1,20,54,365,385,8/18/2020
3/16/2020,2,24,95,474,498,2,12,0,1,0,0,11,2,0,0,0,2,22,92,457,479,8/18/2020
3/17/2020,12,36,162,636,672,6,18,0,1,0,0,17,2,0,0,0,11,33,152,609,642,8/18/2020
3/18/2020,9,45,116,752,797,3,21,0,1,0,0,20,2,0,0,0,11,44,111,720,764,8/18/2020
3/19/2020,15,60,262,1014,1074,2,23,1,2,0,0,21,3,0,1,1,17,61,251,971,1032,8/18/2020
3/20/2020,13,73,197,1211,1284,5,28,0,2,0,0,26,4,0,0,1,13,74,192,1163,1237,8/18/2020
3/21/2020,12,85,126,1337,1422,3,31,2,4,0,0,27,5,0,0,1,14,88,123,1286,1374,8/18/2020
3/22/2020,27,112,282,1619,1731,2,33,0,4,0,0,29,5,0,0,1,25,113,263,1549,1662,8/18/2020
3/23/2020,14,126,169,1788,1914,15,48,1,5,0,0,43,9,3,0,1,16,129,165,1714,1843,8/18/2020
3/24/2020,20,146,242,2030,2176,7,55,0,5,0,0,50,10,4,0,1,19,148,238,1952,2100,8/18/2020
3/25/2020,26,172,182,2212,2384,5,60,1,6,0,0,54,11,3,0,1,28,176,173,2125,2301,8/18/2020
3/26/2020,35,207,181,2393,2600,10,70,5,11,0,0,59,14,5,0,1,41,217,176,2301,2518,8/18/2020
3/27/2020,27,234,214,2607,2841,9,79,1,12,1,1,66,17,6,2,3,31,248,202,2503,2751,8/18/2020
3/28/2020,59,293,260,2867,3160,13,92,3,15,2,3,74,15,6,1,4,63,311,242,2745,3056,8/18/2020
3/29/2020,100,393,350,3217,3610,8,100,4,19,1,4,77,18,8,2,6,105,416,314,3059,3475,8/18/2020
3/30/2020,62,455,222,3439,3894,20,120,5,24,0,4,92,20,11,3,9,78,494,191,3250,3744,8/18/2020
3/31/2020,71,526,369,3808,4334,11,131,7,31,1,5,95,22,13,2,11,73,567,298,3548,4115,8/18/2020
4/1/2020,99,625,698,4506,5131,18,149,7,38,0,5,106,30,15,1,12,100,667,647,4195,4862,8/18/2020
4/2/2020,52,677,477,4983,5660,22,171,6,44,2,7,120,36,21,4,16,62,729,436,4631,5360,8/18/2020
4/3/2020,108,785,774,5757,6542,23,194,7,51,0,7,136,43,25,3,19,100,829,716,5347,6176,8/18/2020
4/4/2020,143,928,660,6417,7345,22,216,4,55,5,12,149,41,30,9,28,138,967,620,5967,6934,8/18/2020
4/5/2020,187,1115,1156,7573,8688,20,236,9,64,1,13,159,44,36,2,30,182,1149,1071,7038,8187,8/18/2020
4/6/2020,218,1333,1706,9279,10612,26,262,7,71,0,13,178,48,40,7,37,206,1355,1576,8614,9969,8/18/2020
4/7/2020,284,1617,1629,10908,12525,20,282,3,74,2,15,193,50,42,5,42,260,1615,1487,10101,11716,8/18/2020
4/8/2020,290,1907,1720,12628,14535,19,301,7,81,6,21,199,50,38,10,52,272,1887,1568,11669,13556,8/18/2020
4/9/2020,283,2190,1516,14144,16334,32,333,9,90,4,25,218,53,40,7,59,278,2165,1364,13033,15198,8/18/2020
4/10/2020,419,2609,2574,16718,19327,28,361,17,107,5,30,224,59,41,11,70,403,2568,2379,15412,17980,8/18/2020
4/11/2020,297,2906,1905,18623,21529,29,390,11,118,2,32,240,61,48,12,82,281,2849,1726,17138,19987,8/18/2020
4/12/2020,314,3220,1670,20293,23513,35,425,13,131,5,37,257,59,49,9,91,289,3138,1440,18578,21716,8/18/2020
4/13/2020,161,3381,935,21228,24609,35,460,13,144,3,40,276,64,54,9,100,187,3325,844,19422,22747,8/18/2020
4/14/2020,289,3670,1787,23015,26685,27,487,16,160,5,45,282,72,53,8,108,265,3590,1533,20955,24545,8/18/2020
4/15/2020,351,4021,1799,24814,28835,31,518,20,180,3,48,290,72,54,17,125,307,3897,1569,22524,26421,8/18/2020
4/16/2020,447,4468,2494,27308,31776,36,554,25,205,6,54,295,72,53,14,139,391,4288,2093,24617,28905,8/18/2020
4/17/2020,304,4772,1821,29129,33901,32,586,20,225,7,61,300,66,45,21,160,291,4579,1466,26083,30662,8/18/2020
4/18/2020,321,5093,1725,30854,35947,26,612,18,243,4,65,304,63,49,15,175,284,4863,1354,27437,32300,8/18/2020
4/19/2020,381,5474,2047,32901,38375,23,635,26,269,1,66,300,65,55,11,186,338,5201,1753,29190,34391,8/18/2020
4/20/2020,394,5868,1907,34808,40676,46,681,29,298,2,68,315,75,56,10,196,377,5578,1584,30774,36352,8/18/2020
4/21/2020,444,6312,2110,36918,43230,45,726,31,329,5,73,324,72,56,18,214,390,5968,1721,32495,38463,8/18/2020
4/22/2020,418,6730,2390,39308,46038,41,767,32,361,5,78,328,73,58,18,232,382,6350,1921,34416,40766,8/18/2020
4/23/2020,479,7209,2469,41777,48986,30,797,28,389,5,83,325,76,62,15,247,418,6768,1878,36294,43062,8/18/2020
4/24/2020,491,7700,3284,45061,52761,35,832,27,416,4,87,329,85,63,15,262,413,7181,2644,38938,46119,8/18/2020
4/25/2020,393,8093,2206,47267,55360,34,866,17,433,5,92,341,85,62,14,276,305,7486,1780,40718,48204,8/18/2020
4/26/2020,316,8409,2309,49576,57985,33,899,15,448,3,95,356,86,59,14,290,276,7762,1887,42605,50367,8/18/2020
4/27/2020,249,8658,1620,51196,59854,29,928,21,469,4,99,360,86,61,10,300,204,7966,1165,43770,51736,8/18/2020
4/28/2020,410,9068,2263,53459,62527,44,972,24,493,3,102,377,88,59,22,322,325,8291,1772,45542,53833,8/18/2020
4/29/2020,476,9544,3343,56802,66346,36,1008,37,530,11,113,365,78,53,18,340,372,8663,2446,47988,56651,8/18/2020
4/30/2020,432,9976,2769,59571,69547,33,1041,38,568,6,119,354,83,57,24,364,347,9010,1959,49947,58957,8/18/2020
5/1/2020,454,10430,3086,62657,73087,51,1092,40,608,3,122,362,84,58,14,378,317,9327,2221,52168,61495,8/18/2020
5/2/2020,257,10687,1926,64583,75270,36,1128,38,646,5,127,355,91,62,24,402,189,9516,1295,53463,62979,8/18/2020
5/3/2020,283,10970,2160,66743,77713,31,1159,27,673,8,135,351,90,61,21,423,182,9698,1608,55071,64769,8/18/2020
5/4/2020,387,11357,2098,68841,80198,30,1189,31,704,5,140,345,88,57,18,441,293,9991,1574,56645,66636,8/18/2020
5/5/2020,433,11790,2873,71714,83504,29,1218,32,736,6,146,336,82,54,16,457,304,10295,1970,58615,68910,8/18/2020
5/6/2020,488,12278,2829,74543,86821,28,1246,44,780,9,155,311,79,54,21,478,341,10636,1927,60542,71178,8/18/2020
5/7/2020,425,12703,2969,77512,90215,36,1282,42,822,5,160,300,71,52,21,499,269,10905,1988,62530,73435,8/18/2020
5/8/2020,359,13062,2598,80110,93172,30,1312,29,851,5,165,296,71,53,22,521,231,11136,1770,64300,75436,8/18/2020
5/9/2020,467,13529,3346,83456,96985,22,1334,21,872,4,169,293,69,51,15,536,286,11422,2304,66604,78026,8/18/2020
5/10/2020,285,13814,2117,85573,99387,19,1353,23,895,6,175,283,70,49,13,549,186,11608,1526,68130,79738,8/18/2020
5/11/2020,257,14071,1857,87430,101501,31,1384,16,911,6,181,292,71,49,15,564,176,11784,1311,69441,81225,8/18/2020
5/12/2020,387,14458,2611,90041,104499,23,1407,18,929,4,185,293,69,48,22,586,217,12001,1716,71157,83158,8/18/2020
5/13/2020,351,14809,3630,93671,108480,22,1429,24,953,1,186,290,69,49,13,599,196,12197,2023,73180,85377,8/18/2020
5/14/2020,329,15138,3408,97079,112217,19,1448,27,980,3,189,279,64,45,15,614,227,12424,2022,75202,87626,8/18/2020
5/15/2020,381,15519,3458,100537,116056,24,1472,41,1021,5,194,257,62,45,13,627,234,12658,1816,77018,89676,8/18/2020
5/16/2020,448,15967,4156,104693,120660,25,1497,12,1033,5,199,265,61,46,15,642,251,12909,1969,78987,91896,8/18/2020
5/17/2020,231,16198,2768,107461,123659,17,1514,7,1040,5,204,270,59,45,10,652,124,13033,1568,80555,93588,8/18/2020
5/18/2020,250,16448,2001,109462,125910,19,1533,15,1055,5,209,269,57,40,18,670,139,13172,1374,81929,95101,8/18/2020
5/19/2020,415,16863,3168,112630,129493,23,1556,32,1087,5,214,255,56,38,11,681,212,13384,1942,83871,97255,8/18/2020
5/20/2020,326,17189,2770,115400,132589,19,1575,23,1110,7,221,244,52,33,22,703,187,13571,1522,85393,98964,8/18/2020
5/21/2020,374,17563,3757,119157,136720,26,1601,15,1125,3,224,252,53,29,20,723,170,13741,1952,87345,101086,8/18/2020
5/22/2020,349,17912,3161,122318,140230,20,1621,29,1154,5,229,238,52,29,10,733,204,13945,1615,88960,102905,8/18/2020
5/23/2020,240,18152,2742,125060,143212,19,1640,11,1165,3,232,243,52,32,13,746,109,14054,1284,90244,104298,8/18/2020
5/24/2020,151,18303,1370,126430,144733,12,1652,14,1179,2,234,239,53,36,8,754,84,14138,773,91017,105155,8/18/2020
5/25/2020,134,18437,1385,127815,146252,12,1664,14,1193,0,234,237,53,34,10,764,70,14208,765,91782,105990,8/18/2020
5/26/2020,284,18721,2620,130435,149156,24,1688,22,1215,5,239,234,48,33,15,779,155,14363,1784,93566,107929,8/18/2020
5/27/2020,276,18997,2065,132500,151497,20,1708,17,1232,3,242,234,50,33,10,789,133,14496,1143,94709,109205,8/18/2020
5/28/2020,345,19342,3371,135871,155213,17,1725,29,1261,4,246,218,47,32,8,797,133,14629,1131,95840,110469,8/18/2020
5/29/2020,412,19754,3928,139799,159553,18,1743,27,1288,6,252,203,43,31,12,809,179,14808,1589,97429,112237,8/18/2020
5/30/2020,208,19962,3915,143714,163676,15,1758,19,1307,4,256,195,40,29,12,821,104,14912,1827,99256,114168,8/18/2020
5/31/2020,145,20107,1688,145402,165509,11,1769,10,1317,0,256,196,43,26,3,824,77,14989,860,100116,115105,8/18/2020
6/1/2020,214,20321,2792,148194,168515,8,1777,13,1330,1,257,190,44,29,5,829,98,15087,1385,101501,116588,8/18/2020
6/2/2020,273,20594,3033,151227,171821,8,1785,9,1339,3,260,186,37,25,10,839,107,15194,1468,102969,118163,8/18/2020
6/3/2020,254,20848,3495,154722,175570,13,1798,18,1357,6,266,175,34,25,11,850,105,15299,1678,104647,119946,8/18/2020
6/4/2020,277,21125,4474,159196,180321,7,1805,25,1382,3,269,154,31,24,11,861,114,15413,2049,106696,122109,8/18/2020
6/5/2020,215,21340,3521,162717,184057,15,1820,13,1395,6,275,150,27,21,9,870,106,15519,1583,108279,123798,8/18/2020
6/6/2020,196,21536,2618,165335,186871,10,1830,7,1402,2,277,151,29,19,6,876,68,15587,1139,109418,125005,8/18/2020
6/7/2020,77,21613,1625,166960,188573,11,1841,7,1409,1,278,154,25,17,4,880,49,15636,785,110203,125839,8/18/2020
6/8/2020,122,21735,1860,168820,190555,15,1856,12,1421,2,280,155,27,18,4,884,44,15680,974,111177,126857,8/18/2020
6/9/2020,225,21960,2688,171508,193468,10,1866,18,1439,0,280,147,28,21,1,885,67,15747,1276,112453,128200,8/18/2020
6/10/2020,211,22171,2986,174494,196665,13,1879,12,1451,2,282,146,24,17,3,888,105,15852,1468,113921,129773,8/18/2020
6/11/2020,195,22366,3516,178010,200376,7,1886,15,1466,1,283,137,25,16,6,894,88,15940,1542,115463,131403,8/18/2020
6/12/2020,214,22580,4608,182618,205198,9,1895,15,1481,1,284,130,24,16,2,896,81,16021,2193,117656,133677,8/18/2020
6/13/2020,110,22690,3038,185656,208346,6,1901,4,1485,0,284,132,20,15,3,899,50,16071,1380,119036,135107,8/18/2020
6/14/2020,77,22767,2046,187702,210469,6,1907,8,1493,1,285,129,20,14,3,902,32,16103,969,120005,136108,8/18/2020
6/15/2020,188,22955,3117,190819,213774,14,1921,14,1507,0,285,129,20,16,4,906,78,16181,1797,121802,137983,8/18/2020
6/16/2020,115,23070,3026,193845,216915,11,1932,10,1517,1,286,129,22,16,8,914,52,16233,1588,123390,139623,8/18/2020
6/17/2020,127,23197,2838,196683,219880,15,1947,20,1537,4,290,120,18,14,6,920,52,16285,1326,124716,141001,8/18/2020
6/18/2020,150,23347,3047,199730,223077,9,1956,13,1550,1,291,115,19,16,7,927,70,16355,1338,126054,142409,8/18/2020
6/19/2020,141,23488,3778,203508,226996,12,1968,11,1561,1,292,115,20,17,3,930,59,16414,1381,127435,143849,8/18/2020
6/20/2020,84,23572,1890,205398,228970,9,1977,12,1573,0,292,112,20,18,4,934,36,16450,816,128251,144701,8/18/2020
6/21/2020,37,23609,1064,206462,230071,7,1984,5,1578,0,292,114,20,18,2,936,29,16479,693,128944,145423,8/18/2020
6/22/2020,142,23751,3728,210190,233941,12,1996,16,1594,0,292,110,19,18,1,937,70,16549,1714,130658,147207,8/18/2020
6/23/2020,163,23914,3843,214033,237947,3,1999,13,1607,3,295,97,18,18,6,943,83,16632,1798,132456,149088,8/18/2020
6/24/2020,122,24036,3508,217541,241577,9,2008,10,1617,1,296,95,18,18,5,948,47,16679,1699,134155,150834,8/18/2020
6/25/2020,103,24139,2893,220434,244573,5,2013,14,1631,1,297,85,17,17,1,949,52,16731,1522,135677,152408,8/18/2020
6/26/2020,95,24234,2454,222888,247122,2,2015,9,1640,0,297,78,18,18,1,950,64,16795,1304,136981,153776,8/18/2020
6/27/2020,84,24318,3215,226103,250421,5,2020,3,1643,1,298,79,17,17,5,955,37,16832,1221,138202,155034,8/18/2020
6/28/2020,38,24356,1470,227573,251929,4,2024,4,1647,4,302,75,15,14,6,961,18,16850,597,138799,155649,8/18/2020
6/29/2020,88,24444,3697,231270,255714,4,2028,5,1652,0,302,74,14,14,1,962,40,16890,1353,140152,157042,8/18/2020
6/30/2020,58,24502,1960,233230,257732,1,2029,5,1657,1,303,69,12,11,3,965,35,16925,1000,141152,158077,8/18/2020
7/1/2020,144,24646,4109,237339,261985,7,2036,9,1666,0,303,67,11,11,1,966,81,17006,1954,143106,160112,8/18/2020
7/2/2020,102,24748,2797,240136,264884,5,2041,5,1671,1,304,66,9,9,1,967,56,17062,1087,144193,161255,8/18/2020
7/3/2020,51,24799,2028,242164,266963,9,2050,6,1677,0,304,69,8,8,3,970,26,17088,775,144968,162056,8/18/2020
7/4/2020,57,24856,2329,244493,269349,2,2052,4,1681,1,305,66,9,8,2,972,35,17123,995,145963,163086,8/18/2020
7/5/2020,49,24905,2932,247425,272330,1,2053,2,1683,1,306,64,7,7,2,974,23,17146,1451,147414,164560,8/18/2020
7/6/2020,103,25008,2812,250237,275245,6,2059,6,1689,0,306,64,8,9,4,978,60,17206,1559,148973,166179,8/18/2020
7/7/2020,81,25089,3452,253689,278778,5,2064,7,1696,0,306,62,7,8,1,979,47,17253,1529,150502,167755,8/18/2020
7/8/2020,106,25195,3391,257080,282275,4,2068,2,1698,0,306,64,8,8,0,979,66,17319,1419,151921,169240,8/18/2020
7/9/2020,93,25288,3668,260748,286036,9,2077,3,1701,0,306,70,8,8,0,979,49,17368,1601,153522,170890,8/18/2020
7/10/2020,131,25419,4398,265146,290565,6,2083,3,1704,2,308,71,7,7,3,982,80,17448,2090,155612,173060,8/18/2020
7/11/2020,62,25481,2893,268039,293520,6,2089,3,1707,1,309,73,6,6,3,985,34,17482,1291,156903,174385,8/18/2020
7/12/2020,45,25526,1781,269820,295346,1,2090,3,1710,1,310,70,6,5,3,988,33,17515,898,157801,175316,8/18/2020
7/13/2020,85,25611,3160,272980,298591,8,2098,10,1720,0,310,68,6,5,1,989,57,17572,1483,159284,176856,8/18/2020
7/14/2020,74,25685,3260,276240,301925,7,2105,4,1724,0,310,71,5,5,1,990,49,17621,1355,160639,178260,8/18/2020
7/15/2020,124,25809,4127,280367,306176,5,2110,7,1731,0,310,69,5,4,0,990,94,17715,1730,162369,180084,8/18/2020
7/16/2020,102,25911,3703,284070,309981,6,2116,9,1740,0,310,66,6,5,1,991,78,17793,1602,163971,181764,8/18/2020
7/17/2020,152,26063,4137,288207,314270,14,2130,3,1743,1,311,76,5,5,1,992,78,17871,1806,165777,183648,8/18/2020
7/18/2020,80,26143,3166,291373,317516,5,2135,9,1752,1,312,71,5,4,4,996,67,17938,1336,167113,185051,8/18/2020
7/19/2020,82,26225,2587,293960,320185,6,2141,3,1755,0,312,74,6,4,2,998,59,17997,1068,168181,186178,8/18/2020
7/20/2020,73,26298,2660,296620,322918,9,2150,7,1762,0,312,76,7,5,2,1000,62,18059,1467,169648,187707,8/18/2020
7/21/2020,127,26425,4229,300849,327274,9,2159,10,1772,0,312,75,9,6,1,1001,104,18163,1877,171525,189688,8/18/2020
7/22/2020,124,26549,3790,304639,331188,11,2170,11,1783,1,313,74,7,6,1,1002,86,18249,1579,173104,191353,8/18/2020
7/23/2020,123,26672,4089,308728,335400,8,2178,5,1788,0,313,77,8,7,0,1002,104,18353,1770,174874,193227,8/18/2020
7/24/2020,163,26835,5691,314419,341254,13,2191,13,1801,0,313,77,9,7,0,1002,119,18472,2151,177025,195497,8/18/2020
7/25/2020,126,26961,4265,318684,345645,7,2198,7,1808,0,313,77,10,8,1,1003,104,18576,2003,179028,197604,8/18/2020
7/26/2020,56,27017,2972,321656,348673,8,2206,9,1817,0,313,76,11,7,1,1004,52,18628,1301,180329,198957,8/18/2020
7/27/2020,182,27199,3895,325551,352750,12,2218,7,1824,0,313,81,13,8,1,1005,138,18766,2128,182457,201223,8/18/2020
7/28/2020,105,27304,3682,329233,356537,5,2223,5,1829,0,313,81,14,7,1,1006,88,18854,1524,183981,202835,8/18/2020
7/29/2020,161,27465,4794,334027,361492,10,2233,12,1841,0,313,79,15,7,0,1006,145,18999,2097,186078,205077,8/18/2020
7/30/2020,98,27563,3963,337990,365553,6,2239,2,1843,1,314,82,15,6,0,1006,77,19076,1361,187439,206515,8/18/2020
7/31/2020,115,27678,5093,343083,370761,8,2247,9,1852,0,314,81,15,7,0,1006,87,19163,1620,189059,208222,8/18/2020
8/1/2020,90,27768,3905,346988,374756,7,2254,2,1854,0,314,86,14,7,1,1007,78,19241,1327,190386,209627,8/18/2020
8/2/2020,77,27845,2673,349661,377506,12,2266,12,1866,1,315,85,14,8,2,1009,65,19306,1189,191575,210881,8/18/2020
8/3/2020,168,28013,4829,354490,382503,13,2279,12,1878,0,315,86,16,7,1,1010,147,19453,1906,193481,212934,8/18/2020
8/4/2020,118,28131,3426,357916,386047,8,2287,6,1884,1,316,87,12,5,2,1012,100,19553,1595,195076,214629,8/18/2020
8/5/2020,137,28268,5373,363289,391557,12,2299,10,1894,1,317,88,10,5,2,1014,112,19665,2058,197134,216799,8/18/2020
8/6/2020,156,28424,4646,367935,396359,6,2305,9,1903,0,317,85,9,4,0,1014,114,19779,1787,198921,218700,8/18/2020
8/7/2020,106,28530,4156,372091,400621,13,2318,10,1913,1,318,87,9,3,1,1015,85,19864,1679,200600,220464,8/18/2020
8/8/2020,104,28634,3680,375771,404405,19,2337,6,1919,1,319,99,8,3,1,1016,92,19956,1518,202118,222074,8/18/2020
8/9/2020,36,28670,1538,377309,405979,8,2345,11,1930,0,319,96,9,4,0,1016,34,19990,952,203070,223060,8/18/2020
8/10/2020,133,28803,4053,381362,410165,11,2356,11,1941,0,319,96,9,4,1,1017,109,20099,1665,204735,224834,8/18/2020
8/11/2020,99,28902,3913,385275,414177,5,2361,14,1955,0,319,87,10,4,2,1019,94,20193,2017,206752,226945,8/18/2020
8/12/2020,116,29018,4546,389821,418839,8,2369,11,1966,0,319,84,9,3,1,1020,103,20296,2190,208942,229238,8/18/2020
8/13/2020,112,29130,3426,393247,422377,11,2380,11,1977,0,319,84,11,3,0,1020,87,20383,1493,210435,230818,8/18/2020
8/14/2020,132,29262,4753,398000,427262,12,2392,11,1988,0,319,85,11,3,1,1021,87,20470,1603,212038,232508,8/18/2020
8/15/2020,94,29356,3662,401662,431018,8,2400,10,1998,0,319,83,11,5,0,1021,84,20554,1261,213299,233853,8/18/2020
8/16/2020,73,29429,2045,403707,433136,5,2405,6,2004,4,323,78,8,4,3,1024,63,20617,737,214036,234653,8/18/2020
8/17/2020,93,29522,2962,406669,436191,,,,,,,,,,0,1024,75,20692,1435,215471,236163,8/18/2020
2/27/2020,0,0,0,0,0,1,1,0,0,0,0,1,0,0,0,0,0,0,0,0,0,8/19/2020
2/28/2020,0,0,0,0,0,0,1,0,0,0,0,1,1,0,0,0,0,0,0,0,0,8/19/2020
2/29/2020,0,0,0,0,0,0,1,0,0,0,0,1,1,0,0,0,0,0,0,0,0,8/19/2020
3/1/2020,2,2,2,2,4,0,1,0,0,0,0,1,1,1,0,0,2,2,2,2,4,8/19/2020
3/2/2020,0,2,1,3,5,1,2,0,0,0,0,2,2,2,0,0,0,2,1,3,5,8/19/2020
3/3/2020,0,2,2,5,7,0,2,0,0,0,0,2,2,2,0,0,0,2,2,5,7,8/19/2020
3/4/2020,0,2,12,17,19,1,3,0,0,0,0,3,2,2,0,0,0,2,10,15,17,8/19/2020
3/5/2020,0,2,4,21,23,0,3,0,0,0,0,3,2,2,0,0,1,3,4,19,22,8/19/2020
3/6/2020,1,3,12,33,36,0,3,0,0,0,0,3,2,2,0,0,0,3,12,31,34,8/19/2020
3/7/2020,0,3,19,52,55,0,3,0,0,0,0,3,2,1,0,0,0,3,19,50,53,8/19/2020
3/8/2020,0,3,18,70,73,0,3,0,0,0,0,3,2,1,0,0,0,3,18,68,71,8/19/2020
3/9/2020,1,4,15,85,89,0,3,0,0,0,0,3,2,1,0,0,1,4,16,84,88,8/19/2020
3/10/2020,2,6,25,110,116,0,3,0,0,0,0,3,2,1,0,0,1,5,24,108,113,8/19/2020
3/11/2020,0,6,34,144,150,1,4,0,0,0,0,4,1,1,0,0,0,5,34,142,147,8/19/2020
3/12/2020,9,15,41,185,200,1,5,0,0,0,0,5,1,1,0,0,8,13,47,189,202,8/19/2020
3/13/2020,6,21,50,235,256,4,9,1,1,0,0,8,1,1,0,0,6,19,54,243,262,8/19/2020
3/14/2020,0,21,90,325,346,0,9,0,1,0,0,8,1,1,0,0,0,19,86,329,348,8/19/2020
3/15/2020,1,22,54,379,401,1,10,0,1,0,0,9,2,1,0,0,1,20,55,384,404,8/19/2020
3/16/2020,2,24,95,474,498,2,12,0,1,0,0,11,2,0,0,0,2,22,94,478,500,8/19/2020
3/17/2020,12,36,162,636,672,6,18,0,1,0,0,17,2,0,0,0,11,33,164,642,675,8/19/2020
3/18/2020,9,45,116,752,797,3,21,0,1,0,0,20,2,0,0,0,11,44,120,762,806,8/19/2020
3/19/2020,15,60,262,1014,1074,2,23,1,2,0,0,21,3,0,1,1,17,61,265,1027,1088,8/19/2020
3/20/2020,13,73,197,1211,1284,5,28,0,2,0,0,26,4,0,0,1,13,74,205,1232,1306,8/19/2020
3/21/2020,12,85,126,1337,1422,3,31,2,4,0,0,27,5,0,0,1,14,88,135,1367,1455,8/19/2020
3/22/2020,27,112,282,1619,1731,2,33,0,4,0,0,29,5,0,0,1,25,113,289,1656,1769,8/19/2020
3/23/2020,14,126,169,1788,1914,15,48,1,5,0,0,43,9,3,0,1,16,129,179,1835,1964,8/19/2020
3/24/2020,20,146,242,2030,2176,7,55,0,5,0,0,50,10,4,0,1,19,148,258,2093,2241,8/19/2020
3/25/2020,26,172,182,2212,2384,5,60,1,6,0,0,54,11,3,0,1,28,176,199,2292,2468,8/19/2020
3/26/2020,35,207,181,2393,2600,10,70,5,11,0,0,59,14,5,0,1,41,217,211,2503,2720,8/19/2020
3/27/2020,27,234,214,2607,2841,9,79,1,12,1,1,66,17,6,2,3,31,248,228,2731,2979,8/19/2020
3/28/2020,59,293,260,2867,3160,13,92,3,15,2,3,74,15,6,1,4,63,311,299,3030,3341,8/19/2020
3/29/2020,100,393,350,3217,3610,8,100,4,19,1,4,77,18,8,2,6,105,416,414,3444,3860,8/19/2020
3/30/2020,62,455,222,3439,3894,20,120,5,24,0,4,92,20,11,3,9,78,494,253,3697,4191,8/19/2020
3/31/2020,71,526,369,3808,4334,11,131,7,31,1,5,95,22,13,2,11,73,567,368,4065,4632,8/19/2020
4/1/2020,99,625,698,4506,5131,18,149,7,38,0,5,106,30,15,1,12,100,667,745,4810,5477,8/19/2020
4/2/2020,52,677,477,4983,5660,22,171,6,44,2,7,120,36,21,4,16,62,729,487,5297,6026,8/19/2020
4/3/2020,108,785,774,5757,6542,23,194,7,51,0,7,136,43,25,3,19,100,829,819,6116,6945,8/19/2020
4/4/2020,143,928,660,6417,7345,22,216,4,55,5,12,149,41,30,9,28,138,967,759,6875,7842,8/19/2020
4/5/2020,187,1115,1156,7573,8688,20,236,9,64,1,13,159,44,36,2,30,182,1149,1254,8129,9278,8/19/2020
4/6/2020,218,1333,1706,9279,10612,26,262,7,71,0,13,178,48,40,7,37,206,1355,1787,9916,11271,8/19/2020
4/7/2020,284,1617,1629,10908,12525,19,281,3,74,2,15,192,50,42,5,42,260,1615,1749,11665,13280,8/19/2020
4/8/2020,290,1907,1720,12628,14535,19,300,7,81,6,21,198,50,38,10,52,272,1887,1845,13510,15397,8/19/2020
4/9/2020,283,2190,1516,14144,16334,32,332,9,90,4,25,217,53,40,7,59,278,2165,1627,15137,17302,8/19/2020
4/10/2020,419,2609,2574,16718,19327,29,361,16,106,5,30,225,59,41,11,70,403,2568,2781,17918,20486,8/19/2020
4/11/2020,297,2906,1905,18623,21529,29,390,11,117,2,32,241,61,48,12,82,281,2849,2000,19918,22767,8/19/2020
4/12/2020,314,3220,1670,20293,23513,35,425,13,130,5,37,258,59,49,9,91,289,3138,1723,21641,24779,8/19/2020
4/13/2020,161,3381,935,21228,24609,35,460,13,143,3,40,277,64,54,9,100,187,3325,982,22623,25948,8/19/2020
4/14/2020,289,3670,1787,23015,26685,27,487,17,160,5,45,282,72,53,8,108,265,3590,1787,24410,28000,8/19/2020
4/15/2020,351,4021,1799,24814,28835,31,518,20,180,3,48,290,72,54,17,125,307,3897,1866,26276,30173,8/19/2020
4/16/2020,447,4468,2494,27308,31776,36,554,25,205,6,54,295,72,53,14,139,391,4288,2497,28773,33061,8/19/2020
4/17/2020,304,4772,1821,29129,33901,32,586,20,225,7,61,300,66,45,21,160,291,4579,1740,30513,35092,8/19/2020
4/18/2020,321,5093,1725,30854,35947,26,612,18,243,4,65,304,63,49,15,175,284,4863,1637,32150,37013,8/19/2020
4/19/2020,381,5474,2047,32901,38375,23,635,26,269,1,66,300,65,55,11,186,338,5201,2092,34242,39443,8/19/2020
4/20/2020,394,5868,1907,34808,40676,46,681,29,298,2,68,315,75,56,10,196,377,5578,1951,36193,41771,8/19/2020
4/21/2020,444,6312,2110,36918,43230,45,726,31,329,5,73,324,72,56,18,214,390,5968,2101,38294,44262,8/19/2020
4/22/2020,418,6730,2390,39308,46038,41,767,32,361,5,78,328,73,58,18,232,382,6350,2295,40589,46939,8/19/2020
4/23/2020,479,7209,2469,41777,48986,30,797,28,389,5,83,325,76,62,15,247,418,6768,2300,42889,49657,8/19/2020
4/24/2020,491,7700,3284,45061,52761,35,832,27,416,4,87,329,85,63,15,262,413,7181,3055,45944,53125,8/19/2020
4/25/2020,393,8093,2206,47267,55360,34,866,17,433,5,92,341,85,62,14,276,305,7486,2077,48021,55507,8/19/2020
4/26/2020,316,8409,2309,49576,57985,33,899,15,448,3,95,356,86,59,14,290,276,7762,2152,50173,57935,8/19/2020
4/27/2020,249,8658,1620,51196,59854,29,928,21,469,4,99,360,86,61,10,300,204,7966,1370,51543,59509,8/19/2020
4/28/2020,410,9068,2263,53459,62527,44,972,24,493,3,102,377,88,59,22,322,325,8291,2106,53649,61940,8/19/2020
4/29/2020,476,9544,3343,56802,66346,36,1008,37,530,11,113,365,78,53,18,340,372,8663,2811,56460,65123,8/19/2020
4/30/2020,432,9976,2769,59571,69547,33,1041,38,568,6,119,354,83,57,24,364,347,9010,2302,58762,67772,8/19/2020
5/1/2020,454,10430,3086,62657,73087,51,1092,39,607,3,122,363,84,58,14,378,317,9327,2538,61300,70627,8/19/2020
5/2/2020,257,10687,1926,64583,75270,36,1128,39,646,5,127,355,91,62,24,402,189,9516,1472,62772,72288,8/19/2020
5/3/2020,283,10970,2160,66743,77713,31,1159,27,673,8,135,351,90,61,21,423,182,9698,1793,64565,74263,8/19/2020
5/4/2020,387,11357,2098,68841,80198,30,1189,31,704,5,140,345,88,57,18,441,293,9991,1861,66426,76417,8/19/2020
5/5/2020,433,11790,2873,71714,83504,29,1218,32,736,6,146,336,82,54,16,457,304,10295,2278,68704,78999,8/19/2020
5/6/2020,488,12278,2829,74543,86821,28,1246,44,780,9,155,311,79,54,21,478,341,10636,2270,70974,81610,8/19/2020
5/7/2020,425,12703,2969,77512,90215,36,1282,42,822,5,160,300,71,52,21,499,269,10905,2259,73233,84138,8/19/2020
5/8/2020,359,13062,2598,80110,93172,30,1312,29,851,5,165,296,71,53,22,521,231,11136,2013,75246,86382,8/19/2020
5/9/2020,467,13529,3346,83456,96985,22,1334,21,872,4,169,293,69,51,15,536,286,11422,2612,77858,89280,8/19/2020
5/10/2020,285,13814,2117,85573,99387,19,1353,23,895,6,175,283,70,49,13,549,187,11609,1713,79571,91180,8/19/2020
5/11/2020,257,14071,1857,87430,101501,31,1384,16,911,6,181,292,71,49,15,564,176,11785,1482,81053,92838,8/19/2020
5/12/2020,387,14458,2611,90041,104499,23,1407,18,929,4,185,293,69,48,22,586,217,12002,1951,83004,95006,8/19/2020
5/13/2020,351,14809,3630,93671,108480,22,1429,24,953,1,186,290,69,49,13,599,196,12198,2214,85218,97416,8/19/2020
5/14/2020,329,15138,3408,97079,112217,19,1448,27,980,3,189,279,64,45,15,614,227,12425,2240,87458,99883,8/19/2020
5/15/2020,381,15519,3458,100537,116056,24,1472,41,1021,5,194,257,62,45,13,627,234,12659,2050,89508,102167,8/19/2020
5/16/2020,449,15968,4156,104693,120661,25,1497,12,1033,5,199,265,61,46,15,642,252,12911,2229,91737,104648,8/19/2020
5/17/2020,240,16208,2768,107461,123669,17,1514,7,1040,5,204,270,59,45,10,652,124,13035,1682,93419,106454,8/19/2020
5/18/2020,250,16458,2001,109462,125920,19,1533,15,1055,5,209,269,57,40,18,670,139,13174,1526,94945,108119,8/19/2020
5/19/2020,415,16873,3168,112630,129503,23,1556,32,1087,5,214,255,56,38,11,681,212,13386,2151,97096,110482,8/19/2020
5/20/2020,326,17199,2770,115400,132599,19,1575,23,1110,7,221,244,52,33,22,703,187,13573,1701,98797,112370,8/19/2020
5/21/2020,374,17573,3757,119157,136730,26,1601,15,1125,3,224,252,53,29,20,723,170,13743,2124,100921,114664,8/19/2020
5/22/2020,351,17924,3161,122318,140242,20,1621,29,1154,5,229,238,52,29,10,733,204,13947,1813,102734,116681,8/19/2020
5/23/2020,253,18177,2742,125060,143237,19,1640,11,1165,3,232,243,52,32,13,746,109,14056,1394,104128,118184,8/19/2020
5/24/2020,163,18340,1370,126430,144770,12,1652,14,1179,2,234,239,53,36,8,754,84,14140,857,104985,119125,8/19/2020
5/25/2020,147,18487,1385,127815,146302,13,1665,14,1193,0,234,238,53,34,10,764,71,14211,836,105821,120032,8/19/2020
5/26/2020,285,18772,2620,130435,149207,24,1689,22,1215,5,239,235,48,33,15,779,156,14367,1937,107758,122125,8/19/2020
5/27/2020,276,19048,2065,132500,151548,20,1709,18,1233,3,242,234,50,33,10,789,133,14500,1269,109027,123527,8/19/2020
5/28/2020,349,19397,3371,135871,155268,17,1726,29,1262,4,246,218,47,32,8,797,133,14633,1258,110285,124918,8/19/2020
5/29/2020,413,19810,3928,139799,159609,19,1745,27,1289,6,252,204,43,31,12,809,179,14812,1759,112044,126856,8/19/2020
5/30/2020,225,20035,3915,143714,163749,15,1760,19,1308,4,256,196,40,29,12,821,110,14922,1935,113979,128901,8/19/2020
5/31/2020,155,20190,1688,145402,165592,11,1771,10,1318,0,256,197,43,26,3,824,78,15000,935,114914,129914,8/19/2020
6/1/2020,214,20404,2792,148194,168598,8,1779,14,1332,1,257,190,44,29,5,829,99,15099,1488,116402,131501,8/19/2020
6/2/2020,273,20677,3033,151227,171904,8,1787,9,1341,3,260,186,37,25,10,839,107,15206,1575,117977,133183,8/19/2020
6/3/2020,254,20931,3495,154722,175653,13,1800,18,1359,6,266,175,34,25,11,850,105,15311,1774,119751,135062,8/19/2020
6/4/2020,277,21208,4474,159196,180404,7,1807,25,1384,3,269,154,31,24,11,861,114,15425,2160,121911,137336,8/19/2020
6/5/2020,215,21423,3521,162717,184140,15,1822,13,1397,6,275,150,27,21,9,870,105,15530,1685,123596,139126,8/19/2020
6/6/2020,201,21624,2618,165335,186959,10,1832,7,1404,2,277,151,29,19,6,876,68,15598,1206,124802,140400,8/19/2020
6/7/2020,83,21707,1625,166960,188667,11,1843,7,1411,1,278,154,25,17,4,880,50,15648,832,125634,141282,8/19/2020
6/8/2020,122,21829,1860,168820,190649,15,1858,12,1423,2,280,155,27,18,4,884,44,15692,1022,126656,142348,8/19/2020
6/9/2020,225,22054,2688,171508,193562,10,1868,18,1441,0,280,147,28,21,1,885,67,15759,1341,127997,143756,8/19/2020
6/10/2020,211,22265,2986,174494,196759,13,1881,12,1453,2,282,146,24,17,3,888,105,15864,1576,129573,145437,8/19/2020
6/11/2020,195,22460,3516,178010,200470,7,1888,15,1468,1,283,137,25,16,6,894,88,15952,1623,131196,147148,8/19/2020
6/12/2020,214,22674,4608,182618,205292,9,1897,15,1483,1,284,130,24,16,2,896,81,16033,2270,133466,149499,8/19/2020
6/13/2020,113,22787,3038,185656,208443,6,1903,4,1487,0,284,132,20,15,3,899,50,16083,1429,134895,150978,8/19/2020
6/14/2020,80,22867,2046,187702,210569,6,1909,8,1495,1,285,129,20,14,3,902,32,16115,1002,135897,152012,8/19/2020
6/15/2020,188,23055,3117,190819,213874,14,1923,14,1509,0,285,129,20,16,4,906,78,16193,1874,137771,153964,8/19/2020
6/16/2020,115,23170,3026,193845,217015,11,1934,10,1519,1,286,129,22,16,8,914,52,16245,1641,139412,155657,8/19/2020
6/17/2020,127,23297,2838,196683,219980,15,1949,20,1539,4,290,120,18,14,6,920,53,16298,1379,140791,157089,8/19/2020
6/18/2020,150,23447,3048,199731,223178,9,1958,13,1552,1,291,115,19,16,7,927,70,16368,1408,142199,158567,8/19/2020
6/19/2020,141,23588,3778,203509,227097,12,1970,11,1563,1,292,115,20,17,3,930,59,16427,1445,143644,160071,8/19/2020
6/20/2020,84,23672,1890,205399,229071,9,1979,12,1575,0,292,112,20,18,4,934,36,16463,855,144499,160962,8/19/2020
6/21/2020,37,23709,1064,206463,230172,7,1986,5,1580,0,292,114,20,18,2,936,28,16491,718,145217,161708,8/19/2020
6/22/2020,142,23851,3728,210191,234042,12,1998,16,1596,0,292,110,19,18,1,937,70,16561,1787,147004,163565,8/19/2020
6/23/2020,163,24014,3843,214034,238048,3,2001,13,1609,3,295,97,18,18,6,943,82,16643,1882,148886,165529,8/19/2020
6/24/2020,122,24136,3508,217542,241678,9,2010,10,1619,1,296,95,18,18,5,948,48,16691,1743,150629,167320,8/19/2020
6/25/2020,103,24239,2893,220435,244674,5,2015,14,1633,1,297,85,17,17,1,949,53,16744,1568,152197,168941,8/19/2020
6/26/2020,95,24334,2454,222889,247223,2,2017,9,1642,0,297,78,18,18,1,950,64,16808,1362,153559,170367,8/19/2020
6/27/2020,84,24418,3215,226104,250522,5,2022,3,1645,1,298,79,17,17,5,955,37,16845,1258,154817,171662,8/19/2020
6/28/2020,38,24456,1470,227574,252030,4,2026,4,1649,4,302,75,15,14,6,961,19,16864,614,155431,172295,8/19/2020
6/29/2020,88,24544,3697,231271,255815,4,2030,5,1654,0,302,74,14,14,1,962,40,16904,1392,156823,173727,8/19/2020
6/30/2020,58,24602,1960,233231,257833,1,2031,5,1659,1,303,69,12,11,3,965,33,16937,1027,157850,174787,8/19/2020
7/1/2020,144,24746,4109,237340,262086,7,2038,9,1668,0,303,67,11,11,1,966,81,17018,2030,159880,176898,8/19/2020
7/2/2020,102,24848,2797,240137,264985,5,2043,5,1673,1,304,66,9,9,1,967,57,17075,1148,161028,178103,8/19/2020
7/3/2020,51,24899,2028,242165,267064,9,2052,6,1679,0,304,69,8,8,3,970,26,17101,801,161829,178930,8/19/2020
7/4/2020,57,24956,2329,244494,269450,2,2054,4,1683,1,305,66,9,8,2,972,34,17135,1026,162855,179990,8/19/2020
7/5/2020,49,25005,2932,247426,272431,1,2055,2,1685,1,306,64,7,7,2,974,26,17161,1475,164330,181491,8/19/2020
7/6/2020,103,25108,2812,250238,275346,6,2061,6,1691,0,306,64,8,9,4,978,58,17219,1618,165948,183167,8/19/2020
7/7/2020,81,25189,3452,253690,278879,5,2066,7,1698,0,306,62,7,8,1,979,48,17267,1574,167522,184789,8/19/2020
7/8/2020,106,25295,3391,257081,282376,4,2070,2,1700,0,306,64,8,8,0,979,66,17333,1480,169002,186335,8/19/2020
7/9/2020,93,25388,3668,260749,286137,9,2079,3,1703,0,306,70,8,8,0,979,49,17382,1649,170651,188033,8/19/2020
7/10/2020,131,25519,4398,265147,290666,6,2085,3,1706,2,308,71,7,7,3,982,80,17462,2169,172820,190282,8/19/2020
7/11/2020,62,25581,2893,268040,293621,6,2091,3,1709,1,309,73,6,6,3,985,33,17495,1319,174139,191634,8/19/2020
7/12/2020,45,25626,1781,269821,295447,1,2092,3,1712,1,310,70,6,5,3,988,33,17528,929,175068,192596,8/19/2020
7/13/2020,85,25711,3160,272981,298692,8,2100,10,1722,0,310,68,6,5,1,989,57,17585,1538,176606,194191,8/19/2020
7/14/2020,74,25785,3260,276241,302026,7,2107,4,1726,0,310,71,5,5,1,990,49,17634,1407,178013,195647,8/19/2020
7/15/2020,124,25909,4128,280369,306278,5,2112,7,1733,0,310,69,5,4,0,990,94,17728,1815,179828,197556,8/19/2020
7/16/2020,102,26011,3703,284072,310083,6,2118,9,1742,0,310,66,6,5,1,991,78,17806,1675,181503,199309,8/19/2020
7/17/2020,152,26163,4137,288209,314372,14,2132,3,1745,1,311,76,5,5,1,992,78,17884,1879,183382,201266,8/19/2020
7/18/2020,80,26243,3166,291375,317618,5,2137,9,1754,1,312,71,5,4,4,996,67,17951,1393,184775,202726,8/19/2020
7/19/2020,82,26325,2587,293962,320287,6,2143,3,1757,0,312,74,6,4,2,998,59,18010,1120,185895,203905,8/19/2020
7/20/2020,73,26398,2660,296622,323020,9,2152,7,1764,0,312,76,7,5,2,1000,63,18073,1522,187417,205490,8/19/2020
7/21/2020,127,26525,4229,300851,327376,9,2161,10,1774,0,312,75,9,6,1,1001,103,18176,1974,189391,207567,8/19/2020
7/22/2020,124,26649,3790,304641,331290,11,2172,11,1785,1,313,74,7,6,1,1002,86,18262,1656,191047,209309,8/19/2020
7/23/2020,123,26772,4089,308730,335502,8,2180,5,1790,0,313,77,8,7,0,1002,104,18366,1862,192909,211275,8/19/2020
7/24/2020,163,26935,5691,314421,341356,13,2193,13,1803,0,313,77,9,7,0,1002,121,18487,2263,195172,213659,8/19/2020
7/25/2020,126,27061,4265,318686,345747,7,2200,7,1810,0,313,77,10,8,1,1003,104,18591,2100,197272,215863,8/19/2020
7/26/2020,56,27117,2972,321658,348775,8,2208,9,1819,0,313,76,11,7,1,1004,52,18643,1343,198615,217258,8/19/2020
7/27/2020,182,27299,3895,325553,352852,12,2220,7,1826,0,313,81,13,8,1,1005,137,18780,2258,200873,219653,8/19/2020
7/28/2020,105,27404,3682,329235,356639,5,2225,5,1831,0,313,81,14,7,1,1006,88,18868,1601,202474,221342,8/19/2020
7/29/2020,161,27565,4794,334029,361594,10,2235,12,1843,0,313,79,15,7,0,1006,145,19013,2221,204695,223708,8/19/2020
7/30/2020,98,27663,3963,337992,365655,6,2241,2,1845,1,314,82,15,6,0,1006,76,19089,1432,206127,225216,8/19/2020
7/31/2020,115,27778,5093,343085,370863,8,2249,9,1854,0,314,81,15,7,0,1006,87,19176,1698,207825,227001,8/19/2020
8/1/2020,90,27868,3905,346990,374858,7,2256,2,1856,0,314,86,14,7,1,1007,79,19255,1394,209219,228474,8/19/2020
8/2/2020,77,27945,2673,349663,377608,12,2268,12,1868,1,315,85,14,8,2,1009,63,19318,1245,210464,229782,8/19/2020
8/3/2020,168,28113,4829,354492,382605,13,2281,12,1880,0,315,86,16,7,1,1010,147,19465,2043,212507,231972,8/19/2020
8/4/2020,118,28231,3426,357918,386149,8,2289,6,1886,1,316,87,12,5,2,1012,100,19565,1686,214193,233758,8/19/2020
8/5/2020,137,28368,5373,363291,391659,12,2301,10,1896,1,317,88,10,5,2,1014,111,19676,2165,216358,236034,8/19/2020
8/6/2020,156,28524,4646,367937,396461,6,2307,9,1905,0,317,85,9,4,0,1014,114,19790,1891,218249,238039,8/19/2020
8/7/2020,106,28630,4156,372093,400723,13,2320,10,1915,1,318,87,9,3,1,1015,86,19876,1758,220007,239883,8/19/2020
8/8/2020,104,28734,3680,375773,404507,19,2339,6,1921,1,319,99,8,3,1,1016,91,19967,1594,221601,241568,8/19/2020
8/9/2020,36,28770,1538,377311,406081,8,2347,11,1932,0,319,96,9,4,0,1016,33,20000,982,222583,242583,8/19/2020
8/10/2020,133,28903,4055,381366,410269,11,2358,11,1943,0,319,96,9,4,1,1017,109,20109,1774,224357,244466,8/19/2020
8/11/2020,99,29002,3913,385279,414281,6,2364,14,1957,0,319,88,10,4,2,1019,94,20203,2102,226459,246662,8/19/2020
8/12/2020,116,29118,4548,389827,418945,8,2372,11,1968,0,319,85,9,3,1,1020,103,20306,2285,228744,249050,8/19/2020
8/13/2020,112,29230,3453,393280,422510,11,2383,11,1979,0,319,85,11,3,0,1020,89,20395,1588,230332,250727,8/19/2020
8/14/2020,133,29363,4788,398068,427431,13,2396,11,1990,0,319,87,11,4,1,1021,92,20487,1700,232032,252519,8/19/2020
8/15/2020,95,29458,3715,401783,431241,8,2404,10,2000,1,320,84,11,5,0,1021,84,20571,1371,233403,253974,8/19/2020
8/16/2020,75,29533,2170,403953,433486,7,2411,6,2006,4,324,81,8,4,5,1026,65,20636,873,234276,254912,8/19/2020
8/17/2020,99,29632,3232,407185,436817,8,2419,7,2013,0,324,82,8,5,1,1027,80,20716,1647,235923,256639,8/19/2020
8/18/2020,106,29738,3204,410389,440127,,,,,,,,,,0,1027,79,20795,1596,237519,258314,8/19/2020
2/27/2020,0,0,0,0,0,1,1,0,0,0,0,1,0,0,0,0,0,0,0,0,0,8/20/2020
2/28/2020,0,0,0,0,0,0,1,0,0,0,0,1,1,0,0,0,0,0,0,0,0,8/20/2020
2/29/2020,0,0,0,0,0,0,1,0,0,0,0,1,1,0,0,0,0,0,0,0,0,8/20/2020
3/1/2020,2,2,2,2,4,0,1,0,0,0,0,1,1,1,0,0,2,2,2,2,4,8/20/2020
3/2/2020,0,2,1,3,5,1,2,0,0,0,0,2,2,2,0,0,0,2,1,3,5,8/20/2020
3/3/2020,0,2,2,5,7,0,2,0,0,0,0,2,2,2,0,0,0,2,2,5,7,8/20/2020
3/4/2020,0,2,12,17,19,1,3,0,0,0,0,3,2,2,0,0,0,2,10,15,17,8/20/2020
3/5/2020,0,2,4,21,23,0,3,0,0,0,0,3,2,2,0,0,1,3,4,19,22,8/20/2020
3/6/2020,1,3,12,33,36,0,3,0,0,0,0,3,2,2,0,0,0,3,11,30,33,8/20/2020
3/7/2020,0,3,19,52,55,0,3,0,0,0,0,3,2,1,0,0,0,3,19,49,52,8/20/2020
3/8/2020,0,3,18,70,73,0,3,0,0,0,0,3,2,1,0,0,0,3,18,67,70,8/20/2020
3/9/2020,1,4,15,85,89,0,3,0,0,0,0,3,2,1,0,0,1,4,15,82,86,8/20/2020
3/10/2020,2,6,25,110,116,0,3,0,0,0,0,3,2,1,0,0,1,5,23,105,110,8/20/2020
3/11/2020,0,6,34,144,150,1,4,0,0,0,0,4,1,1,0,0,0,5,34,139,144,8/20/2020
3/12/2020,9,15,41,185,200,1,5,0,0,0,0,5,1,1,0,0,8,13,38,177,190,8/20/2020
3/13/2020,6,21,50,235,256,4,9,1,1,0,0,8,1,1,0,0,6,19,48,225,244,8/20/2020
3/14/2020,0,21,90,325,346,0,9,0,1,0,0,8,1,1,0,0,0,19,86,311,330,8/20/2020
3/15/2020,1,22,54,379,401,1,10,0,1,0,0,9,2,1,0,0,1,20,54,365,385,8/20/2020
3/16/2020,2,24,95,474,498,2,12,0,1,0,0,11,2,0,0,0,2,22,92,457,479,8/20/2020
3/17/2020,12,36,162,636,672,6,18,0,1,0,0,17,2,0,0,0,11,33,152,609,642,8/20/2020
3/18/2020,9,45,116,752,797,3,21,0,1,0,0,20,2,0,0,0,11,44,111,720,764,8/20/2020
3/19/2020,15,60,262,1014,1074,2,23,1,2,0,0,21,3,0,1,1,17,61,251,971,1032,8/20/2020
3/20/2020,13,73,197,1211,1284,5,28,0,2,0,0,26,4,0,0,1,13,74,192,1163,1237,8/20/2020
3/21/2020,12,85,126,1337,1422,3,31,2,4,0,0,27,5,0,0,1,14,88,123,1286,1374,8/20/2020
3/22/2020,27,112,282,1619,1731,2,33,0,4,0,0,29,5,0,0,1,25,113,262,1548,1661,8/20/2020
3/23/2020,14,126,169,1788,1914,15,48,1,5,0,0,43,9,3,0,1,16,129,165,1713,1842,8/20/2020
3/24/2020,20,146,242,2030,2176,7,55,0,5,0,0,50,10,4,0,1,19,148,238,1951,2099,8/20/2020
3/25/2020,26,172,182,2212,2384,5,60,1,6,0,0,54,11,3,0,1,28,176,172,2123,2299,8/20/2020
3/26/2020,35,207,181,2393,2600,10,70,5,11,0,0,59,14,5,0,1,41,217,176,2299,2516,8/20/2020
3/27/2020,27,234,214,2607,2841,9,79,1,12,1,1,66,17,6,2,3,31,248,202,2501,2749,8/20/2020
3/28/2020,59,293,260,2867,3160,13,92,3,15,2,3,74,15,6,1,4,63,311,241,2742,3053,8/20/2020
3/29/2020,100,393,350,3217,3610,8,100,4,19,1,4,77,18,8,2,6,105,416,314,3056,3472,8/20/2020
3/30/2020,62,455,222,3439,3894,20,120,5,24,0,4,92,20,11,3,9,78,494,191,3247,3741,8/20/2020
3/31/2020,71,526,369,3808,4334,11,131,7,31,1,5,95,22,13,2,11,73,567,298,3545,4112,8/20/2020
4/1/2020,99,625,698,4506,5131,18,149,7,38,0,5,106,30,15,1,12,100,667,647,4192,4859,8/20/2020
4/2/2020,52,677,477,4983,5660,22,171,6,44,2,7,120,36,21,4,16,62,729,436,4628,5357,8/20/2020
4/3/2020,108,785,774,5757,6542,23,194,7,51,0,7,136,43,25,3,19,100,829,716,5344,6173,8/20/2020
4/4/2020,143,928,660,6417,7345,22,216,4,55,5,12,149,41,30,9,28,138,967,620,5964,6931,8/20/2020
4/5/2020,187,1115,1156,7573,8688,20,236,9,64,1,13,159,44,36,2,30,182,1149,1071,7035,8184,8/20/2020
4/6/2020,218,1333,1706,9279,10612,26,262,7,71,0,13,178,48,40,7,37,206,1355,1575,8610,9965,8/20/2020
4/7/2020,284,1617,1629,10908,12525,19,281,3,74,2,15,192,50,42,5,42,260,1615,1487,10097,11712,8/20/2020
4/8/2020,290,1907,1720,12628,14535,19,300,7,81,6,21,198,50,38,10,52,272,1887,1568,11665,13552,8/20/2020
4/9/2020,283,2190,1516,14144,16334,32,332,9,90,4,25,217,53,40,7,59,278,2165,1363,13028,15193,8/20/2020
4/10/2020,419,2609,2574,16718,19327,29,361,16,106,5,30,225,59,41,11,70,403,2568,2379,15407,17975,8/20/2020
4/11/2020,297,2906,1905,18623,21529,29,390,11,117,2,32,241,61,48,12,82,281,2849,1726,17133,19982,8/20/2020
4/12/2020,314,3220,1670,20293,23513,35,425,13,130,5,37,258,59,49,9,91,289,3138,1440,18573,21711,8/20/2020
4/13/2020,161,3381,935,21228,24609,35,460,13,143,3,40,277,64,54,9,100,187,3325,843,19416,22741,8/20/2020
4/14/2020,289,3670,1787,23015,26685,27,487,17,160,5,45,282,72,53,8,108,265,3590,1533,20949,24539,8/20/2020
4/15/2020,351,4021,1799,24814,28835,31,518,20,180,3,48,290,72,54,17,125,307,3897,1568,22517,26414,8/20/2020
4/16/2020,447,4468,2494,27308,31776,36,554,25,205,6,54,295,72,53,14,139,391,4288,2091,24608,28896,8/20/2020
4/17/2020,304,4772,1821,29129,33901,32,586,20,225,7,61,300,66,45,21,160,291,4579,1464,26072,30651,8/20/2020
4/18/2020,321,5093,1725,30854,35947,26,612,18,243,4,65,304,63,49,15,175,284,4863,1352,27424,32287,8/20/2020
4/19/2020,381,5474,2047,32901,38375,23,635,26,269,1,66,300,65,55,11,186,338,5201,1752,29176,34377,8/20/2020
4/20/2020,394,5868,1907,34808,40676,46,681,29,298,2,68,315,75,56,10,196,377,5578,1583,30759,36337,8/20/2020
4/21/2020,444,6312,2110,36918,43230,45,726,31,329,5,73,324,72,56,18,214,390,5968,1721,32480,38448,8/20/2020
4/22/2020,418,6730,2390,39308,46038,41,767,32,361,5,78,328,73,58,18,232,382,6350,1921,34401,40751,8/20/2020
4/23/2020,479,7209,2469,41777,48986,30,797,28,389,5,83,325,76,62,15,247,418,6768,1878,36279,43047,8/20/2020
4/24/2020,491,7700,3284,45061,52761,35,832,27,416,4,87,329,85,63,15,262,413,7181,2642,38921,46102,8/20/2020
4/25/2020,393,8093,2206,47267,55360,34,866,17,433,5,92,341,85,62,14,276,305,7486,1780,40701,48187,8/20/2020
4/26/2020,316,8409,2309,49576,57985,33,899,15,448,3,95,356,86,59,14,290,276,7762,1886,42587,50349,8/20/2020
4/27/2020,249,8658,1620,51196,59854,29,928,21,469,4,99,360,86,61,10,300,204,7966,1165,43752,51718,8/20/2020
4/28/2020,410,9068,2263,53459,62527,44,972,24,493,3,102,377,88,59,22,322,325,8291,1772,45524,53815,8/20/2020
4/29/2020,476,9544,3343,56802,66346,36,1008,37,530,11,113,365,78,53,18,340,371,8662,2445,47969,56631,8/20/2020
4/30/2020,432,9976,2769,59571,69547,33,1041,38,568,6,119,354,83,57,24,364,348,9010,1959,49928,58938,8/20/2020
5/1/2020,454,10430,3086,62657,73087,51,1092,40,608,3,122,362,84,58,14,378,317,9327,2221,52149,61476,8/20/2020
5/2/2020,257,10687,1926,64583,75270,36,1128,38,646,5,127,355,91,62,24,402,189,9516,1295,53444,62960,8/20/2020
5/3/2020,283,10970,2160,66743,77713,31,1159,26,672,8,135,352,90,61,21,423,182,9698,1606,55050,64748,8/20/2020
5/4/2020,387,11357,2098,68841,80198,30,1189,31,703,6,141,345,88,57,18,441,293,9991,1573,56623,66614,8/20/2020
5/5/2020,433,11790,2873,71714,83504,29,1218,32,735,6,147,336,82,54,16,457,304,10295,1968,58591,68886,8/20/2020
5/6/2020,488,12278,2829,74543,86821,28,1246,44,779,9,156,311,79,54,21,478,341,10636,1927,60518,71154,8/20/2020
5/7/2020,425,12703,2969,77512,90215,36,1282,42,821,5,161,300,71,52,21,499,269,10905,1986,62504,73409,8/20/2020
5/8/2020,359,13062,2598,80110,93172,30,1312,29,850,5,166,296,71,53,22,521,231,11136,1770,64274,75410,8/20/2020
5/9/2020,467,13529,3346,83456,96985,22,1334,21,871,4,170,293,69,51,15,536,286,11422,2304,66578,78000,8/20/2020
5/10/2020,285,13814,2117,85573,99387,19,1353,23,894,6,176,283,70,49,13,549,187,11609,1526,68104,79713,8/20/2020
5/11/2020,257,14071,1857,87430,101501,31,1384,16,910,6,182,292,71,49,15,564,176,11785,1311,69415,81200,8/20/2020
5/12/2020,387,14458,2611,90041,104499,23,1407,18,928,4,186,293,69,48,22,586,217,12002,1715,71130,83132,8/20/2020
5/13/2020,351,14809,3630,93671,108480,22,1429,24,952,1,187,290,69,49,13,599,196,12198,2022,73152,85350,8/20/2020
5/14/2020,329,15138,3408,97079,112217,19,1448,27,979,3,190,279,64,45,15,614,227,12425,2021,75173,87598,8/20/2020
5/15/2020,381,15519,3458,100537,116056,24,1472,41,1020,5,195,257,62,45,13,627,234,12659,1816,76989,89648,8/20/2020
5/16/2020,449,15968,4156,104693,120661,25,1497,12,1032,5,200,265,61,46,15,642,252,12911,1968,78957,91868,8/20/2020
5/17/2020,240,16208,2768,107461,123669,17,1514,7,1039,5,205,270,59,45,10,652,124,13035,1568,80525,93560,8/20/2020
5/18/2020,250,16458,2001,109462,125920,19,1533,15,1054,5,210,269,57,40,18,670,139,13174,1374,81899,95073,8/20/2020
5/19/2020,415,16873,3168,112630,129503,23,1556,32,1086,5,215,255,56,38,11,681,212,13386,1941,83840,97226,8/20/2020
5/20/2020,326,17199,2770,115400,132599,19,1575,23,1109,7,222,244,52,33,22,703,187,13573,1522,85362,98935,8/20/2020
5/21/2020,374,17573,3757,119157,136730,26,1601,15,1124,3,225,252,53,29,20,723,170,13743,1951,87313,101056,8/20/2020
5/22/2020,351,17924,3161,122318,140242,20,1621,29,1153,5,230,238,52,29,10,733,204,13947,1615,88928,102875,8/20/2020
5/23/2020,253,18177,2742,125060,143237,19,1640,11,1164,3,233,243,52,32,13,746,109,14056,1284,90212,104268,8/20/2020
5/24/2020,163,18340,1370,126430,144770,12,1652,14,1178,2,235,239,53,36,8,754,84,14140,773,90985,105125,8/20/2020
5/25/2020,147,18487,1385,127815,146302,13,1665,14,1192,0,235,238,53,34,10,764,71,14211,765,91750,105961,8/20/2020
5/26/2020,285,18772,2620,130435,149207,24,1689,22,1214,5,240,235,48,33,15,779,156,14367,1784,93534,107901,8/20/2020
5/27/2020,276,19048,2065,132500,151548,20,1709,18,1232,3,243,234,50,33,10,789,133,14500,1143,94677,109177,8/20/2020
5/28/2020,349,19397,3371,135871,155268,17,1726,29,1261,4,247,218,47,32,8,797,133,14633,1131,95808,110441,8/20/2020
5/29/2020,413,19810,3928,139799,159609,19,1745,27,1288,6,253,204,43,31,12,809,179,14812,1588,97396,112208,8/20/2020
5/30/2020,225,20035,3915,143714,163749,15,1760,19,1307,4,257,196,40,29,12,821,110,14922,1827,99223,114145,8/20/2020
5/31/2020,155,20190,1688,145402,165592,11,1771,10,1317,0,257,197,43,26,3,824,78,15000,860,100083,115083,8/20/2020
6/1/2020,214,20404,2792,148194,168598,8,1779,14,1331,1,258,190,44,29,5,829,99,15099,1385,101468,116567,8/20/2020
6/2/2020,273,20677,3033,151227,171904,8,1787,9,1340,3,261,186,37,25,10,839,107,15206,1466,102934,118140,8/20/2020
6/3/2020,254,20931,3495,154722,175653,13,1800,18,1358,6,267,175,34,25,11,850,105,15311,1676,104610,119921,8/20/2020
6/4/2020,277,21208,4474,159196,180404,7,1807,25,1383,3,270,154,31,24,11,861,114,15425,2049,106659,122084,8/20/2020
6/5/2020,215,21423,3521,162717,184140,15,1822,13,1396,6,276,150,27,21,9,870,105,15530,1583,108242,123772,8/20/2020
6/6/2020,201,21624,2618,165335,186959,10,1832,7,1403,2,278,151,29,19,6,876,68,15598,1138,109380,124978,8/20/2020
6/7/2020,83,21707,1625,166960,188667,11,1843,7,1410,1,279,154,25,17,4,880,50,15648,784,110164,125812,8/20/2020
6/8/2020,122,21829,1860,168820,190649,15,1858,12,1422,2,281,155,27,18,4,884,44,15692,974,111138,126830,8/20/2020
6/9/2020,225,22054,2688,171508,193562,10,1868,18,1440,0,281,147,28,21,1,885,67,15759,1275,112413,128172,8/20/2020
6/10/2020,211,22265,2986,174494,196759,13,1881,12,1452,2,283,146,24,17,3,888,105,15864,1467,113880,129744,8/20/2020
6/11/2020,195,22460,3516,178010,200470,7,1888,15,1467,1,284,137,25,16,6,894,88,15952,1542,115422,131374,8/20/2020
6/12/2020,214,22674,4608,182618,205292,9,1897,15,1482,1,285,130,24,16,2,896,81,16033,2193,117615,133648,8/20/2020
6/13/2020,113,22787,3038,185656,208443,6,1903,4,1486,0,285,132,20,15,3,899,50,16083,1380,118995,135078,8/20/2020
6/14/2020,80,22867,2046,187702,210569,6,1909,8,1494,1,286,129,20,14,3,902,32,16115,969,119964,136079,8/20/2020
6/15/2020,188,23055,3117,190819,213874,14,1923,14,1508,0,286,129,20,16,4,906,78,16193,1797,121761,137954,8/20/2020
6/16/2020,115,23170,3026,193845,217015,10,1933,9,1517,1,287,129,22,16,8,914,52,16245,1588,123349,139594,8/20/2020
6/17/2020,127,23297,2838,196683,219980,15,1948,20,1537,4,291,120,18,14,6,920,53,16298,1326,124675,140973,8/20/2020
6/18/2020,150,23447,3048,199731,223178,9,1957,13,1550,1,292,115,19,16,7,927,70,16368,1339,126014,142382,8/20/2020
6/19/2020,141,23588,3778,203509,227097,12,1969,11,1561,1,293,115,20,17,3,930,59,16427,1381,127395,143822,8/20/2020
6/20/2020,84,23672,1890,205399,229071,9,1978,12,1573,0,293,112,20,18,4,934,36,16463,816,128211,144674,8/20/2020
6/21/2020,37,23709,1064,206463,230172,7,1985,5,1578,0,293,114,20,18,2,936,28,16491,692,128903,145394,8/20/2020
6/22/2020,142,23851,3728,210191,234042,12,1997,16,1594,0,293,110,19,18,1,937,70,16561,1714,130617,147178,8/20/2020
6/23/2020,163,24014,3843,214034,238048,3,2000,13,1607,3,296,97,18,18,6,943,82,16643,1797,132414,149057,8/20/2020
6/24/2020,122,24136,3508,217542,241678,9,2009,10,1617,1,297,95,18,18,5,948,48,16691,1697,134111,150802,8/20/2020
6/25/2020,103,24239,2893,220435,244674,6,2015,14,1631,1,298,86,17,17,1,949,53,16744,1522,135633,152377,8/20/2020
6/26/2020,95,24334,2454,222889,247223,2,2017,10,1641,0,298,78,18,18,1,950,64,16808,1304,136937,153745,8/20/2020
6/27/2020,84,24418,3215,226104,250522,5,2022,3,1644,1,299,79,17,17,5,955,37,16845,1221,138158,155003,8/20/2020
6/28/2020,38,24456,1470,227574,252030,4,2026,4,1648,4,303,75,15,14,6,961,19,16864,597,138755,155619,8/20/2020
6/29/2020,88,24544,3697,231271,255815,4,2030,5,1653,0,303,74,14,14,1,962,40,16904,1353,140108,157012,8/20/2020
6/30/2020,58,24602,1960,233231,257833,1,2031,5,1658,1,304,69,12,11,3,965,33,16937,999,141107,158044,8/20/2020
7/1/2020,144,24746,4109,237340,262086,7,2038,9,1667,0,304,67,11,11,1,966,81,17018,1954,143061,160079,8/20/2020
7/2/2020,102,24848,2797,240137,264985,5,2043,5,1672,1,305,66,9,9,1,967,57,17075,1087,144148,161223,8/20/2020
7/3/2020,51,24899,2028,242165,267064,9,2052,6,1678,0,305,69,8,8,3,970,26,17101,775,144923,162024,8/20/2020
7/4/2020,57,24956,2329,244494,269450,2,2054,4,1682,1,306,66,9,8,2,972,34,17135,995,145918,163053,8/20/2020
7/5/2020,49,25005,2932,247426,272431,1,2055,2,1684,1,307,64,7,7,2,974,26,17161,1450,147368,164529,8/20/2020
7/6/2020,103,25108,2812,250238,275346,6,2061,6,1690,0,307,64,8,9,4,978,58,17219,1558,148926,166145,8/20/2020
7/7/2020,81,25189,3452,253690,278879,5,2066,7,1697,0,307,62,7,8,1,979,48,17267,1529,150455,167722,8/20/2020
7/8/2020,106,25295,3391,257081,282376,4,2070,2,1699,0,307,64,8,8,0,979,66,17333,1417,151872,169205,8/20/2020
7/9/2020,93,25388,3668,260749,286137,9,2079,3,1702,0,307,70,8,8,0,979,49,17382,1601,153473,170855,8/20/2020
7/10/2020,131,25519,4398,265147,290666,6,2085,3,1705,2,309,71,7,7,3,982,80,17462,2090,155563,173025,8/20/2020
7/11/2020,62,25581,2893,268040,293621,6,2091,3,1708,1,310,73,6,6,3,985,33,17495,1291,156854,174349,8/20/2020
7/12/2020,45,25626,1781,269821,295447,1,2092,3,1711,1,311,70,6,5,3,988,33,17528,898,157752,175280,8/20/2020
7/13/2020,85,25711,3160,272981,298692,8,2100,10,1721,0,311,68,6,5,1,989,57,17585,1483,159235,176820,8/20/2020
7/14/2020,74,25785,3260,276241,302026,7,2107,4,1725,0,311,71,5,5,1,990,49,17634,1355,160590,178224,8/20/2020
7/15/2020,124,25909,4128,280369,306278,5,2112,7,1732,0,311,69,5,4,0,990,94,17728,1730,162320,180048,8/20/2020
7/16/2020,102,26011,3703,284072,310083,6,2118,9,1741,0,311,66,6,5,1,991,78,17806,1602,163922,181728,8/20/2020
7/17/2020,152,26163,4137,288209,314372,14,2132,3,1744,1,312,76,5,5,1,992,78,17884,1805,165727,183611,8/20/2020
7/18/2020,80,26243,3166,291375,317618,5,2137,9,1753,1,313,71,5,4,4,996,67,17951,1336,167063,185014,8/20/2020
7/19/2020,82,26325,2587,293962,320287,6,2143,3,1756,0,313,74,6,4,2,998,59,18010,1067,168130,186140,8/20/2020
7/20/2020,73,26398,2660,296622,323020,9,2152,7,1763,0,313,76,7,5,2,1000,63,18073,1466,169596,187669,8/20/2020
7/21/2020,127,26525,4229,300851,327376,9,2161,10,1773,0,313,75,9,6,1,1001,103,18176,1877,171473,189649,8/20/2020
7/22/2020,124,26649,3790,304641,331290,11,2172,11,1784,1,314,74,7,6,1,1002,86,18262,1579,173052,191314,8/20/2020
7/23/2020,123,26772,4089,308730,335502,8,2180,5,1789,0,314,77,8,7,0,1002,104,18366,1769,174821,193187,8/20/2020
7/24/2020,163,26935,5691,314421,341356,13,2193,13,1802,0,314,77,9,7,0,1002,121,18487,2151,176972,195459,8/20/2020
7/25/2020,126,27061,4265,318686,345747,7,2200,7,1809,0,314,77,10,8,1,1003,104,18591,2002,178974,197565,8/20/2020
7/26/2020,56,27117,2972,321658,348775,8,2208,9,1818,0,314,76,11,7,1,1004,52,18643,1300,180274,198917,8/20/2020
7/27/2020,182,27299,3895,325553,352852,12,2220,7,1825,0,314,81,13,8,1,1005,137,18780,2128,182402,201182,8/20/2020
7/28/2020,105,27404,3682,329235,356639,5,2225,5,1830,0,314,81,14,7,1,1006,88,18868,1523,183925,202793,8/20/2020
7/29/2020,161,27565,4794,334029,361594,10,2235,12,1842,0,314,79,15,7,0,1006,145,19013,2095,186020,205033,8/20/2020
7/30/2020,98,27663,3963,337992,365655,6,2241,2,1844,1,315,82,15,6,0,1006,76,19089,1360,187380,206469,8/20/2020
7/31/2020,115,27778,5093,343085,370863,8,2249,9,1853,0,315,81,15,7,0,1006,87,19176,1618,188998,208174,8/20/2020
8/1/2020,90,27868,3905,346990,374858,7,2256,2,1855,0,315,86,14,7,1,1007,80,19256,1326,190324,209580,8/20/2020
8/2/2020,77,27945,2673,349663,377608,12,2268,12,1867,1,316,85,14,8,2,1009,63,19319,1189,191513,210832,8/20/2020
8/3/2020,168,28113,4829,354492,382605,13,2281,12,1879,0,316,86,16,7,1,1010,147,19466,1905,193418,212884,8/20/2020
8/4/2020,118,28231,3426,357918,386149,8,2289,6,1885,1,317,87,12,5,2,1012,101,19567,1595,195013,214580,8/20/2020
8/5/2020,137,28368,5373,363291,391659,12,2301,10,1895,1,318,88,10,5,2,1014,111,19678,2058,197071,216749,8/20/2020
8/6/2020,156,28524,4646,367937,396461,6,2307,9,1904,0,318,85,9,4,0,1014,114,19792,1787,198858,218650,8/20/2020
8/7/2020,106,28630,4156,372093,400723,13,2320,10,1914,1,319,87,9,3,1,1015,86,19878,1679,200537,220415,8/20/2020
8/8/2020,104,28734,3680,375773,404507,19,2339,6,1920,1,320,99,8,3,1,1016,91,19969,1518,202055,222024,8/20/2020
8/9/2020,36,28770,1538,377311,406081,8,2347,11,1931,0,320,96,9,4,0,1016,33,20002,952,203007,223009,8/20/2020
8/10/2020,133,28903,4055,381366,410269,11,2358,11,1942,0,320,96,9,4,1,1017,109,20111,1666,204673,224784,8/20/2020
8/11/2020,99,29002,3913,385279,414281,6,2364,14,1956,0,320,88,10,4,2,1019,95,20206,2016,206689,226895,8/20/2020
8/12/2020,116,29118,4548,389827,418945,8,2372,11,1967,0,320,85,9,3,1,1020,103,20309,2190,208879,229188,8/20/2020
8/13/2020,112,29230,3453,393280,422510,11,2383,11,1978,0,320,85,11,3,0,1020,90,20399,1508,210387,230786,8/20/2020
8/14/2020,135,29365,5170,398450,427815,13,2396,11,1989,0,320,87,11,4,1,1021,93,20492,1803,212190,232682,8/20/2020
8/15/2020,95,29460,3930,402380,431840,8,2404,10,1999,1,321,84,11,5,0,1021,87,20579,1407,213597,234176,8/20/2020
8/16/2020,75,29535,2223,404603,434138,7,2411,6,2005,4,325,81,8,4,5,1026,67,20646,840,214437,235083,8/20/2020
8/17/2020,101,29636,3746,408349,437985,9,2420,7,2012,0,325,83,8,5,2,1028,83,20729,1739,216176,236905,8/20/2020
8/18/2020,112,29748,3638,411987,441735,11,2431,9,2021,1,326,84,8,4,0,1028,80,20809,1604,217780,238589,8/20/2020
8/19/2020,83,29831,2756,414743,444574,,,,,,,,,,0,1028,62,20871,1112,218892,239763,8/20/2020
2/27/2020,0,0,0,0,0,1,1,0,0,0,0,1,0,0,0,0,0,0,0,0,0,8/21/2020
2/28/2020,0,0,0,0,0,0,1,0,0,0,0,1,1,0,0,0,0,0,0,0,0,8/21/2020
2/29/2020,0,0,0,0,0,0,1,0,0,0,0,1,1,0,0,0,0,0,0,0,0,8/21/2020
3/1/2020,2,2,2,2,4,0,1,0,0,0,0,1,1,1,0,0,2,2,2,2,4,8/21/2020
3/2/2020,0,2,1,3,5,1,2,0,0,0,0,2,2,2,0,0,0,2,1,3,5,8/21/2020
3/3/2020,0,2,2,5,7,0,2,0,0,0,0,2,2,2,0,0,0,2,2,5,7,8/21/2020
3/4/2020,0,2,12,17,19,1,3,0,0,0,0,3,2,2,0,0,0,2,10,15,17,8/21/2020
3/5/2020,0,2,4,21,23,0,3,0,0,0,0,3,2,2,0,0,1,3,4,19,22,8/21/2020
3/6/2020,1,3,12,33,36,0,3,0,0,0,0,3,2,2,0,0,0,3,11,30,33,8/21/2020
3/7/2020,0,3,19,52,55,0,3,0,0,0,0,3,2,1,0,0,0,3,19,49,52,8/21/2020
3/8/2020,0,3,18,70,73,0,3,0,0,0,0,3,2,1,0,0,0,3,18,67,70,8/21/2020
3/9/2020,1,4,15,85,89,0,3,0,0,0,0,3,2,1,0,0,1,4,15,82,86,8/21/2020
3/10/2020,2,6,25,110,116,0,3,0,0,0,0,3,2,1,0,0,1,5,23,105,110,8/21/2020
3/11/2020,0,6,34,144,150,1,4,0,0,0,0,4,1,1,0,0,0,5,34,139,144,8/21/2020
3/12/2020,9,15,41,185,200,1,5,0,0,0,0,5,1,1,0,0,8,13,38,177,190,8/21/2020
3/13/2020,6,21,50,235,256,4,9,1,1,0,0,8,1,1,0,0,6,19,48,225,244,8/21/2020
3/14/2020,0,21,90,325,346,0,9,0,1,0,0,8,1,1,0,0,0,19,86,311,330,8/21/2020
3/15/2020,1,22,54,379,401,1,10,0,1,0,0,9,2,1,0,0,1,20,54,365,385,8/21/2020
3/16/2020,2,24,95,474,498,2,12,0,1,0,0,11,2,0,0,0,2,22,92,457,479,8/21/2020
3/17/2020,12,36,162,636,672,6,18,0,1,0,0,17,2,0,0,0,11,33,152,609,642,8/21/2020
3/18/2020,9,45,116,752,797,3,21,0,1,0,0,20,2,0,0,0,11,44,111,720,764,8/21/2020
3/19/2020,15,60,262,1014,1074,2,23,1,2,0,0,21,3,0,1,1,17,61,251,971,1032,8/21/2020
3/20/2020,13,73,197,1211,1284,5,28,0,2,0,0,26,4,0,0,1,13,74,192,1163,1237,8/21/2020
3/21/2020,12,85,126,1337,1422,3,31,2,4,0,0,27,5,0,0,1,14,88,123,1286,1374,8/21/2020
3/22/2020,27,112,282,1619,1731,2,33,0,4,0,0,29,5,0,0,1,25,113,262,1548,1661,8/21/2020
3/23/2020,14,126,169,1788,1914,15,48,1,5,0,0,43,9,3,0,1,16,129,165,1713,1842,8/21/2020
3/24/2020,20,146,242,2030,2176,7,55,0,5,0,0,50,10,4,0,1,19,148,238,1951,2099,8/21/2020
3/25/2020,26,172,182,2212,2384,5,60,1,6,0,0,54,11,3,0,1,28,176,172,2123,2299,8/21/2020
3/26/2020,35,207,181,2393,2600,10,70,5,11,0,0,59,14,5,0,1,41,217,176,2299,2516,8/21/2020
3/27/2020,27,234,214,2607,2841,9,79,1,12,1,1,66,17,6,2,3,31,248,202,2501,2749,8/21/2020
3/28/2020,59,293,260,2867,3160,13,92,3,15,2,3,74,15,6,1,4,63,311,241,2742,3053,8/21/2020
3/29/2020,100,393,350,3217,3610,8,100,4,19,1,4,77,18,8,2,6,105,416,314,3056,3472,8/21/2020
3/30/2020,62,455,222,3439,3894,20,120,5,24,0,4,92,20,11,3,9,78,494,191,3247,3741,8/21/2020
3/31/2020,71,526,369,3808,4334,11,131,7,31,1,5,95,22,13,2,11,73,567,298,3545,4112,8/21/2020
4/1/2020,99,625,698,4506,5131,18,149,7,38,0,5,106,30,15,1,12,100,667,646,4191,4858,8/21/2020
4/2/2020,52,677,477,4983,5660,22,171,6,44,2,7,120,36,21,4,16,62,729,436,4627,5356,8/21/2020
4/3/2020,108,785,774,5757,6542,23,194,7,51,0,7,136,43,25,3,19,100,829,716,5343,6172,8/21/2020
4/4/2020,143,928,660,6417,7345,22,216,4,55,5,12,149,41,30,9,28,138,967,620,5963,6930,8/21/2020
4/5/2020,187,1115,1156,7573,8688,20,236,9,64,1,13,159,44,36,2,30,182,1149,1071,7034,8183,8/21/2020
4/6/2020,218,1333,1706,9279,10612,26,262,7,71,0,13,178,48,40,7,37,206,1355,1575,8609,9964,8/21/2020
4/7/2020,284,1617,1629,10908,12525,19,281,3,74,2,15,192,50,42,5,42,260,1615,1487,10096,11711,8/21/2020
4/8/2020,290,1907,1720,12628,14535,19,300,7,81,6,21,198,50,38,10,52,272,1887,1568,11664,13551,8/21/2020
4/9/2020,283,2190,1516,14144,16334,32,332,9,90,4,25,217,53,40,7,59,278,2165,1363,13027,15192,8/21/2020
4/10/2020,419,2609,2574,16718,19327,29,361,16,106,5,30,225,59,41,11,70,403,2568,2379,15406,17974,8/21/2020
4/11/2020,297,2906,1905,18623,21529,29,390,11,117,2,32,241,61,48,12,82,281,2849,1725,17131,19980,8/21/2020
4/12/2020,314,3220,1670,20293,23513,35,425,13,130,5,37,258,59,49,9,91,289,3138,1440,18571,21709,8/21/2020
4/13/2020,161,3381,935,21228,24609,35,460,13,143,3,40,277,64,54,9,100,187,3325,843,19414,22739,8/21/2020
4/14/2020,289,3670,1787,23015,26685,27,487,17,160,5,45,282,72,53,8,108,265,3590,1533,20947,24537,8/21/2020
4/15/2020,351,4021,1799,24814,28835,31,518,20,180,3,48,290,72,54,17,125,307,3897,1568,22515,26412,8/21/2020
4/16/2020,447,4468,2494,27308,31776,36,554,25,205,6,54,295,72,53,14,139,391,4288,2089,24604,28892,8/21/2020
4/17/2020,304,4772,1821,29129,33901,32,586,20,225,7,61,300,66,45,21,160,291,4579,1463,26067,30646,8/21/2020
4/18/2020,321,5093,1725,30854,35947,26,612,18,243,4,65,304,63,49,15,175,284,4863,1352,27419,32282,8/21/2020
4/19/2020,381,5474,2047,32901,38375,23,635,26,269,1,66,300,65,55,11,186,338,5201,1752,29171,34372,8/21/2020
4/20/2020,394,5868,1907,34808,40676,46,681,29,298,2,68,315,75,56,10,196,377,5578,1583,30754,36332,8/21/2020
4/21/2020,444,6312,2110,36918,43230,45,726,31,329,5,73,324,72,56,18,214,390,5968,1721,32475,38443,8/21/2020
4/22/2020,418,6730,2390,39308,46038,41,767,32,361,5,78,328,73,58,18,232,382,6350,1921,34396,40746,8/21/2020
4/23/2020,479,7209,2469,41777,48986,30,797,28,389,5,83,325,76,62,15,247,418,6768,1877,36273,43041,8/21/2020
4/24/2020,491,7700,3284,45061,52761,35,832,27,416,4,87,329,85,63,15,262,413,7181,2640,38913,46094,8/21/2020
4/25/2020,393,8093,2206,47267,55360,34,866,17,433,5,92,341,85,62,14,276,304,7485,1779,40692,48177,8/21/2020
4/26/2020,316,8409,2309,49576,57985,33,899,15,448,3,95,356,86,59,14,290,276,7761,1885,42577,50338,8/21/2020
4/27/2020,249,8658,1620,51196,59854,29,928,21,469,4,99,360,86,61,10,300,204,7965,1164,43741,51706,8/21/2020
4/28/2020,410,9068,2263,53459,62527,44,972,24,493,3,102,377,88,59,22,322,325,8290,1771,45512,53802,8/21/2020
4/29/2020,476,9544,3343,56802,66346,36,1008,37,530,11,113,365,78,53,18,340,371,8661,2445,47957,56618,8/21/2020
4/30/2020,432,9976,2769,59571,69547,33,1041,38,568,6,119,354,83,57,24,364,348,9009,1959,49916,58925,8/21/2020
5/1/2020,454,10430,3086,62657,73087,51,1092,39,607,3,122,363,84,58,14,378,317,9326,2221,52137,61463,8/21/2020
5/2/2020,257,10687,1926,64583,75270,36,1128,39,646,5,127,355,91,62,24,402,189,9515,1295,53432,62947,8/21/2020
5/3/2020,283,10970,2160,66743,77713,31,1159,27,673,8,135,351,90,61,21,423,182,9697,1606,55038,64735,8/21/2020
5/4/2020,387,11357,2098,68841,80198,30,1189,31,704,5,140,345,88,57,18,441,293,9990,1573,56611,66601,8/21/2020
5/5/2020,433,11790,2873,71714,83504,29,1218,32,736,6,146,336,82,54,16,457,304,10294,1968,58579,68873,8/21/2020
5/6/2020,488,12278,2829,74543,86821,28,1246,44,780,9,155,311,79,54,21,478,341,10635,1926,60505,71140,8/21/2020
5/7/2020,425,12703,2969,77512,90215,36,1282,42,822,5,160,300,71,52,21,499,269,10904,1985,62490,73394,8/21/2020
5/8/2020,359,13062,2598,80110,93172,30,1312,29,851,5,165,296,71,53,22,521,231,11135,1766,64256,75391,8/21/2020
5/9/2020,467,13529,3346,83456,96985,22,1334,21,872,4,169,293,69,51,15,536,286,11421,2304,66560,77981,8/21/2020
5/10/2020,285,13814,2117,85573,99387,19,1353,23,895,6,175,283,70,49,13,549,187,11608,1526,68086,79694,8/21/2020
5/11/2020,257,14071,1857,87430,101501,31,1384,16,911,6,181,292,71,49,15,564,176,11784,1310,69396,81180,8/21/2020
5/12/2020,387,14458,2611,90041,104499,23,1407,18,929,4,185,293,69,48,22,586,218,12002,1714,71110,83112,8/21/2020
5/13/2020,351,14809,3630,93671,108480,22,1429,24,953,1,186,290,69,49,13,599,196,12198,2021,73131,85329,8/21/2020
5/14/2020,329,15138,3408,97079,112217,19,1448,27,980,3,189,279,64,45,15,614,227,12425,2021,75152,87577,8/21/2020
5/15/2020,381,15519,3458,100537,116056,24,1472,41,1021,5,194,257,62,45,13,627,234,12659,1815,76967,89626,8/21/2020
5/16/2020,449,15968,4156,104693,120661,25,1497,12,1033,5,199,265,61,46,15,642,252,12911,1968,78935,91846,8/21/2020
5/17/2020,240,16208,2768,107461,123669,17,1514,7,1040,5,204,270,59,45,10,652,124,13035,1567,80502,93537,8/21/2020
5/18/2020,250,16458,2001,109462,125920,19,1533,15,1055,5,209,269,57,40,18,670,139,13174,1374,81876,95050,8/21/2020
5/19/2020,415,16873,3168,112630,129503,23,1556,32,1087,5,214,255,56,38,11,681,212,13386,1938,83814,97200,8/21/2020
5/20/2020,326,17199,2771,115401,132600,19,1575,23,1110,7,221,244,52,33,22,703,187,13573,1521,85335,98908,8/21/2020
5/21/2020,374,17573,3757,119158,136731,26,1601,15,1125,3,224,252,53,29,20,723,170,13743,1950,87285,101028,8/21/2020
5/22/2020,351,17924,3161,122319,140243,20,1621,29,1154,5,229,238,52,29,10,733,204,13947,1615,88900,102847,8/21/2020
5/23/2020,253,18177,2742,125061,143238,19,1640,11,1165,3,232,243,52,32,13,746,109,14056,1283,90183,104239,8/21/2020
5/24/2020,163,18340,1370,126431,144771,12,1652,14,1179,2,234,239,53,36,8,754,84,14140,773,90956,105096,8/21/2020
5/25/2020,147,18487,1385,127816,146303,13,1665,14,1193,0,234,238,53,34,10,764,71,14211,765,91721,105932,8/21/2020
5/26/2020,285,18772,2620,130436,149208,24,1689,22,1215,5,239,235,48,33,15,779,156,14367,1784,93505,107872,8/21/2020
5/27/2020,276,19048,2065,132501,151549,20,1709,18,1233,3,242,234,50,33,10,789,133,14500,1143,94648,109148,8/21/2020
5/28/2020,349,19397,3371,135872,155269,17,1726,29,1262,4,246,218,47,32,8,797,133,14633,1131,95779,110412,8/21/2020
5/29/2020,413,19810,3928,139800,159610,19,1745,27,1289,6,252,204,43,31,12,809,179,14812,1588,97367,112179,8/21/2020
5/30/2020,225,20035,3915,143715,163750,15,1760,19,1308,4,256,196,40,29,12,821,110,14922,1827,99194,114116,8/21/2020
5/31/2020,155,20190,1688,145403,165593,11,1771,10,1318,0,256,197,43,26,3,824,78,15000,860,100054,115054,8/21/2020
6/1/2020,214,20404,2792,148195,168599,8,1779,14,1332,1,257,190,44,29,5,829,99,15099,1385,101439,116538,8/21/2020
6/2/2020,273,20677,3034,151229,171906,8,1787,9,1341,3,260,186,37,25,10,839,107,15206,1467,102906,118112,8/21/2020
6/3/2020,254,20931,3495,154724,175655,13,1800,18,1359,6,266,175,34,25,11,850,105,15311,1676,104582,119893,8/21/2020
6/4/2020,277,21208,4474,159198,180406,7,1807,25,1384,3,269,154,31,24,11,861,114,15425,2049,106631,122056,8/21/2020
6/5/2020,215,21423,3521,162719,184142,15,1822,13,1397,6,275,150,27,21,9,870,105,15530,1583,108214,123744,8/21/2020
6/6/2020,201,21624,2618,165337,186961,10,1832,7,1404,2,277,151,29,19,6,876,68,15598,1138,109352,124950,8/21/2020
6/7/2020,83,21707,1625,166962,188669,11,1843,7,1411,1,278,154,25,17,4,880,50,15648,783,110135,125783,8/21/2020
6/8/2020,122,21829,1860,168822,190651,15,1858,12,1423,2,280,155,27,18,4,884,44,15692,974,111109,126801,8/21/2020
6/9/2020,225,22054,2688,171510,193564,10,1868,18,1441,0,280,147,28,21,1,885,67,15759,1275,112384,128143,8/21/2020
6/10/2020,211,22265,2986,174496,196761,13,1881,12,1453,2,282,146,24,17,3,888,105,15864,1467,113851,129715,8/21/2020
6/11/2020,195,22460,3516,178012,200472,7,1888,15,1468,1,283,137,25,16,6,894,88,15952,1542,115393,131345,8/21/2020
6/12/2020,214,22674,4608,182620,205294,9,1897,15,1483,1,284,130,24,16,2,896,81,16033,2193,117586,133619,8/21/2020
6/13/2020,113,22787,3038,185658,208445,6,1903,4,1487,0,284,132,20,15,3,899,50,16083,1380,118966,135049,8/21/2020
6/14/2020,80,22867,2046,187704,210571,6,1909,8,1495,1,285,129,20,14,3,902,32,16115,969,119935,136050,8/21/2020
6/15/2020,188,23055,3117,190821,213876,14,1923,14,1509,0,285,129,20,16,4,906,78,16193,1797,121732,137925,8/21/2020
6/16/2020,115,23170,3026,193847,217017,10,1933,9,1518,1,286,129,22,16,8,914,52,16245,1588,123320,139565,8/21/2020
6/17/2020,127,23297,2838,196685,219982,15,1948,20,1538,4,290,120,18,14,6,920,53,16298,1326,124646,140944,8/21/2020
6/18/2020,150,23447,3048,199733,223180,9,1957,13,1551,1,291,115,19,16,7,927,70,16368,1339,125985,142353,8/21/2020
6/19/2020,141,23588,3779,203512,227100,12,1969,11,1562,1,292,115,20,17,3,930,59,16427,1380,127365,143792,8/21/2020
6/20/2020,84,23672,1890,205402,229074,9,1978,12,1574,0,292,112,20,18,4,934,36,16463,816,128181,144644,8/21/2020
6/21/2020,37,23709,1064,206466,230175,7,1985,5,1579,0,292,114,20,18,2,936,28,16491,692,128873,145364,8/21/2020
6/22/2020,142,23851,3728,210194,234045,12,1997,16,1595,0,292,110,19,18,1,937,70,16561,1714,130587,147148,8/21/2020
6/23/2020,163,24014,3843,214037,238051,3,2000,13,1608,3,295,97,18,18,6,943,82,16643,1797,132384,149027,8/21/2020
6/24/2020,122,24136,3508,217545,241681,9,2009,10,1618,1,296,95,18,18,5,948,48,16691,1696,134080,150771,8/21/2020
6/25/2020,103,24239,2893,220438,244677,6,2015,14,1632,1,297,86,17,17,1,949,53,16744,1522,135602,152346,8/21/2020
6/26/2020,95,24334,2454,222892,247226,2,2017,10,1642,0,297,78,18,18,1,950,64,16808,1304,136906,153714,8/21/2020
6/27/2020,84,24418,3215,226107,250525,5,2022,3,1645,1,298,79,17,17,5,955,37,16845,1221,138127,154972,8/21/2020
6/28/2020,38,24456,1470,227577,252033,4,2026,4,1649,4,302,75,15,14,6,961,19,16864,597,138724,155588,8/21/2020
6/29/2020,88,24544,3697,231274,255818,4,2030,5,1654,0,302,74,14,14,1,962,40,16904,1353,140077,156981,8/21/2020
6/30/2020,58,24602,1961,233235,257837,1,2031,5,1659,1,303,69,12,11,3,965,33,16937,1000,141077,158014,8/21/2020
7/1/2020,144,24746,4109,237344,262090,7,2038,9,1668,0,303,67,11,11,1,966,81,17018,1953,143030,160048,8/21/2020
7/2/2020,102,24848,2797,240141,264989,5,2043,5,1673,1,304,66,9,9,1,967,57,17075,1087,144117,161192,8/21/2020
7/3/2020,51,24899,2028,242169,267068,9,2052,6,1679,0,304,69,8,8,3,970,26,17101,775,144892,161993,8/21/2020
7/4/2020,57,24956,2330,244499,269455,2,2054,4,1683,1,305,66,9,8,2,972,34,17135,996,145888,163023,8/21/2020
7/5/2020,49,25005,2932,247431,272436,1,2055,2,1685,1,306,64,7,7,2,974,26,17161,1449,147337,164498,8/21/2020
7/6/2020,103,25108,2812,250243,275351,6,2061,6,1691,0,306,64,8,9,4,978,58,17219,1558,148895,166114,8/21/2020
7/7/2020,81,25189,3454,253697,278886,5,2066,7,1698,0,306,62,7,8,1,979,48,17267,1531,150426,167693,8/21/2020
7/8/2020,106,25295,3391,257088,282383,4,2070,2,1700,0,306,64,8,8,0,979,66,17333,1417,151843,169176,8/21/2020
7/9/2020,93,25388,3669,260757,286145,9,2079,3,1703,0,306,70,8,8,0,979,49,17382,1602,153445,170827,8/21/2020
7/10/2020,131,25519,4398,265155,290674,6,2085,3,1706,2,308,71,7,7,3,982,80,17462,2090,155535,172997,8/21/2020
7/11/2020,62,25581,2894,268049,293630,6,2091,3,1709,1,309,73,6,6,3,985,33,17495,1290,156825,174320,8/21/2020
7/12/2020,45,25626,1782,269831,295457,1,2092,3,1712,1,310,70,6,5,3,988,33,17528,899,157724,175252,8/21/2020
7/13/2020,85,25711,3160,272991,298702,8,2100,10,1722,0,310,68,6,5,1,989,57,17585,1482,159206,176791,8/21/2020
7/14/2020,74,25785,3279,276270,302055,7,2107,4,1726,0,310,71,5,5,1,990,49,17634,1371,160577,178211,8/21/2020
7/15/2020,124,25909,4129,280399,306308,5,2112,7,1733,0,310,69,5,4,0,990,94,17728,1730,162307,180035,8/21/2020
7/16/2020,102,26011,3704,284103,310114,6,2118,9,1742,0,310,66,6,5,1,991,78,17806,1602,163909,181715,8/21/2020
7/17/2020,152,26163,4137,288240,314403,14,2132,3,1745,1,311,76,5,5,1,992,78,17884,1802,165711,183595,8/21/2020
7/18/2020,80,26243,3168,291408,317651,5,2137,9,1754,1,312,71,5,4,4,996,67,17951,1337,167048,184999,8/21/2020
7/19/2020,82,26325,2588,293996,320321,6,2143,3,1757,0,312,74,6,4,2,998,59,18010,1066,168114,186124,8/21/2020
7/20/2020,73,26398,2661,296657,323055,9,2152,7,1764,0,312,76,7,5,2,1000,63,18073,1466,169580,187653,8/21/2020
7/21/2020,127,26525,4228,300885,327410,9,2161,10,1774,0,312,75,9,6,1,1001,103,18176,1875,171455,189631,8/21/2020
7/22/2020,124,26649,3790,304675,331324,11,2172,11,1785,1,313,74,7,6,1,1002,86,18262,1579,173034,191296,8/21/2020
7/23/2020,123,26772,4089,308764,335536,8,2180,5,1790,0,313,77,8,7,0,1002,104,18366,1769,174803,193169,8/21/2020
7/24/2020,164,26936,5691,314455,341391,13,2193,13,1803,0,313,77,9,7,0,1002,121,18487,2150,176953,195440,8/21/2020
7/25/2020,126,27062,4266,318721,345783,7,2200,7,1810,0,313,77,10,8,1,1003,104,18591,2003,178956,197547,8/21/2020
7/26/2020,56,27118,2972,321693,348811,8,2208,9,1819,0,313,76,11,7,1,1004,52,18643,1300,180256,198899,8/21/2020
7/27/2020,182,27300,3896,325589,352889,12,2220,7,1826,0,313,81,13,8,1,1005,137,18780,2130,182386,201166,8/21/2020
7/28/2020,105,27405,3683,329272,356677,5,2225,5,1831,0,313,81,14,7,1,1006,88,18868,1524,183910,202778,8/21/2020
7/29/2020,161,27566,4795,334067,361633,10,2235,12,1843,0,313,79,15,7,0,1006,145,19013,2093,186003,205016,8/21/2020
7/30/2020,98,27664,4002,338069,365733,6,2241,2,1845,1,314,82,15,6,0,1006,76,19089,1393,187396,206485,8/21/2020
7/31/2020,115,27779,5109,343178,370957,8,2249,9,1854,0,314,81,15,7,0,1006,87,19176,1630,189026,208202,8/21/2020
8/1/2020,91,27870,3916,347094,374964,7,2256,2,1856,0,314,86,14,7,1,1007,80,19256,1334,190360,209616,8/21/2020
8/2/2020,77,27947,2706,349800,377747,12,2268,12,1868,1,315,85,14,8,2,1009,63,19319,1216,191576,210895,8/21/2020
8/3/2020,168,28115,4829,354629,382744,13,2281,12,1880,0,315,86,16,7,1,1010,147,19466,1903,193479,212945,8/21/2020
8/4/2020,118,28233,3426,358055,386288,8,2289,6,1886,1,316,87,12,5,2,1012,101,19567,1595,195074,214641,8/21/2020
8/5/2020,137,28370,5406,363461,391831,12,2301,10,1896,1,317,88,10,5,2,1014,111,19678,2088,197162,216840,8/21/2020
8/6/2020,156,28526,4661,368122,396648,6,2307,9,1905,0,317,85,9,4,0,1014,114,19792,1801,198963,218755,8/21/2020
8/7/2020,106,28632,4159,372281,400913,13,2320,10,1915,1,318,87,9,3,1,1015,86,19878,1679,200642,220520,8/21/2020
8/8/2020,104,28736,3680,375961,404697,19,2339,6,1921,1,319,99,8,3,1,1016,91,19969,1516,202158,222127,8/21/2020
8/9/2020,36,28772,1538,377499,406271,8,2347,11,1932,0,319,96,9,4,0,1016,33,20002,952,203110,223112,8/21/2020
8/10/2020,134,28906,4054,381553,410459,11,2358,11,1943,0,319,96,9,4,1,1017,110,20112,1665,204775,224887,8/21/2020
8/11/2020,99,29005,3915,385468,414473,6,2364,14,1957,0,319,88,10,4,2,1019,94,20206,2015,206790,226996,8/21/2020
8/12/2020,116,29121,4560,390028,419149,8,2372,11,1968,0,319,85,9,3,1,1020,103,20309,2199,208989,229298,8/21/2020
8/13/2020,112,29233,3419,393447,422680,11,2383,11,1979,0,319,85,11,3,0,1020,89,20398,1504,210493,230891,8/21/2020
8/14/2020,135,29368,4925,398372,427740,13,2396,11,1990,0,319,87,11,4,1,1021,99,20497,1772,212265,232762,8/21/2020
8/15/2020,96,29464,3890,402262,431726,8,2404,10,2000,1,320,84,11,5,0,1021,89,20586,1412,213677,234263,8/21/2020
8/16/2020,76,29540,2560,404822,434362,7,2411,6,2006,4,324,81,8,4,5,1026,68,20654,883,214560,235214,8/21/2020
8/17/2020,101,29641,3647,408469,438110,10,2421,7,2013,0,324,84,8,5,2,1028,85,20739,1741,216301,237040,8/21/2020
8/18/2020,118,29759,4648,413117,442876,11,2432,9,2022,1,325,85,8,4,0,1028,86,20825,2657,218958,239783,8/21/2020
8/19/2020,97,29856,4792,417909,447765,6,2438,9,2031,1,326,81,9,5,0,1028,67,20892,2543,221501,242393,8/21/2020
8/20/2020,166,30022,7046,424955,454977,,,,,,,,,,2,1030,130,21022,3331,224832,245854,8/21/2020
2/27/2020,0,0,0,0,0,1,1,0,0,0,0,1,0,0,0,0,0,0,0,0,0,8/24/2020
2/28/2020,0,0,0,0,0,0,1,0,0,0,0,1,1,0,0,0,0,0,0,0,0,8/24/2020
2/29/2020,0,0,0,0,0,0,1,0,0,0,0,1,1,0,0,0,0,0,0,0,0,8/24/2020
3/1/2020,2,2,2,2,4,0,1,0,0,0,0,1,1,1,0,0,2,2,2,2,4,8/24/2020
3/2/2020,0,2,1,3,5,1,2,0,0,0,0,2,2,2,0,0,0,2,1,3,5,8/24/2020
3/3/2020,0,2,2,5,7,0,2,0,0,0,0,2,2,2,0,0,0,2,2,5,7,8/24/2020
3/4/2020,0,2,12,17,19,1,3,0,0,0,0,3,2,2,0,0,0,2,10,15,17,8/24/2020
3/5/2020,0,2,4,21,23,0,3,0,0,0,0,3,2,2,0,0,1,3,4,19,22,8/24/2020
3/6/2020,1,3,12,33,36,0,3,0,0,0,0,3,2,2,0,0,0,3,11,30,33,8/24/2020
3/7/2020,0,3,19,52,55,0,3,0,0,0,0,3,2,1,0,0,0,3,19,49,52,8/24/2020
3/8/2020,0,3,18,70,73,0,3,0,0,0,0,3,2,1,0,0,0,3,18,67,70,8/24/2020
3/9/2020,1,4,15,85,89,0,3,0,0,0,0,3,2,1,0,0,1,4,15,82,86,8/24/2020
3/10/2020,2,6,25,110,116,0,3,0,0,0,0,3,2,1,0,0,1,5,23,105,110,8/24/2020
3/11/2020,0,6,34,144,150,1,4,0,0,0,0,4,1,1,0,0,0,5,34,139,144,8/24/2020
3/12/2020,9,15,41,185,200,1,5,0,0,0,0,5,1,1,0,0,8,13,38,177,190,8/24/2020
3/13/2020,6,21,50,235,256,4,9,1,1,0,0,8,1,1,0,0,6,19,48,225,244,8/24/2020
3/14/2020,0,21,90,325,346,0,9,0,1,0,0,8,1,1,0,0,0,19,86,311,330,8/24/2020
3/15/2020,1,22,54,379,401,1,10,0,1,0,0,9,2,1,0,0,1,20,54,365,385,8/24/2020
3/16/2020,2,24,95,474,498,2,12,0,1,0,0,11,2,0,0,0,2,22,92,457,479,8/24/2020
3/17/2020,12,36,162,636,672,6,18,0,1,0,0,17,2,0,0,0,11,33,152,609,642,8/24/2020
3/18/2020,9,45,116,752,797,3,21,0,1,0,0,20,2,0,0,0,11,44,111,720,764,8/24/2020
3/19/2020,15,60,262,1014,1074,2,23,1,2,0,0,21,3,0,1,1,17,61,251,971,1032,8/24/2020
3/20/2020,13,73,197,1211,1284,5,28,0,2,0,0,26,4,0,0,1,13,74,192,1163,1237,8/24/2020
3/21/2020,12,85,126,1337,1422,3,31,2,4,0,0,27,5,0,0,1,14,88,123,1286,1374,8/24/2020
3/22/2020,27,112,282,1619,1731,2,33,0,4,0,0,29,5,0,0,1,25,113,262,1548,1661,8/24/2020
3/23/2020,14,126,169,1788,1914,15,48,1,5,0,0,43,9,3,0,1,16,129,165,1713,1842,8/24/2020
3/24/2020,20,146,242,2030,2176,7,55,0,5,0,0,50,10,4,0,1,19,148,238,1951,2099,8/24/2020
3/25/2020,26,172,182,2212,2384,5,60,1,6,0,0,54,11,3,0,1,28,176,172,2123,2299,8/24/2020
3/26/2020,35,207,181,2393,2600,10,70,5,11,0,0,59,14,5,0,1,41,217,176,2299,2516,8/24/2020
3/27/2020,27,234,214,2607,2841,9,79,1,12,1,1,66,17,6,2,3,31,248,202,2501,2749,8/24/2020
3/28/2020,59,293,260,2867,3160,13,92,3,15,2,3,74,15,6,1,4,63,311,241,2742,3053,8/24/2020
3/29/2020,100,393,350,3217,3610,8,100,4,19,1,4,77,18,8,2,6,105,416,314,3056,3472,8/24/2020
3/30/2020,62,455,222,3439,3894,20,120,5,24,0,4,92,20,11,3,9,78,494,187,3243,3737,8/24/2020
3/31/2020,71,526,369,3808,4334,11,131,7,31,1,5,95,22,13,2,11,73,567,298,3541,4108,8/24/2020
4/1/2020,99,625,698,4506,5131,18,149,7,38,0,5,106,30,15,1,12,100,667,645,4186,4853,8/24/2020
4/2/2020,52,677,477,4983,5660,22,171,6,44,2,7,120,36,21,4,16,62,729,436,4622,5351,8/24/2020
4/3/2020,108,785,774,5757,6542,23,194,7,51,0,7,136,43,25,3,19,100,829,716,5338,6167,8/24/2020
4/4/2020,143,928,660,6417,7345,22,216,4,55,5,12,149,41,30,9,28,138,967,620,5958,6925,8/24/2020
4/5/2020,187,1115,1156,7573,8688,20,236,9,64,1,13,159,44,36,2,30,182,1149,1070,7028,8177,8/24/2020
4/6/2020,218,1333,1706,9279,10612,26,262,7,71,0,13,178,48,40,7,37,206,1355,1568,8596,9951,8/24/2020
4/7/2020,284,1617,1629,10908,12525,19,281,3,74,2,15,192,50,42,5,42,260,1615,1486,10082,11697,8/24/2020
4/8/2020,290,1907,1720,12628,14535,19,300,7,81,6,21,198,50,38,10,52,272,1887,1567,11649,13536,8/24/2020
4/9/2020,283,2190,1516,14144,16334,32,332,9,90,4,25,217,53,40,7,59,278,2165,1361,13010,15175,8/24/2020
4/10/2020,419,2609,2574,16718,19327,29,361,16,106,5,30,225,59,41,11,70,403,2568,2378,15388,17956,8/24/2020
4/11/2020,297,2906,1905,18623,21529,29,390,11,117,2,32,241,61,48,12,82,281,2849,1721,17109,19958,8/24/2020
4/12/2020,314,3220,1670,20293,23513,35,425,13,130,5,37,258,59,49,9,91,289,3138,1440,18549,21687,8/24/2020
4/13/2020,161,3381,935,21228,24609,35,460,13,143,3,40,277,64,54,9,100,187,3325,842,19391,22716,8/24/2020
4/14/2020,289,3670,1787,23015,26685,27,487,17,160,5,45,282,72,53,8,108,265,3590,1531,20922,24512,8/24/2020
4/15/2020,351,4021,1799,24814,28835,31,518,20,180,3,48,290,72,54,17,125,307,3897,1567,22489,26386,8/24/2020
4/16/2020,447,4468,2494,27308,31776,36,554,25,205,6,54,295,72,53,14,139,391,4288,2088,24577,28865,8/24/2020
4/17/2020,304,4772,1821,29129,33901,32,586,20,225,7,61,300,66,45,21,160,291,4579,1462,26039,30618,8/24/2020
4/18/2020,321,5093,1725,30854,35947,26,612,18,243,4,65,304,63,49,15,175,284,4863,1349,27388,32251,8/24/2020
4/19/2020,381,5474,2047,32901,38375,23,635,26,269,1,66,300,65,55,11,186,338,5201,1749,29137,34338,8/24/2020
4/20/2020,394,5868,1907,34808,40676,46,681,29,298,2,68,315,75,56,10,196,377,5578,1582,30719,36297,8/24/2020
4/21/2020,444,6312,2110,36918,43230,45,726,31,329,5,73,324,72,56,18,214,390,5968,1720,32439,38407,8/24/2020
4/22/2020,418,6730,2390,39308,46038,41,767,32,361,5,78,328,73,58,18,232,382,6350,1920,34359,40709,8/24/2020
4/23/2020,479,7209,2469,41777,48986,30,797,28,389,5,83,325,76,62,15,247,418,6768,1872,36231,42999,8/24/2020
4/24/2020,491,7700,3284,45061,52761,35,832,27,416,4,87,329,85,63,15,262,413,7181,2637,38868,46049,8/24/2020
4/25/2020,393,8093,2206,47267,55360,34,866,17,433,5,92,341,85,62,14,276,304,7485,1779,40647,48132,8/24/2020
4/26/2020,316,8409,2309,49576,57985,33,899,15,448,3,95,356,86,59,14,290,276,7761,1885,42532,50293,8/24/2020
4/27/2020,249,8658,1620,51196,59854,29,928,21,469,4,99,360,86,61,10,300,204,7965,1164,43696,51661,8/24/2020
4/28/2020,410,9068,2263,53459,62527,44,972,24,493,3,102,377,88,59,22,322,325,8290,1771,45467,53757,8/24/2020
4/29/2020,476,9544,3343,56802,66346,36,1008,37,530,11,113,365,78,53,18,340,371,8661,2441,47908,56569,8/24/2020
4/30/2020,432,9976,2769,59571,69547,33,1041,38,568,6,119,354,83,57,24,364,348,9009,1958,49866,58875,8/24/2020
5/1/2020,454,10430,3086,62657,73087,51,1092,40,608,3,122,362,84,58,14,378,317,9326,2221,52087,61413,8/24/2020
5/2/2020,257,10687,1926,64583,75270,36,1128,38,646,5,127,355,91,62,24,402,189,9515,1294,53381,62896,8/24/2020
5/3/2020,283,10970,2160,66743,77713,31,1159,27,673,8,135,351,90,61,21,423,182,9697,1605,54986,64683,8/24/2020
5/4/2020,387,11357,2098,68841,80198,30,1189,31,704,5,140,345,88,57,18,441,293,9990,1573,56559,66549,8/24/2020
5/5/2020,433,11790,2873,71714,83504,29,1218,32,736,6,146,336,82,54,16,457,304,10294,1968,58527,68821,8/24/2020
5/6/2020,488,12278,2829,74543,86821,28,1246,44,780,9,155,311,79,54,21,478,341,10635,1925,60452,71087,8/24/2020
5/7/2020,425,12703,2969,77512,90215,36,1282,42,822,5,160,300,71,52,21,499,269,10904,1983,62435,73339,8/24/2020
5/8/2020,359,13062,2598,80110,93172,30,1312,29,851,5,165,296,71,53,22,521,231,11135,1765,64200,75335,8/24/2020
5/9/2020,467,13529,3346,83456,96985,22,1334,21,872,4,169,293,69,51,15,536,286,11421,2297,66497,77918,8/24/2020
5/10/2020,285,13814,2117,85573,99387,19,1353,23,895,6,175,283,70,49,13,549,187,11608,1526,68023,79631,8/24/2020
5/11/2020,257,14071,1857,87430,101501,31,1384,16,911,6,181,292,71,49,15,564,176,11784,1307,69330,81114,8/24/2020
5/12/2020,387,14458,2611,90041,104499,23,1407,18,929,4,185,293,69,48,22,586,218,12002,1714,71044,83046,8/24/2020
5/13/2020,351,14809,3630,93671,108480,22,1429,24,953,1,186,290,69,49,13,599,196,12198,2019,73063,85261,8/24/2020
5/14/2020,329,15138,3408,97079,112217,19,1448,27,980,3,189,279,64,45,15,614,227,12425,2021,75084,87509,8/24/2020
5/15/2020,381,15519,3458,100537,116056,24,1472,41,1021,5,194,257,62,45,13,627,234,12659,1814,76898,89557,8/24/2020
5/16/2020,449,15968,4156,104693,120661,25,1497,12,1033,5,199,265,61,46,15,642,252,12911,1967,78865,91776,8/24/2020
5/17/2020,240,16208,2768,107461,123669,17,1514,7,1040,5,204,270,59,45,10,652,124,13035,1567,80432,93467,8/24/2020
5/18/2020,250,16458,2001,109462,125920,19,1533,15,1055,5,209,269,57,40,18,670,139,13174,1374,81806,94980,8/24/2020
5/19/2020,415,16873,3168,112630,129503,23,1556,32,1087,5,214,255,56,38,11,681,212,13386,1937,83743,97129,8/24/2020
5/20/2020,326,17199,2771,115401,132600,19,1575,23,1110,7,221,244,52,33,22,703,187,13573,1521,85264,98837,8/24/2020
5/21/2020,374,17573,3757,119158,136731,26,1601,15,1125,3,224,252,53,29,20,723,170,13743,1950,87214,100957,8/24/2020
5/22/2020,351,17924,3161,122319,140243,20,1621,29,1154,5,229,238,52,29,10,733,204,13947,1614,88828,102775,8/24/2020
5/23/2020,253,18177,2742,125061,143238,19,1640,11,1165,3,232,243,52,32,13,746,109,14056,1282,90110,104166,8/24/2020
5/24/2020,163,18340,1370,126431,144771,12,1652,14,1179,2,234,239,53,36,8,754,84,14140,773,90883,105023,8/24/2020
5/25/2020,147,18487,1385,127816,146303,13,1665,14,1193,0,234,238,53,34,10,764,71,14211,765,91648,105859,8/24/2020
5/26/2020,285,18772,2620,130436,149208,24,1689,22,1215,5,239,235,48,33,15,779,156,14367,1784,93432,107799,8/24/2020
5/27/2020,276,19048,2065,132501,151549,20,1709,18,1233,3,242,234,50,33,10,789,133,14500,1143,94575,109075,8/24/2020
5/28/2020,349,19397,3371,135872,155269,17,1726,29,1262,4,246,218,47,32,8,797,133,14633,1131,95706,110339,8/24/2020
5/29/2020,413,19810,3928,139800,159610,19,1745,27,1289,6,252,204,43,31,12,809,179,14812,1587,97293,112105,8/24/2020
5/30/2020,225,20035,3915,143715,163750,15,1760,19,1308,4,256,196,40,29,12,821,109,14921,1826,99119,114040,8/24/2020
5/31/2020,155,20190,1688,145403,165593,11,1771,10,1318,0,256,197,43,26,3,824,78,14999,860,99979,114978,8/24/2020
6/1/2020,214,20404,2792,148195,168599,8,1779,14,1332,1,257,190,44,29,5,829,99,15098,1384,101363,116461,8/24/2020
6/2/2020,273,20677,3034,151229,171906,8,1787,9,1341,3,260,186,37,25,10,839,107,15205,1467,102830,118035,8/24/2020
6/3/2020,254,20931,3495,154724,175655,13,1800,18,1359,6,266,175,34,25,11,850,105,15310,1676,104506,119816,8/24/2020
6/4/2020,277,21208,4474,159198,180406,7,1807,25,1384,3,269,154,31,24,11,861,114,15424,2049,106555,121979,8/24/2020
6/5/2020,215,21423,3521,162719,184142,15,1822,13,1397,6,275,150,27,21,9,870,105,15529,1583,108138,123667,8/24/2020
6/6/2020,201,21624,2618,165337,186961,10,1832,7,1404,2,277,151,29,19,6,876,68,15597,1138,109276,124873,8/24/2020
6/7/2020,83,21707,1625,166962,188669,11,1843,7,1411,1,278,154,25,17,4,880,50,15647,783,110059,125706,8/24/2020
6/8/2020,122,21829,1860,168822,190651,15,1858,12,1423,2,280,155,27,18,4,884,44,15691,974,111033,126724,8/24/2020
6/9/2020,225,22054,2688,171510,193564,10,1868,18,1441,0,280,147,28,21,1,885,67,15758,1275,112308,128066,8/24/2020
6/10/2020,211,22265,2986,174496,196761,13,1881,12,1453,2,282,146,24,17,3,888,105,15863,1467,113775,129638,8/24/2020
6/11/2020,195,22460,3516,178012,200472,7,1888,15,1468,1,283,137,25,16,6,894,88,15951,1541,115316,131267,8/24/2020
6/12/2020,214,22674,4608,182620,205294,9,1897,15,1483,1,284,130,24,16,2,896,81,16032,2192,117508,133540,8/24/2020
6/13/2020,113,22787,3038,185658,208445,6,1903,4,1487,0,284,132,20,15,3,899,50,16082,1380,118888,134970,8/24/2020
6/14/2020,80,22867,2046,187704,210571,6,1909,8,1495,1,285,129,20,14,3,902,32,16114,968,119856,135970,8/24/2020
6/15/2020,188,23055,3117,190821,213876,14,1923,14,1509,0,285,129,20,16,4,906,78,16192,1797,121653,137845,8/24/2020
6/16/2020,115,23170,3026,193847,217017,10,1933,9,1518,1,286,129,22,16,8,914,52,16244,1588,123241,139485,8/24/2020
6/17/2020,127,23297,2838,196685,219982,15,1948,20,1538,4,290,120,18,14,6,920,53,16297,1326,124567,140864,8/24/2020
6/18/2020,150,23447,3048,199733,223180,9,1957,13,1551,1,291,115,19,16,7,927,70,16367,1339,125906,142273,8/24/2020
6/19/2020,141,23588,3779,203512,227100,12,1969,11,1562,1,292,115,20,17,3,930,59,16426,1380,127286,143712,8/24/2020
6/20/2020,84,23672,1890,205402,229074,9,1978,12,1574,0,292,112,20,18,4,934,36,16462,816,128102,144564,8/24/2020
6/21/2020,37,23709,1064,206466,230175,7,1985,5,1579,0,292,114,20,18,2,936,28,16490,692,128794,145284,8/24/2020
6/22/2020,142,23851,3728,210194,234045,12,1997,16,1595,0,292,110,19,18,1,937,70,16560,1714,130508,147068,8/24/2020
6/23/2020,163,24014,3843,214037,238051,3,2000,13,1608,3,295,97,18,18,6,943,82,16642,1797,132305,148947,8/24/2020
6/24/2020,122,24136,3508,217545,241681,9,2009,10,1618,1,296,95,18,18,5,948,48,16690,1696,134001,150691,8/24/2020
6/25/2020,103,24239,2893,220438,244677,6,2015,14,1632,1,297,86,17,17,1,949,53,16743,1522,135523,152266,8/24/2020
6/26/2020,95,24334,2454,222892,247226,2,2017,10,1642,0,297,78,18,18,1,950,64,16807,1304,136827,153634,8/24/2020
6/27/2020,84,24418,3215,226107,250525,5,2022,3,1645,1,298,79,17,17,5,955,37,16844,1221,138048,154892,8/24/2020
6/28/2020,38,24456,1470,227577,252033,4,2026,4,1649,4,302,75,15,14,6,961,19,16863,597,138645,155508,8/24/2020
6/29/2020,88,24544,3697,231274,255818,4,2030,5,1654,0,302,74,14,14,1,962,40,16903,1353,139998,156901,8/24/2020
6/30/2020,58,24602,1961,233235,257837,1,2031,5,1659,1,303,69,12,11,3,965,33,16936,1000,140998,157934,8/24/2020
7/1/2020,144,24746,4109,237344,262090,7,2038,9,1668,0,303,67,11,11,1,966,81,17017,1949,142947,159964,8/24/2020
7/2/2020,102,24848,2797,240141,264989,5,2043,5,1673,1,304,66,9,9,1,967,57,17074,1087,144034,161108,8/24/2020
7/3/2020,51,24899,2028,242169,267068,9,2052,6,1679,0,304,69,8,8,3,970,26,17100,775,144809,161909,8/24/2020
7/4/2020,57,24956,2330,244499,269455,2,2054,4,1683,1,305,66,9,8,2,972,34,17134,996,145805,162939,8/24/2020
7/5/2020,49,25005,2932,247431,272436,1,2055,2,1685,1,306,64,7,7,2,974,26,17160,1449,147254,164414,8/24/2020
7/6/2020,103,25108,2812,250243,275351,6,2061,6,1691,0,306,64,8,9,4,978,58,17218,1558,148812,166030,8/24/2020
7/7/2020,81,25189,3454,253697,278886,5,2066,7,1698,0,306,62,7,8,1,979,48,17266,1530,150342,167608,8/24/2020
7/8/2020,106,25295,3391,257088,282383,4,2070,2,1700,0,306,64,8,8,0,979,66,17332,1417,151759,169091,8/24/2020
7/9/2020,93,25388,3669,260757,286145,9,2079,3,1703,0,306,70,8,8,0,979,49,17381,1601,153360,170741,8/24/2020
7/10/2020,131,25519,4398,265155,290674,6,2085,3,1706,2,308,71,7,7,3,982,80,17461,2088,155448,172909,8/24/2020
7/11/2020,62,25581,2894,268049,293630,6,2091,3,1709,1,309,73,6,6,3,985,33,17494,1290,156738,174232,8/24/2020
7/12/2020,45,25626,1782,269831,295457,1,2092,3,1712,1,310,70,6,5,3,988,34,17528,898,157636,175164,8/24/2020
7/13/2020,85,25711,3160,272991,298702,8,2100,10,1722,0,310,68,6,5,1,989,57,17585,1481,159117,176702,8/24/2020
7/14/2020,74,25785,3279,276270,302055,7,2107,4,1726,0,310,71,5,5,1,990,49,17634,1371,160488,178122,8/24/2020
7/15/2020,124,25909,4129,280399,306308,5,2112,7,1733,0,310,69,5,4,0,990,94,17728,1730,162218,179946,8/24/2020
7/16/2020,102,26011,3704,284103,310114,6,2118,9,1742,0,310,66,6,5,1,991,78,17806,1601,163819,181625,8/24/2020
7/17/2020,152,26163,4137,288240,314403,14,2132,3,1745,1,311,76,5,5,1,992,78,17884,1801,165620,183504,8/24/2020
7/18/2020,80,26243,3168,291408,317651,5,2137,9,1754,1,312,71,5,4,4,996,66,17950,1335,166955,184905,8/24/2020
7/19/2020,82,26325,2588,293996,320321,6,2143,3,1757,0,312,74,6,4,2,998,59,18009,1066,168021,186030,8/24/2020
7/20/2020,73,26398,2661,296657,323055,9,2152,7,1764,0,312,76,7,5,2,1000,63,18072,1466,169487,187559,8/24/2020
7/21/2020,127,26525,4228,300885,327410,9,2161,10,1774,0,312,75,9,6,1,1001,103,18175,1874,171361,189536,8/24/2020
7/22/2020,124,26649,3791,304676,331325,11,2172,11,1785,1,313,74,7,6,1,1002,86,18261,1580,172941,191202,8/24/2020
7/23/2020,123,26772,4091,308767,335539,8,2180,5,1790,0,313,77,8,7,0,1002,104,18365,1769,174710,193075,8/24/2020
7/24/2020,167,26939,5698,314465,341404,13,2193,13,1803,0,313,77,9,7,0,1002,122,18487,2156,176866,195353,8/24/2020
7/25/2020,127,27066,4270,318735,345801,7,2200,7,1810,0,313,77,10,8,1,1003,104,18591,2004,178870,197461,8/24/2020
7/26/2020,56,27122,2972,321707,348829,8,2208,9,1819,0,313,76,11,7,1,1004,52,18643,1300,180170,198813,8/24/2020
7/27/2020,183,27305,3904,325611,352916,12,2220,7,1826,0,313,81,13,8,1,1005,137,18780,2133,182303,201083,8/24/2020
7/28/2020,106,27411,3693,329304,356715,5,2225,5,1831,0,313,81,14,7,1,1006,88,18868,1529,183832,202700,8/24/2020
7/29/2020,166,27577,4805,334109,361686,10,2235,12,1843,0,313,79,15,7,0,1006,145,19013,2099,185931,204944,8/24/2020
7/30/2020,100,27677,4009,338118,365795,6,2241,2,1845,1,314,82,15,6,0,1006,76,19089,1398,187329,206418,8/24/2020
7/31/2020,118,27795,5119,343237,371032,8,2249,9,1854,0,314,81,15,7,0,1006,87,19176,1637,188966,208142,8/24/2020
8/1/2020,94,27889,3931,347168,375057,7,2256,2,1856,0,314,86,14,7,1,1007,81,19257,1343,190309,209566,8/24/2020
8/2/2020,77,27966,2705,349873,377839,12,2268,12,1868,1,315,85,14,8,2,1009,63,19320,1216,191525,210845,8/24/2020
8/3/2020,171,28137,4844,354717,382854,13,2281,12,1880,0,315,86,16,7,1,1010,147,19467,1912,193437,212904,8/24/2020
8/4/2020,120,28257,3442,358159,386416,8,2289,6,1886,1,316,87,12,5,2,1012,101,19568,1605,195042,214610,8/24/2020
8/5/2020,138,28395,5423,363582,391977,12,2301,10,1896,1,317,88,10,5,2,1014,111,19679,2103,197145,216824,8/24/2020
8/6/2020,157,28552,4680,368262,396814,6,2307,9,1905,0,317,85,9,4,0,1014,114,19793,1814,198959,218752,8/24/2020
8/7/2020,106,28658,4179,372441,401099,13,2320,10,1915,1,318,87,9,3,1,1015,85,19878,1689,200648,220526,8/24/2020
8/8/2020,106,28764,3690,376131,404895,19,2339,6,1921,1,319,99,8,3,1,1016,91,19969,1522,202170,222139,8/24/2020
8/9/2020,36,28800,1538,377669,406469,8,2347,11,1932,0,319,96,9,4,0,1016,33,20002,952,203122,223124,8/24/2020
8/10/2020,134,28934,4079,381748,410682,11,2358,11,1943,0,319,96,9,4,1,1017,111,20113,1666,204788,224901,8/24/2020
8/11/2020,101,29035,3929,385677,414712,6,2364,14,1957,0,319,88,10,4,2,1019,95,20208,2020,206808,227016,8/24/2020
8/12/2020,117,29152,4615,390292,419444,8,2372,11,1968,0,319,85,9,3,1,1020,104,20312,2216,209024,229336,8/24/2020
8/13/2020,113,29265,3716,394008,423273,11,2383,11,1979,0,319,85,11,3,0,1020,89,20401,1596,210620,231021,8/24/2020
8/14/2020,135,29400,5228,399236,428636,13,2396,11,1990,0,319,87,11,4,2,1022,100,20501,1820,212440,232941,8/24/2020
8/15/2020,98,29498,4134,403370,432868,8,2404,10,2000,1,320,84,11,5,0,1022,90,20591,1457,213897,234488,8/24/2020
8/16/2020,77,29575,2794,406164,435739,7,2411,6,2006,4,324,81,8,4,5,1027,69,20660,1007,214904,235564,8/24/2020
8/17/2020,103,29678,3918,410082,439760,10,2421,7,2013,0,324,84,8,5,2,1029,85,20745,1881,216785,237530,8/24/2020
8/18/2020,122,29800,4821,414903,444703,11,2432,9,2022,1,325,85,8,4,2,1031,92,20837,2765,219550,240387,8/24/2020
8/19/2020,100,29900,5233,420136,450036,6,2438,9,2031,1,326,81,9,5,0,1031,79,20916,2692,222242,243158,8/24/2020
8/20/2020,172,30072,7902,428038,458110,10,2448,6,2037,1,327,84,10,5,2,1033,127,21043,3646,225888,246931,8/24/2020
8/21/2020,139,30211,6423,434461,464672,7,2455,3,2040,1,328,87,9,4,2,1035,132,21175,3063,228951,250126,8/24/2020
8/22/2020,89,30300,5401,439862,470162,5,2460,12,2052,0,328,80,11,4,0,1035,88,21263,2357,231308,252571,8/24/2020
8/23/2020,45,30345,3463,443325,473670,,,,,,,,,,0,1035,39,21302,2064,233372,254674,8/24/2020
2/27/2020,0,0,0,0,0,1,1,0,0,0,0,1,0,0,0,0,0,0,0,0,0,8/25/2020
2/28/2020,0,0,0,0,0,0,1,0,0,0,0,1,1,0,0,0,0,0,0,0,0,8/25/2020
2/29/2020,0,0,0,0,0,0,1,0,0,0,0,1,1,0,0,0,0,0,0,0,0,8/25/2020
3/1/2020,2,2,2,2,4,0,1,0,0,0,0,1,1,1,0,0,2,2,2,2,4,8/25/2020
3/2/2020,0,2,1,3,5,1,2,0,0,0,0,2,2,2,0,0,0,2,1,3,5,8/25/2020
3/3/2020,0,2,2,5,7,0,2,0,0,0,0,2,2,2,0,0,0,2,2,5,7,8/25/2020
3/4/2020,0,2,12,17,19,1,3,0,0,0,0,3,2,2,0,0,0,2,10,15,17,8/25/2020
3/5/2020,0,2,4,21,23,0,3,0,0,0,0,3,2,2,0,0,1,3,4,19,22,8/25/2020
3/6/2020,1,3,12,33,36,0,3,0,0,0,0,3,2,2,0,0,0,3,11,30,33,8/25/2020
3/7/2020,0,3,19,52,55,0,3,0,0,0,0,3,2,1,0,0,0,3,19,49,52,8/25/2020
3/8/2020,0,3,18,70,73,0,3,0,0,0,0,3,2,1,0,0,0,3,18,67,70,8/25/2020
3/9/2020,1,4,15,85,89,0,3,0,0,0,0,3,2,1,0,0,1,4,15,82,86,8/25/2020
3/10/2020,2,6,25,110,116,0,3,0,0,0,0,3,2,1,0,0,1,5,23,105,110,8/25/2020
3/11/2020,0,6,34,144,150,1,4,0,0,0,0,4,1,1,0,0,0,5,34,139,144,8/25/2020
3/12/2020,9,15,41,185,200,1,5,0,0,0,0,5,1,1,0,0,8,13,38,177,190,8/25/2020
3/13/2020,6,21,50,235,256,4,9,1,1,0,0,8,1,1,0,0,6,19,48,225,244,8/25/2020
3/14/2020,0,21,90,325,346,0,9,0,1,0,0,8,1,1,0,0,0,19,86,311,330,8/25/2020
3/15/2020,1,22,54,379,401,1,10,0,1,0,0,9,2,1,0,0,1,20,54,365,385,8/25/2020
3/16/2020,2,24,95,474,498,2,12,0,1,0,0,11,2,0,0,0,2,22,92,457,479,8/25/2020
3/17/2020,12,36,162,636,672,6,18,0,1,0,0,17,2,0,0,0,11,33,152,609,642,8/25/2020
3/18/2020,9,45,116,752,797,3,21,0,1,0,0,20,2,0,0,0,11,44,111,720,764,8/25/2020
3/19/2020,15,60,262,1014,1074,2,23,1,2,0,0,21,3,0,1,1,17,61,251,971,1032,8/25/2020
3/20/2020,13,73,197,1211,1284,5,28,0,2,0,0,26,4,0,0,1,13,74,192,1163,1237,8/25/2020
3/21/2020,12,85,126,1337,1422,3,31,2,4,0,0,27,5,0,0,1,14,88,123,1286,1374,8/25/2020
3/22/2020,27,112,282,1619,1731,2,33,0,4,0,0,29,5,0,0,1,25,113,262,1548,1661,8/25/2020
3/23/2020,14,126,169,1788,1914,15,48,1,5,0,0,43,9,3,0,1,16,129,165,1713,1842,8/25/2020
3/24/2020,20,146,242,2030,2176,7,55,0,5,0,0,50,10,4,0,1,19,148,238,1951,2099,8/25/2020
3/25/2020,26,172,182,2212,2384,5,60,1,6,0,0,54,11,3,0,1,28,176,172,2123,2299,8/25/2020
3/26/2020,35,207,181,2393,2600,10,70,5,11,0,0,59,14,5,0,1,41,217,176,2299,2516,8/25/2020
3/27/2020,27,234,214,2607,2841,9,79,1,12,1,1,66,17,6,2,3,31,248,202,2501,2749,8/25/2020
3/28/2020,59,293,260,2867,3160,13,92,3,15,2,3,74,15,6,1,4,63,311,241,2742,3053,8/25/2020
3/29/2020,100,393,350,3217,3610,8,100,4,19,1,4,77,18,8,2,6,105,416,314,3056,3472,8/25/2020
3/30/2020,62,455,222,3439,3894,20,120,5,24,0,4,92,20,11,3,9,78,494,187,3243,3737,8/25/2020
3/31/2020,71,526,369,3808,4334,11,131,7,31,1,5,95,22,13,2,11,73,567,298,3541,4108,8/25/2020
4/1/2020,99,625,698,4506,5131,18,149,7,38,0,5,106,30,15,1,12,100,667,645,4186,4853,8/25/2020
4/2/2020,52,677,477,4983,5660,22,171,6,44,2,7,120,36,21,4,16,62,729,436,4622,5351,8/25/2020
4/3/2020,108,785,774,5757,6542,23,194,7,51,0,7,136,43,25,3,19,100,829,716,5338,6167,8/25/2020
4/4/2020,143,928,660,6417,7345,22,216,4,55,5,12,149,41,30,9,28,138,967,620,5958,6925,8/25/2020
4/5/2020,187,1115,1156,7573,8688,20,236,9,64,1,13,159,44,36,2,30,182,1149,1070,7028,8177,8/25/2020
4/6/2020,218,1333,1706,9279,10612,26,262,7,71,0,13,178,48,40,7,37,206,1355,1567,8595,9950,8/25/2020
4/7/2020,284,1617,1629,10908,12525,19,281,3,74,2,15,192,50,42,5,42,260,1615,1486,10081,11696,8/25/2020
4/8/2020,290,1907,1720,12628,14535,19,300,7,81,6,21,198,50,38,10,52,272,1887,1567,11648,13535,8/25/2020
4/9/2020,283,2190,1516,14144,16334,32,332,9,90,4,25,217,53,40,7,59,278,2165,1361,13009,15174,8/25/2020
4/10/2020,419,2609,2574,16718,19327,29,361,16,106,5,30,225,59,41,11,70,403,2568,2378,15387,17955,8/25/2020
4/11/2020,297,2906,1905,18623,21529,29,390,11,117,2,32,241,61,48,12,82,281,2849,1721,17108,19957,8/25/2020
4/12/2020,314,3220,1670,20293,23513,35,425,13,130,5,37,258,59,49,9,91,289,3138,1440,18548,21686,8/25/2020
4/13/2020,161,3381,935,21228,24609,35,460,13,143,3,40,277,64,54,9,100,187,3325,842,19390,22715,8/25/2020
4/14/2020,289,3670,1787,23015,26685,27,487,17,160,5,45,282,72,53,8,108,265,3590,1531,20921,24511,8/25/2020
4/15/2020,351,4021,1799,24814,28835,31,518,20,180,3,48,290,72,54,17,125,307,3897,1567,22488,26385,8/25/2020
4/16/2020,447,4468,2494,27308,31776,36,554,25,205,6,54,295,72,53,14,139,391,4288,2087,24575,28863,8/25/2020
4/17/2020,304,4772,1821,29129,33901,32,586,20,225,7,61,300,66,45,21,160,291,4579,1462,26037,30616,8/25/2020
4/18/2020,321,5093,1725,30854,35947,26,612,18,243,4,65,304,63,49,15,175,284,4863,1348,27385,32248,8/25/2020
4/19/2020,381,5474,2047,32901,38375,23,635,26,269,1,66,300,65,55,11,186,338,5201,1749,29134,34335,8/25/2020
4/20/2020,394,5868,1907,34808,40676,46,681,29,298,2,68,315,75,56,10,196,377,5578,1582,30716,36294,8/25/2020
4/21/2020,444,6312,2110,36918,43230,45,726,31,329,5,73,324,72,56,18,214,390,5968,1719,32435,38403,8/25/2020
4/22/2020,418,6730,2390,39308,46038,41,767,32,361,5,78,328,73,58,18,232,382,6350,1920,34355,40705,8/25/2020
4/23/2020,479,7209,2469,41777,48986,30,797,28,389,5,83,325,76,62,15,247,418,6768,1872,36227,42995,8/25/2020
4/24/2020,491,7700,3284,45061,52761,35,832,27,416,4,87,329,85,63,15,262,413,7181,2636,38863,46044,8/25/2020
4/25/2020,393,8093,2206,47267,55360,34,866,17,433,5,92,341,85,62,14,276,304,7485,1778,40641,48126,8/25/2020
4/26/2020,316,8409,2309,49576,57985,33,899,15,448,3,95,356,86,59,14,290,276,7761,1884,42525,50286,8/25/2020
4/27/2020,249,8658,1620,51196,59854,29,928,21,469,4,99,360,86,61,10,300,204,7965,1164,43689,51654,8/25/2020
4/28/2020,410,9068,2263,53459,62527,44,972,24,493,3,102,377,88,59,22,322,325,8290,1771,45460,53750,8/25/2020
4/29/2020,476,9544,3343,56802,66346,36,1008,37,530,11,113,365,78,53,18,340,371,8661,2441,47901,56562,8/25/2020
4/30/2020,432,9976,2769,59571,69547,33,1041,38,568,6,119,354,83,57,24,364,348,9009,1958,49859,58868,8/25/2020
5/1/2020,454,10430,3086,62657,73087,51,1092,39,607,3,122,363,84,58,14,378,317,9326,2221,52080,61406,8/25/2020
5/2/2020,257,10687,1926,64583,75270,36,1128,39,646,5,127,355,91,62,24,402,189,9515,1294,53374,62889,8/25/2020
5/3/2020,283,10970,2160,66743,77713,31,1159,27,673,8,135,351,90,61,21,423,182,9697,1605,54979,64676,8/25/2020
5/4/2020,387,11357,2098,68841,80198,30,1189,31,704,5,140,345,88,57,18,441,293,9990,1573,56552,66542,8/25/2020
5/5/2020,433,11790,2873,71714,83504,29,1218,32,736,6,146,336,82,54,16,457,304,10294,1968,58520,68814,8/25/2020
5/6/2020,488,12278,2829,74543,86821,28,1246,44,780,9,155,311,79,54,21,478,341,10635,1924,60444,71079,8/25/2020
5/7/2020,425,12703,2969,77512,90215,36,1282,42,822,5,160,300,71,52,21,499,269,10904,1983,62427,73331,8/25/2020
5/8/2020,359,13062,2598,80110,93172,30,1312,29,851,5,165,296,71,53,22,521,231,11135,1765,64192,75327,8/25/2020
5/9/2020,467,13529,3346,83456,96985,22,1334,21,872,4,169,293,69,51,15,536,286,11421,2297,66489,77910,8/25/2020
5/10/2020,285,13814,2117,85573,99387,19,1353,23,895,6,175,283,70,49,13,549,187,11608,1525,68014,79622,8/25/2020
5/11/2020,257,14071,1857,87430,101501,31,1384,16,911,6,181,292,71,49,15,564,176,11784,1306,69320,81104,8/25/2020
5/12/2020,387,14458,2611,90041,104499,23,1407,18,929,4,185,293,69,48,22,586,218,12002,1714,71034,83036,8/25/2020
5/13/2020,351,14809,3630,93671,108480,22,1429,24,953,1,186,290,69,49,13,599,196,12198,2019,73053,85251,8/25/2020
5/14/2020,329,15138,3408,97079,112217,19,1448,27,980,3,189,279,64,45,15,614,227,12425,2021,75074,87499,8/25/2020
5/15/2020,381,15519,3458,100537,116056,24,1472,41,1021,5,194,257,62,45,13,627,234,12659,1814,76888,89547,8/25/2020
5/16/2020,449,15968,4156,104693,120661,25,1497,12,1033,5,199,265,61,46,15,642,252,12911,1967,78855,91766,8/25/2020
5/17/2020,240,16208,2768,107461,123669,17,1514,7,1040,5,204,270,59,45,10,652,124,13035,1567,80422,93457,8/25/2020
5/18/2020,250,16458,2001,109462,125920,19,1533,15,1055,5,209,269,57,40,18,670,139,13174,1374,81796,94970,8/25/2020
5/19/2020,415,16873,3168,112630,129503,23,1556,32,1087,5,214,255,56,38,11,681,212,13386,1937,83733,97119,8/25/2020
5/20/2020,326,17199,2771,115401,132600,19,1575,23,1110,7,221,244,52,33,22,703,187,13573,1521,85254,98827,8/25/2020
5/21/2020,374,17573,3757,119158,136731,26,1601,15,1125,3,224,252,53,29,20,723,170,13743,1949,87203,100946,8/25/2020
5/22/2020,351,17924,3161,122319,140243,20,1621,29,1154,5,229,238,52,29,10,733,204,13947,1614,88817,102764,8/25/2020
5/23/2020,253,18177,2742,125061,143238,19,1640,11,1165,3,232,243,52,32,13,746,109,14056,1281,90098,104154,8/25/2020
5/24/2020,163,18340,1370,126431,144771,12,1652,14,1179,2,234,239,53,36,8,754,84,14140,773,90871,105011,8/25/2020
5/25/2020,147,18487,1385,127816,146303,13,1665,14,1193,0,234,238,53,34,10,764,71,14211,765,91636,105847,8/25/2020
5/26/2020,285,18772,2620,130436,149208,24,1689,22,1215,5,239,235,48,33,15,779,156,14367,1784,93420,107787,8/25/2020
5/27/2020,276,19048,2065,132501,151549,20,1709,18,1233,3,242,234,50,33,10,789,133,14500,1143,94563,109063,8/25/2020
5/28/2020,349,19397,3371,135872,155269,17,1726,29,1262,4,246,218,47,32,8,797,133,14633,1131,95694,110327,8/25/2020
5/29/2020,413,19810,3928,139800,159610,19,1745,27,1289,6,252,204,43,31,12,809,179,14812,1587,97281,112093,8/25/2020
5/30/2020,225,20035,3915,143715,163750,15,1760,19,1308,4,256,196,40,29,12,821,109,14921,1825,99106,114027,8/25/2020
5/31/2020,155,20190,1688,145403,165593,11,1771,10,1318,0,256,197,43,26,3,824,78,14999,859,99965,114964,8/25/2020
6/1/2020,214,20404,2792,148195,168599,8,1779,14,1332,1,257,190,44,29,5,829,99,15098,1384,101349,116447,8/25/2020
6/2/2020,273,20677,3034,151229,171906,8,1787,9,1341,3,260,186,37,25,10,839,107,15205,1467,102816,118021,8/25/2020
6/3/2020,254,20931,3495,154724,175655,13,1800,18,1359,6,266,175,34,25,11,850,105,15310,1676,104492,119802,8/25/2020
6/4/2020,277,21208,4474,159198,180406,7,1807,25,1384,3,269,154,31,24,11,861,113,15423,2049,106541,121964,8/25/2020
6/5/2020,215,21423,3521,162719,184142,15,1822,13,1397,6,275,150,27,21,10,871,105,15528,1583,108124,123652,8/25/2020
6/6/2020,201,21624,2618,165337,186961,10,1832,7,1404,2,277,151,29,19,6,877,68,15596,1138,109262,124858,8/25/2020
6/7/2020,83,21707,1625,166962,188669,11,1843,7,1411,1,278,154,25,17,4,881,50,15646,783,110045,125691,8/25/2020
6/8/2020,122,21829,1860,168822,190651,15,1858,12,1423,2,280,155,27,18,4,885,44,15690,974,111019,126709,8/25/2020
6/9/2020,225,22054,2688,171510,193564,10,1868,18,1441,0,280,147,28,21,1,886,67,15757,1275,112294,128051,8/25/2020
6/10/2020,211,22265,2986,174496,196761,13,1881,12,1453,2,282,146,24,17,3,889,105,15862,1467,113761,129623,8/25/2020
6/11/2020,195,22460,3516,178012,200472,7,1888,15,1468,1,283,137,25,16,6,895,88,15950,1541,115302,131252,8/25/2020
6/12/2020,214,22674,4608,182620,205294,9,1897,15,1483,1,284,130,24,16,2,897,81,16031,2192,117494,133525,8/25/2020
6/13/2020,113,22787,3038,185658,208445,6,1903,4,1487,0,284,132,20,15,3,900,50,16081,1380,118874,134955,8/25/2020
6/14/2020,80,22867,2046,187704,210571,6,1909,8,1495,1,285,129,20,14,3,903,32,16113,968,119842,135955,8/25/2020
6/15/2020,188,23055,3117,190821,213876,14,1923,14,1509,0,285,129,20,16,4,907,78,16191,1797,121639,137830,8/25/2020
6/16/2020,115,23170,3026,193847,217017,10,1933,9,1518,1,286,129,22,16,8,915,52,16243,1588,123227,139470,8/25/2020
6/17/2020,127,23297,2838,196685,219982,15,1948,20,1538,4,290,120,18,14,6,921,53,16296,1326,124553,140849,8/25/2020
6/18/2020,150,23447,3048,199733,223180,9,1957,13,1551,1,291,115,19,16,7,928,70,16366,1339,125892,142258,8/25/2020
6/19/2020,141,23588,3779,203512,227100,12,1969,11,1562,1,292,115,20,17,3,931,59,16425,1380,127272,143697,8/25/2020
6/20/2020,84,23672,1890,205402,229074,9,1978,12,1574,0,292,112,20,18,4,935,36,16461,816,128088,144549,8/25/2020
6/21/2020,37,23709,1064,206466,230175,7,1985,5,1579,0,292,114,20,18,2,937,28,16489,692,128780,145269,8/25/2020
6/22/2020,142,23851,3728,210194,234045,12,1997,16,1595,0,292,110,19,18,1,938,70,16559,1714,130494,147053,8/25/2020
6/23/2020,163,24014,3843,214037,238051,3,2000,13,1608,3,295,97,18,18,6,944,82,16641,1796,132290,148931,8/25/2020
6/24/2020,122,24136,3508,217545,241681,9,2009,10,1618,1,296,95,18,18,5,949,48,16689,1696,133986,150675,8/25/2020
6/25/2020,103,24239,2893,220438,244677,6,2015,14,1632,1,297,86,17,17,1,950,53,16742,1522,135508,152250,8/25/2020
6/26/2020,95,24334,2454,222892,247226,2,2017,10,1642,0,297,78,18,18,1,951,64,16806,1304,136812,153618,8/25/2020
6/27/2020,84,24418,3215,226107,250525,5,2022,3,1645,1,298,79,17,17,5,956,37,16843,1221,138033,154876,8/25/2020
6/28/2020,38,24456,1470,227577,252033,4,2026,4,1649,4,302,75,15,14,6,962,19,16862,597,138630,155492,8/25/2020
6/29/2020,88,24544,3697,231274,255818,4,2030,5,1654,0,302,74,14,14,1,963,40,16902,1353,139983,156885,8/25/2020
6/30/2020,58,24602,1961,233235,257837,1,2031,5,1659,1,303,69,12,11,3,966,33,16935,1000,140983,157918,8/25/2020
7/1/2020,144,24746,4109,237344,262090,7,2038,9,1668,0,303,67,11,11,1,967,81,17016,1949,142932,159948,8/25/2020
7/2/2020,102,24848,2797,240141,264989,5,2043,5,1673,1,304,66,9,9,1,968,57,17073,1087,144019,161092,8/25/2020
7/3/2020,51,24899,2028,242169,267068,9,2052,6,1679,0,304,69,8,8,3,971,26,17099,775,144794,161893,8/25/2020
7/4/2020,57,24956,2330,244499,269455,2,2054,4,1683,1,305,66,9,8,2,973,34,17133,996,145790,162923,8/25/2020
7/5/2020,49,25005,2932,247431,272436,1,2055,2,1685,1,306,64,7,7,2,975,26,17159,1449,147239,164398,8/25/2020
7/6/2020,103,25108,2812,250243,275351,6,2061,6,1691,0,306,64,8,9,4,979,58,17217,1558,148797,166014,8/25/2020
7/7/2020,81,25189,3454,253697,278886,5,2066,7,1698,0,306,62,7,8,1,980,48,17265,1530,150327,167592,8/25/2020
7/8/2020,106,25295,3391,257088,282383,4,2070,2,1700,0,306,64,8,8,0,980,66,17331,1417,151744,169075,8/25/2020
7/9/2020,93,25388,3669,260757,286145,9,2079,3,1703,0,306,70,8,8,0,980,49,17380,1601,153345,170725,8/25/2020
7/10/2020,131,25519,4398,265155,290674,6,2085,3,1706,2,308,71,7,7,3,983,80,17460,2086,155431,172891,8/25/2020
7/11/2020,62,25581,2894,268049,293630,6,2091,3,1709,1,309,73,6,6,3,986,33,17493,1290,156721,174214,8/25/2020
7/12/2020,45,25626,1782,269831,295457,1,2092,3,1712,1,310,70,6,5,3,989,34,17527,898,157619,175146,8/25/2020
7/13/2020,85,25711,3160,272991,298702,8,2100,10,1722,0,310,68,6,5,1,990,57,17584,1481,159100,176684,8/25/2020
7/14/2020,74,25785,3279,276270,302055,7,2107,4,1726,0,310,71,5,5,1,991,49,17633,1371,160471,178104,8/25/2020
7/15/2020,124,25909,4129,280399,306308,5,2112,7,1733,0,310,69,5,4,0,991,94,17727,1730,162201,179928,8/25/2020
7/16/2020,102,26011,3704,284103,310114,6,2118,9,1742,0,310,66,6,5,1,992,78,17805,1601,163802,181607,8/25/2020
7/17/2020,152,26163,4137,288240,314403,14,2132,3,1745,1,311,76,5,5,1,993,78,17883,1801,165603,183486,8/25/2020
7/18/2020,80,26243,3168,291408,317651,5,2137,9,1754,1,312,71,5,4,4,997,66,17949,1335,166938,184887,8/25/2020
7/19/2020,82,26325,2588,293996,320321,6,2143,3,1757,0,312,74,6,4,2,999,59,18008,1066,168004,186012,8/25/2020
7/20/2020,73,26398,2661,296657,323055,9,2152,7,1764,0,312,76,7,5,2,1001,63,18071,1466,169470,187541,8/25/2020
7/21/2020,127,26525,4228,300885,327410,9,2161,10,1774,0,312,75,9,6,1,1002,103,18174,1874,171344,189518,8/25/2020
7/22/2020,124,26649,3791,304676,331325,11,2172,11,1785,1,313,74,7,6,1,1003,86,18260,1580,172924,191184,8/25/2020
7/23/2020,123,26772,4091,308767,335539,8,2180,5,1790,0,313,77,8,7,0,1003,104,18364,1769,174693,193057,8/25/2020
7/24/2020,167,26939,5698,314465,341404,13,2193,13,1803,0,313,77,9,7,0,1003,122,18486,2156,176849,195335,8/25/2020
7/25/2020,127,27066,4270,318735,345801,7,2200,7,1810,0,313,77,10,8,1,1004,104,18590,2004,178853,197443,8/25/2020
7/26/2020,56,27122,2972,321707,348829,8,2208,9,1819,0,313,76,11,7,1,1005,52,18642,1300,180153,198795,8/25/2020
7/27/2020,183,27305,3904,325611,352916,12,2220,7,1826,0,313,81,13,8,1,1006,137,18779,2132,182285,201064,8/25/2020
7/28/2020,106,27411,3693,329304,356715,5,2225,5,1831,0,313,81,14,7,1,1007,88,18867,1529,183814,202681,8/25/2020
7/29/2020,166,27577,4805,334109,361686,10,2235,12,1843,0,313,79,15,7,0,1007,145,19012,2099,185913,204925,8/25/2020
7/30/2020,100,27677,4009,338118,365795,6,2241,2,1845,1,314,82,15,6,0,1007,76,19088,1398,187311,206399,8/25/2020
7/31/2020,118,27795,5119,343237,371032,8,2249,9,1854,0,314,81,15,7,0,1007,88,19176,1637,188948,208124,8/25/2020
8/1/2020,94,27889,3931,347168,375057,7,2256,2,1856,0,314,86,14,7,1,1008,81,19257,1343,190291,209548,8/25/2020
8/2/2020,77,27966,2705,349873,377839,12,2268,12,1868,1,315,85,14,8,2,1010,63,19320,1216,191507,210827,8/25/2020
8/3/2020,171,28137,4844,354717,382854,13,2281,12,1880,0,315,86,16,7,1,1011,147,19467,1912,193419,212886,8/25/2020
8/4/2020,120,28257,3442,358159,386416,8,2289,6,1886,1,316,87,12,5,2,1013,101,19568,1605,195024,214592,8/25/2020
8/5/2020,138,28395,5423,363582,391977,12,2301,10,1896,1,317,88,10,5,2,1015,111,19679,2103,197127,216806,8/25/2020
8/6/2020,157,28552,4680,368262,396814,6,2307,9,1905,0,317,85,9,4,0,1015,114,19793,1814,198941,218734,8/25/2020
8/7/2020,106,28658,4179,372441,401099,13,2320,10,1915,1,318,87,9,3,1,1016,85,19878,1689,200630,220508,8/25/2020
8/8/2020,106,28764,3690,376131,404895,19,2339,6,1921,1,319,99,8,3,1,1017,91,19969,1522,202152,222121,8/25/2020
8/9/2020,36,28800,1538,377669,406469,8,2347,11,1932,0,319,96,9,4,0,1017,33,20002,952,203104,223106,8/25/2020
8/10/2020,134,28934,4079,381748,410682,11,2358,11,1943,0,319,96,9,4,1,1018,111,20113,1665,204769,224882,8/25/2020
8/11/2020,101,29035,3929,385677,414712,6,2364,14,1957,0,319,88,10,4,2,1020,95,20208,2020,206789,226997,8/25/2020
8/12/2020,117,29152,4615,390292,419444,8,2372,11,1968,0,319,85,9,3,1,1021,103,20311,2216,209005,229316,8/25/2020
8/13/2020,113,29265,3716,394008,423273,11,2383,11,1979,0,319,85,11,3,0,1021,89,20400,1596,210601,231001,8/25/2020
8/14/2020,135,29400,5228,399236,428636,13,2396,11,1990,0,319,87,11,4,2,1023,100,20500,1820,212421,232921,8/25/2020
8/15/2020,98,29498,4134,403370,432868,8,2404,10,2000,1,320,84,11,5,0,1023,90,20590,1457,213878,234468,8/25/2020
8/16/2020,77,29575,2794,406164,435739,7,2411,6,2006,4,324,81,8,4,5,1028,69,20659,1007,214885,235544,8/25/2020
8/17/2020,103,29678,3918,410082,439760,10,2421,7,2013,0,324,84,8,5,2,1030,84,20743,1881,216766,237509,8/25/2020
8/18/2020,122,29800,4821,414903,444703,11,2432,9,2022,1,325,85,8,4,4,1034,92,20835,2765,219531,240366,8/25/2020
8/19/2020,100,29900,5232,420135,450035,6,2438,9,2031,1,326,81,9,5,0,1034,80,20915,2691,222222,243137,8/25/2020
8/20/2020,173,30073,7928,428063,458136,11,2449,6,2037,1,327,85,10,5,2,1036,126,21041,3654,225876,246917,8/25/2020
8/21/2020,140,30213,6598,434661,464874,8,2457,4,2041,1,328,88,9,4,2,1038,137,21178,3168,229044,250222,8/25/2020
8/22/2020,97,30310,5748,440409,470719,8,2465,12,2053,0,328,84,11,4,0,1038,91,21269,2515,231559,252828,8/25/2020
8/23/2020,50,30360,3862,444271,474631,9,2474,6,2059,0,328,87,11,2,0,1038,43,21312,2312,233871,255183,8/25/2020
8/24/2020,80,30440,4672,448943,479383,,,,,,,,,,1,1039,60,21372,2546,236417,257789,8/25/2020
2/27/2020,0,0,0,0,0,1,1,0,0,0,0,1,0,0,0,0,0,0,0,0,0,8/26/2020
2/28/2020,0,0,0,0,0,0,1,0,0,0,0,1,1,0,0,0,0,0,0,0,0,8/26/2020
2/29/2020,0,0,0,0,0,0,1,0,0,0,0,1,1,0,0,0,0,0,0,0,0,8/26/2020
3/1/2020,2,2,2,2,4,0,1,0,0,0,0,1,1,1,0,0,2,2,2,2,4,8/26/2020
3/2/2020,0,2,1,3,5,1,2,0,0,0,0,2,2,2,0,0,0,2,1,3,5,8/26/2020
3/3/2020,0,2,2,5,7,0,2,0,0,0,0,2,2,2,0,0,0,2,2,5,7,8/26/2020
3/4/2020,0,2,12,17,19,1,3,0,0,0,0,3,2,2,0,0,0,2,10,15,17,8/26/2020
3/5/2020,0,2,4,21,23,0,3,0,0,0,0,3,2,2,0,0,1,3,4,19,22,8/26/2020
3/6/2020,1,3,12,33,36,0,3,0,0,0,0,3,2,2,0,0,0,3,11,30,33,8/26/2020
3/7/2020,0,3,19,52,55,0,3,0,0,0,0,3,2,1,0,0,0,3,19,49,52,8/26/2020
3/8/2020,0,3,18,70,73,0,3,0,0,0,0,3,2,1,0,0,0,3,18,67,70,8/26/2020
3/9/2020,1,4,15,85,89,0,3,0,0,0,0,3,2,1,0,0,1,4,15,82,86,8/26/2020
3/10/2020,2,6,25,110,116,0,3,0,0,0,0,3,2,1,0,0,1,5,23,105,110,8/26/2020
3/11/2020,0,6,34,144,150,1,4,0,0,0,0,4,1,1,0,0,0,5,34,139,144,8/26/2020
3/12/2020,9,15,41,185,200,1,5,0,0,0,0,5,1,1,0,0,8,13,38,177,190,8/26/2020
3/13/2020,6,21,50,235,256,4,9,1,1,0,0,8,1,1,0,0,6,19,48,225,244,8/26/2020
3/14/2020,0,21,90,325,346,0,9,0,1,0,0,8,1,1,0,0,0,19,86,311,330,8/26/2020
3/15/2020,1,22,54,379,401,1,10,0,1,0,0,9,2,1,0,0,1,20,54,365,385,8/26/2020
3/16/2020,2,24,95,474,498,2,12,0,1,0,0,11,2,0,0,0,2,22,92,457,479,8/26/2020
3/17/2020,16,40,162,636,676,6,18,0,1,0,0,17,2,0,0,0,11,33,152,609,642,8/26/2020
3/18/2020,12,52,116,752,804,3,21,0,1,0,0,20,2,0,0,0,11,44,111,720,764,8/26/2020
3/19/2020,17,69,262,1014,1083,2,23,1,2,0,0,21,3,0,1,1,17,61,251,971,1032,8/26/2020
3/20/2020,14,83,197,1211,1294,5,28,0,2,0,0,26,4,0,0,1,13,74,192,1163,1237,8/26/2020
3/21/2020,21,104,126,1337,1441,3,31,2,4,0,0,27,5,0,0,1,14,88,123,1286,1374,8/26/2020
3/22/2020,30,134,282,1619,1753,2,33,0,4,0,0,29,5,0,0,1,25,113,262,1548,1661,8/26/2020
3/23/2020,14,148,169,1788,1936,15,48,1,5,0,0,43,9,3,0,1,16,129,165,1713,1842,8/26/2020
3/24/2020,20,168,242,2030,2198,7,55,0,5,0,0,50,10,4,0,1,19,148,238,1951,2099,8/26/2020
3/25/2020,26,194,183,2213,2407,5,60,1,6,0,0,54,11,3,0,1,28,176,172,2123,2299,8/26/2020
3/26/2020,35,229,181,2394,2623,10,70,5,11,0,0,59,14,5,0,1,41,217,176,2299,2516,8/26/2020
3/27/2020,27,256,215,2609,2865,9,79,1,12,1,1,66,17,6,2,3,31,248,202,2501,2749,8/26/2020
3/28/2020,59,315,260,2869,3184,13,92,3,15,2,3,74,15,6,1,4,63,311,241,2742,3053,8/26/2020
3/29/2020,106,421,356,3225,3646,8,100,4,19,1,4,77,18,8,2,6,105,416,314,3056,3472,8/26/2020
3/30/2020,62,483,222,3447,3930,20,120,5,24,0,4,92,20,11,3,9,78,494,187,3243,3737,8/26/2020
3/31/2020,71,554,369,3816,4370,11,131,7,31,1,5,95,22,13,2,11,73,567,298,3541,4108,8/26/2020
4/1/2020,99,653,699,4515,5168,18,149,7,38,0,5,106,30,15,1,12,100,667,644,4185,4852,8/26/2020
4/2/2020,52,705,477,4992,5697,22,171,6,44,2,7,120,36,21,4,16,62,729,436,4621,5350,8/26/2020
4/3/2020,108,813,775,5767,6580,23,194,7,51,0,7,136,43,25,3,19,100,829,716,5337,6166,8/26/2020
4/4/2020,143,956,660,6427,7383,22,216,4,55,5,12,149,41,30,9,28,138,967,620,5957,6924,8/26/2020
4/5/2020,187,1143,1156,7583,8726,20,236,9,64,1,13,159,44,36,2,30,182,1149,1070,7027,8176,8/26/2020
4/6/2020,218,1361,1707,9290,10651,26,262,7,71,0,13,178,48,40,7,37,206,1355,1565,8592,9947,8/26/2020
4/7/2020,285,1646,1631,10921,12567,19,281,3,74,2,15,192,50,42,5,42,260,1615,1486,10078,11693,8/26/2020
4/8/2020,290,1936,1723,12644,14580,19,300,7,81,6,21,198,50,38,10,52,272,1887,1566,11644,13531,8/26/2020
4/9/2020,284,2220,1521,14165,16385,32,332,9,90,4,25,217,53,40,7,59,278,2165,1361,13005,15170,8/26/2020
4/10/2020,420,2640,2577,16742,19382,29,361,16,106,5,30,225,59,41,11,70,403,2568,2378,15383,17951,8/26/2020
4/11/2020,299,2939,1911,18653,21592,29,390,11,117,2,32,241,61,48,12,82,281,2849,1721,17104,19953,8/26/2020
4/12/2020,315,3254,1674,20327,23581,35,425,13,130,5,37,258,59,49,9,91,289,3138,1440,18544,21682,8/26/2020
4/13/2020,162,3416,938,21265,24681,35,460,13,143,3,40,277,64,54,9,100,187,3325,842,19386,22711,8/26/2020
4/14/2020,289,3705,1788,23053,26758,27,487,17,160,5,45,282,72,53,8,108,265,3590,1531,20917,24507,8/26/2020
4/15/2020,353,4058,1803,24856,28914,31,518,20,180,3,48,290,72,54,17,125,307,3897,1567,22484,26381,8/26/2020
4/16/2020,449,4507,2500,27356,31863,36,554,25,205,6,54,295,72,53,14,139,391,4288,2087,24571,28859,8/26/2020
4/17/2020,308,4815,1823,29179,33994,32,586,20,225,7,61,300,66,45,21,160,291,4579,1462,26033,30612,8/26/2020
4/18/2020,322,5137,1728,30907,36044,26,612,18,243,4,65,304,63,49,15,175,284,4863,1348,27381,32244,8/26/2020
4/19/2020,382,5519,2059,32966,38485,23,635,26,269,1,66,300,65,55,11,186,338,5201,1747,29128,34329,8/26/2020
4/20/2020,396,5915,1909,34875,40790,46,681,29,298,2,68,315,75,56,10,196,377,5578,1582,30710,36288,8/26/2020
4/21/2020,445,6360,2114,36989,43349,45,726,31,329,5,73,324,72,56,18,214,390,5968,1719,32429,38397,8/26/2020
4/22/2020,420,6780,2398,39387,46167,41,767,32,361,5,78,328,73,58,18,232,382,6350,1920,34349,40699,8/26/2020
4/23/2020,481,7261,2471,41858,49119,30,797,28,389,5,83,325,76,62,15,247,418,6768,1872,36221,42989,8/26/2020
4/24/2020,494,7755,3292,45150,52905,35,832,27,416,4,87,329,85,63,15,262,413,7181,2636,38857,46038,8/26/2020
4/25/2020,394,8149,2210,47360,55509,34,866,17,433,5,92,341,85,62,14,276,304,7485,1778,40635,48120,8/26/2020
4/26/2020,316,8465,2314,49674,58139,33,899,15,448,3,95,356,86,59,14,290,276,7761,1884,42519,50280,8/26/2020
4/27/2020,250,8715,1624,51298,60013,29,928,21,469,4,99,360,86,61,10,300,204,7965,1164,43683,51648,8/26/2020
4/28/2020,411,9126,2268,53566,62692,44,972,24,493,3,102,377,88,59,22,322,325,8290,1771,45454,53744,8/26/2020
4/29/2020,476,9602,3351,56917,66519,36,1008,37,530,11,113,365,78,53,18,340,371,8661,2441,47895,56556,8/26/2020
4/30/2020,432,10034,2772,59689,69723,33,1041,38,568,6,119,354,83,57,24,364,348,9009,1957,49852,58861,8/26/2020
5/1/2020,457,10491,3089,62778,73269,51,1092,39,607,3,122,363,84,58,14,378,317,9326,2221,52073,61399,8/26/2020
5/2/2020,260,10751,1927,64705,75456,36,1128,39,646,5,127,355,91,62,24,402,189,9515,1294,53367,62882,8/26/2020
5/3/2020,284,11035,2168,66873,77908,31,1159,27,673,8,135,351,90,61,21,423,182,9697,1604,54971,64668,8/26/2020
5/4/2020,388,11423,2101,68974,80397,30,1189,31,704,5,140,345,88,57,18,441,293,9990,1573,56544,66534,8/26/2020
5/5/2020,436,11859,2878,71852,83711,29,1218,32,736,6,146,336,82,54,16,457,304,10294,1968,58512,68806,8/26/2020
5/6/2020,490,12349,2836,74688,87037,28,1246,44,780,9,155,311,79,54,21,478,341,10635,1924,60436,71071,8/26/2020
5/7/2020,425,12774,2975,77663,90437,36,1282,42,822,5,160,300,71,52,21,499,269,10904,1981,62417,73321,8/26/2020
5/8/2020,360,13134,2603,80266,93400,30,1312,29,851,5,165,296,71,53,22,521,231,11135,1761,64178,75313,8/26/2020
5/9/2020,470,13604,3356,83622,97226,22,1334,21,872,4,169,293,69,51,15,536,286,11421,2291,66469,77890,8/26/2020
5/10/2020,285,13889,2122,85744,99633,19,1353,23,895,6,175,283,70,49,13,549,187,11608,1525,67994,79602,8/26/2020
5/11/2020,259,14148,1861,87605,101753,31,1384,16,911,6,181,292,71,49,15,564,176,11784,1306,69300,81084,8/26/2020
5/12/2020,387,14535,2622,90227,104762,23,1407,18,929,4,185,293,69,48,22,586,218,12002,1714,71014,83016,8/26/2020
5/13/2020,352,14887,3634,93861,108748,22,1429,24,953,1,186,290,69,49,13,599,196,12198,2018,73032,85230,8/26/2020
5/14/2020,330,15217,3415,97276,112493,19,1448,27,980,3,189,279,64,45,15,614,227,12425,2021,75053,87478,8/26/2020
5/15/2020,382,15599,3470,100746,116345,24,1472,41,1021,5,194,257,62,45,13,627,234,12659,1814,76867,89526,8/26/2020
5/16/2020,453,16052,4168,104914,120966,25,1497,12,1033,5,199,265,61,46,15,642,252,12911,1967,78834,91745,8/26/2020
5/17/2020,240,16292,2775,107689,123981,17,1514,7,1040,5,204,270,59,45,10,652,124,13035,1567,80401,93436,8/26/2020
5/18/2020,251,16543,2007,109696,126239,19,1533,15,1055,5,209,269,57,40,18,670,139,13174,1374,81775,94949,8/26/2020
5/19/2020,416,16959,3178,112874,129833,23,1556,32,1087,5,214,255,56,38,11,681,212,13386,1937,83712,97098,8/26/2020
5/20/2020,328,17287,2775,115649,132936,19,1575,23,1110,7,221,244,52,33,22,703,187,13573,1521,85233,98806,8/26/2020
5/21/2020,374,17661,3764,119413,137074,26,1601,15,1125,3,224,252,53,29,20,723,170,13743,1948,87181,100924,8/26/2020
5/22/2020,353,18014,3172,122585,140599,20,1621,29,1154,5,229,238,52,29,10,733,204,13947,1614,88795,102742,8/26/2020
5/23/2020,253,18267,2748,125333,143600,19,1640,11,1165,3,232,243,52,32,13,746,109,14056,1281,90076,104132,8/26/2020
5/24/2020,165,18432,1372,126705,145137,12,1652,14,1179,2,234,239,53,36,8,754,84,14140,773,90849,104989,8/26/2020
5/25/2020,147,18579,1389,128094,146673,13,1665,14,1193,0,234,238,53,34,10,764,71,14211,765,91614,105825,8/26/2020
5/26/2020,285,18864,2624,130718,149582,24,1689,22,1215,5,239,235,48,33,15,779,156,14367,1784,93398,107765,8/26/2020
5/27/2020,276,19140,2134,132852,151992,20,1709,18,1233,3,242,234,50,33,10,789,133,14500,1143,94541,109041,8/26/2020
5/28/2020,350,19490,3384,136236,155726,17,1726,29,1262,4,246,218,47,32,8,797,133,14633,1131,95672,110305,8/26/2020
5/29/2020,420,19910,3989,140225,160135,19,1745,27,1289,6,252,204,43,31,12,809,179,14812,1587,97259,112071,8/26/2020
5/30/2020,228,20138,3973,144198,164336,15,1760,19,1308,4,256,196,40,29,12,821,109,14921,1825,99084,114005,8/26/2020
5/31/2020,159,20297,1759,145957,166254,11,1771,10,1318,0,256,197,43,26,3,824,78,14999,859,99943,114942,8/26/2020
6/1/2020,217,20514,2825,148782,169296,8,1779,14,1332,1,257,190,44,29,5,829,99,15098,1384,101327,116425,8/26/2020
6/2/2020,273,20787,3089,151871,172658,8,1787,9,1341,3,260,186,37,25,10,839,107,15205,1466,102793,117998,8/26/2020
6/3/2020,260,21047,3523,155394,176441,13,1800,18,1359,6,266,175,34,25,11,850,105,15310,1676,104469,119779,8/26/2020
6/4/2020,282,21329,4539,159933,181262,7,1807,25,1384,3,269,154,31,24,11,861,112,15422,2049,106518,121940,8/26/2020
6/5/2020,216,21545,3594,163527,185072,15,1822,13,1397,6,275,150,27,21,10,871,105,15527,1583,108101,123628,8/26/2020
6/6/2020,203,21748,2632,166159,187907,10,1832,7,1404,2,277,151,29,19,6,877,68,15595,1138,109239,124834,8/26/2020
6/7/2020,83,21831,1629,167788,189619,11,1843,7,1411,1,278,154,25,17,4,881,50,15645,783,110022,125667,8/26/2020
6/8/2020,123,21954,1863,169651,191605,15,1858,12,1423,2,280,155,27,18,4,885,44,15689,974,110996,126685,8/26/2020
6/9/2020,225,22179,2698,172349,194528,10,1868,18,1441,0,280,147,28,21,1,886,67,15756,1275,112271,128027,8/26/2020
6/10/2020,212,22391,2999,175348,197739,13,1881,12,1453,2,282,146,24,17,3,889,105,15861,1466,113737,129598,8/26/2020
6/11/2020,195,22586,3523,178871,201457,7,1888,15,1468,1,283,137,25,16,6,895,88,15949,1541,115278,131227,8/26/2020
6/12/2020,214,22800,4622,183493,206293,9,1897,15,1483,1,284,130,24,16,2,897,81,16030,2192,117470,133500,8/26/2020
6/13/2020,114,22914,3046,186539,209453,6,1903,4,1487,0,284,132,20,15,3,900,50,16080,1380,118850,134930,8/26/2020
6/14/2020,81,22995,2050,188589,211584,6,1909,8,1495,1,285,129,20,14,3,903,32,16112,968,119818,135930,8/26/2020
6/15/2020,189,23184,3126,191715,214899,14,1923,14,1509,0,285,129,20,16,4,907,78,16190,1797,121615,137805,8/26/2020
6/16/2020,116,23300,3033,194748,218048,10,1933,9,1518,1,286,129,22,16,8,915,52,16242,1588,123203,139445,8/26/2020
6/17/2020,128,23428,2846,197594,221022,15,1948,20,1538,4,290,120,18,14,6,921,53,16295,1326,124529,140824,8/26/2020
6/18/2020,150,23578,3057,200651,224229,9,1957,13,1551,1,291,115,19,16,7,928,70,16365,1339,125868,142233,8/26/2020
6/19/2020,141,23719,3783,204434,228153,12,1969,11,1562,1,292,115,20,17,3,931,59,16424,1380,127248,143672,8/26/2020
6/20/2020,84,23803,1895,206329,230132,9,1978,12,1574,0,292,112,20,18,4,935,36,16460,816,128064,144524,8/26/2020
6/21/2020,37,23840,1070,207399,231239,7,1985,5,1579,0,292,114,20,18,2,937,28,16488,692,128756,145244,8/26/2020
6/22/2020,142,23982,3738,211137,235119,12,1997,16,1595,0,292,110,19,18,1,938,70,16558,1714,130470,147028,8/26/2020
6/23/2020,163,24145,3867,215004,239149,3,2000,13,1608,3,295,97,18,18,6,944,82,16640,1796,132266,148906,8/26/2020
6/24/2020,122,24267,3524,218528,242795,9,2009,10,1618,1,296,95,18,18,5,949,48,16688,1696,133962,150650,8/26/2020
6/25/2020,103,24370,2909,221437,245807,6,2015,14,1632,1,297,86,17,17,1,950,53,16741,1522,135484,152225,8/26/2020
6/26/2020,95,24465,2465,223902,248367,2,2017,10,1642,0,297,78,18,18,1,951,64,16805,1304,136788,153593,8/26/2020
6/27/2020,84,24549,3228,227130,251679,5,2022,3,1645,1,298,79,17,17,5,956,37,16842,1221,138009,154851,8/26/2020
6/28/2020,40,24589,1472,228602,253191,4,2026,4,1649,4,302,75,15,14,6,962,19,16861,597,138606,155467,8/26/2020
6/29/2020,88,24677,3701,232303,256980,4,2030,5,1654,0,302,74,14,14,1,963,40,16901,1352,139958,156859,8/26/2020
6/30/2020,60,24737,1969,234272,259009,1,2031,5,1659,1,303,69,12,11,3,966,33,16934,1000,140958,157892,8/26/2020
7/1/2020,145,24882,4122,238394,263276,7,2038,9,1668,0,303,67,11,11,1,967,81,17015,1949,142907,159922,8/26/2020
7/2/2020,102,24984,2800,241194,266178,5,2043,5,1673,1,304,66,9,9,1,968,57,17072,1087,143994,161066,8/26/2020
7/3/2020,51,25035,2032,243226,268261,9,2052,6,1679,0,304,69,8,8,3,971,26,17098,775,144769,161867,8/26/2020
7/4/2020,58,25093,2335,245561,270654,2,2054,4,1683,1,305,66,9,8,2,973,34,17132,996,145765,162897,8/26/2020
7/5/2020,51,25144,2939,248500,273644,1,2055,2,1685,1,306,64,7,7,2,975,26,17158,1449,147214,164372,8/26/2020
7/6/2020,104,25248,2822,251322,276570,6,2061,6,1691,0,306,64,8,9,4,979,58,17216,1557,148771,165987,8/26/2020
7/7/2020,82,25330,3467,254789,280119,5,2066,7,1698,0,306,62,7,8,1,980,48,17264,1530,150301,167565,8/26/2020
7/8/2020,106,25436,3404,258193,283629,4,2070,2,1700,0,306,64,8,8,0,980,66,17330,1417,151718,169048,8/26/2020
7/9/2020,94,25530,3682,261875,287405,9,2079,3,1703,0,306,70,8,8,0,980,49,17379,1601,153319,170698,8/26/2020
7/10/2020,131,25661,4413,266288,291949,6,2085,3,1706,2,308,71,7,7,3,983,80,17459,2086,155405,172864,8/26/2020
7/11/2020,63,25724,2905,269193,294917,6,2091,3,1709,1,309,73,6,6,3,986,33,17492,1290,156695,174187,8/26/2020
7/12/2020,45,25769,1787,270980,296749,1,2092,3,1712,1,310,70,6,5,3,989,34,17526,898,157593,175119,8/26/2020
7/13/2020,85,25854,3168,274148,300002,8,2100,10,1722,0,310,68,6,5,1,990,57,17583,1481,159074,176657,8/26/2020
7/14/2020,75,25929,3290,277438,303367,7,2107,4,1726,0,310,71,5,5,1,991,49,17632,1371,160445,178077,8/26/2020
7/15/2020,124,26053,4141,281579,307632,5,2112,7,1733,0,310,69,5,4,0,991,94,17726,1730,162175,179901,8/26/2020
7/16/2020,102,26155,3718,285297,311452,6,2118,9,1742,0,310,66,6,5,1,992,78,17804,1601,163776,181580,8/26/2020
7/17/2020,153,26308,4145,289442,315750,14,2132,3,1745,1,311,76,5,5,1,993,78,17882,1801,165577,183459,8/26/2020
7/18/2020,80,26388,3178,292620,319008,5,2137,9,1754,1,312,71,5,4,4,997,66,17948,1335,166912,184860,8/26/2020
7/19/2020,83,26471,2604,295224,321695,6,2143,3,1757,0,312,74,6,4,2,999,59,18007,1066,167978,185985,8/26/2020
7/20/2020,73,26544,2663,297887,324431,9,2152,7,1764,0,312,76,7,5,2,1001,63,18070,1465,169443,187513,8/26/2020
7/21/2020,128,26672,4241,302128,328800,9,2161,10,1774,0,312,75,9,6,1,1002,103,18173,1874,171317,189490,8/26/2020
7/22/2020,124,26796,3804,305932,332728,11,2172,11,1785,1,313,74,7,6,1,1003,86,18259,1580,172897,191156,8/26/2020
7/23/2020,123,26919,4103,310035,336954,8,2180,5,1790,0,313,77,8,7,0,1003,104,18363,1769,174666,193029,8/26/2020
7/24/2020,168,27087,5707,315742,342829,13,2193,13,1803,0,313,77,9,7,0,1003,125,18488,2156,176822,195310,8/26/2020
7/25/2020,128,27215,4283,320025,347240,7,2200,7,1810,0,313,77,10,8,1,1004,104,18592,2004,178826,197418,8/26/2020
7/26/2020,56,27271,2985,323010,350281,8,2208,9,1819,0,313,76,11,7,1,1005,52,18644,1300,180126,198770,8/26/2020
7/27/2020,183,27454,3922,326932,354386,12,2220,7,1826,0,313,81,13,8,1,1006,138,18782,2131,182257,201039,8/26/2020
7/28/2020,106,27560,3706,330638,358198,5,2225,5,1831,0,313,81,14,7,1,1007,89,18871,1529,183786,202657,8/26/2020
7/29/2020,166,27726,4826,335464,363190,10,2235,12,1843,0,313,79,15,7,0,1007,148,19019,2099,185885,204904,8/26/2020
7/30/2020,100,27826,4022,339486,367312,6,2241,2,1845,1,314,82,15,6,0,1007,78,19097,1398,187283,206380,8/26/2020
7/31/2020,119,27945,5129,344615,372560,8,2249,9,1854,0,314,81,15,7,0,1007,90,19187,1637,188920,208107,8/26/2020
8/1/2020,95,28040,3938,348553,376593,7,2256,2,1856,0,314,86,14,7,1,1008,83,19270,1343,190263,209533,8/26/2020
8/2/2020,77,28117,2714,351267,379384,12,2268,12,1868,1,315,85,14,8,2,1010,63,19333,1216,191479,210812,8/26/2020
8/3/2020,171,28288,4854,356121,384409,13,2281,12,1880,0,315,86,16,7,1,1011,149,19482,1912,193391,212873,8/26/2020
8/4/2020,120,28408,3450,359571,387979,8,2289,6,1886,1,316,87,12,5,2,1013,103,19585,1605,194996,214581,8/26/2020
8/5/2020,140,28548,5444,365015,393563,12,2301,10,1896,1,317,88,10,5,2,1015,112,19697,2103,197099,216796,8/26/2020
8/6/2020,157,28705,4688,369703,398408,6,2307,9,1905,0,317,85,9,4,0,1015,114,19811,1814,198913,218724,8/26/2020
8/7/2020,106,28811,4189,373892,402703,13,2320,10,1915,1,318,87,9,3,1,1016,84,19895,1689,200602,220497,8/26/2020
8/8/2020,106,28917,3701,377593,406510,19,2339,6,1921,1,319,99,8,3,1,1017,93,19988,1522,202124,222112,8/26/2020
8/9/2020,36,28953,1544,379137,408090,8,2347,11,1932,0,319,96,9,4,0,1017,33,20021,952,203076,223097,8/26/2020
8/10/2020,135,29088,4091,383228,412316,11,2358,11,1943,0,319,96,9,4,1,1018,108,20129,1665,204741,224870,8/26/2020
8/11/2020,101,29189,3931,387159,416348,6,2364,14,1957,0,319,88,10,4,2,1020,97,20226,2020,206761,226987,8/26/2020
8/12/2020,117,29306,4627,391786,421092,8,2372,11,1968,0,319,85,9,3,1,1021,104,20330,2216,208977,229307,8/26/2020
8/13/2020,113,29419,3723,395509,424928,11,2383,11,1979,0,319,85,11,3,0,1021,90,20420,1597,210574,230994,8/26/2020
8/14/2020,135,29554,5239,400748,430302,13,2396,11,1990,0,319,87,11,4,2,1023,99,20519,1820,212394,232913,8/26/2020
8/15/2020,98,29652,4138,404886,434538,8,2404,10,2000,1,320,84,11,5,0,1023,90,20609,1457,213851,234460,8/26/2020
8/16/2020,77,29729,2798,407684,437413,7,2411,6,2006,4,324,81,8,4,5,1028,69,20678,1007,214858,235536,8/26/2020
8/17/2020,104,29833,3924,411608,441441,10,2421,7,2013,0,324,84,8,5,2,1030,85,20763,1881,216739,237502,8/26/2020
8/18/2020,123,29956,4832,416440,446396,11,2432,9,2022,1,325,85,8,4,4,1034,93,20856,2763,219502,240358,8/26/2020
8/19/2020,100,30056,5241,421681,451737,6,2438,9,2031,1,326,81,9,5,0,1034,80,20936,2690,222192,243128,8/26/2020
8/20/2020,173,30229,7979,429660,459889,11,2449,6,2037,1,327,85,10,5,2,1036,139,21075,3655,225847,246922,8/26/2020
8/21/2020,141,30370,6618,436278,466648,8,2457,4,2041,1,328,88,9,4,2,1038,115,21190,3169,229016,250206,8/26/2020
8/22/2020,97,30467,5774,442052,472519,8,2465,12,2053,0,328,84,11,4,0,1038,84,21274,2517,231533,252807,8/26/2020
8/23/2020,56,30523,3886,445938,476461,8,2473,6,2059,0,328,86,11,2,1,1039,43,21317,2325,233858,255175,8/26/2020
8/24/2020,87,30610,4841,450779,481389,5,2478,10,2069,1,329,80,11,4,1,1040,69,21386,2637,236495,257881,8/26/2020
8/25/2020,87,30697,3550,454329,485026,,,,,,,,,,1,1041,68,21454,1681,238176,259630,8/26/2020
2/27/2020,0,0,0,0,0,1,1,0,0,0,0,1,0,0,0,0,0,0,0,0,0,8/27/2020
2/28/2020,0,0,0,0,0,0,1,0,0,0,0,1,1,0,0,0,0,0,0,0,0,8/27/2020
2/29/2020,0,0,0,0,0,0,1,0,0,0,0,1,1,0,0,0,0,0,0,0,0,8/27/2020
3/1/2020,2,2,2,2,4,0,1,0,0,0,0,1,1,1,0,0,2,2,2,2,4,8/27/2020
3/2/2020,0,2,1,3,5,1,2,0,0,0,0,2,2,2,0,0,0,2,1,3,5,8/27/2020
3/3/2020,0,2,2,5,7,0,2,0,0,0,0,2,2,2,0,0,0,2,2,5,7,8/27/2020
3/4/2020,0,2,12,17,19,1,3,0,0,0,0,3,2,2,0,0,0,2,10,15,17,8/27/2020
3/5/2020,0,2,4,21,23,0,3,0,0,0,0,3,2,2,0,0,1,3,4,19,22,8/27/2020
3/6/2020,1,3,12,33,36,0,3,0,0,0,0,3,2,2,0,0,0,3,11,30,33,8/27/2020
3/7/2020,0,3,19,52,55,0,3,0,0,0,0,3,2,1,0,0,0,3,19,49,52,8/27/2020
3/8/2020,0,3,18,70,73,0,3,0,0,0,0,3,2,1,0,0,0,3,18,67,70,8/27/2020
3/9/2020,1,4,15,85,89,0,3,0,0,0,0,3,2,1,0,0,1,4,15,82,86,8/27/2020
3/10/2020,2,6,25,110,116,0,3,0,0,0,0,3,2,1,0,0,1,5,23,105,110,8/27/2020
3/11/2020,0,6,34,144,150,1,4,0,0,0,0,4,1,1,0,0,0,5,34,139,144,8/27/2020
3/12/2020,9,15,41,185,200,1,5,0,0,0,0,5,1,1,0,0,8,13,38,177,190,8/27/2020
3/13/2020,6,21,50,235,256,4,9,1,1,0,0,8,1,1,0,0,6,19,48,225,244,8/27/2020
3/14/2020,0,21,90,325,346,0,9,0,1,0,0,8,1,1,0,0,0,19,86,311,330,8/27/2020
3/15/2020,1,22,54,379,401,1,10,0,1,0,0,9,2,1,0,0,1,20,54,365,385,8/27/2020
3/16/2020,2,24,95,474,498,2,12,0,1,0,0,11,2,0,0,0,2,22,92,457,479,8/27/2020
3/17/2020,16,40,162,636,676,6,18,0,1,0,0,17,2,0,0,0,11,33,152,609,642,8/27/2020
3/18/2020,12,52,116,752,804,3,21,0,1,0,0,20,2,0,0,0,11,44,111,720,764,8/27/2020
3/19/2020,17,69,262,1014,1083,2,23,1,2,0,0,21,3,0,1,1,17,61,251,971,1032,8/27/2020
3/20/2020,14,83,197,1211,1294,5,28,0,2,0,0,26,4,0,0,1,13,74,192,1163,1237,8/27/2020
3/21/2020,21,104,126,1337,1441,3,31,2,4,0,0,27,5,0,0,1,14,88,123,1286,1374,8/27/2020
3/22/2020,30,134,282,1619,1753,2,33,0,4,0,0,29,5,0,0,1,25,113,262,1548,1661,8/27/2020
3/23/2020,14,148,169,1788,1936,15,48,1,5,0,0,43,9,3,0,1,16,129,165,1713,1842,8/27/2020
3/24/2020,20,168,242,2030,2198,7,55,0,5,0,0,50,10,4,0,1,19,148,238,1951,2099,8/27/2020
3/25/2020,26,194,183,2213,2407,5,60,1,6,0,0,54,11,3,0,1,28,176,172,2123,2299,8/27/2020
3/26/2020,35,229,181,2394,2623,10,70,5,11,0,0,59,14,5,0,1,41,217,176,2299,2516,8/27/2020
3/27/2020,27,256,215,2609,2865,9,79,1,12,1,1,66,17,6,2,3,31,248,202,2501,2749,8/27/2020
3/28/2020,59,315,260,2869,3184,13,92,3,15,2,3,74,15,6,1,4,63,311,241,2742,3053,8/27/2020
3/29/2020,106,421,356,3225,3646,8,100,4,19,1,4,77,18,8,2,6,105,416,314,3056,3472,8/27/2020
3/30/2020,62,483,222,3447,3930,20,120,5,24,0,4,92,20,11,3,9,78,494,187,3243,3737,8/27/2020
3/31/2020,71,554,369,3816,4370,11,131,7,31,1,5,95,22,13,2,11,73,567,298,3541,4108,8/27/2020
4/1/2020,99,653,699,4515,5168,18,149,7,38,0,5,106,30,15,1,12,100,667,644,4185,4852,8/27/2020
4/2/2020,52,705,477,4992,5697,22,171,6,44,2,7,120,36,21,4,16,62,729,436,4621,5350,8/27/2020
4/3/2020,108,813,775,5767,6580,23,194,7,51,0,7,136,43,25,3,19,100,829,716,5337,6166,8/27/2020
4/4/2020,143,956,660,6427,7383,22,216,4,55,5,12,149,41,30,9,28,138,967,620,5957,6924,8/27/2020
4/5/2020,187,1143,1156,7583,8726,20,236,9,64,1,13,159,44,36,2,30,182,1149,1070,7027,8176,8/27/2020
4/6/2020,218,1361,1707,9290,10651,26,262,7,71,0,13,178,48,40,7,37,206,1355,1564,8591,9946,8/27/2020
4/7/2020,285,1646,1631,10921,12567,19,281,4,75,2,15,191,50,42,5,42,260,1615,1486,10077,11692,8/27/2020
4/8/2020,290,1936,1723,12644,14580,19,300,7,82,6,21,197,50,38,10,52,272,1887,1566,11643,13530,8/27/2020
4/9/2020,284,2220,1521,14165,16385,32,332,9,91,4,25,216,53,40,7,59,278,2165,1360,13003,15168,8/27/2020
4/10/2020,420,2640,2577,16742,19382,29,361,15,106,5,30,225,59,41,11,70,403,2568,2376,15379,17947,8/27/2020
4/11/2020,299,2939,1911,18653,21592,29,390,11,117,2,32,241,61,48,12,82,281,2849,1721,17100,19949,8/27/2020
4/12/2020,315,3254,1674,20327,23581,35,425,13,130,5,37,258,59,49,9,91,289,3138,1440,18540,21678,8/27/2020
4/13/2020,162,3416,938,21265,24681,35,460,13,143,3,40,277,64,54,9,100,187,3325,842,19382,22707,8/27/2020
4/14/2020,289,3705,1788,23053,26758,27,487,17,160,5,45,282,72,53,8,108,265,3590,1530,20912,24502,8/27/2020
4/15/2020,353,4058,1803,24856,28914,31,518,20,180,3,48,290,72,54,17,125,307,3897,1566,22478,26375,8/27/2020
4/16/2020,449,4507,2500,27356,31863,36,554,25,205,6,54,295,72,53,14,139,391,4288,2086,24564,28852,8/27/2020
4/17/2020,308,4815,1823,29179,33994,32,586,20,225,7,61,300,66,45,21,160,291,4579,1461,26025,30604,8/27/2020
4/18/2020,322,5137,1728,30907,36044,26,612,18,243,4,65,304,63,49,15,175,284,4863,1347,27372,32235,8/27/2020
4/19/2020,382,5519,2059,32966,38485,23,635,26,269,1,66,300,65,55,11,186,338,5201,1747,29119,34320,8/27/2020
4/20/2020,396,5915,1909,34875,40790,46,681,29,298,2,68,315,75,56,10,196,377,5578,1582,30701,36279,8/27/2020
4/21/2020,445,6360,2114,36989,43349,45,726,31,329,5,73,324,72,56,18,214,390,5968,1719,32420,38388,8/27/2020
4/22/2020,420,6780,2398,39387,46167,41,767,32,361,5,78,328,73,58,18,232,382,6350,1920,34340,40690,8/27/2020
4/23/2020,481,7261,2471,41858,49119,30,797,28,389,5,83,325,76,62,15,247,418,6768,1871,36211,42979,8/27/2020
4/24/2020,494,7755,3292,45150,52905,35,832,27,416,4,87,329,85,63,15,262,413,7181,2636,38847,46028,8/27/2020
4/25/2020,394,8149,2210,47360,55509,34,866,17,433,5,92,341,85,62,14,276,304,7485,1778,40625,48110,8/27/2020
4/26/2020,316,8465,2314,49674,58139,33,899,15,448,3,95,356,86,59,14,290,276,7761,1884,42509,50270,8/27/2020
4/27/2020,250,8715,1624,51298,60013,29,928,21,469,4,99,360,86,61,10,300,204,7965,1164,43673,51638,8/27/2020
4/28/2020,411,9126,2268,53566,62692,44,972,24,493,3,102,377,88,59,22,322,325,8290,1771,45444,53734,8/27/2020
4/29/2020,476,9602,3351,56917,66519,36,1008,37,530,11,113,365,78,53,18,340,371,8661,2440,47884,56545,8/27/2020
4/30/2020,432,10034,2772,59689,69723,33,1041,38,568,6,119,354,83,57,24,364,348,9009,1955,49839,58848,8/27/2020
5/1/2020,457,10491,3089,62778,73269,51,1092,39,607,3,122,363,84,58,14,378,317,9326,2221,52060,61386,8/27/2020
5/2/2020,260,10751,1927,64705,75456,36,1128,39,646,5,127,355,91,62,24,402,189,9515,1293,53353,62868,8/27/2020
5/3/2020,284,11035,2168,66873,77908,31,1159,27,673,8,135,351,90,61,21,423,182,9697,1603,54956,64653,8/27/2020
5/4/2020,388,11423,2101,68974,80397,30,1189,31,704,5,140,345,88,57,18,441,293,9990,1573,56529,66519,8/27/2020
5/5/2020,436,11859,2878,71852,83711,29,1218,32,736,6,146,336,82,54,16,457,304,10294,1968,58497,68791,8/27/2020
5/6/2020,490,12349,2836,74688,87037,28,1246,44,780,9,155,311,79,54,21,478,341,10635,1924,60421,71056,8/27/2020
5/7/2020,425,12774,2975,77663,90437,36,1282,42,822,5,160,300,71,52,21,499,269,10904,1981,62402,73306,8/27/2020
5/8/2020,360,13134,2603,80266,93400,30,1312,29,851,5,165,296,71,53,22,521,231,11135,1759,64161,75296,8/27/2020
5/9/2020,470,13604,3356,83622,97226,22,1334,21,872,4,169,293,69,51,15,536,286,11421,2277,66438,77859,8/27/2020
5/10/2020,285,13889,2122,85744,99633,19,1353,23,895,6,175,283,70,49,13,549,187,11608,1525,67963,79571,8/27/2020
5/11/2020,259,14148,1861,87605,101753,31,1384,16,911,6,181,292,71,49,15,564,176,11784,1306,69269,81053,8/27/2020
5/12/2020,387,14535,2622,90227,104762,23,1407,18,929,4,185,293,69,48,22,586,218,12002,1714,70983,82985,8/27/2020
5/13/2020,352,14887,3634,93861,108748,22,1429,24,953,1,186,290,69,49,13,599,196,12198,2018,73001,85199,8/27/2020
5/14/2020,330,15217,3415,97276,112493,19,1448,27,980,3,189,279,64,45,15,614,227,12425,2021,75022,87447,8/27/2020
5/15/2020,382,15599,3470,100746,116345,24,1472,41,1021,5,194,257,62,45,13,627,234,12659,1814,76836,89495,8/27/2020
5/16/2020,453,16052,4168,104914,120966,25,1497,12,1033,5,199,265,61,46,15,642,252,12911,1967,78803,91714,8/27/2020
5/17/2020,240,16292,2775,107689,123981,17,1514,7,1040,5,204,270,59,45,10,652,124,13035,1566,80369,93404,8/27/2020
5/18/2020,251,16543,2007,109696,126239,19,1533,15,1055,5,209,269,57,40,18,670,139,13174,1374,81743,94917,8/27/2020
5/19/2020,416,16959,3178,112874,129833,23,1556,32,1087,5,214,255,56,38,11,681,212,13386,1937,83680,97066,8/27/2020
5/20/2020,328,17287,2775,115649,132936,19,1575,23,1110,7,221,244,52,33,22,703,187,13573,1521,85201,98774,8/27/2020
5/21/2020,374,17661,3764,119413,137074,26,1601,15,1125,3,224,252,53,29,20,723,170,13743,1948,87149,100892,8/27/2020
5/22/2020,353,18014,3172,122585,140599,20,1621,29,1154,5,229,238,52,29,10,733,204,13947,1614,88763,102710,8/27/2020
5/23/2020,253,18267,2748,125333,143600,19,1640,11,1165,3,232,243,52,32,13,746,109,14056,1281,90044,104100,8/27/2020
5/24/2020,165,18432,1372,126705,145137,12,1652,14,1179,2,234,239,53,36,8,754,84,14140,773,90817,104957,8/27/2020
5/25/2020,147,18579,1389,128094,146673,13,1665,14,1193,0,234,238,53,34,10,764,71,14211,765,91582,105793,8/27/2020
5/26/2020,285,18864,2624,130718,149582,24,1689,22,1215,5,239,235,48,33,15,779,156,14367,1784,93366,107733,8/27/2020
5/27/2020,276,19140,2134,132852,151992,20,1709,18,1233,3,242,234,50,33,10,789,133,14500,1143,94509,109009,8/27/2020
5/28/2020,350,19490,3384,136236,155726,17,1726,29,1262,4,246,218,47,32,8,797,133,14633,1131,95640,110273,8/27/2020
5/29/2020,420,19910,3989,140225,160135,19,1745,27,1289,6,252,204,43,31,12,809,179,14812,1587,97227,112039,8/27/2020
5/30/2020,228,20138,3973,144198,164336,15,1760,19,1308,4,256,196,40,29,12,821,109,14921,1824,99051,113972,8/27/2020
5/31/2020,159,20297,1759,145957,166254,11,1771,10,1318,0,256,197,43,26,3,824,78,14999,859,99910,114909,8/27/2020
6/1/2020,217,20514,2825,148782,169296,8,1779,14,1332,1,257,190,44,29,5,829,99,15098,1384,101294,116392,8/27/2020
6/2/2020,273,20787,3089,151871,172658,8,1787,9,1341,3,260,186,37,25,10,839,107,15205,1466,102760,117965,8/27/2020
6/3/2020,260,21047,3523,155394,176441,13,1800,18,1359,6,266,175,34,25,11,850,105,15310,1675,104435,119745,8/27/2020
6/4/2020,282,21329,4539,159933,181262,7,1807,25,1384,3,269,154,31,24,11,861,112,15422,2048,106483,121905,8/27/2020
6/5/2020,216,21545,3594,163527,185072,15,1822,13,1397,6,275,150,27,21,10,871,105,15527,1582,108065,123592,8/27/2020
6/6/2020,203,21748,2632,166159,187907,10,1832,7,1404,2,277,151,29,19,6,877,68,15595,1138,109203,124798,8/27/2020
6/7/2020,83,21831,1629,167788,189619,11,1843,7,1411,1,278,154,25,17,4,881,50,15645,783,109986,125631,8/27/2020
6/8/2020,123,21954,1863,169651,191605,15,1858,12,1423,2,280,155,27,18,4,885,44,15689,972,110958,126647,8/27/2020
6/9/2020,225,22179,2698,172349,194528,10,1868,18,1441,0,280,147,28,21,1,886,67,15756,1275,112233,127989,8/27/2020
6/10/2020,212,22391,2999,175348,197739,13,1881,12,1453,2,282,146,24,17,3,889,105,15861,1466,113699,129560,8/27/2020
6/11/2020,195,22586,3523,178871,201457,7,1888,15,1468,1,283,137,25,16,6,895,88,15949,1541,115240,131189,8/27/2020
6/12/2020,214,22800,4622,183493,206293,9,1897,15,1483,1,284,130,24,16,2,897,81,16030,2191,117431,133461,8/27/2020
6/13/2020,114,22914,3046,186539,209453,6,1903,4,1487,0,284,132,20,15,3,900,50,16080,1380,118811,134891,8/27/2020
6/14/2020,81,22995,2050,188589,211584,6,1909,8,1495,1,285,129,20,14,3,903,32,16112,968,119779,135891,8/27/2020
6/15/2020,189,23184,3126,191715,214899,14,1923,14,1509,0,285,129,20,16,4,907,78,16190,1797,121576,137766,8/27/2020
6/16/2020,116,23300,3033,194748,218048,10,1933,9,1518,1,286,129,22,16,8,915,52,16242,1588,123164,139406,8/27/2020
6/17/2020,128,23428,2846,197594,221022,15,1948,20,1538,4,290,120,18,14,6,921,53,16295,1325,124489,140784,8/27/2020
6/18/2020,150,23578,3057,200651,224229,9,1957,13,1551,1,291,115,19,16,7,928,70,16365,1339,125828,142193,8/27/2020
6/19/2020,141,23719,3783,204434,228153,12,1969,11,1562,1,292,115,20,17,3,931,59,16424,1380,127208,143632,8/27/2020
6/20/2020,84,23803,1895,206329,230132,9,1978,12,1574,0,292,112,20,18,4,935,36,16460,816,128024,144484,8/27/2020
6/21/2020,37,23840,1070,207399,231239,7,1985,5,1579,0,292,114,20,18,2,937,28,16488,692,128716,145204,8/27/2020
6/22/2020,142,23982,3738,211137,235119,12,1997,16,1595,0,292,110,19,18,1,938,70,16558,1713,130429,146987,8/27/2020
6/23/2020,163,24145,3867,215004,239149,3,2000,13,1608,3,295,97,18,18,6,944,82,16640,1796,132225,148865,8/27/2020
6/24/2020,122,24267,3524,218528,242795,9,2009,10,1618,1,296,95,18,18,5,949,48,16688,1695,133920,150608,8/27/2020
6/25/2020,103,24370,2909,221437,245807,6,2015,14,1632,1,297,86,17,17,1,950,53,16741,1522,135442,152183,8/27/2020
6/26/2020,95,24465,2465,223902,248367,2,2017,10,1642,0,297,78,18,18,1,951,64,16805,1303,136745,153550,8/27/2020
6/27/2020,84,24549,3228,227130,251679,5,2022,3,1645,1,298,79,17,17,5,956,37,16842,1221,137966,154808,8/27/2020
6/28/2020,40,24589,1472,228602,253191,4,2026,4,1649,4,302,75,15,14,6,962,19,16861,597,138563,155424,8/27/2020
6/29/2020,88,24677,3701,232303,256980,4,2030,5,1654,0,302,74,14,14,1,963,40,16901,1352,139915,156816,8/27/2020
6/30/2020,60,24737,1969,234272,259009,1,2031,5,1659,1,303,69,12,11,3,966,33,16934,1000,140915,157849,8/27/2020
7/1/2020,145,24882,4122,238394,263276,7,2038,9,1668,0,303,67,11,11,1,967,81,17015,1949,142864,159879,8/27/2020
7/2/2020,102,24984,2800,241194,266178,5,2043,5,1673,1,304,66,9,9,1,968,57,17072,1087,143951,161023,8/27/2020
7/3/2020,51,25035,2032,243226,268261,9,2052,6,1679,0,304,69,8,8,3,971,26,17098,775,144726,161824,8/27/2020
7/4/2020,58,25093,2335,245561,270654,2,2054,4,1683,1,305,66,9,8,2,973,34,17132,996,145722,162854,8/27/2020
7/5/2020,51,25144,2939,248500,273644,1,2055,2,1685,1,306,64,7,7,2,975,26,17158,1449,147171,164329,8/27/2020
7/6/2020,104,25248,2822,251322,276570,6,2061,6,1691,0,306,64,8,9,4,979,58,17216,1557,148728,165944,8/27/2020
7/7/2020,82,25330,3467,254789,280119,5,2066,7,1698,0,306,62,7,8,1,980,48,17264,1530,150258,167522,8/27/2020
7/8/2020,106,25436,3404,258193,283629,4,2070,2,1700,0,306,64,8,8,0,980,66,17330,1417,151675,169005,8/27/2020
7/9/2020,94,25530,3682,261875,287405,9,2079,3,1703,0,306,70,8,8,0,980,49,17379,1601,153276,170655,8/27/2020
7/10/2020,131,25661,4413,266288,291949,6,2085,3,1706,2,308,71,7,7,3,983,80,17459,2086,155362,172821,8/27/2020
7/11/2020,63,25724,2905,269193,294917,6,2091,3,1709,1,309,73,6,6,3,986,34,17493,1290,156652,174145,8/27/2020
7/12/2020,45,25769,1787,270980,296749,1,2092,3,1712,1,310,70,6,5,3,989,34,17527,897,157549,175076,8/27/2020
7/13/2020,85,25854,3168,274148,300002,8,2100,10,1722,0,310,68,6,5,1,990,57,17584,1481,159030,176614,8/27/2020
7/14/2020,75,25929,3290,277438,303367,7,2107,4,1726,0,310,71,5,5,1,991,49,17633,1371,160401,178034,8/27/2020
7/15/2020,124,26053,4141,281579,307632,5,2112,7,1733,0,310,69,5,4,0,991,94,17727,1730,162131,179858,8/27/2020
7/16/2020,102,26155,3718,285297,311452,6,2118,9,1742,0,310,66,6,5,1,992,78,17805,1601,163732,181537,8/27/2020
7/17/2020,153,26308,4145,289442,315750,14,2132,3,1745,1,311,76,5,5,1,993,78,17883,1801,165533,183416,8/27/2020
7/18/2020,80,26388,3178,292620,319008,5,2137,9,1754,1,312,71,5,4,4,997,66,17949,1335,166868,184817,8/27/2020
7/19/2020,83,26471,2604,295224,321695,6,2143,3,1757,0,312,74,6,4,2,999,59,18008,1066,167934,185942,8/27/2020
7/20/2020,73,26544,2663,297887,324431,9,2152,7,1764,0,312,76,7,5,2,1001,63,18071,1465,169399,187470,8/27/2020
7/21/2020,128,26672,4241,302128,328800,9,2161,10,1774,0,312,75,9,6,1,1002,103,18174,1874,171273,189447,8/27/2020
7/22/2020,124,26796,3804,305932,332728,11,2172,11,1785,1,313,74,7,6,1,1003,86,18260,1579,172852,191112,8/27/2020
7/23/2020,123,26919,4103,310035,336954,8,2180,5,1790,0,313,77,8,7,0,1003,104,18364,1768,174620,192984,8/27/2020
7/24/2020,168,27087,5707,315742,342829,13,2193,13,1803,0,313,77,9,7,0,1003,125,18489,2156,176776,195265,8/27/2020
7/25/2020,128,27215,4283,320025,347240,7,2200,7,1810,0,313,77,10,8,1,1004,104,18593,2004,178780,197373,8/27/2020
7/26/2020,56,27271,2985,323010,350281,8,2208,9,1819,0,313,76,11,7,1,1005,52,18645,1300,180080,198725,8/27/2020
7/27/2020,183,27454,3922,326932,354386,12,2220,7,1826,0,313,81,13,8,1,1006,138,18783,2131,182211,200994,8/27/2020
7/28/2020,106,27560,3706,330638,358198,5,2225,5,1831,0,313,81,14,7,1,1007,89,18872,1529,183740,202612,8/27/2020
7/29/2020,166,27726,4826,335464,363190,10,2235,12,1843,0,313,79,15,7,0,1007,148,19020,2099,185839,204859,8/27/2020
7/30/2020,100,27826,4022,339486,367312,6,2241,2,1845,1,314,82,15,6,0,1007,78,19098,1397,187236,206334,8/27/2020
7/31/2020,119,27945,5129,344615,372560,8,2249,9,1854,0,314,81,15,7,0,1007,90,19188,1637,188873,208061,8/27/2020
8/1/2020,95,28040,3938,348553,376593,7,2256,2,1856,0,314,86,14,7,1,1008,83,19271,1343,190216,209487,8/27/2020
8/2/2020,77,28117,2714,351267,379384,12,2268,12,1868,1,315,85,14,8,2,1010,63,19334,1216,191432,210766,8/27/2020
8/3/2020,171,28288,4854,356121,384409,13,2281,12,1880,0,315,86,16,7,1,1011,149,19483,1912,193344,212827,8/27/2020
8/4/2020,120,28408,3450,359571,387979,8,2289,6,1886,1,316,87,12,5,2,1013,103,19586,1605,194949,214535,8/27/2020
8/5/2020,140,28548,5444,365015,393563,12,2301,10,1896,1,317,88,10,5,2,1015,112,19698,2102,197051,216749,8/27/2020
8/6/2020,157,28705,4688,369703,398408,6,2307,9,1905,0,317,85,9,4,0,1015,114,19812,1814,198865,218677,8/27/2020
8/7/2020,106,28811,4189,373892,402703,13,2320,10,1915,1,318,87,9,3,1,1016,84,19896,1688,200553,220449,8/27/2020
8/8/2020,106,28917,3701,377593,406510,19,2339,6,1921,1,319,99,8,3,1,1017,93,19989,1522,202075,222064,8/27/2020
8/9/2020,36,28953,1544,379137,408090,8,2347,11,1932,0,319,96,9,4,0,1017,33,20022,952,203027,223049,8/27/2020
8/10/2020,135,29088,4091,383228,412316,11,2358,11,1943,0,319,96,9,4,1,1018,108,20130,1665,204692,224822,8/27/2020
8/11/2020,101,29189,3931,387159,416348,6,2364,14,1957,0,319,88,10,4,2,1020,97,20227,2020,206712,226939,8/27/2020
8/12/2020,117,29306,4627,391786,421092,8,2372,11,1968,0,319,85,9,3,1,1021,104,20331,2215,208927,229258,8/27/2020
8/13/2020,113,29419,3723,395509,424928,11,2383,11,1979,0,319,85,11,3,0,1021,90,20421,1597,210524,230945,8/27/2020
8/14/2020,135,29554,5239,400748,430302,13,2396,11,1990,0,319,87,11,4,2,1023,98,20519,1819,212343,232862,8/27/2020
8/15/2020,98,29652,4138,404886,434538,8,2404,10,2000,1,320,84,11,5,0,1023,90,20609,1456,213799,234408,8/27/2020
8/16/2020,77,29729,2798,407684,437413,7,2411,6,2006,4,324,81,8,4,5,1028,69,20678,1007,214806,235484,8/27/2020
8/17/2020,104,29833,3924,411608,441441,10,2421,7,2013,0,324,84,8,5,2,1030,85,20763,1881,216687,237450,8/27/2020
8/18/2020,123,29956,4832,416440,446396,11,2432,9,2022,1,325,85,8,4,5,1035,93,20856,2762,219449,240305,8/27/2020
8/19/2020,100,30056,5241,421681,451737,6,2438,9,2031,1,326,81,9,5,0,1035,80,20936,2690,222139,243075,8/27/2020
8/20/2020,173,30229,7981,429662,459891,11,2449,6,2037,1,327,85,10,5,3,1038,139,21075,3657,225796,246871,8/27/2020
8/21/2020,141,30370,6620,436282,466652,8,2457,4,2041,1,328,88,9,4,2,1040,115,21190,3168,228964,250154,8/27/2020
8/22/2020,97,30467,5777,442059,472526,8,2465,12,2053,0,328,84,11,4,0,1040,84,21274,2519,231483,252757,8/27/2020
8/23/2020,60,30527,4280,446339,476866,8,2473,6,2059,0,328,86,11,2,1,1041,49,21323,2462,233945,255268,8/27/2020
8/24/2020,91,30618,5349,451688,482306,5,2478,10,2069,1,329,80,11,4,1,1042,73,21396,2930,236875,258271,8/27/2020
8/25/2020,108,30726,4567,456255,486981,7,2485,4,2073,1,330,82,10,3,1,1043,85,21481,2223,239098,260579,8/27/2020
8/26/2020,146,30872,8448,464703,495575,,,,,,,,,,1,1044,108,21589,2726,241824,263413,8/27/2020
2/27/2020,0,0,0,0,0,1,1,0,0,0,0,1,0,0,0,0,0,0,0,0,0,8/28/2020
2/28/2020,0,0,0,0,0,0,1,0,0,0,0,1,1,0,0,0,0,0,0,0,0,8/28/2020
2/29/2020,0,0,0,0,0,0,1,0,0,0,0,1,1,0,0,0,0,0,0,0,0,8/28/2020
3/1/2020,2,2,2,2,4,0,1,0,0,0,0,1,1,1,0,0,2,2,2,2,4,8/28/2020
3/2/2020,0,2,1,3,5,1,2,0,0,0,0,2,2,2,0,0,0,2,1,3,5,8/28/2020
3/3/2020,0,2,2,5,7,0,2,0,0,0,0,2,2,2,0,0,0,2,2,5,7,8/28/2020
3/4/2020,0,2,12,17,19,1,3,0,0,0,0,3,2,2,0,0,0,2,10,15,17,8/28/2020
3/5/2020,0,2,4,21,23,0,3,0,0,0,0,3,2,2,0,0,1,3,4,19,22,8/28/2020
3/6/2020,1,3,12,33,36,0,3,0,0,0,0,3,2,2,0,0,0,3,11,30,33,8/28/2020
3/7/2020,0,3,19,52,55,0,3,0,0,0,0,3,2,1,0,0,0,3,19,49,52,8/28/2020
3/8/2020,0,3,18,70,73,0,3,0,0,0,0,3,2,1,0,0,0,3,18,67,70,8/28/2020
3/9/2020,1,4,15,85,89,0,3,0,0,0,0,3,2,1,0,0,1,4,15,82,86,8/28/2020
3/10/2020,2,6,25,110,116,0,3,0,0,0,0,3,2,1,0,0,1,5,23,105,110,8/28/2020
3/11/2020,0,6,34,144,150,1,4,0,0,0,0,4,1,1,0,0,0,5,34,139,144,8/28/2020
3/12/2020,9,15,41,185,200,1,5,0,0,0,0,5,1,1,0,0,8,13,38,177,190,8/28/2020
3/13/2020,6,21,50,235,256,4,9,1,1,0,0,8,1,1,0,0,6,19,48,225,244,8/28/2020
3/14/2020,0,21,90,325,346,0,9,0,1,0,0,8,1,1,0,0,0,19,86,311,330,8/28/2020
3/15/2020,1,22,54,379,401,1,10,0,1,0,0,9,2,1,0,0,1,20,54,365,385,8/28/2020
3/16/2020,2,24,95,474,498,2,12,0,1,0,0,11,2,0,0,0,2,22,92,457,479,8/28/2020
3/17/2020,16,40,162,636,676,6,18,0,1,0,0,17,2,0,0,0,11,33,152,609,642,8/28/2020
3/18/2020,12,52,116,752,804,3,21,0,1,0,0,20,2,0,0,0,11,44,111,720,764,8/28/2020
3/19/2020,17,69,262,1014,1083,2,23,1,2,0,0,21,3,0,1,1,17,61,251,971,1032,8/28/2020
3/20/2020,14,83,197,1211,1294,5,28,0,2,0,0,26,4,0,0,1,13,74,192,1163,1237,8/28/2020
3/21/2020,21,104,126,1337,1441,3,31,2,4,0,0,27,5,0,0,1,14,88,123,1286,1374,8/28/2020
3/22/2020,30,134,282,1619,1753,2,33,0,4,0,0,29,5,0,0,1,25,113,262,1548,1661,8/28/2020
3/23/2020,14,148,169,1788,1936,15,48,1,5,0,0,43,9,3,0,1,16,129,165,1713,1842,8/28/2020
3/24/2020,20,168,242,2030,2198,7,55,0,5,0,0,50,10,4,0,1,19,148,238,1951,2099,8/28/2020
3/25/2020,26,194,183,2213,2407,5,60,1,6,0,0,54,11,3,0,1,28,176,172,2123,2299,8/28/2020
3/26/2020,35,229,181,2394,2623,10,70,5,11,0,0,59,14,5,0,1,41,217,176,2299,2516,8/28/2020
3/27/2020,27,256,215,2609,2865,9,79,1,12,1,1,66,17,6,2,3,31,248,202,2501,2749,8/28/2020
3/28/2020,59,315,260,2869,3184,13,92,3,15,2,3,74,15,6,1,4,63,311,241,2742,3053,8/28/2020
3/29/2020,106,421,356,3225,3646,8,100,4,19,1,4,77,18,8,2,6,105,416,314,3056,3472,8/28/2020
3/30/2020,62,483,222,3447,3930,20,120,5,24,0,4,92,20,11,3,9,78,494,187,3243,3737,8/28/2020
3/31/2020,71,554,369,3816,4370,11,131,7,31,1,5,95,22,13,2,11,73,567,298,3541,4108,8/28/2020
4/1/2020,99,653,699,4515,5168,18,149,7,38,0,5,106,30,15,1,12,100,667,644,4185,4852,8/28/2020
4/2/2020,52,705,477,4992,5697,22,171,6,44,2,7,120,36,21,4,16,62,729,436,4621,5350,8/28/2020
4/3/2020,108,813,775,5767,6580,23,194,7,51,0,7,136,43,25,3,19,100,829,716,5337,6166,8/28/2020
4/4/2020,143,956,660,6427,7383,22,216,4,55,5,12,149,41,30,9,28,138,967,620,5957,6924,8/28/2020
4/5/2020,187,1143,1156,7583,8726,20,236,9,64,1,13,159,44,36,2,30,182,1149,1070,7027,8176,8/28/2020
4/6/2020,218,1361,1707,9290,10651,26,262,7,71,0,13,178,48,40,7,37,206,1355,1565,8592,9947,8/28/2020
4/7/2020,285,1646,1631,10921,12567,19,281,3,74,2,15,192,50,42,5,42,260,1615,1486,10078,11693,8/28/2020
4/8/2020,290,1936,1723,12644,14580,19,300,7,81,6,21,198,50,38,10,52,272,1887,1567,11645,13532,8/28/2020
4/9/2020,284,2220,1521,14165,16385,32,332,9,90,4,25,217,53,40,7,59,278,2165,1360,13005,15170,8/28/2020
4/10/2020,420,2640,2577,16742,19382,29,361,16,106,5,30,225,59,41,11,70,403,2568,2376,15381,17949,8/28/2020
4/11/2020,299,2939,1911,18653,21592,29,390,11,117,2,32,241,61,48,12,82,281,2849,1721,17102,19951,8/28/2020
4/12/2020,315,3254,1674,20327,23581,35,425,13,130,5,37,258,59,49,9,91,289,3138,1440,18542,21680,8/28/2020
4/13/2020,162,3416,938,21265,24681,35,460,13,143,3,40,277,64,54,9,100,187,3325,842,19384,22709,8/28/2020
4/14/2020,289,3705,1788,23053,26758,27,487,17,160,5,45,282,72,53,8,108,265,3590,1530,20914,24504,8/28/2020
4/15/2020,353,4058,1803,24856,28914,31,518,20,180,3,48,290,72,54,17,125,307,3897,1565,22479,26376,8/28/2020
4/16/2020,449,4507,2500,27356,31863,36,554,25,205,6,54,295,72,53,14,139,391,4288,2086,24565,28853,8/28/2020
4/17/2020,308,4815,1823,29179,33994,32,586,20,225,7,61,300,66,45,21,160,291,4579,1459,26024,30603,8/28/2020
4/18/2020,322,5137,1728,30907,36044,26,612,18,243,4,65,304,63,49,15,175,284,4863,1346,27370,32233,8/28/2020
4/19/2020,382,5519,2059,32966,38485,23,635,26,269,1,66,300,65,55,11,186,338,5201,1747,29117,34318,8/28/2020
4/20/2020,396,5915,1909,34875,40790,46,681,29,298,2,68,315,75,56,10,196,377,5578,1582,30699,36277,8/28/2020
4/21/2020,445,6360,2114,36989,43349,45,726,31,329,5,73,324,72,56,18,214,390,5968,1718,32417,38385,8/28/2020
4/22/2020,420,6780,2398,39387,46167,41,767,32,361,5,78,328,73,58,18,232,382,6350,1919,34336,40686,8/28/2020
4/23/2020,481,7261,2471,41858,49119,31,798,28,389,5,83,326,76,62,15,247,418,6768,1871,36207,42975,8/28/2020
4/24/2020,494,7755,3292,45150,52905,35,833,27,416,4,87,330,85,63,15,262,413,7181,2636,38843,46024,8/28/2020
4/25/2020,394,8149,2210,47360,55509,34,867,17,433,5,92,342,85,62,14,276,304,7485,1778,40621,48106,8/28/2020
4/26/2020,316,8465,2314,49674,58139,33,900,15,448,3,95,357,86,59,14,290,276,7761,1884,42505,50266,8/28/2020
4/27/2020,250,8715,1624,51298,60013,29,929,21,469,4,99,361,86,61,10,300,204,7965,1165,43670,51635,8/28/2020
4/28/2020,411,9126,2268,53566,62692,44,973,24,493,3,102,378,88,59,22,322,325,8290,1770,45440,53730,8/28/2020
4/29/2020,476,9602,3351,56917,66519,36,1009,37,530,11,113,366,78,53,18,340,371,8661,2442,47882,56543,8/28/2020
4/30/2020,432,10034,2772,59689,69723,33,1042,38,568,6,119,355,83,57,24,364,348,9009,1955,49837,58846,8/28/2020
5/1/2020,457,10491,3089,62778,73269,51,1093,39,607,3,122,364,84,58,14,378,317,9326,2221,52058,61384,8/28/2020
5/2/2020,260,10751,1927,64705,75456,36,1129,39,646,5,127,356,91,62,24,402,189,9515,1293,53351,62866,8/28/2020
5/3/2020,284,11035,2168,66873,77908,31,1160,27,673,8,135,352,90,61,21,423,182,9697,1603,54954,64651,8/28/2020
5/4/2020,388,11423,2101,68974,80397,30,1190,31,704,5,140,346,88,57,18,441,293,9990,1573,56527,66517,8/28/2020
5/5/2020,436,11859,2878,71852,83711,29,1219,32,736,6,146,337,82,54,16,457,304,10294,1968,58495,68789,8/28/2020
5/6/2020,490,12349,2836,74688,87037,28,1247,44,780,9,155,312,79,54,21,478,341,10635,1924,60419,71054,8/28/2020
5/7/2020,425,12774,2975,77663,90437,36,1283,42,822,5,160,301,71,52,21,499,269,10904,1981,62400,73304,8/28/2020
5/8/2020,360,13134,2603,80266,93400,30,1313,29,851,5,165,297,71,53,22,521,231,11135,1758,64158,75293,8/28/2020
5/9/2020,470,13604,3356,83622,97226,22,1335,21,872,4,169,294,69,51,15,536,286,11421,2276,66434,77855,8/28/2020
5/10/2020,285,13889,2122,85744,99633,20,1355,23,895,6,175,285,70,49,13,549,187,11608,1525,67959,79567,8/28/2020
5/11/2020,259,14148,1861,87605,101753,31,1386,16,911,6,181,294,71,49,15,564,176,11784,1306,69265,81049,8/28/2020
5/12/2020,387,14535,2622,90227,104762,23,1409,18,929,4,185,295,69,48,22,586,218,12002,1714,70979,82981,8/28/2020
5/13/2020,352,14887,3634,93861,108748,22,1431,25,954,1,186,291,69,49,13,599,196,12198,2018,72997,85195,8/28/2020
5/14/2020,330,15217,3415,97276,112493,19,1450,27,981,3,189,280,64,45,15,614,227,12425,2021,75018,87443,8/28/2020
5/15/2020,382,15599,3470,100746,116345,24,1474,41,1022,5,194,258,62,45,13,627,234,12659,1814,76832,89491,8/28/2020
5/16/2020,453,16052,4168,104914,120966,25,1499,13,1035,5,199,265,61,46,15,642,252,12911,1967,78799,91710,8/28/2020
5/17/2020,240,16292,2775,107689,123981,17,1516,7,1042,5,204,270,59,45,10,652,124,13035,1566,80365,93400,8/28/2020
5/18/2020,251,16543,2007,109696,126239,19,1535,15,1057,5,209,269,57,40,18,670,139,13174,1374,81739,94913,8/28/2020
5/19/2020,416,16959,3178,112874,129833,23,1558,32,1089,5,214,255,56,38,11,681,212,13386,1934,83673,97059,8/28/2020
5/20/2020,328,17287,2775,115649,132936,19,1577,23,1112,7,221,244,52,33,22,703,187,13573,1521,85194,98767,8/28/2020
5/21/2020,374,17661,3764,119413,137074,26,1603,15,1127,3,224,252,53,29,20,723,170,13743,1948,87142,100885,8/28/2020
5/22/2020,353,18014,3172,122585,140599,20,1623,29,1156,5,229,238,52,29,10,733,204,13947,1615,88757,102704,8/28/2020
5/23/2020,253,18267,2748,125333,143600,19,1642,11,1167,3,232,243,52,32,13,746,109,14056,1281,90038,104094,8/28/2020
5/24/2020,165,18432,1372,126705,145137,12,1654,14,1181,2,234,239,53,36,8,754,84,14140,773,90811,104951,8/28/2020
5/25/2020,147,18579,1389,128094,146673,13,1667,14,1195,0,234,238,53,34,10,764,71,14211,765,91576,105787,8/28/2020
5/26/2020,285,18864,2624,130718,149582,24,1691,22,1217,5,239,235,48,33,15,779,156,14367,1783,93359,107726,8/28/2020
5/27/2020,276,19140,2125,132843,151983,20,1711,18,1235,3,242,234,50,33,10,789,133,14500,1136,94495,108995,8/28/2020
5/28/2020,349,19489,3372,136215,155704,17,1728,29,1264,4,246,218,47,32,8,797,133,14633,1124,95619,110252,8/28/2020
5/29/2020,417,19906,3973,140188,160094,19,1747,27,1291,6,252,204,43,31,12,809,179,14812,1576,97195,112007,8/28/2020
5/30/2020,228,20134,3972,144160,164294,15,1762,19,1310,4,256,196,40,29,12,821,109,14921,1823,99018,113939,8/28/2020
5/31/2020,159,20293,1759,145919,166212,11,1773,10,1320,0,256,197,43,26,3,824,78,14999,858,99876,114875,8/28/2020
6/1/2020,215,20508,2823,148742,169250,8,1781,14,1334,1,257,190,44,29,5,829,99,15098,1387,101263,116361,8/28/2020
6/2/2020,273,20781,3076,151818,172599,8,1789,9,1343,3,260,186,37,25,10,839,107,15205,1455,102718,117923,8/28/2020
6/3/2020,260,21041,3514,155332,176373,13,1802,18,1361,6,266,175,34,25,11,850,105,15310,1668,104386,119696,8/28/2020
6/4/2020,281,21322,4536,159868,181190,7,1809,25,1386,3,269,154,31,24,11,861,112,15422,2045,106431,121853,8/28/2020
6/5/2020,216,21538,3586,163454,184992,15,1824,13,1399,6,275,150,27,21,10,871,106,15528,1579,108010,123538,8/28/2020
6/6/2020,203,21741,2630,166084,187825,10,1834,7,1406,2,277,151,29,19,6,877,67,15595,1138,109148,124743,8/28/2020
6/7/2020,83,21824,1629,167713,189537,11,1845,7,1413,1,278,154,25,17,4,881,50,15645,783,109931,125576,8/28/2020
6/8/2020,120,21944,1852,169565,191509,15,1860,12,1425,2,280,155,27,18,4,885,44,15689,965,110896,126585,8/28/2020
6/9/2020,223,22167,2683,172248,194415,10,1870,18,1443,0,280,147,28,21,1,886,67,15756,1262,112158,127914,8/28/2020
6/10/2020,210,22377,2997,175245,197622,13,1883,12,1455,2,282,146,24,17,3,889,105,15861,1467,113625,129486,8/28/2020
6/11/2020,195,22572,3517,178762,201334,7,1890,15,1470,1,283,137,25,16,6,895,88,15949,1539,115164,131113,8/28/2020
6/12/2020,209,22781,4614,183376,206157,9,1899,15,1485,1,284,130,24,16,2,897,81,16030,2189,117353,133383,8/28/2020
6/13/2020,114,22895,3044,186420,209315,6,1905,4,1489,0,284,132,20,15,3,900,50,16080,1378,118731,134811,8/28/2020
6/14/2020,81,22976,2050,188470,211446,6,1911,8,1497,1,285,129,20,14,3,903,32,16112,969,119700,135812,8/28/2020
6/15/2020,189,23165,3117,191587,214752,14,1925,14,1511,0,285,129,20,16,4,907,78,16190,1794,121494,137684,8/28/2020
6/16/2020,111,23276,3024,194611,217887,10,1935,9,1520,1,286,129,22,16,8,915,52,16242,1579,123073,139315,8/28/2020
6/17/2020,128,23404,2842,197453,220857,15,1950,20,1540,4,290,120,18,14,6,921,53,16295,1324,124397,140692,8/28/2020
6/18/2020,149,23553,3053,200506,224059,9,1959,13,1553,1,291,115,19,16,7,928,70,16365,1337,125734,142099,8/28/2020
6/19/2020,141,23694,3773,204279,227973,12,1971,11,1564,1,292,115,20,17,3,931,59,16424,1375,127109,143533,8/28/2020
6/20/2020,84,23778,1896,206175,229953,9,1980,12,1576,0,292,112,20,18,4,935,36,16460,816,127925,144385,8/28/2020
6/21/2020,37,23815,1069,207244,231059,8,1988,5,1581,0,292,115,20,18,2,937,28,16488,692,128617,145105,8/28/2020
6/22/2020,138,23953,3736,210980,234933,12,2000,16,1597,0,292,111,19,18,1,938,69,16557,1711,130328,146885,8/28/2020
6/23/2020,163,24116,3854,214834,238950,3,2003,13,1610,3,295,98,18,18,6,944,83,16640,1788,132116,148756,8/28/2020
6/24/2020,120,24236,3518,218352,242588,9,2012,10,1620,1,296,96,18,18,5,949,47,16687,1690,133806,150493,8/28/2020
6/25/2020,103,24339,2898,221250,245589,6,2018,14,1634,1,297,87,17,17,1,950,54,16741,1517,135323,152064,8/28/2020
6/26/2020,94,24433,2460,223710,248143,2,2020,10,1644,0,297,79,18,18,1,951,64,16805,1301,136624,153429,8/28/2020
6/27/2020,84,24517,3227,226937,251454,5,2025,3,1647,1,298,80,17,17,5,956,37,16842,1222,137846,154688,8/28/2020
6/28/2020,40,24557,1471,228408,252965,4,2029,4,1651,4,302,76,15,14,6,962,19,16861,597,138443,155304,8/28/2020
6/29/2020,85,24642,3689,232097,256739,4,2033,5,1656,0,302,75,14,14,1,963,40,16901,1346,139789,156690,8/28/2020
6/30/2020,59,24701,1961,234058,258759,1,2034,5,1661,1,303,70,12,11,3,966,33,16934,994,140783,157717,8/28/2020
7/1/2020,145,24846,4111,238169,263015,7,2041,9,1670,0,303,68,11,11,1,967,81,17015,1941,142724,159739,8/28/2020
7/2/2020,102,24948,2796,240965,265913,5,2046,5,1675,1,304,67,10,10,1,968,57,17072,1085,143809,160881,8/28/2020
7/3/2020,50,24998,2030,242995,267993,9,2055,6,1681,0,304,70,9,9,3,971,26,17098,773,144582,161680,8/28/2020
7/4/2020,58,25056,2334,245329,270385,2,2057,4,1685,1,305,67,10,9,2,973,34,17132,997,145579,162711,8/28/2020
7/5/2020,51,25107,2939,248268,273375,1,2058,2,1687,1,306,65,8,8,2,975,26,17158,1448,147027,164185,8/28/2020
7/6/2020,102,25209,2820,251088,276297,6,2064,6,1693,0,306,65,9,9,4,979,58,17216,1556,148583,165799,8/28/2020
7/7/2020,82,25291,3458,254546,279837,5,2069,7,1700,0,306,63,8,8,2,981,48,17264,1525,150108,167372,8/28/2020
7/8/2020,105,25396,3398,257944,283340,4,2073,2,1702,0,306,65,9,8,0,981,66,17330,1415,151523,168853,8/28/2020
7/9/2020,94,25490,3672,261616,287106,9,2082,3,1705,0,306,71,9,8,0,981,49,17379,1594,153117,170496,8/28/2020
7/10/2020,131,25621,4405,266021,291642,6,2088,3,1708,2,308,72,7,7,3,984,80,17459,2083,155200,172659,8/28/2020
7/11/2020,63,25684,2904,268925,294609,6,2094,3,1711,1,309,74,6,6,3,987,34,17493,1290,156490,173983,8/28/2020
7/12/2020,45,25729,1785,270710,296439,1,2095,3,1714,1,310,71,6,5,3,990,34,17527,898,157388,174915,8/28/2020
7/13/2020,83,25812,3165,273875,299687,8,2103,10,1724,0,310,69,6,5,1,991,57,17584,1479,158867,176451,8/28/2020
7/14/2020,74,25886,3280,277155,303041,7,2110,4,1728,0,310,72,5,5,1,992,49,17633,1362,160229,177862,8/28/2020
7/15/2020,121,26007,4131,281286,307293,5,2115,7,1735,0,310,70,5,4,0,992,94,17727,1725,161954,179681,8/28/2020
7/16/2020,102,26109,3710,284996,311105,6,2121,9,1744,0,310,67,6,5,1,993,78,17805,1597,163551,181356,8/28/2020
7/17/2020,153,26262,4141,289137,315399,14,2135,3,1747,1,311,77,5,5,1,994,78,17883,1798,165349,183232,8/28/2020
7/18/2020,80,26342,3176,292313,318655,5,2140,9,1756,1,312,72,5,4,4,998,66,17949,1334,166683,184632,8/28/2020
7/19/2020,83,26425,2605,294918,321343,6,2146,3,1759,0,312,75,6,4,2,1000,59,18008,1066,167749,185757,8/28/2020
7/20/2020,71,26496,2657,297575,324071,9,2155,7,1766,0,312,77,7,5,2,1002,69,18077,1461,169210,187287,8/28/2020
7/21/2020,127,26623,4233,301808,328431,9,2164,10,1776,0,312,76,9,6,1,1003,110,18187,1868,171078,189265,8/28/2020
7/22/2020,122,26745,3797,305605,332350,11,2175,11,1787,1,313,75,7,6,1,1004,86,18273,1576,172654,190927,8/28/2020
7/23/2020,120,26865,4099,309704,336569,8,2183,5,1792,0,313,78,8,7,0,1004,104,18377,1766,174420,192797,8/28/2020
7/24/2020,168,27033,5698,315402,342435,13,2196,13,1805,0,313,78,9,7,0,1004,126,18503,2149,176569,195072,8/28/2020
7/25/2020,128,27161,4283,319685,346846,7,2203,7,1812,0,313,78,10,8,1,1005,104,18607,2004,178573,197180,8/28/2020
7/26/2020,56,27217,2985,322670,349887,8,2211,9,1821,0,313,77,11,7,1,1006,52,18659,1301,179874,198533,8/28/2020
7/27/2020,181,27398,3912,326582,353980,12,2223,7,1828,0,313,82,13,8,1,1007,138,18797,2127,182001,200798,8/28/2020
7/28/2020,104,27502,3854,330436,357938,5,2228,5,1833,0,313,82,14,7,1,1008,89,18886,1642,183643,202529,8/28/2020
7/29/2020,170,27672,4879,335315,362987,10,2238,12,1845,0,313,80,15,7,0,1008,148,19034,2122,185765,204799,8/28/2020
7/30/2020,98,27770,4017,339332,367102,6,2244,2,1847,1,314,83,15,6,0,1008,78,19112,1394,187159,206271,8/28/2020
7/31/2020,123,27893,5254,344586,372479,8,2252,9,1856,0,314,82,15,7,0,1008,89,19201,1699,188858,208059,8/28/2020
8/1/2020,101,27994,4090,348676,376670,7,2259,2,1858,0,314,87,14,7,1,1009,82,19283,1403,190261,209544,8/28/2020
8/2/2020,80,28074,2776,351452,379526,12,2271,12,1870,2,316,85,14,8,2,1011,63,19346,1257,191518,210864,8/28/2020
8/3/2020,176,28250,4921,356373,384623,13,2284,12,1882,0,316,86,16,7,1,1012,149,19495,1957,193475,212970,8/28/2020
8/4/2020,125,28375,3510,359883,388258,8,2292,6,1888,1,317,87,12,5,2,1014,103,19598,1629,195104,214702,8/28/2020
8/5/2020,139,28514,5449,365332,393846,12,2304,10,1898,1,318,88,10,5,2,1016,112,19710,2096,197200,216910,8/28/2020
8/6/2020,164,28678,4862,370194,398872,6,2310,9,1907,0,318,85,9,4,0,1016,114,19824,1882,199082,218906,8/28/2020
8/7/2020,112,28790,4314,374508,403298,13,2323,10,1917,1,319,87,9,3,1,1017,85,19909,1745,200827,220736,8/28/2020
8/8/2020,108,28898,3832,378340,407238,19,2342,6,1923,1,320,99,8,3,1,1018,93,20002,1585,202412,222414,8/28/2020
8/9/2020,38,28936,1620,379960,408896,8,2350,11,1934,0,320,96,9,4,0,1018,33,20035,996,203408,223443,8/28/2020
8/10/2020,137,29073,4164,384124,413197,11,2361,11,1945,0,320,96,9,4,1,1019,108,20143,1710,205118,225261,8/28/2020
8/11/2020,105,29178,4071,388195,417373,6,2367,14,1959,0,320,88,10,4,2,1021,95,20238,2066,207184,227422,8/28/2020
8/12/2020,117,29295,4746,392941,422236,8,2375,11,1970,0,320,85,9,3,1,1022,104,20342,2288,209472,229814,8/28/2020
8/13/2020,114,29409,3865,396806,426215,11,2386,11,1981,0,320,85,11,3,0,1022,90,20432,1668,211140,231572,8/28/2020
8/14/2020,137,29546,5358,402164,431710,13,2399,11,1992,0,320,87,11,4,2,1024,97,20529,1863,213003,233532,8/28/2020
8/15/2020,101,29647,4270,406434,436081,8,2407,10,2002,1,321,84,11,5,0,1024,90,20619,1507,214510,235129,8/28/2020
8/16/2020,77,29724,2798,409232,438956,7,2414,6,2008,4,325,81,8,4,5,1029,69,20688,1007,215517,236205,8/28/2020
8/17/2020,104,29828,3914,413146,442974,10,2424,7,2015,0,325,84,8,5,2,1031,86,20774,1869,217386,238160,8/28/2020
8/18/2020,125,29953,4911,418057,448010,11,2435,9,2024,1,326,85,8,4,5,1036,93,20867,2809,220195,241062,8/28/2020
8/19/2020,100,30053,5231,423288,453341,7,2442,9,2033,1,327,82,9,5,0,1036,80,20947,2683,222878,243825,8/28/2020
8/20/2020,173,30226,8066,431354,461580,11,2453,6,2039,1,328,86,10,5,3,1039,140,21087,3649,226527,247614,8/28/2020
8/21/2020,141,30367,6614,437968,468335,8,2461,5,2044,1,329,88,9,4,2,1041,116,21203,3154,229681,250884,8/28/2020
8/22/2020,96,30463,5776,443744,474207,9,2470,12,2056,0,329,85,11,4,0,1041,84,21287,2516,232197,253484,8/28/2020
8/23/2020,64,30527,4372,448116,478643,8,2478,6,2062,0,329,87,11,2,1,1042,52,21339,2499,234696,256035,8/28/2020
8/24/2020,90,30617,5341,453457,484074,5,2483,10,2072,1,330,81,11,4,1,1043,75,21414,2926,237622,259036,8/28/2020
8/25/2020,106,30723,4753,458210,488933,10,2493,4,2076,1,331,86,10,3,1,1044,98,21512,2313,239935,261447,8/28/2020
8/26/2020,152,30875,8597,466807,497682,3,2496,8,2084,0,331,81,8,4,1,1045,113,21625,2754,242689,264314,8/28/2020
8/27/2020,78,30953,7144,473951,504904,,,,,,,,,,1,1046,58,21683,2419,245108,266791,8/28/2020
2/27/2020,0,0,0,0,0,1,1,0,0,0,0,1,0,0,0,0,0,0,0,0,0,8/31/2020
2/28/2020,0,0,0,0,0,0,1,0,0,0,0,1,1,0,0,0,0,0,0,0,0,8/31/2020
2/29/2020,0,0,0,0,0,0,1,0,0,0,0,1,1,0,0,0,0,0,0,0,0,8/31/2020
3/1/2020,2,2,2,2,4,0,1,0,0,0,0,1,1,1,0,0,2,2,2,2,4,8/31/2020
3/2/2020,0,2,1,3,5,1,2,0,0,0,0,2,2,2,0,0,0,2,1,3,5,8/31/2020
3/3/2020,0,2,2,5,7,0,2,0,0,0,0,2,2,2,0,0,0,2,2,5,7,8/31/2020
3/4/2020,0,2,12,17,19,1,3,0,0,0,0,3,2,2,0,0,0,2,10,15,17,8/31/2020
3/5/2020,0,2,4,21,23,0,3,0,0,0,0,3,2,2,0,0,1,3,4,19,22,8/31/2020
3/6/2020,1,3,12,33,36,0,3,0,0,0,0,3,2,2,0,0,0,3,11,30,33,8/31/2020
3/7/2020,0,3,19,52,55,0,3,0,0,0,0,3,2,1,0,0,0,3,19,49,52,8/31/2020
3/8/2020,0,3,18,70,73,0,3,0,0,0,0,3,2,1,0,0,0,3,18,67,70,8/31/2020
3/9/2020,1,4,15,85,89,0,3,0,0,0,0,3,2,1,0,0,1,4,15,82,86,8/31/2020
3/10/2020,2,6,25,110,116,0,3,0,0,0,0,3,2,1,0,0,1,5,23,105,110,8/31/2020
3/11/2020,0,6,34,144,150,1,4,0,0,0,0,4,1,1,0,0,0,5,34,139,144,8/31/2020
3/12/2020,9,15,41,185,200,1,5,0,0,0,0,5,1,1,0,0,8,13,38,177,190,8/31/2020
3/13/2020,6,21,50,235,256,4,9,1,1,0,0,8,1,1,0,0,6,19,48,225,244,8/31/2020
3/14/2020,0,21,90,325,346,0,9,0,1,0,0,8,1,1,0,0,0,19,86,311,330,8/31/2020
3/15/2020,1,22,54,379,401,1,10,0,1,0,0,9,2,1,0,0,1,20,54,365,385,8/31/2020
3/16/2020,2,24,95,474,498,2,12,0,1,0,0,11,2,0,0,0,2,22,92,457,479,8/31/2020
3/17/2020,16,40,162,636,676,6,18,0,1,0,0,17,2,0,0,0,11,33,152,609,642,8/31/2020
3/18/2020,12,52,116,752,804,3,21,0,1,0,0,20,2,0,0,0,11,44,111,720,764,8/31/2020
3/19/2020,17,69,262,1014,1083,2,23,1,2,0,0,21,3,0,1,1,17,61,251,971,1032,8/31/2020
3/20/2020,14,83,197,1211,1294,5,28,0,2,0,0,26,4,0,0,1,13,74,192,1163,1237,8/31/2020
3/21/2020,21,104,126,1337,1441,3,31,2,4,0,0,27,5,0,0,1,14,88,123,1286,1374,8/31/2020
3/22/2020,30,134,282,1619,1753,2,33,0,4,0,0,29,5,0,0,1,25,113,262,1548,1661,8/31/2020
3/23/2020,14,148,169,1788,1936,15,48,1,5,0,0,43,9,3,0,1,16,129,165,1713,1842,8/31/2020
3/24/2020,20,168,242,2030,2198,7,55,0,5,0,0,50,10,4,0,1,19,148,238,1951,2099,8/31/2020
3/25/2020,26,194,183,2213,2407,5,60,1,6,0,0,54,11,3,0,1,28,176,172,2123,2299,8/31/2020
3/26/2020,35,229,181,2394,2623,10,70,5,11,0,0,59,14,5,0,1,41,217,176,2299,2516,8/31/2020
3/27/2020,27,256,215,2609,2865,9,79,1,12,1,1,66,17,6,2,3,31,248,202,2501,2749,8/31/2020
3/28/2020,59,315,260,2869,3184,13,92,3,15,2,3,74,15,6,1,4,63,311,241,2742,3053,8/31/2020
3/29/2020,106,421,356,3225,3646,8,100,4,19,1,4,77,18,8,2,6,105,416,314,3056,3472,8/31/2020
3/30/2020,62,483,222,3447,3930,20,120,5,24,0,4,92,20,11,3,9,78,494,186,3242,3736,8/31/2020
3/31/2020,71,554,369,3816,4370,11,131,7,31,1,5,95,22,13,2,11,73,567,298,3540,4107,8/31/2020
4/1/2020,99,653,699,4515,5168,18,149,7,38,0,5,106,30,15,1,12,100,667,643,4183,4850,8/31/2020
4/2/2020,52,705,477,4992,5697,22,171,6,44,2,7,120,36,21,4,16,62,729,436,4619,5348,8/31/2020
4/3/2020,108,813,775,5767,6580,23,194,7,51,0,7,136,43,25,3,19,100,829,715,5334,6163,8/31/2020
4/4/2020,143,956,660,6427,7383,22,216,4,55,5,12,149,41,30,9,28,138,967,620,5954,6921,8/31/2020
4/5/2020,187,1143,1156,7583,8726,20,236,9,64,1,13,159,44,36,2,30,182,1149,1070,7024,8173,8/31/2020
4/6/2020,218,1361,1707,9290,10651,26,262,7,71,0,13,178,48,40,7,37,206,1355,1563,8587,9942,8/31/2020
4/7/2020,285,1646,1631,10921,12567,19,281,4,75,2,15,191,50,42,5,42,261,1616,1486,10073,11689,8/31/2020
4/8/2020,290,1936,1723,12644,14580,19,300,7,82,6,21,197,50,38,10,52,272,1888,1567,11640,13528,8/31/2020
4/9/2020,284,2220,1521,14165,16385,32,332,9,91,4,25,216,53,40,7,59,280,2168,1360,13000,15168,8/31/2020
4/10/2020,420,2640,2577,16742,19382,29,361,15,106,5,30,225,59,41,11,70,403,2571,2375,15375,17946,8/31/2020
4/11/2020,299,2939,1911,18653,21592,29,390,11,117,2,32,241,61,48,12,82,281,2852,1720,17095,19947,8/31/2020
4/12/2020,315,3254,1674,20327,23581,35,425,13,130,5,37,258,59,49,9,91,289,3141,1440,18535,21676,8/31/2020
4/13/2020,162,3416,938,21265,24681,35,460,13,143,3,40,277,64,54,9,100,187,3328,841,19376,22704,8/31/2020
4/14/2020,289,3705,1788,23053,26758,27,487,17,160,5,45,282,72,53,8,108,265,3593,1529,20905,24498,8/31/2020
4/15/2020,353,4058,1803,24856,28914,31,518,20,180,3,48,290,72,54,17,125,307,3900,1565,22470,26370,8/31/2020
4/16/2020,449,4507,2500,27356,31863,36,554,25,205,6,54,295,72,53,14,139,391,4291,2086,24556,28847,8/31/2020
4/17/2020,308,4815,1823,29179,33994,32,586,20,225,7,61,300,66,45,21,160,292,4583,1459,26015,30598,8/31/2020
4/18/2020,322,5137,1728,30907,36044,25,611,18,243,4,65,303,63,49,15,175,285,4868,1346,27361,32229,8/31/2020
4/19/2020,382,5519,2059,32966,38485,23,634,26,269,1,66,299,65,55,11,186,338,5206,1747,29108,34314,8/31/2020
4/20/2020,396,5915,1909,34875,40790,46,680,29,298,2,68,314,75,56,10,196,377,5583,1580,30688,36271,8/31/2020
4/21/2020,445,6360,2114,36989,43349,45,725,31,329,5,73,323,72,56,18,214,390,5973,1718,32406,38379,8/31/2020
4/22/2020,420,6780,2398,39387,46167,41,766,32,361,5,78,327,73,58,18,232,385,6358,1918,34324,40682,8/31/2020
4/23/2020,481,7261,2471,41858,49119,32,798,28,389,5,83,326,76,62,15,247,419,6777,1870,36194,42971,8/31/2020
4/24/2020,494,7755,3292,45150,52905,35,833,27,416,4,87,330,85,63,15,262,415,7192,2635,38829,46021,8/31/2020
4/25/2020,394,8149,2210,47360,55509,34,867,17,433,5,92,342,85,62,14,276,305,7497,1777,40606,48103,8/31/2020
4/26/2020,316,8465,2314,49674,58139,33,900,15,448,3,95,357,86,59,14,290,276,7773,1884,42490,50263,8/31/2020
4/27/2020,250,8715,1624,51298,60013,29,929,21,469,4,99,361,86,61,10,300,205,7978,1165,43655,51633,8/31/2020
4/28/2020,411,9126,2268,53566,62692,44,973,24,493,3,102,378,88,59,22,322,329,8307,1769,45424,53731,8/31/2020
4/29/2020,476,9602,3351,56917,66519,36,1009,38,531,11,113,365,78,53,18,340,373,8680,2440,47864,56544,8/31/2020
4/30/2020,432,10034,2772,59689,69723,33,1042,37,568,6,119,355,83,57,24,364,351,9031,1955,49819,58850,8/31/2020
5/1/2020,457,10491,3089,62778,73269,51,1093,39,607,3,122,364,84,58,14,378,321,9352,2220,52039,61391,8/31/2020
5/2/2020,260,10751,1927,64705,75456,36,1129,39,646,5,127,356,91,62,24,402,189,9541,1292,53331,62872,8/31/2020
5/3/2020,284,11035,2168,66873,77908,31,1160,27,673,8,135,352,90,61,21,423,182,9723,1603,54934,64657,8/31/2020
5/4/2020,388,11423,2101,68974,80397,30,1190,31,704,5,140,346,88,57,18,441,294,10017,1572,56506,66523,8/31/2020
5/5/2020,436,11859,2878,71852,83711,29,1219,32,736,6,146,337,82,54,16,457,309,10326,1968,58474,68800,8/31/2020
5/6/2020,490,12349,2836,74688,87037,28,1247,44,780,9,155,312,79,54,21,478,342,10668,1924,60398,71066,8/31/2020
5/7/2020,425,12774,2975,77663,90437,36,1283,42,822,5,160,301,71,52,21,499,274,10942,1979,62377,73319,8/31/2020
5/8/2020,360,13134,2603,80266,93400,30,1313,29,851,5,165,297,71,53,22,521,233,11175,1752,64129,75304,8/31/2020
5/9/2020,470,13604,3356,83622,97226,22,1335,21,872,4,169,294,69,51,15,536,291,11466,2274,66403,77869,8/31/2020
5/10/2020,285,13889,2122,85744,99633,20,1355,23,895,6,175,285,70,49,13,549,188,11654,1525,67928,79582,8/31/2020
5/11/2020,259,14148,1861,87605,101753,31,1386,16,911,6,181,294,71,49,15,564,179,11833,1305,69233,81066,8/31/2020
5/12/2020,387,14535,2622,90227,104762,23,1409,18,929,4,185,295,69,48,22,586,219,12052,1713,70946,82998,8/31/2020
5/13/2020,352,14887,3634,93861,108748,22,1431,25,954,1,186,291,69,49,13,599,197,12249,2016,72962,85211,8/31/2020
5/14/2020,330,15217,3415,97276,112493,19,1450,27,981,3,189,280,64,45,15,614,231,12480,2021,74983,87463,8/31/2020
5/15/2020,382,15599,3470,100746,116345,24,1474,41,1022,5,194,258,62,45,13,627,237,12717,1814,76797,89514,8/31/2020
5/16/2020,453,16052,4168,104914,120966,25,1499,13,1035,5,199,265,61,46,15,642,253,12970,1967,78764,91734,8/31/2020
5/17/2020,240,16292,2775,107689,123981,17,1516,7,1042,5,204,270,59,45,10,652,129,13099,1565,80329,93428,8/31/2020
5/18/2020,251,16543,2007,109696,126239,19,1535,15,1057,5,209,269,57,40,18,670,140,13239,1373,81702,94941,8/31/2020
5/19/2020,416,16959,3178,112874,129833,23,1558,32,1089,5,214,255,56,38,11,681,215,13454,1934,83636,97090,8/31/2020
5/20/2020,328,17287,2775,115649,132936,19,1577,23,1112,7,221,244,52,33,22,703,189,13643,1521,85157,98800,8/31/2020
5/21/2020,374,17661,3764,119413,137074,26,1603,15,1127,3,224,252,53,29,20,723,171,13814,1948,87105,100919,8/31/2020
5/22/2020,353,18014,3172,122585,140599,20,1623,29,1156,5,229,238,52,29,10,733,204,14018,1615,88720,102738,8/31/2020
5/23/2020,253,18267,2748,125333,143600,18,1641,11,1167,3,232,242,52,32,13,746,109,14127,1280,90000,104127,8/31/2020
5/24/2020,165,18432,1372,126705,145137,12,1653,14,1181,2,234,238,53,36,8,754,84,14211,773,90773,104984,8/31/2020
5/25/2020,147,18579,1389,128094,146673,13,1666,14,1195,0,234,237,53,34,10,764,72,14283,762,91535,105818,8/31/2020
5/26/2020,285,18864,2624,130718,149582,24,1690,22,1217,5,239,234,48,33,15,779,165,14448,1783,93318,107766,8/31/2020
5/27/2020,276,19140,2125,132843,151983,20,1710,18,1235,3,242,233,50,33,10,789,133,14581,1136,94454,109035,8/31/2020
5/28/2020,349,19489,3372,136215,155704,17,1727,28,1263,4,246,218,47,32,8,797,134,14715,1124,95578,110293,8/31/2020
5/29/2020,417,19906,3973,140188,160094,19,1746,27,1290,6,252,204,43,31,12,809,179,14894,1576,97154,112048,8/31/2020
5/30/2020,228,20134,3972,144160,164294,15,1761,19,1309,4,256,196,40,29,12,821,110,15004,1822,98976,113980,8/31/2020
5/31/2020,159,20293,1759,145919,166212,11,1772,10,1319,0,256,197,43,26,3,824,78,15082,858,99834,114916,8/31/2020
6/1/2020,215,20508,2823,148742,169250,8,1780,14,1333,1,257,190,44,29,5,829,99,15181,1387,101221,116402,8/31/2020
6/2/2020,273,20781,3076,151818,172599,8,1788,9,1342,3,260,186,37,25,10,839,107,15288,1455,102676,117964,8/31/2020
6/3/2020,260,21041,3514,155332,176373,13,1801,18,1360,6,266,175,34,25,11,850,105,15393,1668,104344,119737,8/31/2020
6/4/2020,281,21322,4536,159868,181190,7,1808,25,1385,3,269,154,31,24,11,861,112,15505,2042,106386,121891,8/31/2020
6/5/2020,216,21538,3586,163454,184992,15,1823,13,1398,6,275,150,27,21,10,871,106,15611,1579,107965,123576,8/31/2020
6/6/2020,203,21741,2630,166084,187825,10,1833,7,1405,2,277,151,29,19,6,877,68,15679,1138,109103,124782,8/31/2020
6/7/2020,83,21824,1629,167713,189537,11,1844,7,1412,1,278,154,25,17,4,881,50,15729,783,109886,125615,8/31/2020
6/8/2020,120,21944,1852,169565,191509,15,1859,12,1424,2,280,155,27,18,4,885,44,15773,965,110851,126624,8/31/2020
6/9/2020,223,22167,2683,172248,194415,10,1869,18,1442,0,280,147,28,21,1,886,67,15840,1262,112113,127953,8/31/2020
6/10/2020,210,22377,2997,175245,197622,13,1882,12,1454,2,282,146,24,17,3,889,105,15945,1467,113580,129525,8/31/2020
6/11/2020,195,22572,3517,178762,201334,7,1889,15,1469,1,283,137,25,16,6,895,88,16033,1539,115119,131152,8/31/2020
6/12/2020,209,22781,4614,183376,206157,9,1898,15,1484,1,284,130,24,16,2,897,82,16115,2188,117307,133422,8/31/2020
6/13/2020,114,22895,3044,186420,209315,6,1904,4,1488,0,284,132,20,15,3,900,50,16165,1378,118685,134850,8/31/2020
6/14/2020,81,22976,2050,188470,211446,6,1910,8,1496,1,285,129,20,14,3,903,32,16197,969,119654,135851,8/31/2020
6/15/2020,189,23165,3117,191587,214752,14,1924,14,1510,0,285,129,20,16,4,907,78,16275,1794,121448,137723,8/31/2020
6/16/2020,111,23276,3024,194611,217887,10,1934,9,1519,1,286,129,22,16,8,915,52,16327,1579,123027,139354,8/31/2020
6/17/2020,128,23404,2842,197453,220857,15,1949,20,1539,4,290,120,18,14,6,921,53,16380,1324,124351,140731,8/31/2020
6/18/2020,149,23553,3053,200506,224059,9,1958,13,1552,1,291,115,19,16,7,928,70,16450,1337,125688,142138,8/31/2020
6/19/2020,141,23694,3773,204279,227973,12,1970,11,1563,1,292,115,20,17,3,931,59,16509,1374,127062,143571,8/31/2020
6/20/2020,84,23778,1896,206175,229953,9,1979,12,1575,0,292,112,20,18,4,935,36,16545,816,127878,144423,8/31/2020
6/21/2020,37,23815,1069,207244,231059,8,1987,5,1580,0,292,115,20,18,2,937,28,16573,692,128570,145143,8/31/2020
6/22/2020,138,23953,3736,210980,234933,12,1999,16,1596,0,292,111,19,18,1,938,69,16642,1711,130281,146923,8/31/2020
6/23/2020,163,24116,3854,214834,238950,3,2002,13,1609,3,295,98,18,18,6,944,83,16725,1788,132069,148794,8/31/2020
6/24/2020,120,24236,3518,218352,242588,9,2011,10,1619,1,296,96,18,18,5,949,47,16772,1690,133759,150531,8/31/2020
6/25/2020,103,24339,2898,221250,245589,6,2017,14,1633,1,297,87,17,17,1,950,54,16826,1517,135276,152102,8/31/2020
6/26/2020,94,24433,2460,223710,248143,2,2019,10,1643,0,297,79,18,18,1,951,64,16890,1298,136574,153464,8/31/2020
6/27/2020,84,24517,3227,226937,251454,5,2024,3,1646,1,298,80,17,17,5,956,37,16927,1221,137795,154722,8/31/2020
6/28/2020,40,24557,1471,228408,252965,4,2028,4,1650,4,302,76,15,14,6,962,19,16946,597,138392,155338,8/31/2020
6/29/2020,85,24642,3689,232097,256739,4,2032,5,1655,0,302,75,14,14,1,963,40,16986,1345,139737,156723,8/31/2020
6/30/2020,59,24701,1961,234058,258759,1,2033,5,1660,1,303,70,12,11,3,966,33,17019,994,140731,157750,8/31/2020
7/1/2020,145,24846,4111,238169,263015,7,2040,9,1669,0,303,68,11,11,1,967,81,17100,1941,142672,159772,8/31/2020
7/2/2020,102,24948,2796,240965,265913,5,2045,5,1674,1,304,67,10,10,1,968,57,17157,1085,143757,160914,8/31/2020
7/3/2020,50,24998,2030,242995,267993,9,2054,6,1680,0,304,70,9,9,3,971,26,17183,773,144530,161713,8/31/2020
7/4/2020,58,25056,2334,245329,270385,2,2056,4,1684,1,305,67,10,9,2,973,34,17217,997,145527,162744,8/31/2020
7/5/2020,51,25107,2939,248268,273375,1,2057,2,1686,1,306,65,8,8,2,975,26,17243,1448,146975,164218,8/31/2020
7/6/2020,102,25209,2820,251088,276297,6,2063,6,1692,0,306,65,9,9,4,979,58,17301,1556,148531,165832,8/31/2020
7/7/2020,82,25291,3458,254546,279837,5,2068,7,1699,0,306,63,8,8,2,981,48,17349,1525,150056,167405,8/31/2020
7/8/2020,105,25396,3398,257944,283340,4,2072,2,1701,0,306,65,9,8,0,981,66,17415,1415,151471,168886,8/31/2020
7/9/2020,94,25490,3672,261616,287106,9,2081,3,1704,0,306,71,9,8,0,981,49,17464,1594,153065,170529,8/31/2020
7/10/2020,131,25621,4405,266021,291642,6,2087,3,1707,2,308,72,7,7,3,984,80,17544,2082,155147,172691,8/31/2020
7/11/2020,63,25684,2904,268925,294609,6,2093,3,1710,1,309,74,6,6,3,987,34,17578,1290,156437,174015,8/31/2020
7/12/2020,45,25729,1785,270710,296439,1,2094,3,1713,1,310,71,6,5,3,990,34,17612,898,157335,174947,8/31/2020
7/13/2020,83,25812,3165,273875,299687,8,2102,10,1723,0,310,69,6,5,1,991,57,17669,1479,158814,176483,8/31/2020
7/14/2020,74,25886,3280,277155,303041,7,2109,4,1727,0,310,72,5,5,1,992,49,17718,1362,160176,177894,8/31/2020
7/15/2020,121,26007,4131,281286,307293,5,2114,7,1734,0,310,70,5,4,0,992,94,17812,1724,161900,179712,8/31/2020
7/16/2020,102,26109,3710,284996,311105,6,2120,9,1743,0,310,67,6,5,1,993,78,17890,1597,163497,181387,8/31/2020
7/17/2020,153,26262,4141,289137,315399,14,2134,3,1746,1,311,77,5,5,1,994,78,17968,1798,165295,183263,8/31/2020
7/18/2020,80,26342,3176,292313,318655,5,2139,9,1755,1,312,72,5,4,4,998,66,18034,1333,166628,184662,8/31/2020
7/19/2020,83,26425,2605,294918,321343,6,2145,3,1758,0,312,75,6,4,2,1000,59,18093,1066,167694,185787,8/31/2020
7/20/2020,71,26496,2657,297575,324071,9,2154,7,1765,0,312,77,7,5,2,1002,69,18162,1461,169155,187317,8/31/2020
7/21/2020,127,26623,4233,301808,328431,9,2163,10,1775,0,312,76,9,6,1,1003,109,18271,1867,171022,189293,8/31/2020
7/22/2020,122,26745,3797,305605,332350,11,2174,11,1786,1,313,75,7,6,1,1004,85,18356,1576,172598,190954,8/31/2020
7/23/2020,120,26865,4099,309704,336569,8,2182,5,1791,0,313,78,8,7,0,1004,104,18460,1765,174363,192823,8/31/2020
7/24/2020,168,27033,5698,315402,342435,13,2195,13,1804,0,313,78,9,7,0,1004,125,18585,2149,176512,195097,8/31/2020
7/25/2020,128,27161,4283,319685,346846,7,2202,7,1811,0,313,78,10,8,1,1005,104,18689,2003,178515,197204,8/31/2020
7/26/2020,56,27217,2985,322670,349887,8,2210,9,1820,0,313,77,11,7,1,1006,52,18741,1301,179816,198557,8/31/2020
7/27/2020,181,27398,3912,326582,353980,12,2222,7,1827,0,313,82,13,8,1,1007,138,18879,2127,181943,200822,8/31/2020
7/28/2020,104,27502,3854,330436,357938,5,2227,5,1832,0,313,82,14,7,1,1008,88,18967,1640,183583,202550,8/31/2020
7/29/2020,170,27672,4879,335315,362987,10,2237,12,1844,0,313,80,15,7,0,1008,150,19117,2122,185705,204822,8/31/2020
7/30/2020,98,27770,4017,339332,367102,6,2243,2,1846,1,314,83,15,6,0,1008,78,19195,1393,187098,206293,8/31/2020
7/31/2020,123,27893,5254,344586,372479,8,2251,9,1855,0,314,82,15,7,0,1008,87,19282,1698,188796,208078,8/31/2020
8/1/2020,101,27994,4090,348676,376670,7,2258,2,1857,0,314,87,14,7,1,1009,84,19366,1403,190199,209565,8/31/2020
8/2/2020,80,28074,2776,351452,379526,12,2270,12,1869,2,316,85,14,8,2,1011,63,19429,1257,191456,210885,8/31/2020
8/3/2020,176,28250,4921,356373,384623,13,2283,12,1881,0,316,86,16,7,1,1012,149,19578,1957,193413,212991,8/31/2020
8/4/2020,125,28375,3510,359883,388258,8,2291,6,1887,1,317,87,12,5,2,1014,105,19683,1629,195042,214725,8/31/2020
8/5/2020,139,28514,5449,365332,393846,12,2303,10,1897,1,318,88,10,5,2,1016,111,19794,2096,197138,216932,8/31/2020
8/6/2020,164,28678,4862,370194,398872,6,2309,9,1906,0,318,85,9,4,0,1016,116,19910,1882,199020,218930,8/31/2020
8/7/2020,112,28790,4314,374508,403298,13,2322,10,1916,1,319,87,9,3,1,1017,85,19995,1745,200765,220760,8/31/2020
8/8/2020,108,28898,3832,378340,407238,19,2341,6,1922,1,320,99,8,3,1,1018,92,20087,1585,202350,222437,8/31/2020
8/9/2020,38,28936,1620,379960,408896,8,2349,11,1933,0,320,96,9,4,0,1018,33,20120,996,203346,223466,8/31/2020
8/10/2020,137,29073,4164,384124,413197,11,2360,11,1944,0,320,96,9,4,1,1019,109,20229,1710,205056,225285,8/31/2020
8/11/2020,105,29178,4071,388195,417373,6,2366,14,1958,0,320,88,10,4,2,1021,95,20324,2066,207122,227446,8/31/2020
8/12/2020,117,29295,4746,392941,422236,8,2374,11,1969,0,320,85,9,3,1,1022,104,20428,2288,209410,229838,8/31/2020
8/13/2020,114,29409,3865,396806,426215,12,2386,11,1980,0,320,86,11,3,0,1022,88,20516,1668,211078,231594,8/31/2020
8/14/2020,137,29546,5358,402164,431710,13,2399,11,1991,0,320,88,11,4,2,1024,97,20613,1863,212941,233554,8/31/2020
8/15/2020,101,29647,4270,406434,436081,8,2407,11,2002,1,321,84,11,5,0,1024,92,20705,1505,214446,235151,8/31/2020
8/16/2020,77,29724,2798,409232,438956,7,2414,6,2008,4,325,81,8,4,5,1029,68,20773,1003,215449,236222,8/31/2020
8/17/2020,104,29828,3914,413146,442974,10,2424,7,2015,0,325,84,8,5,2,1031,85,20858,1869,217318,238176,8/31/2020
8/18/2020,125,29953,4911,418057,448010,11,2435,9,2024,1,326,85,8,4,5,1036,92,20950,2806,220124,241074,8/31/2020
8/19/2020,100,30053,5231,423288,453341,8,2443,9,2033,1,327,83,9,5,0,1036,80,21030,2683,222807,243837,8/31/2020
8/20/2020,173,30226,8068,431356,461582,12,2455,6,2039,2,329,87,10,5,3,1039,140,21170,3641,226448,247618,8/31/2020
8/21/2020,141,30367,6614,437970,468337,8,2463,5,2044,1,330,89,9,4,2,1041,116,21286,3154,229602,250888,8/31/2020
8/22/2020,96,30463,5776,443746,474209,9,2472,12,2056,0,330,86,11,4,0,1041,86,21372,2514,232116,253488,8/31/2020
8/23/2020,64,30527,4374,448120,478647,9,2481,6,2062,0,330,89,11,2,1,1042,54,21426,2499,234615,256041,8/31/2020
8/24/2020,90,30617,5341,453461,484078,5,2486,10,2072,1,331,83,11,4,1,1043,74,21500,2926,237541,259041,8/31/2020
8/25/2020,106,30723,4756,458217,488940,10,2496,4,2076,1,332,88,10,3,1,1044,96,21596,2315,239856,261452,8/31/2020
8/26/2020,162,30885,9423,467640,498525,3,2499,8,2084,0,332,83,8,4,1,1045,118,21714,3050,242906,264620,8/31/2020
8/27/2020,87,30972,8587,476227,507199,4,2503,13,2097,1,333,73,5,4,1,1046,68,21782,3114,246020,267802,8/31/2020
8/28/2020,99,31071,7844,484071,515142,11,2514,4,2101,0,333,80,8,6,1,1047,75,21857,2334,248354,270211,8/31/2020
8/29/2020,64,31135,5272,489343,520478,5,2519,7,2108,1,334,77,9,5,0,1047,46,21903,1759,250113,272016,8/31/2020
8/30/2020,63,31198,3873,493216,524414,,,,,,,,,,1,1048,46,21949,1835,251948,273897,8/31/2020
2/27/2020,0,0,0,0,0,1,1,0,0,0,0,1,0,0,0,0,0,0,0,0,0,9/1/2020
2/28/2020,0,0,0,0,0,0,1,0,0,0,0,1,1,0,0,0,0,0,0,0,0,9/1/2020
2/29/2020,0,0,0,0,0,0,1,0,0,0,0,1,1,0,0,0,0,0,0,0,0,9/1/2020
3/1/2020,2,2,2,2,4,0,1,0,0,0,0,1,1,1,0,0,2,2,2,2,4,9/1/2020
3/2/2020,0,2,1,3,5,1,2,0,0,0,0,2,2,2,0,0,0,2,1,3,5,9/1/2020
3/3/2020,0,2,2,5,7,0,2,0,0,0,0,2,2,2,0,0,0,2,2,5,7,9/1/2020
3/4/2020,0,2,12,17,19,1,3,0,0,0,0,3,2,2,0,0,0,2,10,15,17,9/1/2020
3/5/2020,0,2,4,21,23,0,3,0,0,0,0,3,2,2,0,0,1,3,4,19,22,9/1/2020
3/6/2020,1,3,12,33,36,0,3,0,0,0,0,3,2,2,0,0,0,3,11,30,33,9/1/2020
3/7/2020,0,3,19,52,55,0,3,0,0,0,0,3,2,1,0,0,0,3,19,49,52,9/1/2020
3/8/2020,0,3,18,70,73,0,3,0,0,0,0,3,2,1,0,0,0,3,18,67,70,9/1/2020
3/9/2020,1,4,15,85,89,0,3,0,0,0,0,3,2,1,0,0,1,4,15,82,86,9/1/2020
3/10/2020,2,6,25,110,116,0,3,0,0,0,0,3,2,1,0,0,1,5,23,105,110,9/1/2020
3/11/2020,0,6,34,144,150,1,4,0,0,0,0,4,1,1,0,0,0,5,34,139,144,9/1/2020
3/12/2020,9,15,41,185,200,1,5,0,0,0,0,5,1,1,0,0,8,13,38,177,190,9/1/2020
3/13/2020,6,21,50,235,256,4,9,1,1,0,0,8,1,1,0,0,6,19,48,225,244,9/1/2020
3/14/2020,0,21,90,325,346,0,9,0,1,0,0,8,1,1,0,0,0,19,86,311,330,9/1/2020
3/15/2020,1,22,54,379,401,1,10,0,1,0,0,9,2,1,0,0,1,20,54,365,385,9/1/2020
3/16/2020,2,24,95,474,498,2,12,0,1,0,0,11,2,0,0,0,2,22,92,457,479,9/1/2020
3/17/2020,16,40,162,636,676,6,18,0,1,0,0,17,2,0,0,0,11,33,152,609,642,9/1/2020
3/18/2020,12,52,116,752,804,3,21,0,1,0,0,20,2,0,0,0,11,44,111,720,764,9/1/2020
3/19/2020,17,69,262,1014,1083,2,23,1,2,0,0,21,3,0,1,1,17,61,251,971,1032,9/1/2020
3/20/2020,14,83,197,1211,1294,5,28,0,2,0,0,26,4,0,0,1,13,74,192,1163,1237,9/1/2020
3/21/2020,21,104,126,1337,1441,3,31,2,4,0,0,27,5,0,0,1,14,88,123,1286,1374,9/1/2020
3/22/2020,30,134,282,1619,1753,2,33,0,4,0,0,29,5,0,0,1,25,113,262,1548,1661,9/1/2020
3/23/2020,14,148,169,1788,1936,15,48,1,5,0,0,43,9,3,0,1,16,129,165,1713,1842,9/1/2020
3/24/2020,20,168,242,2030,2198,7,55,0,5,0,0,50,10,4,0,1,19,148,238,1951,2099,9/1/2020
3/25/2020,26,194,183,2213,2407,5,60,1,6,0,0,54,11,3,0,1,28,176,172,2123,2299,9/1/2020
3/26/2020,35,229,181,2394,2623,10,70,5,11,0,0,59,14,5,0,1,41,217,176,2299,2516,9/1/2020
3/27/2020,27,256,215,2609,2865,9,79,1,12,1,1,66,17,6,2,3,31,248,202,2501,2749,9/1/2020
3/28/2020,59,315,260,2869,3184,13,92,3,15,2,3,74,15,6,1,4,63,311,241,2742,3053,9/1/2020
3/29/2020,106,421,356,3225,3646,8,100,4,19,1,4,77,18,8,2,6,105,416,314,3056,3472,9/1/2020
3/30/2020,62,483,222,3447,3930,20,120,5,24,0,4,92,20,11,3,9,78,494,186,3242,3736,9/1/2020
3/31/2020,71,554,369,3816,4370,11,131,7,31,1,5,95,22,13,2,11,73,567,298,3540,4107,9/1/2020
4/1/2020,99,653,699,4515,5168,18,149,7,38,0,5,106,30,15,1,12,100,667,643,4183,4850,9/1/2020
4/2/2020,52,705,477,4992,5697,22,171,6,44,2,7,120,36,21,4,16,62,729,436,4619,5348,9/1/2020
4/3/2020,108,813,775,5767,6580,23,194,7,51,0,7,136,43,25,3,19,100,829,715,5334,6163,9/1/2020
4/4/2020,143,956,660,6427,7383,22,216,4,55,5,12,149,41,30,9,28,138,967,620,5954,6921,9/1/2020
4/5/2020,187,1143,1156,7583,8726,20,236,9,64,1,13,159,44,36,2,30,182,1149,1070,7024,8173,9/1/2020
4/6/2020,218,1361,1707,9290,10651,26,262,7,71,0,13,178,48,40,7,37,206,1355,1563,8587,9942,9/1/2020
4/7/2020,285,1646,1631,10921,12567,19,281,4,75,2,15,191,50,42,5,42,261,1616,1486,10073,11689,9/1/2020
4/8/2020,290,1936,1723,12644,14580,19,300,7,82,6,21,197,50,38,10,52,272,1888,1567,11640,13528,9/1/2020
4/9/2020,284,2220,1521,14165,16385,32,332,9,91,4,25,216,53,40,7,59,280,2168,1360,13000,15168,9/1/2020
4/10/2020,420,2640,2577,16742,19382,29,361,15,106,5,30,225,59,41,11,70,403,2571,2375,15375,17946,9/1/2020
4/11/2020,299,2939,1911,18653,21592,29,390,11,117,2,32,241,61,48,12,82,281,2852,1720,17095,19947,9/1/2020
4/12/2020,315,3254,1674,20327,23581,35,425,13,130,5,37,258,59,49,9,91,289,3141,1440,18535,21676,9/1/2020
4/13/2020,162,3416,938,21265,24681,35,460,13,143,3,40,277,64,54,9,100,187,3328,841,19376,22704,9/1/2020
4/14/2020,289,3705,1788,23053,26758,27,487,17,160,5,45,282,72,53,8,108,265,3593,1529,20905,24498,9/1/2020
4/15/2020,353,4058,1803,24856,28914,31,518,20,180,3,48,290,72,54,17,125,307,3900,1565,22470,26370,9/1/2020
4/16/2020,449,4507,2500,27356,31863,36,554,25,205,6,54,295,72,53,14,139,391,4291,2086,24556,28847,9/1/2020
4/17/2020,308,4815,1823,29179,33994,32,586,20,225,7,61,300,66,45,21,160,292,4583,1459,26015,30598,9/1/2020
4/18/2020,322,5137,1728,30907,36044,26,612,18,243,4,65,304,63,49,15,175,285,4868,1346,27361,32229,9/1/2020
4/19/2020,382,5519,2059,32966,38485,23,635,26,269,1,66,300,65,55,11,186,338,5206,1747,29108,34314,9/1/2020
4/20/2020,396,5915,1909,34875,40790,46,681,29,298,2,68,315,75,56,10,196,377,5583,1579,30687,36270,9/1/2020
4/21/2020,445,6360,2114,36989,43349,45,726,31,329,5,73,324,72,56,18,214,390,5973,1718,32405,38378,9/1/2020
4/22/2020,420,6780,2398,39387,46167,41,767,32,361,5,78,328,73,58,18,232,385,6358,1917,34322,40680,9/1/2020
4/23/2020,481,7261,2471,41858,49119,31,798,28,389,5,83,326,76,62,15,247,419,6777,1870,36192,42969,9/1/2020
4/24/2020,494,7755,3292,45150,52905,35,833,27,416,4,87,330,85,63,15,262,415,7192,2635,38827,46019,9/1/2020
4/25/2020,394,8149,2210,47360,55509,34,867,17,433,5,92,342,85,62,14,276,305,7497,1777,40604,48101,9/1/2020
4/26/2020,316,8465,2314,49674,58139,33,900,15,448,3,95,357,86,59,14,290,276,7773,1884,42488,50261,9/1/2020
4/27/2020,250,8715,1624,51298,60013,29,929,21,469,4,99,361,86,61,10,300,205,7978,1165,43653,51631,9/1/2020
4/28/2020,411,9126,2268,53566,62692,44,973,24,493,3,102,378,88,59,22,322,329,8307,1769,45422,53729,9/1/2020
4/29/2020,476,9602,3351,56917,66519,36,1009,37,530,11,113,366,78,53,18,340,373,8680,2437,47859,56539,9/1/2020
4/30/2020,432,10034,2772,59689,69723,33,1042,38,568,6,119,355,83,57,24,364,351,9031,1955,49814,58845,9/1/2020
5/1/2020,457,10491,3089,62778,73269,51,1093,39,607,3,122,364,84,58,14,378,321,9352,2220,52034,61386,9/1/2020
5/2/2020,260,10751,1927,64705,75456,36,1129,39,646,5,127,356,91,62,24,402,189,9541,1292,53326,62867,9/1/2020
5/3/2020,284,11035,2168,66873,77908,31,1160,27,673,8,135,352,90,61,21,423,182,9723,1603,54929,64652,9/1/2020
5/4/2020,388,11423,2101,68974,80397,30,1190,31,704,5,140,346,88,57,18,441,294,10017,1572,56501,66518,9/1/2020
5/5/2020,436,11859,2878,71852,83711,29,1219,32,736,6,146,337,82,54,16,457,309,10326,1968,58469,68795,9/1/2020
5/6/2020,490,12349,2836,74688,87037,28,1247,44,780,9,155,312,79,54,21,478,342,10668,1924,60393,71061,9/1/2020
5/7/2020,425,12774,2975,77663,90437,36,1283,42,822,5,160,301,71,52,21,499,274,10942,1979,62372,73314,9/1/2020
5/8/2020,360,13134,2603,80266,93400,30,1313,29,851,5,165,297,71,53,22,521,233,11175,1752,64124,75299,9/1/2020
5/9/2020,470,13604,3356,83622,97226,22,1335,21,872,4,169,294,69,51,15,536,291,11466,2274,66398,77864,9/1/2020
5/10/2020,285,13889,2122,85744,99633,20,1355,23,895,6,175,285,70,49,13,549,188,11654,1525,67923,79577,9/1/2020
5/11/2020,259,14148,1861,87605,101753,31,1386,16,911,6,181,294,71,49,15,564,179,11833,1305,69228,81061,9/1/2020
5/12/2020,387,14535,2622,90227,104762,23,1409,18,929,4,185,295,69,48,22,586,219,12052,1713,70941,82993,9/1/2020
5/13/2020,352,14887,3634,93861,108748,22,1431,25,954,1,186,291,69,49,13,599,197,12249,2016,72957,85206,9/1/2020
5/14/2020,330,15217,3415,97276,112493,19,1450,27,981,3,189,280,64,45,15,614,231,12480,2021,74978,87458,9/1/2020
5/15/2020,382,15599,3470,100746,116345,24,1474,41,1022,5,194,258,62,45,13,627,237,12717,1814,76792,89509,9/1/2020
5/16/2020,453,16052,4168,104914,120966,25,1499,13,1035,5,199,265,61,46,15,642,253,12970,1967,78759,91729,9/1/2020
5/17/2020,240,16292,2775,107689,123981,17,1516,7,1042,5,204,270,59,45,10,652,129,13099,1564,80323,93422,9/1/2020
5/18/2020,251,16543,2007,109696,126239,19,1535,15,1057,5,209,269,57,40,18,670,140,13239,1373,81696,94935,9/1/2020
5/19/2020,416,16959,3178,112874,129833,23,1558,32,1089,5,214,255,56,38,11,681,215,13454,1934,83630,97084,9/1/2020
5/20/2020,328,17287,2775,115649,132936,19,1577,23,1112,7,221,244,52,33,22,703,189,13643,1521,85151,98794,9/1/2020
5/21/2020,374,17661,3764,119413,137074,26,1603,15,1127,3,224,252,53,29,20,723,171,13814,1948,87099,100913,9/1/2020
5/22/2020,353,18014,3172,122585,140599,20,1623,29,1156,5,229,238,52,29,10,733,204,14018,1615,88714,102732,9/1/2020
5/23/2020,253,18267,2748,125333,143600,19,1642,11,1167,3,232,243,52,32,13,746,109,14127,1279,89993,104120,9/1/2020
5/24/2020,165,18432,1372,126705,145137,12,1654,14,1181,2,234,239,53,36,8,754,84,14211,773,90766,104977,9/1/2020
5/25/2020,147,18579,1389,128094,146673,13,1667,14,1195,0,234,238,53,34,10,764,72,14283,762,91528,105811,9/1/2020
5/26/2020,285,18864,2624,130718,149582,24,1691,22,1217,5,239,235,48,33,15,779,165,14448,1782,93310,107758,9/1/2020
5/27/2020,276,19140,2125,132843,151983,20,1711,18,1235,3,242,234,50,33,10,789,133,14581,1136,94446,109027,9/1/2020
5/28/2020,349,19489,3372,136215,155704,17,1728,29,1264,4,246,218,47,32,8,797,134,14715,1124,95570,110285,9/1/2020
5/29/2020,417,19906,3973,140188,160094,19,1747,27,1291,6,252,204,43,31,12,809,179,14894,1576,97146,112040,9/1/2020
5/30/2020,228,20134,3972,144160,164294,15,1762,19,1310,4,256,196,40,29,12,821,110,15004,1822,98968,113972,9/1/2020
5/31/2020,159,20293,1759,145919,166212,11,1773,10,1320,0,256,197,43,26,3,824,78,15082,858,99826,114908,9/1/2020
6/1/2020,215,20508,2823,148742,169250,8,1781,14,1334,1,257,190,44,29,5,829,99,15181,1387,101213,116394,9/1/2020
6/2/2020,273,20781,3076,151818,172599,8,1789,9,1343,3,260,186,37,25,10,839,107,15288,1455,102668,117956,9/1/2020
6/3/2020,260,21041,3514,155332,176373,13,1802,18,1361,6,266,175,34,25,11,850,105,15393,1668,104336,119729,9/1/2020
6/4/2020,281,21322,4536,159868,181190,7,1809,25,1386,3,269,154,31,24,11,861,112,15505,2042,106378,121883,9/1/2020
6/5/2020,216,21538,3586,163454,184992,15,1824,13,1399,6,275,150,27,21,10,871,106,15611,1579,107957,123568,9/1/2020
6/6/2020,203,21741,2630,166084,187825,10,1834,7,1406,2,277,151,29,19,6,877,68,15679,1138,109095,124774,9/1/2020
6/7/2020,83,21824,1629,167713,189537,11,1845,7,1413,1,278,154,25,17,4,881,50,15729,783,109878,125607,9/1/2020
6/8/2020,120,21944,1852,169565,191509,15,1860,12,1425,2,280,155,27,18,4,885,44,15773,965,110843,126616,9/1/2020
6/9/2020,223,22167,2683,172248,194415,10,1870,18,1443,0,280,147,28,21,1,886,67,15840,1262,112105,127945,9/1/2020
6/10/2020,210,22377,2999,175247,197624,13,1883,12,1455,2,282,146,24,17,3,889,105,15945,1469,113574,129519,9/1/2020
6/11/2020,195,22572,3518,178765,201337,7,1890,15,1470,1,283,137,25,16,6,895,88,16033,1540,115114,131147,9/1/2020
6/12/2020,209,22781,4614,183379,206160,9,1899,15,1485,1,284,130,24,16,2,897,82,16115,2188,117302,133417,9/1/2020
6/13/2020,114,22895,3044,186423,209318,6,1905,4,1489,0,284,132,20,15,3,900,50,16165,1378,118680,134845,9/1/2020
6/14/2020,81,22976,2050,188473,211449,6,1911,8,1497,1,285,129,20,14,3,903,32,16197,969,119649,135846,9/1/2020
6/15/2020,189,23165,3117,191590,214755,14,1925,14,1511,0,285,129,20,16,4,907,78,16275,1794,121443,137718,9/1/2020
6/16/2020,111,23276,3024,194614,217890,10,1935,9,1520,1,286,129,22,16,8,915,52,16327,1579,123022,139349,9/1/2020
6/17/2020,128,23404,2843,197457,220861,15,1950,20,1540,4,290,120,18,14,6,921,53,16380,1324,124346,140726,9/1/2020
6/18/2020,149,23553,3056,200513,224066,9,1959,13,1553,1,291,115,19,16,7,928,70,16450,1340,125686,142136,9/1/2020
6/19/2020,141,23694,3773,204286,227980,12,1971,11,1564,1,292,115,20,17,3,931,59,16509,1374,127060,143569,9/1/2020
6/20/2020,84,23778,1896,206182,229960,9,1980,12,1576,0,292,112,20,18,4,935,36,16545,816,127876,144421,9/1/2020
6/21/2020,37,23815,1069,207251,231066,8,1988,5,1581,0,292,115,20,18,2,937,28,16573,692,128568,145141,9/1/2020
6/22/2020,138,23953,3736,210987,234940,12,2000,16,1597,0,292,111,19,18,1,938,69,16642,1711,130279,146921,9/1/2020
6/23/2020,163,24116,3854,214841,238957,3,2003,13,1610,3,295,98,18,18,7,945,83,16725,1788,132067,148792,9/1/2020
6/24/2020,120,24236,3518,218359,242595,9,2012,10,1620,1,296,96,18,18,5,950,47,16772,1690,133757,150529,9/1/2020
6/25/2020,103,24339,2899,221258,245597,6,2018,14,1634,1,297,87,17,17,1,951,54,16826,1518,135275,152101,9/1/2020
6/26/2020,94,24433,2499,223757,248190,2,2020,10,1644,0,297,79,18,18,1,952,64,16890,1336,136611,153501,9/1/2020
6/27/2020,84,24517,3227,226984,251501,5,2025,3,1647,1,298,80,17,17,5,957,37,16927,1221,137832,154759,9/1/2020
6/28/2020,40,24557,1471,228455,253012,4,2029,4,1651,4,302,76,15,14,6,963,19,16946,597,138429,155375,9/1/2020
6/29/2020,85,24642,3689,232144,256786,4,2033,5,1656,0,302,75,14,14,1,964,40,16986,1345,139774,156760,9/1/2020
6/30/2020,59,24701,1964,234108,258809,1,2034,5,1661,1,303,70,12,11,3,967,33,17019,996,140770,157789,9/1/2020
7/1/2020,145,24846,4111,238219,263065,7,2041,9,1670,0,303,68,11,11,1,968,81,17100,1939,142709,159809,9/1/2020
7/2/2020,102,24948,2805,241024,265972,5,2046,5,1675,1,304,67,10,10,1,969,57,17157,1091,143800,160957,9/1/2020
7/3/2020,50,24998,2068,243092,268090,9,2055,6,1681,0,304,70,9,9,3,972,26,17183,774,144574,161757,9/1/2020
7/4/2020,58,25056,2334,245426,270482,2,2057,4,1685,1,305,67,10,9,2,974,34,17217,997,145571,162788,9/1/2020
7/5/2020,51,25107,2939,248365,273472,1,2058,2,1687,1,306,65,8,8,2,976,26,17243,1448,147019,164262,9/1/2020
7/6/2020,102,25209,2820,251185,276394,6,2064,6,1693,0,306,65,9,9,4,980,58,17301,1556,148575,165876,9/1/2020
7/7/2020,82,25291,3458,254643,279934,5,2069,7,1700,0,306,63,8,8,2,982,48,17349,1525,150100,167449,9/1/2020
7/8/2020,105,25396,3401,258044,283440,4,2073,2,1702,0,306,65,9,8,0,982,66,17415,1414,151514,168929,9/1/2020
7/9/2020,94,25490,3676,261720,287210,9,2082,3,1705,0,306,71,9,8,0,982,49,17464,1594,153108,170572,9/1/2020
7/10/2020,131,25621,4445,266165,291786,6,2088,3,1708,2,308,72,7,7,3,985,80,17544,2085,155193,172737,9/1/2020
7/11/2020,63,25684,2906,269071,294755,6,2094,3,1711,1,309,74,6,6,3,988,34,17578,1291,156484,174062,9/1/2020
7/12/2020,45,25729,1785,270856,296585,1,2095,3,1714,1,310,71,6,5,3,991,34,17612,898,157382,174994,9/1/2020
7/13/2020,83,25812,3165,274021,299833,8,2103,10,1724,0,310,69,6,5,1,992,57,17669,1478,158860,176529,9/1/2020
7/14/2020,74,25886,3286,277307,303193,7,2110,4,1728,0,310,72,5,5,1,993,49,17718,1364,160224,177942,9/1/2020
7/15/2020,122,26008,4146,281453,307461,5,2115,7,1735,0,310,70,5,4,0,993,94,17812,1734,161958,179770,9/1/2020
7/16/2020,102,26110,3726,285179,311289,6,2121,9,1744,0,310,67,6,5,1,994,78,17890,1607,163565,181455,9/1/2020
7/17/2020,154,26264,4190,289369,315633,14,2135,3,1747,1,311,77,5,5,1,995,78,17968,1807,165372,183340,9/1/2020
7/18/2020,80,26344,3176,292545,318889,5,2140,9,1756,1,312,72,5,4,4,999,66,18034,1333,166705,184739,9/1/2020
7/19/2020,83,26427,2605,295150,321577,6,2146,3,1759,0,312,75,6,4,2,1001,59,18093,1066,167771,185864,9/1/2020
7/20/2020,71,26498,2657,297807,324305,9,2155,7,1766,0,312,77,7,5,2,1003,69,18162,1461,169232,187394,9/1/2020
7/21/2020,127,26625,4240,302047,328672,9,2164,10,1776,0,312,76,9,6,1,1004,109,18271,1873,171105,189376,9/1/2020
7/22/2020,122,26747,3807,305854,332601,11,2175,11,1787,1,313,75,7,6,1,1005,85,18356,1582,172687,191043,9/1/2020
7/23/2020,120,26867,4113,309967,336834,8,2183,5,1792,0,313,78,8,7,0,1005,104,18460,1769,174456,192916,9/1/2020
7/24/2020,168,27035,5747,315714,342749,13,2196,13,1805,0,313,78,9,7,0,1005,125,18585,2155,176611,195196,9/1/2020
7/25/2020,128,27163,4296,320010,347173,7,2203,7,1812,0,313,78,10,8,1,1006,104,18689,2008,178619,197308,9/1/2020
7/26/2020,56,27219,2985,322995,350214,8,2211,9,1821,0,313,77,11,7,1,1007,52,18741,1300,179919,198660,9/1/2020
7/27/2020,181,27400,3914,326909,354309,12,2223,7,1828,0,313,82,13,8,1,1008,138,18879,2125,182044,200923,9/1/2020
7/28/2020,104,27504,3861,330770,358274,5,2228,5,1833,0,313,82,14,7,1,1009,88,18967,1644,183688,202655,9/1/2020
7/29/2020,170,27674,4894,335664,363338,10,2238,12,1845,0,313,80,15,7,0,1009,150,19117,2126,185814,204931,9/1/2020
7/30/2020,99,27773,4057,339721,367494,6,2244,2,1847,1,314,83,15,6,0,1009,78,19195,1422,187236,206431,9/1/2020
7/31/2020,123,27896,5311,345032,372928,8,2252,9,1856,0,314,82,15,7,0,1009,87,19282,1711,188947,208229,9/1/2020
8/1/2020,101,27997,4107,349139,377136,7,2259,2,1858,0,314,87,14,7,1,1010,84,19366,1413,190360,209726,9/1/2020
8/2/2020,80,28077,2784,351923,380000,12,2271,12,1870,2,316,85,14,8,2,1012,63,19429,1257,191617,211046,9/1/2020
8/3/2020,176,28253,4921,356844,385097,13,2284,12,1882,0,316,86,16,7,1,1013,149,19578,1956,193573,213151,9/1/2020
8/4/2020,125,28378,3598,360442,388820,8,2292,6,1888,1,317,87,12,5,2,1015,105,19683,1697,195270,214953,9/1/2020
8/5/2020,139,28517,5732,366174,394691,12,2304,10,1898,1,318,88,10,5,2,1017,111,19794,2335,197605,217399,9/1/2020
8/6/2020,165,28682,5248,371422,400104,6,2310,9,1907,0,318,85,9,4,0,1017,116,19910,2203,199808,219718,9/1/2020
8/7/2020,112,28794,4563,375985,404779,13,2323,10,1917,1,319,87,9,3,1,1018,85,19995,1924,201732,221727,9/1/2020
8/8/2020,108,28902,3891,379876,408778,19,2342,6,1923,1,320,99,8,3,1,1019,92,20087,1617,203349,223436,9/1/2020
8/9/2020,39,28941,1622,381498,410439,8,2350,11,1934,0,320,96,9,4,0,1019,33,20120,997,204346,224466,9/1/2020
8/10/2020,137,29078,4282,385780,414858,11,2361,11,1945,0,320,96,9,4,1,1020,109,20229,1803,206149,226378,9/1/2020
8/11/2020,105,29183,4212,389992,419175,6,2367,14,1959,0,320,88,10,4,2,1022,95,20324,2170,208319,228643,9/1/2020
8/12/2020,118,29301,5080,395072,424373,8,2375,11,1970,0,320,85,9,3,1,1023,104,20428,2552,210871,231299,9/1/2020
8/13/2020,114,29415,3865,398937,428352,12,2387,11,1981,0,320,86,11,3,0,1023,88,20516,1664,212535,233051,9/1/2020
8/14/2020,137,29552,5358,404295,433847,13,2400,11,1992,0,320,88,11,4,2,1025,97,20613,1863,214398,235011,9/1/2020
8/15/2020,101,29653,4270,408565,438218,8,2408,11,2003,1,321,84,11,5,0,1025,92,20705,1505,215903,236608,9/1/2020
8/16/2020,77,29730,2798,411363,441093,7,2415,6,2009,4,325,81,8,4,5,1030,68,20773,1000,216903,237676,9/1/2020
8/17/2020,104,29834,3914,415277,445111,10,2425,7,2016,0,325,84,8,5,2,1032,85,20858,1868,218771,239629,9/1/2020
8/18/2020,125,29959,4911,420188,450147,11,2436,9,2025,1,326,85,8,4,5,1037,92,20950,2704,221475,242425,9/1/2020
8/19/2020,100,30059,5231,425419,455478,8,2444,9,2034,1,327,83,9,5,0,1037,80,21030,2547,224022,245052,9/1/2020
8/20/2020,173,30232,8068,433487,463719,12,2456,6,2040,2,329,87,10,5,3,1040,140,21170,3447,227469,248639,9/1/2020
8/21/2020,141,30373,6614,440101,470474,8,2464,5,2045,1,330,89,9,4,2,1042,116,21286,3065,230534,251820,9/1/2020
8/22/2020,96,30469,5776,445877,476346,9,2473,12,2057,0,330,86,11,4,0,1042,86,21372,2501,233035,254407,9/1/2020
8/23/2020,64,30533,4374,450251,480784,9,2482,6,2063,0,330,89,11,2,1,1043,54,21426,2492,235527,256953,9/1/2020
8/24/2020,90,30623,5341,455592,486215,6,2488,10,2073,1,331,84,12,4,1,1044,74,21500,2894,238421,259921,9/1/2020
8/25/2020,106,30729,4756,460348,491077,10,2498,4,2077,1,332,89,11,4,1,1045,96,21596,2285,240706,262302,9/1/2020
8/26/2020,162,30891,9423,469771,500662,3,2501,8,2085,0,332,84,9,5,1,1046,118,21714,2987,243693,265407,9/1/2020
8/27/2020,87,30978,8649,478420,509398,4,2505,13,2098,1,333,74,6,5,1,1047,68,21782,3104,246797,268579,9/1/2020
8/28/2020,100,31078,7895,486315,517393,12,2517,4,2102,0,333,82,9,7,1,1048,75,21857,2336,249133,270990,9/1/2020
8/29/2020,64,31142,5308,491623,522765,6,2523,7,2109,1,334,80,10,6,1,1049,46,21903,1771,250904,272807,9/1/2020
8/30/2020,64,31206,4097,495720,526926,5,2528,4,2113,0,334,81,8,5,1,1050,46,21949,1910,252814,274763,9/1/2020
8/31/2020,75,31281,3487,499207,530488,,,,,,,,,,0,1050,53,22002,1666,254480,276482,9/1/2020
2/27/2020,0,0,0,0,0,1,1,0,0,0,0,1,0,0,0,0,0,0,0,0,0,9/2/2020
2/28/2020,0,0,0,0,0,0,1,0,0,0,0,1,1,0,0,0,0,0,0,0,0,9/2/2020
2/29/2020,0,0,0,0,0,0,1,0,0,0,0,1,1,0,0,0,0,0,0,0,0,9/2/2020
3/1/2020,2,2,2,2,4,0,1,0,0,0,0,1,1,1,0,0,2,2,2,2,4,9/2/2020
3/2/2020,0,2,1,3,5,1,2,0,0,0,0,2,2,2,0,0,0,2,1,3,5,9/2/2020
3/3/2020,0,2,2,5,7,0,2,0,0,0,0,2,2,2,0,0,0,2,2,5,7,9/2/2020
3/4/2020,0,2,12,17,19,1,3,0,0,0,0,3,2,2,0,0,0,2,10,15,17,9/2/2020
3/5/2020,0,2,4,21,23,0,3,0,0,0,0,3,2,2,0,0,1,3,4,19,22,9/2/2020
3/6/2020,1,3,12,33,36,0,3,0,0,0,0,3,2,2,0,0,0,3,11,30,33,9/2/2020
3/7/2020,0,3,19,52,55,0,3,0,0,0,0,3,2,1,0,0,0,3,19,49,52,9/2/2020
3/8/2020,0,3,18,70,73,0,3,0,0,0,0,3,2,1,0,0,0,3,18,67,70,9/2/2020
3/9/2020,1,4,15,85,89,0,3,0,0,0,0,3,2,1,0,0,1,4,15,82,86,9/2/2020
3/10/2020,2,6,25,110,116,0,3,0,0,0,0,3,2,1,0,0,1,5,23,105,110,9/2/2020
3/11/2020,0,6,34,144,150,1,4,0,0,0,0,4,1,1,0,0,0,5,34,139,144,9/2/2020
3/12/2020,9,15,41,185,200,1,5,0,0,0,0,5,1,1,0,0,8,13,38,177,190,9/2/2020
3/13/2020,6,21,50,235,256,4,9,1,1,0,0,8,1,1,0,0,6,19,48,225,244,9/2/2020
3/14/2020,0,21,90,325,346,0,9,0,1,0,0,8,1,1,0,0,0,19,86,311,330,9/2/2020
3/15/2020,1,22,54,379,401,1,10,0,1,0,0,9,2,1,0,0,1,20,54,365,385,9/2/2020
3/16/2020,2,24,95,474,498,2,12,0,1,0,0,11,2,0,0,0,2,22,92,457,479,9/2/2020
3/17/2020,16,40,162,636,676,6,18,0,1,0,0,17,2,0,0,0,11,33,152,609,642,9/2/2020
3/18/2020,12,52,116,752,804,3,21,0,1,0,0,20,2,0,0,0,11,44,111,720,764,9/2/2020
3/19/2020,17,69,262,1014,1083,2,23,1,2,0,0,21,3,0,1,1,17,61,251,971,1032,9/2/2020
3/20/2020,14,83,197,1211,1294,5,28,0,2,0,0,26,4,0,0,1,13,74,192,1163,1237,9/2/2020
3/21/2020,21,104,126,1337,1441,3,31,2,4,0,0,27,5,0,0,1,14,88,123,1286,1374,9/2/2020
3/22/2020,30,134,282,1619,1753,2,33,0,4,0,0,29,5,0,0,1,25,113,262,1548,1661,9/2/2020
3/23/2020,14,148,169,1788,1936,15,48,1,5,0,0,43,9,3,0,1,16,129,165,1713,1842,9/2/2020
3/24/2020,20,168,242,2030,2198,7,55,0,5,0,0,50,10,4,0,1,19,148,238,1951,2099,9/2/2020
3/25/2020,26,194,183,2213,2407,5,60,1,6,0,0,54,11,3,0,1,28,176,172,2123,2299,9/2/2020
3/26/2020,35,229,181,2394,2623,10,70,5,11,0,0,59,14,5,0,1,41,217,176,2299,2516,9/2/2020
3/27/2020,27,256,215,2609,2865,9,79,1,12,1,1,66,17,6,2,3,31,248,202,2501,2749,9/2/2020
3/28/2020,59,315,260,2869,3184,13,92,3,15,2,3,74,15,6,1,4,63,311,241,2742,3053,9/2/2020
3/29/2020,106,421,356,3225,3646,8,100,4,19,1,4,77,18,8,2,6,105,416,314,3056,3472,9/2/2020
3/30/2020,62,483,222,3447,3930,20,120,5,24,0,4,92,20,11,3,9,78,494,186,3242,3736,9/2/2020
3/31/2020,71,554,369,3816,4370,11,131,7,31,1,5,95,22,13,2,11,73,567,298,3540,4107,9/2/2020
4/1/2020,99,653,699,4515,5168,18,149,7,38,0,5,106,30,15,1,12,101,668,643,4183,4851,9/2/2020
4/2/2020,52,705,477,4992,5697,22,171,6,44,2,7,120,36,21,4,16,62,730,436,4619,5349,9/2/2020
4/3/2020,108,813,775,5767,6580,23,194,7,51,0,7,136,43,25,3,19,100,830,715,5334,6164,9/2/2020
4/4/2020,143,956,660,6427,7383,22,216,4,55,5,12,149,41,30,9,28,137,967,620,5954,6921,9/2/2020
4/5/2020,187,1143,1156,7583,8726,20,236,9,64,1,13,159,44,36,2,30,182,1149,1070,7024,8173,9/2/2020
4/6/2020,218,1361,1707,9290,10651,26,262,7,71,0,13,178,48,40,7,37,206,1355,1563,8587,9942,9/2/2020
4/7/2020,285,1646,1631,10921,12567,19,281,4,75,2,15,191,50,42,5,42,261,1616,1486,10073,11689,9/2/2020
4/8/2020,290,1936,1723,12644,14580,19,300,7,82,6,21,197,50,38,10,52,272,1888,1567,11640,13528,9/2/2020
4/9/2020,284,2220,1521,14165,16385,32,332,9,91,4,25,216,53,40,7,59,280,2168,1360,13000,15168,9/2/2020
4/10/2020,420,2640,2577,16742,19382,29,361,15,106,5,30,225,59,41,11,70,403,2571,2375,15375,17946,9/2/2020
4/11/2020,299,2939,1911,18653,21592,29,390,11,117,2,32,241,61,48,12,82,281,2852,1720,17095,19947,9/2/2020
4/12/2020,315,3254,1674,20327,23581,35,425,13,130,5,37,258,59,49,9,91,289,3141,1440,18535,21676,9/2/2020
4/13/2020,162,3416,938,21265,24681,35,460,13,143,3,40,277,64,54,9,100,187,3328,841,19376,22704,9/2/2020
4/14/2020,289,3705,1788,23053,26758,27,487,17,160,5,45,282,72,53,8,108,265,3593,1529,20905,24498,9/2/2020
4/15/2020,353,4058,1803,24856,28914,31,518,20,180,3,48,290,72,54,17,125,307,3900,1565,22470,26370,9/2/2020
4/16/2020,449,4507,2500,27356,31863,36,554,25,205,6,54,295,72,53,14,139,391,4291,2085,24555,28846,9/2/2020
4/17/2020,308,4815,1823,29179,33994,32,586,20,225,7,61,300,66,45,21,160,293,4584,1458,26013,30597,9/2/2020
4/18/2020,322,5137,1728,30907,36044,26,612,18,243,4,65,304,63,49,15,175,286,4870,1346,27359,32229,9/2/2020
4/19/2020,382,5519,2059,32966,38485,23,635,26,269,1,66,300,65,55,11,186,338,5208,1746,29105,34313,9/2/2020
4/20/2020,396,5915,1909,34875,40790,46,681,29,298,2,68,315,75,56,10,196,377,5585,1578,30683,36268,9/2/2020
4/21/2020,445,6360,2114,36989,43349,45,726,31,329,5,73,324,72,56,18,214,390,5975,1718,32401,38376,9/2/2020
4/22/2020,420,6780,2398,39387,46167,41,767,32,361,5,78,328,73,58,18,232,385,6360,1917,34318,40678,9/2/2020
4/23/2020,481,7261,2471,41858,49119,32,799,28,389,5,83,327,76,62,15,247,419,6779,1869,36187,42966,9/2/2020
4/24/2020,494,7755,3292,45150,52905,35,834,27,416,4,87,331,85,63,15,262,416,7195,2635,38822,46017,9/2/2020
4/25/2020,394,8149,2210,47360,55509,34,868,17,433,5,92,343,85,62,14,276,305,7500,1777,40599,48099,9/2/2020
4/26/2020,316,8465,2314,49674,58139,33,901,15,448,3,95,358,86,59,14,290,275,7775,1884,42483,50258,9/2/2020
4/27/2020,250,8715,1624,51298,60013,29,930,21,469,4,99,362,86,61,10,300,205,7980,1164,43647,51627,9/2/2020
4/28/2020,411,9126,2268,53566,62692,44,974,24,493,3,102,379,88,59,22,322,329,8309,1769,45416,53725,9/2/2020
4/29/2020,476,9602,3351,56917,66519,36,1010,38,531,11,113,366,78,53,18,340,373,8682,2437,47853,56535,9/2/2020
4/30/2020,432,10034,2772,59689,69723,33,1043,38,569,6,119,355,83,57,24,364,351,9033,1955,49808,58841,9/2/2020
5/1/2020,457,10491,3089,62778,73269,51,1094,39,608,3,122,364,84,58,14,378,320,9353,2220,52028,61381,9/2/2020
5/2/2020,260,10751,1927,64705,75456,36,1130,39,647,5,127,356,91,62,24,402,189,9542,1292,53320,62862,9/2/2020
5/3/2020,284,11035,2168,66873,77908,31,1161,27,674,8,135,352,90,61,21,423,182,9724,1603,54923,64647,9/2/2020
5/4/2020,388,11423,2101,68974,80397,30,1191,31,705,5,140,346,88,57,18,441,293,10017,1572,56495,66512,9/2/2020
5/5/2020,436,11859,2878,71852,83711,29,1220,32,737,6,146,337,82,54,16,457,308,10325,1968,58463,68788,9/2/2020
5/6/2020,490,12349,2836,74688,87037,28,1248,44,781,9,155,312,79,54,21,478,342,10667,1923,60386,71053,9/2/2020
5/7/2020,425,12774,2975,77663,90437,36,1284,42,823,5,160,301,71,52,21,499,274,10941,1978,62364,73305,9/2/2020
5/8/2020,360,13134,2603,80266,93400,30,1314,29,852,5,165,297,71,53,22,521,233,11174,1749,64113,75287,9/2/2020
5/9/2020,470,13604,3356,83622,97226,22,1336,21,873,4,169,294,69,51,15,536,291,11465,2274,66387,77852,9/2/2020
5/10/2020,285,13889,2122,85744,99633,20,1356,23,896,6,175,285,70,49,13,549,187,11652,1525,67912,79564,9/2/2020
5/11/2020,259,14148,1861,87605,101753,31,1387,16,912,6,181,294,71,49,15,564,179,11831,1305,69217,81048,9/2/2020
5/12/2020,387,14535,2622,90227,104762,23,1410,18,930,4,185,295,69,48,22,586,219,12050,1713,70930,82980,9/2/2020
5/13/2020,352,14887,3634,93861,108748,23,1433,25,955,1,186,292,69,49,13,599,199,12249,2014,72944,85193,9/2/2020
5/14/2020,330,15217,3415,97276,112493,19,1452,27,982,3,189,281,64,45,15,614,231,12480,2021,74965,87445,9/2/2020
5/15/2020,382,15599,3470,100746,116345,24,1476,41,1023,5,194,259,62,45,13,627,237,12717,1814,76779,89496,9/2/2020
5/16/2020,453,16052,4168,104914,120966,25,1501,13,1036,5,199,266,61,46,15,642,252,12969,1967,78746,91715,9/2/2020
5/17/2020,240,16292,2775,107689,123981,17,1518,8,1044,5,204,270,59,45,10,652,129,13098,1563,80309,93407,9/2/2020
5/18/2020,251,16543,2007,109696,126239,19,1537,15,1059,5,209,269,57,40,18,670,140,13238,1373,81682,94920,9/2/2020
5/19/2020,416,16959,3178,112874,129833,23,1560,32,1091,5,214,255,56,38,11,681,214,13452,1934,83616,97068,9/2/2020
5/20/2020,328,17287,2775,115649,132936,19,1579,23,1114,7,221,244,52,33,22,703,188,13640,1519,85135,98775,9/2/2020
5/21/2020,374,17661,3764,119413,137074,26,1605,15,1129,3,224,252,53,29,20,723,170,13810,1948,87083,100893,9/2/2020
5/22/2020,353,18014,3172,122585,140599,20,1625,29,1158,5,229,238,52,29,10,733,204,14014,1615,88698,102712,9/2/2020
5/23/2020,253,18267,2748,125333,143600,19,1644,11,1169,3,232,243,52,32,13,746,108,14122,1279,89977,104099,9/2/2020
5/24/2020,165,18432,1372,126705,145137,12,1656,14,1183,2,234,239,53,36,8,754,83,14205,773,90750,104955,9/2/2020
5/25/2020,147,18579,1389,128094,146673,13,1669,14,1197,0,234,238,53,34,10,764,71,14276,762,91512,105788,9/2/2020
5/26/2020,285,18864,2624,130718,149582,24,1693,22,1219,5,239,235,48,33,15,779,165,14441,1782,93294,107735,9/2/2020
5/27/2020,276,19140,2125,132843,151983,20,1713,18,1237,3,242,234,50,33,10,789,133,14574,1136,94430,109004,9/2/2020
5/28/2020,349,19489,3372,136215,155704,17,1730,29,1266,4,246,218,47,32,8,797,134,14708,1124,95554,110262,9/2/2020
5/29/2020,417,19906,3973,140188,160094,19,1749,27,1293,6,252,204,43,31,12,809,177,14885,1576,97130,112015,9/2/2020
5/30/2020,228,20134,3972,144160,164294,15,1764,19,1312,4,256,196,40,29,12,821,109,14994,1822,98952,113946,9/2/2020
5/31/2020,159,20293,1759,145919,166212,11,1775,10,1322,0,256,197,43,26,3,824,77,15071,857,99809,114880,9/2/2020
6/1/2020,215,20508,2823,148742,169250,8,1783,14,1336,1,257,190,44,29,5,829,99,15170,1387,101196,116366,9/2/2020
6/2/2020,273,20781,3076,151818,172599,8,1791,9,1345,3,260,186,37,25,10,839,107,15277,1455,102651,117928,9/2/2020
6/3/2020,260,21041,3514,155332,176373,13,1804,18,1363,6,266,175,34,25,11,850,105,15382,1668,104319,119701,9/2/2020
6/4/2020,281,21322,4536,159868,181190,7,1811,25,1388,3,269,154,31,24,11,861,111,15493,2042,106361,121854,9/2/2020
6/5/2020,216,21538,3586,163454,184992,15,1826,13,1401,6,275,150,27,21,10,871,106,15599,1579,107940,123539,9/2/2020
6/6/2020,203,21741,2630,166084,187825,10,1836,7,1408,2,277,151,29,19,6,877,69,15668,1138,109078,124746,9/2/2020
6/7/2020,83,21824,1629,167713,189537,11,1847,7,1415,1,278,154,25,17,4,881,50,15718,783,109861,125579,9/2/2020
6/8/2020,120,21944,1852,169565,191509,15,1862,12,1427,2,280,155,27,18,4,885,44,15762,964,110825,126587,9/2/2020
6/9/2020,223,22167,2683,172248,194415,10,1872,18,1445,0,280,147,28,21,1,886,67,15829,1262,112087,127916,9/2/2020
6/10/2020,210,22377,2999,175247,197624,13,1885,12,1457,2,282,146,24,17,3,889,105,15934,1469,113556,129490,9/2/2020
6/11/2020,195,22572,3518,178765,201337,7,1892,15,1472,1,283,137,25,16,6,895,88,16022,1540,115096,131118,9/2/2020
6/12/2020,209,22781,4614,183379,206160,9,1901,15,1487,1,284,130,24,16,2,897,82,16104,2188,117284,133388,9/2/2020
6/13/2020,114,22895,3044,186423,209318,6,1907,4,1491,0,284,132,20,15,3,900,50,16154,1378,118662,134816,9/2/2020
6/14/2020,81,22976,2050,188473,211449,6,1913,8,1499,1,285,129,20,14,3,903,32,16186,969,119631,135817,9/2/2020
6/15/2020,189,23165,3117,191590,214755,14,1927,14,1513,0,285,129,20,16,4,907,78,16264,1794,121425,137689,9/2/2020
6/16/2020,111,23276,3024,194614,217890,10,1937,9,1522,1,286,129,22,16,8,915,52,16316,1579,123004,139320,9/2/2020
6/17/2020,128,23404,2843,197457,220861,15,1952,20,1542,4,290,120,18,14,6,921,53,16369,1324,124328,140697,9/2/2020
6/18/2020,149,23553,3056,200513,224066,9,1961,13,1555,1,291,115,19,16,7,928,70,16439,1340,125668,142107,9/2/2020
6/19/2020,141,23694,3773,204286,227980,12,1973,11,1566,1,292,115,20,17,3,931,59,16498,1374,127042,143540,9/2/2020
6/20/2020,84,23778,1896,206182,229960,9,1982,12,1578,0,292,112,20,18,4,935,36,16534,816,127858,144392,9/2/2020
6/21/2020,37,23815,1069,207251,231066,8,1990,5,1583,0,292,115,20,18,2,937,28,16562,692,128550,145112,9/2/2020
6/22/2020,138,23953,3736,210987,234940,12,2002,16,1599,0,292,111,19,18,1,938,69,16631,1711,130261,146892,9/2/2020
6/23/2020,163,24116,3854,214841,238957,3,2005,13,1612,3,295,98,18,18,7,945,83,16714,1788,132049,148763,9/2/2020
6/24/2020,120,24236,3518,218359,242595,9,2014,10,1622,1,296,96,18,18,5,950,46,16760,1690,133739,150499,9/2/2020
6/25/2020,103,24339,2899,221258,245597,6,2020,14,1636,1,297,87,17,17,1,951,54,16814,1518,135257,152071,9/2/2020
6/26/2020,94,24433,2499,223757,248190,2,2022,10,1646,0,297,79,18,18,1,952,63,16877,1336,136593,153470,9/2/2020
6/27/2020,84,24517,3227,226984,251501,5,2027,3,1649,1,298,80,17,17,5,957,37,16914,1221,137814,154728,9/2/2020
6/28/2020,40,24557,1471,228455,253012,4,2031,4,1653,4,302,76,15,14,6,963,19,16933,597,138411,155344,9/2/2020
6/29/2020,85,24642,3689,232144,256786,4,2035,5,1658,0,302,75,14,14,1,964,39,16972,1345,139756,156728,9/2/2020
6/30/2020,59,24701,1964,234108,258809,1,2036,5,1663,1,303,70,12,11,3,967,33,17005,996,140752,157757,9/2/2020
7/1/2020,145,24846,4111,238219,263065,7,2043,9,1672,0,303,68,11,11,1,968,80,17085,1939,142691,159776,9/2/2020
7/2/2020,102,24948,2805,241024,265972,5,2048,5,1677,1,304,67,10,10,1,969,56,17141,1091,143782,160923,9/2/2020
7/3/2020,50,24998,2068,243092,268090,9,2057,6,1683,0,304,70,9,9,3,972,26,17167,774,144556,161723,9/2/2020
7/4/2020,58,25056,2334,245426,270482,2,2059,4,1687,1,305,67,10,9,2,974,34,17201,997,145553,162754,9/2/2020
7/5/2020,51,25107,2939,248365,273472,1,2060,2,1689,1,306,65,8,8,2,976,26,17227,1448,147001,164228,9/2/2020
7/6/2020,102,25209,2820,251185,276394,6,2066,6,1695,0,306,65,9,9,4,980,58,17285,1556,148557,165842,9/2/2020
7/7/2020,82,25291,3458,254643,279934,5,2071,7,1702,0,306,63,8,8,2,982,48,17333,1525,150082,167415,9/2/2020
7/8/2020,105,25396,3401,258044,283440,4,2075,2,1704,0,306,65,9,8,0,982,65,17398,1414,151496,168894,9/2/2020
7/9/2020,94,25490,3676,261720,287210,9,2084,3,1707,0,306,71,9,8,0,982,50,17448,1594,153090,170538,9/2/2020
7/10/2020,131,25621,4445,266165,291786,6,2090,3,1710,2,308,72,7,7,3,985,80,17528,2084,155174,172702,9/2/2020
7/11/2020,63,25684,2906,269071,294755,6,2096,3,1713,1,309,74,6,6,3,988,34,17562,1291,156465,174027,9/2/2020
7/12/2020,45,25729,1785,270856,296585,1,2097,3,1716,1,310,71,6,5,3,991,34,17596,898,157363,174959,9/2/2020
7/13/2020,83,25812,3165,274021,299833,8,2105,10,1726,0,310,69,6,5,1,992,57,17653,1478,158841,176494,9/2/2020
7/14/2020,74,25886,3286,277307,303193,7,2112,4,1730,0,310,72,5,5,1,993,49,17702,1364,160205,177907,9/2/2020
7/15/2020,122,26008,4146,281453,307461,5,2117,7,1737,0,310,70,5,4,0,993,95,17797,1734,161939,179736,9/2/2020
7/16/2020,102,26110,3726,285179,311289,6,2123,9,1746,0,310,67,6,5,1,994,78,17875,1607,163546,181421,9/2/2020
7/17/2020,154,26264,4190,289369,315633,14,2137,3,1749,1,311,77,5,5,1,995,79,17954,1807,165353,183307,9/2/2020
7/18/2020,80,26344,3176,292545,318889,5,2142,9,1758,1,312,72,5,4,4,999,66,18020,1333,166686,184706,9/2/2020
7/19/2020,83,26427,2605,295150,321577,6,2148,3,1761,0,312,75,6,4,2,1001,59,18079,1066,167752,185831,9/2/2020
7/20/2020,71,26498,2657,297807,324305,9,2157,7,1768,0,312,77,7,5,2,1003,69,18148,1461,169213,187361,9/2/2020
7/21/2020,127,26625,4240,302047,328672,9,2166,10,1778,0,312,76,9,6,1,1004,110,18258,1873,171086,189344,9/2/2020
7/22/2020,122,26747,3807,305854,332601,11,2177,11,1789,1,313,75,7,6,1,1005,86,18344,1582,172668,191012,9/2/2020
7/23/2020,120,26867,4205,310059,336926,8,2185,5,1794,0,313,78,8,7,0,1005,105,18449,1837,174505,192954,9/2/2020
7/24/2020,168,27035,5833,315892,342927,13,2198,13,1807,0,313,78,9,7,0,1005,125,18574,2219,176724,195298,9/2/2020
7/25/2020,128,27163,4296,320188,347351,7,2205,7,1814,0,313,78,10,8,1,1006,104,18678,2008,178732,197410,9/2/2020
7/26/2020,56,27219,2985,323173,350392,8,2213,9,1823,0,313,77,11,7,1,1007,53,18731,1300,180032,198763,9/2/2020
7/27/2020,181,27400,3959,327132,354532,12,2225,7,1830,0,313,82,13,8,1,1008,138,18869,2157,182189,201058,9/2/2020
7/28/2020,104,27504,3844,330976,358480,5,2230,5,1835,0,313,82,14,7,1,1009,89,18958,1637,183826,202784,9/2/2020
7/29/2020,170,27674,4894,335870,363544,10,2240,12,1847,0,313,80,15,7,0,1009,150,19108,2126,185952,205060,9/2/2020
7/30/2020,99,27773,4104,339974,367747,6,2246,2,1849,1,314,83,15,6,0,1009,79,19187,1451,187403,206590,9/2/2020
7/31/2020,123,27896,5391,345365,373261,8,2254,9,1858,0,314,82,15,7,0,1009,87,19274,1767,189170,208444,9/2/2020
8/1/2020,101,27997,4108,349473,377470,7,2261,2,1860,0,314,87,14,7,1,1010,84,19358,1427,190597,209955,9/2/2020
8/2/2020,80,28077,2787,352260,380337,12,2273,12,1872,2,316,85,14,8,2,1012,63,19421,1260,191857,211278,9/2/2020
8/3/2020,176,28253,4926,357186,385439,13,2286,12,1884,0,316,86,16,7,1,1013,149,19570,1961,193818,213388,9/2/2020
8/4/2020,125,28378,3613,360799,389177,8,2294,6,1890,1,317,87,12,5,2,1015,105,19675,1712,195530,215205,9/2/2020
8/5/2020,139,28517,5743,366542,395059,12,2306,10,1900,1,318,88,10,5,2,1017,111,19786,2340,197870,217656,9/2/2020
8/6/2020,165,28682,5278,371820,400502,6,2312,9,1909,0,318,85,9,4,0,1017,117,19903,2231,200101,220004,9/2/2020
8/7/2020,112,28794,4586,376406,405200,13,2325,10,1919,1,319,87,9,3,1,1018,85,19988,1942,202043,222031,9/2/2020
8/8/2020,108,28902,3917,380323,409225,19,2344,6,1925,1,320,99,8,3,1,1019,91,20079,1635,203678,223757,9/2/2020
8/9/2020,39,28941,1622,381945,410886,8,2352,11,1936,0,320,96,9,4,0,1019,34,20113,997,204675,224788,9/2/2020
8/10/2020,137,29078,4329,386274,415352,11,2363,11,1947,0,320,96,9,4,1,1020,108,20221,1831,206506,226727,9/2/2020
8/11/2020,105,29183,4220,390494,419677,6,2369,14,1961,0,320,88,10,4,2,1022,95,20316,2188,208694,229010,9/2/2020
8/12/2020,118,29301,5080,395574,424875,8,2377,11,1972,0,320,85,9,3,1,1023,104,20420,2552,211246,231666,9/2/2020
8/13/2020,114,29415,3918,399492,428907,12,2389,11,1983,0,320,86,11,3,0,1023,89,20509,1700,212946,233455,9/2/2020
8/14/2020,137,29552,5371,404863,434415,13,2402,11,1994,0,320,88,11,4,2,1025,97,20606,1875,214821,235427,9/2/2020
8/15/2020,101,29653,4297,409160,438813,8,2410,11,2005,1,321,84,11,5,0,1025,92,20698,1527,216348,237046,9/2/2020
8/16/2020,77,29730,2798,411958,441688,7,2417,6,2011,4,325,81,8,4,5,1030,68,20766,999,217347,238113,9/2/2020
8/17/2020,104,29834,3960,415918,445752,10,2427,7,2018,0,325,84,8,5,2,1032,85,20851,1897,219244,240095,9/2/2020
8/18/2020,125,29959,4913,420831,450790,11,2438,9,2027,1,326,85,8,4,5,1037,93,20944,2704,221948,242892,9/2/2020
8/19/2020,100,30059,5238,426069,456128,8,2446,9,2036,1,327,83,9,5,0,1037,80,21024,2553,224501,245525,9/2/2020
8/20/2020,173,30232,8068,434137,464369,12,2458,6,2042,2,329,87,10,5,3,1040,138,21162,3447,227948,249110,9/2/2020
8/21/2020,141,30373,6616,440753,471126,8,2466,5,2047,1,330,89,9,4,2,1042,116,21278,3067,231015,252293,9/2/2020
8/22/2020,96,30469,5777,446530,476999,9,2475,12,2059,0,330,86,11,4,0,1042,85,21363,2502,233517,254880,9/2/2020
8/23/2020,64,30533,4375,450905,481438,10,2485,6,2065,0,330,90,11,2,1,1043,54,21417,2493,236010,257427,9/2/2020
8/24/2020,90,30623,5341,456246,486869,6,2491,10,2075,1,331,85,13,4,1,1044,74,21491,2893,238903,260394,9/2/2020
8/25/2020,106,30729,4757,461003,491732,10,2501,4,2079,1,332,90,11,4,1,1045,95,21586,2280,241183,262769,9/2/2020
8/26/2020,162,30891,9423,470426,501317,3,2504,8,2087,0,332,85,9,5,1,1046,120,21706,2979,244162,265868,9/2/2020
8/27/2020,87,30978,8649,479075,510053,4,2508,13,2100,1,333,75,6,5,1,1047,69,21775,3100,247262,269037,9/2/2020
8/28/2020,100,31078,7899,486974,518052,13,2521,4,2104,0,333,84,9,7,2,1049,77,21852,2333,249595,271447,9/2/2020
8/29/2020,64,31142,5325,492299,523441,6,2527,8,2112,1,334,81,10,6,1,1050,51,21903,1781,251376,273279,9/2/2020
8/30/2020,64,31206,4100,496399,527605,5,2532,4,2116,0,334,82,8,5,1,1051,44,21947,1907,253283,275230,9/2/2020
8/31/2020,76,31282,4322,500721,532003,10,2542,14,2130,0,334,78,8,4,0,1051,78,22025,1922,255205,277230,9/2/2020
9/1/2020,80,31362,4056,504777,536139,,,,,,,,,,0,1051,53,22078,1358,256563,278641,9/2/2020
2/27/2020,0,0,0,0,0,1,1,0,0,0,0,1,0,0,0,0,0,0,0,0,0,9/3/2020
2/28/2020,0,0,0,0,0,0,1,0,0,0,0,1,1,0,0,0,0,0,0,0,0,9/3/2020
2/29/2020,0,0,0,0,0,0,1,0,0,0,0,1,1,0,0,0,0,0,0,0,0,9/3/2020
3/1/2020,2,2,2,2,4,0,1,0,0,0,0,1,1,1,0,0,2,2,2,2,4,9/3/2020
3/2/2020,0,2,1,3,5,1,2,0,0,0,0,2,2,2,0,0,0,2,1,3,5,9/3/2020
3/3/2020,0,2,2,5,7,0,2,0,0,0,0,2,2,2,0,0,0,2,2,5,7,9/3/2020
3/4/2020,0,2,12,17,19,1,3,0,0,0,0,3,2,2,0,0,0,2,10,15,17,9/3/2020
3/5/2020,0,2,4,21,23,0,3,0,0,0,0,3,2,2,0,0,1,3,4,19,22,9/3/2020
3/6/2020,1,3,12,33,36,0,3,0,0,0,0,3,2,2,0,0,0,3,11,30,33,9/3/2020
3/7/2020,0,3,19,52,55,0,3,0,0,0,0,3,2,1,0,0,0,3,19,49,52,9/3/2020
3/8/2020,0,3,18,70,73,0,3,0,0,0,0,3,2,1,0,0,0,3,18,67,70,9/3/2020
3/9/2020,1,4,15,85,89,0,3,0,0,0,0,3,2,1,0,0,1,4,15,82,86,9/3/2020
3/10/2020,2,6,25,110,116,0,3,0,0,0,0,3,2,1,0,0,1,5,23,105,110,9/3/2020
3/11/2020,0,6,34,144,150,1,4,0,0,0,0,4,1,1,0,0,0,5,34,139,144,9/3/2020
3/12/2020,9,15,41,185,200,1,5,0,0,0,0,5,1,1,0,0,8,13,38,177,190,9/3/2020
3/13/2020,6,21,50,235,256,4,9,1,1,0,0,8,1,1,0,0,6,19,48,225,244,9/3/2020
3/14/2020,0,21,90,325,346,0,9,0,1,0,0,8,1,1,0,0,0,19,86,311,330,9/3/2020
3/15/2020,1,22,54,379,401,1,10,0,1,0,0,9,2,1,0,0,1,20,54,365,385,9/3/2020
3/16/2020,2,24,95,474,498,2,12,0,1,0,0,11,2,0,0,0,2,22,92,457,479,9/3/2020
3/17/2020,16,40,162,636,676,6,18,0,1,0,0,17,2,0,0,0,11,33,152,609,642,9/3/2020
3/18/2020,12,52,116,752,804,3,21,0,1,0,0,20,2,0,0,0,11,44,111,720,764,9/3/2020
3/19/2020,17,69,262,1014,1083,2,23,1,2,0,0,21,3,0,1,1,17,61,251,971,1032,9/3/2020
3/20/2020,14,83,197,1211,1294,5,28,0,2,0,0,26,4,0,0,1,13,74,192,1163,1237,9/3/2020
3/21/2020,21,104,126,1337,1441,3,31,2,4,0,0,27,5,0,0,1,14,88,123,1286,1374,9/3/2020
3/22/2020,30,134,282,1619,1753,2,33,0,4,0,0,29,5,0,0,1,25,113,262,1548,1661,9/3/2020
3/23/2020,14,148,169,1788,1936,15,48,1,5,0,0,43,9,3,0,1,16,129,165,1713,1842,9/3/2020
3/24/2020,20,168,242,2030,2198,7,55,0,5,0,0,50,10,4,0,1,19,148,238,1951,2099,9/3/2020
3/25/2020,26,194,183,2213,2407,5,60,1,6,0,0,54,11,3,0,1,28,176,172,2123,2299,9/3/2020
3/26/2020,35,229,181,2394,2623,10,70,5,11,0,0,59,14,5,0,1,41,217,176,2299,2516,9/3/2020
3/27/2020,27,256,215,2609,2865,9,79,1,12,1,1,66,17,6,2,3,31,248,202,2501,2749,9/3/2020
3/28/2020,59,315,260,2869,3184,13,92,3,15,2,3,74,15,6,1,4,63,311,241,2742,3053,9/3/2020
3/29/2020,106,421,356,3225,3646,8,100,4,19,1,4,77,18,8,2,6,105,416,314,3056,3472,9/3/2020
3/30/2020,62,483,222,3447,3930,20,120,5,24,0,4,92,20,11,3,9,78,494,186,3242,3736,9/3/2020
3/31/2020,71,554,369,3816,4370,11,131,7,31,1,5,95,22,13,2,11,73,567,298,3540,4107,9/3/2020
4/1/2020,99,653,699,4515,5168,18,149,7,38,0,5,106,30,15,1,12,101,668,643,4183,4851,9/3/2020
4/2/2020,52,705,477,4992,5697,22,171,6,44,2,7,120,36,21,4,16,62,730,436,4619,5349,9/3/2020
4/3/2020,108,813,775,5767,6580,23,194,7,51,0,7,136,43,25,3,19,100,830,715,5334,6164,9/3/2020
4/4/2020,143,956,660,6427,7383,22,216,4,55,5,12,149,41,30,9,28,137,967,620,5954,6921,9/3/2020
4/5/2020,187,1143,1156,7583,8726,20,236,9,64,1,13,159,44,36,2,30,182,1149,1070,7024,8173,9/3/2020
4/6/2020,218,1361,1707,9290,10651,26,262,7,71,0,13,178,48,40,7,37,206,1355,1563,8587,9942,9/3/2020
4/7/2020,285,1646,1631,10921,12567,19,281,4,75,2,15,191,50,42,5,42,261,1616,1486,10073,11689,9/3/2020
4/8/2020,290,1936,1723,12644,14580,19,300,7,82,6,21,197,50,38,10,52,272,1888,1567,11640,13528,9/3/2020
4/9/2020,284,2220,1521,14165,16385,32,332,9,91,4,25,216,53,40,7,59,280,2168,1360,13000,15168,9/3/2020
4/10/2020,420,2640,2577,16742,19382,29,361,15,106,5,30,225,59,41,11,70,403,2571,2375,15375,17946,9/3/2020
4/11/2020,299,2939,1911,18653,21592,29,390,11,117,2,32,241,61,48,12,82,281,2852,1720,17095,19947,9/3/2020
4/12/2020,315,3254,1674,20327,23581,35,425,13,130,5,37,258,59,49,9,91,289,3141,1440,18535,21676,9/3/2020
4/13/2020,162,3416,938,21265,24681,35,460,13,143,3,40,277,64,54,9,100,187,3328,841,19376,22704,9/3/2020
4/14/2020,289,3705,1788,23053,26758,27,487,17,160,5,45,282,72,53,8,108,265,3593,1529,20905,24498,9/3/2020
4/15/2020,353,4058,1803,24856,28914,31,518,20,180,3,48,290,72,54,17,125,307,3900,1565,22470,26370,9/3/2020
4/16/2020,449,4507,2500,27356,31863,36,554,25,205,6,54,295,72,53,14,139,391,4291,2085,24555,28846,9/3/2020
4/17/2020,308,4815,1823,29179,33994,32,586,20,225,7,61,300,66,45,21,160,293,4584,1458,26013,30597,9/3/2020
4/18/2020,322,5137,1728,30907,36044,26,612,18,243,4,65,304,63,49,15,175,286,4870,1346,27359,32229,9/3/2020
4/19/2020,382,5519,2059,32966,38485,23,635,26,269,1,66,300,65,55,11,186,338,5208,1746,29105,34313,9/3/2020
4/20/2020,396,5915,1909,34875,40790,46,681,29,298,2,68,315,75,56,10,196,377,5585,1578,30683,36268,9/3/2020
4/21/2020,445,6360,2114,36989,43349,45,726,31,329,5,73,324,72,56,18,214,390,5975,1718,32401,38376,9/3/2020
4/22/2020,420,6780,2398,39387,46167,41,767,32,361,5,78,328,73,58,18,232,385,6360,1917,34318,40678,9/3/2020
4/23/2020,481,7261,2471,41858,49119,32,799,28,389,5,83,327,76,62,15,247,419,6779,1869,36187,42966,9/3/2020
4/24/2020,494,7755,3292,45150,52905,35,834,27,416,4,87,331,85,63,15,262,416,7195,2634,38821,46016,9/3/2020
4/25/2020,394,8149,2210,47360,55509,34,868,17,433,5,92,343,85,62,14,276,304,7499,1777,40598,48097,9/3/2020
4/26/2020,316,8465,2314,49674,58139,33,901,15,448,3,95,358,86,59,14,290,275,7774,1884,42482,50256,9/3/2020
4/27/2020,250,8715,1624,51298,60013,29,930,21,469,4,99,362,86,61,10,300,205,7979,1163,43645,51624,9/3/2020
4/28/2020,411,9126,2268,53566,62692,44,974,24,493,3,102,379,88,59,22,322,330,8309,1769,45414,53723,9/3/2020
4/29/2020,476,9602,3351,56917,66519,36,1010,38,531,11,113,366,78,53,18,340,373,8682,2434,47848,56530,9/3/2020
4/30/2020,432,10034,2772,59689,69723,33,1043,38,569,6,119,355,83,57,24,364,351,9033,1955,49803,58836,9/3/2020
5/1/2020,457,10491,3089,62778,73269,51,1094,39,608,3,122,364,84,58,14,378,320,9353,2220,52023,61376,9/3/2020
5/2/2020,260,10751,1927,64705,75456,36,1130,39,647,5,127,356,91,62,24,402,189,9542,1292,53315,62857,9/3/2020
5/3/2020,284,11035,2168,66873,77908,31,1161,27,674,8,135,352,90,61,21,423,182,9724,1603,54918,64642,9/3/2020
5/4/2020,388,11423,2101,68974,80397,30,1191,31,705,5,140,346,88,57,18,441,293,10017,1570,56488,66505,9/3/2020
5/5/2020,436,11859,2878,71852,83711,29,1220,32,737,6,146,337,82,54,16,457,308,10325,1967,58455,68780,9/3/2020
5/6/2020,490,12349,2836,74688,87037,28,1248,44,781,9,155,312,79,54,21,478,342,10667,1923,60378,71045,9/3/2020
5/7/2020,425,12774,2975,77663,90437,36,1284,42,823,5,160,301,71,52,21,499,274,10941,1978,62356,73297,9/3/2020
5/8/2020,360,13134,2603,80266,93400,30,1314,29,852,5,165,297,71,53,22,521,233,11174,1749,64105,75279,9/3/2020
5/9/2020,470,13604,3356,83622,97226,22,1336,21,873,4,169,294,69,51,15,536,291,11465,2274,66379,77844,9/3/2020
5/10/2020,285,13889,2122,85744,99633,20,1356,23,896,6,175,285,70,49,13,549,187,11652,1525,67904,79556,9/3/2020
5/11/2020,259,14148,1861,87605,101753,31,1387,16,912,6,181,294,71,49,15,564,179,11831,1305,69209,81040,9/3/2020
5/12/2020,387,14535,2622,90227,104762,23,1410,18,930,4,185,295,69,48,22,586,219,12050,1713,70922,82972,9/3/2020
5/13/2020,352,14887,3634,93861,108748,22,1432,25,955,1,186,291,69,49,13,599,199,12249,2014,72936,85185,9/3/2020
5/14/2020,330,15217,3415,97276,112493,19,1451,27,982,3,189,280,64,45,15,614,231,12480,2021,74957,87437,9/3/2020
5/15/2020,382,15599,3470,100746,116345,24,1475,41,1023,5,194,258,62,45,13,627,237,12717,1814,76771,89488,9/3/2020
5/16/2020,453,16052,4168,104914,120966,25,1500,13,1036,5,199,265,61,46,15,642,252,12969,1967,78738,91707,9/3/2020
5/17/2020,240,16292,2775,107689,123981,17,1517,7,1043,5,204,270,59,45,10,652,129,13098,1563,80301,93399,9/3/2020
5/18/2020,251,16543,2007,109696,126239,19,1536,15,1058,5,209,269,57,40,18,670,140,13238,1373,81674,94912,9/3/2020
5/19/2020,416,16959,3178,112874,129833,23,1559,32,1090,5,214,255,56,38,11,681,214,13452,1934,83608,97060,9/3/2020
5/20/2020,328,17287,2775,115649,132936,19,1578,23,1113,7,221,244,52,33,22,703,188,13640,1519,85127,98767,9/3/2020
5/21/2020,374,17661,3764,119413,137074,26,1604,15,1128,3,224,252,53,29,20,723,170,13810,1948,87075,100885,9/3/2020
5/22/2020,353,18014,3172,122585,140599,20,1624,29,1157,5,229,238,52,29,10,733,204,14014,1615,88690,102704,9/3/2020
5/23/2020,253,18267,2748,125333,143600,19,1643,11,1168,3,232,243,52,32,13,746,108,14122,1279,89969,104091,9/3/2020
5/24/2020,165,18432,1372,126705,145137,12,1655,14,1182,2,234,239,53,36,8,754,83,14205,773,90742,104947,9/3/2020
5/25/2020,147,18579,1389,128094,146673,13,1668,14,1196,0,234,238,53,34,10,764,71,14276,762,91504,105780,9/3/2020
5/26/2020,285,18864,2624,130718,149582,24,1692,22,1218,5,239,235,48,33,15,779,165,14441,1782,93286,107727,9/3/2020
5/27/2020,276,19140,2125,132843,151983,20,1712,18,1236,3,242,234,50,33,10,789,133,14574,1136,94422,108996,9/3/2020
5/28/2020,349,19489,3372,136215,155704,17,1729,29,1265,4,246,218,47,32,8,797,134,14708,1124,95546,110254,9/3/2020
5/29/2020,417,19906,3973,140188,160094,19,1748,27,1292,6,252,204,43,31,12,809,177,14885,1576,97122,112007,9/3/2020
5/30/2020,228,20134,3972,144160,164294,15,1763,19,1311,4,256,196,40,29,12,821,109,14994,1822,98944,113938,9/3/2020
5/31/2020,159,20293,1759,145919,166212,11,1774,10,1321,0,256,197,43,26,3,824,77,15071,857,99801,114872,9/3/2020
6/1/2020,215,20508,2823,148742,169250,8,1782,14,1335,1,257,190,44,29,5,829,99,15170,1387,101188,116358,9/3/2020
6/2/2020,273,20781,3076,151818,172599,8,1790,9,1344,3,260,186,37,25,10,839,107,15277,1455,102643,117920,9/3/2020
6/3/2020,260,21041,3514,155332,176373,13,1803,18,1362,6,266,175,34,25,11,850,105,15382,1667,104310,119692,9/3/2020
6/4/2020,281,21322,4536,159868,181190,7,1810,25,1387,3,269,154,31,24,11,861,111,15493,2042,106352,121845,9/3/2020
6/5/2020,216,21538,3586,163454,184992,15,1825,13,1400,6,275,150,27,21,10,871,106,15599,1579,107931,123530,9/3/2020
6/6/2020,203,21741,2630,166084,187825,10,1835,7,1407,2,277,151,29,19,6,877,69,15668,1138,109069,124737,9/3/2020
6/7/2020,83,21824,1629,167713,189537,11,1846,7,1414,1,278,154,25,17,4,881,50,15718,783,109852,125570,9/3/2020
6/8/2020,120,21944,1852,169565,191509,15,1861,12,1426,2,280,155,27,18,4,885,44,15762,964,110816,126578,9/3/2020
6/9/2020,223,22167,2683,172248,194415,10,1871,18,1444,0,280,147,28,21,1,886,67,15829,1261,112077,127906,9/3/2020
6/10/2020,210,22377,2999,175247,197624,13,1884,12,1456,2,282,146,24,17,3,889,105,15934,1469,113546,129480,9/3/2020
6/11/2020,195,22572,3518,178765,201337,7,1891,15,1471,1,283,137,25,16,6,895,88,16022,1540,115086,131108,9/3/2020
6/12/2020,209,22781,4614,183379,206160,9,1900,15,1486,1,284,130,24,16,2,897,82,16104,2188,117274,133378,9/3/2020
6/13/2020,114,22895,3044,186423,209318,6,1906,4,1490,0,284,132,20,15,3,900,50,16154,1376,118650,134804,9/3/2020
6/14/2020,81,22976,2050,188473,211449,6,1912,8,1498,1,285,129,20,14,3,903,32,16186,969,119619,135805,9/3/2020
6/15/2020,189,23165,3117,191590,214755,14,1926,14,1512,0,285,129,20,16,4,907,78,16264,1794,121413,137677,9/3/2020
6/16/2020,111,23276,3024,194614,217890,10,1936,9,1521,1,286,129,22,16,8,915,52,16316,1579,122992,139308,9/3/2020
6/17/2020,128,23404,2843,197457,220861,15,1951,20,1541,4,290,120,18,14,6,921,53,16369,1324,124316,140685,9/3/2020
6/18/2020,149,23553,3056,200513,224066,9,1960,13,1554,1,291,115,19,16,7,928,70,16439,1339,125655,142094,9/3/2020
6/19/2020,141,23694,3773,204286,227980,12,1972,11,1565,1,292,115,20,17,3,931,59,16498,1374,127029,143527,9/3/2020
6/20/2020,84,23778,1896,206182,229960,9,1981,12,1577,0,292,112,20,18,4,935,36,16534,816,127845,144379,9/3/2020
6/21/2020,37,23815,1069,207251,231066,8,1989,5,1582,0,292,115,20,18,2,937,28,16562,692,128537,145099,9/3/2020
6/22/2020,138,23953,3736,210987,234940,12,2001,16,1598,0,292,111,19,18,1,938,69,16631,1711,130248,146879,9/3/2020
6/23/2020,163,24116,3854,214841,238957,3,2004,13,1611,3,295,98,18,18,7,945,83,16714,1788,132036,148750,9/3/2020
6/24/2020,120,24236,3518,218359,242595,9,2013,10,1621,1,296,96,18,18,5,950,46,16760,1690,133726,150486,9/3/2020
6/25/2020,103,24339,2899,221258,245597,6,2019,14,1635,1,297,87,17,17,1,951,54,16814,1518,135244,152058,9/3/2020
6/26/2020,94,24433,2499,223757,248190,2,2021,10,1645,0,297,79,18,18,1,952,63,16877,1336,136580,153457,9/3/2020
6/27/2020,84,24517,3227,226984,251501,5,2026,3,1648,1,298,80,17,17,5,957,37,16914,1221,137801,154715,9/3/2020
6/28/2020,40,24557,1471,228455,253012,4,2030,4,1652,4,302,76,15,14,6,963,19,16933,597,138398,155331,9/3/2020
6/29/2020,85,24642,3689,232144,256786,4,2034,5,1657,0,302,75,14,14,1,964,39,16972,1345,139743,156715,9/3/2020
6/30/2020,59,24701,1964,234108,258809,1,2035,5,1662,1,303,70,12,11,3,967,33,17005,996,140739,157744,9/3/2020
7/1/2020,145,24846,4111,238219,263065,7,2042,9,1671,0,303,68,11,11,1,968,80,17085,1939,142678,159763,9/3/2020
7/2/2020,102,24948,2805,241024,265972,5,2047,5,1676,1,304,67,10,10,1,969,56,17141,1091,143769,160910,9/3/2020
7/3/2020,50,24998,2068,243092,268090,9,2056,6,1682,0,304,70,9,9,3,972,26,17167,774,144543,161710,9/3/2020
7/4/2020,58,25056,2334,245426,270482,2,2058,4,1686,1,305,67,10,9,2,974,34,17201,997,145540,162741,9/3/2020
7/5/2020,51,25107,2939,248365,273472,1,2059,2,1688,1,306,65,8,8,2,976,26,17227,1448,146988,164215,9/3/2020
7/6/2020,102,25209,2820,251185,276394,6,2065,6,1694,0,306,65,9,9,4,980,58,17285,1554,148542,165827,9/3/2020
7/7/2020,82,25291,3458,254643,279934,5,2070,7,1701,0,306,63,8,8,2,982,48,17333,1525,150067,167400,9/3/2020
7/8/2020,105,25396,3401,258044,283440,4,2074,2,1703,0,306,65,9,8,0,982,65,17398,1414,151481,168879,9/3/2020
7/9/2020,94,25490,3676,261720,287210,9,2083,3,1706,0,306,71,9,8,0,982,50,17448,1593,153074,170522,9/3/2020
7/10/2020,131,25621,4445,266165,291786,6,2089,3,1709,2,308,72,7,7,3,985,80,17528,2084,155158,172686,9/3/2020
7/11/2020,63,25684,2906,269071,294755,6,2095,3,1712,1,309,74,6,6,3,988,34,17562,1291,156449,174011,9/3/2020
7/12/2020,45,25729,1785,270856,296585,1,2096,3,1715,1,310,71,6,5,3,991,34,17596,898,157347,174943,9/3/2020
7/13/2020,83,25812,3165,274021,299833,8,2104,10,1725,0,310,69,6,5,1,992,57,17653,1478,158825,176478,9/3/2020
7/14/2020,74,25886,3286,277307,303193,7,2111,4,1729,0,310,72,5,5,1,993,49,17702,1364,160189,177891,9/3/2020
7/15/2020,122,26008,4146,281453,307461,5,2116,7,1736,0,310,70,5,4,0,993,95,17797,1734,161923,179720,9/3/2020
7/16/2020,102,26110,3726,285179,311289,6,2122,9,1745,0,310,67,6,5,1,994,78,17875,1607,163530,181405,9/3/2020
7/17/2020,154,26264,4190,289369,315633,14,2136,3,1748,1,311,77,5,5,1,995,79,17954,1807,165337,183291,9/3/2020
7/18/2020,80,26344,3176,292545,318889,5,2141,9,1757,1,312,72,5,4,4,999,66,18020,1332,166669,184689,9/3/2020
7/19/2020,83,26427,2605,295150,321577,6,2147,3,1760,0,312,75,6,4,2,1001,59,18079,1066,167735,185814,9/3/2020
7/20/2020,71,26498,2657,297807,324305,9,2156,7,1767,0,312,77,7,5,2,1003,69,18148,1461,169196,187344,9/3/2020
7/21/2020,127,26625,4240,302047,328672,9,2165,10,1777,0,312,76,9,6,1,1004,110,18258,1873,171069,189327,9/3/2020
7/22/2020,122,26747,3807,305854,332601,11,2176,11,1788,1,313,75,7,6,1,1005,86,18344,1582,172651,190995,9/3/2020
7/23/2020,120,26867,4205,310059,336926,8,2184,5,1793,0,313,78,8,7,0,1005,105,18449,1837,174488,192937,9/3/2020
7/24/2020,168,27035,5833,315892,342927,13,2197,13,1806,0,313,78,9,7,0,1005,125,18574,2219,176707,195281,9/3/2020
7/25/2020,128,27163,4296,320188,347351,7,2204,7,1813,0,313,78,10,8,1,1006,104,18678,2008,178715,197393,9/3/2020
7/26/2020,56,27219,2985,323173,350392,8,2212,9,1822,0,313,77,11,7,1,1007,53,18731,1300,180015,198746,9/3/2020
7/27/2020,181,27400,3959,327132,354532,12,2224,7,1829,0,313,82,13,8,1,1008,138,18869,2156,182171,201040,9/3/2020
7/28/2020,104,27504,3844,330976,358480,5,2229,5,1834,0,313,82,14,7,1,1009,89,18958,1637,183808,202766,9/3/2020
7/29/2020,170,27674,4894,335870,363544,10,2239,12,1846,0,313,80,15,7,0,1009,150,19108,2126,185934,205042,9/3/2020
7/30/2020,99,27773,4104,339974,367747,6,2245,2,1848,1,314,83,15,6,0,1009,79,19187,1451,187385,206572,9/3/2020
7/31/2020,123,27896,5391,345365,373261,8,2253,9,1857,0,314,82,15,7,0,1009,87,19274,1767,189152,208426,9/3/2020
8/1/2020,101,27997,4108,349473,377470,7,2260,2,1859,0,314,87,14,7,1,1010,84,19358,1426,190578,209936,9/3/2020
8/2/2020,80,28077,2787,352260,380337,12,2272,12,1871,2,316,85,14,8,2,1012,63,19421,1260,191838,211259,9/3/2020
8/3/2020,176,28253,4926,357186,385439,13,2285,12,1883,0,316,86,16,7,1,1013,149,19570,1961,193799,213369,9/3/2020
8/4/2020,125,28378,3613,360799,389177,8,2293,6,1889,1,317,87,12,5,2,1015,105,19675,1712,195511,215186,9/3/2020
8/5/2020,139,28517,5743,366542,395059,12,2305,10,1899,1,318,88,10,5,2,1017,111,19786,2340,197851,217637,9/3/2020
8/6/2020,165,28682,5278,371820,400502,6,2311,9,1908,0,318,85,9,4,0,1017,117,19903,2231,200082,219985,9/3/2020
8/7/2020,112,28794,4586,376406,405200,13,2324,10,1918,1,319,87,9,3,1,1018,85,19988,1942,202024,222012,9/3/2020
8/8/2020,108,28902,3917,380323,409225,19,2343,6,1924,1,320,99,8,3,1,1019,91,20079,1634,203658,223737,9/3/2020
8/9/2020,39,28941,1622,381945,410886,8,2351,11,1935,0,320,96,9,4,0,1019,34,20113,997,204655,224768,9/3/2020
8/10/2020,137,29078,4329,386274,415352,11,2362,11,1946,0,320,96,9,4,1,1020,108,20221,1829,206484,226705,9/3/2020
8/11/2020,105,29183,4220,390494,419677,6,2368,14,1960,0,320,88,10,4,2,1022,95,20316,2188,208672,228988,9/3/2020
8/12/2020,118,29301,5080,395574,424875,8,2376,11,1971,0,320,85,9,3,1,1023,104,20420,2552,211224,231644,9/3/2020
8/13/2020,114,29415,3918,399492,428907,12,2388,11,1982,0,320,86,11,3,0,1023,89,20509,1700,212924,233433,9/3/2020
8/14/2020,137,29552,5371,404863,434415,13,2401,11,1993,0,320,88,11,4,2,1025,97,20606,1875,214799,235405,9/3/2020
8/15/2020,101,29653,4297,409160,438813,8,2409,11,2004,1,321,84,11,5,0,1025,92,20698,1527,216326,237024,9/3/2020
8/16/2020,77,29730,2798,411958,441688,7,2416,6,2010,4,325,81,8,4,5,1030,68,20766,999,217325,238091,9/3/2020
8/17/2020,104,29834,4342,416300,446134,10,2426,7,2017,0,325,84,8,5,2,1032,85,20851,2241,219566,240417,9/3/2020
8/18/2020,125,29959,4913,421213,451172,11,2437,9,2026,1,326,85,8,4,5,1037,93,20944,2702,222268,243212,9/3/2020
8/19/2020,100,30059,5239,426452,456511,8,2445,9,2035,1,327,83,9,5,0,1037,80,21024,2553,224821,245845,9/3/2020
8/20/2020,173,30232,8068,434520,464752,12,2457,6,2041,2,329,87,10,5,3,1040,137,21161,3444,228265,249426,9/3/2020
8/21/2020,141,30373,6616,441136,471509,8,2465,5,2046,1,330,89,9,4,2,1042,116,21277,2826,231091,252368,9/3/2020
8/22/2020,96,30469,5777,446913,477382,10,2475,12,2058,0,330,87,11,4,1,1043,84,21361,2490,233581,254942,9/3/2020
8/23/2020,64,30533,4375,451288,481821,10,2485,6,2064,0,330,91,11,2,1,1044,54,21415,2489,236070,257485,9/3/2020
8/24/2020,90,30623,5341,456629,487252,6,2491,10,2074,1,331,86,13,4,1,1045,74,21489,2870,238940,260429,9/3/2020
8/25/2020,106,30729,4758,461387,492116,10,2501,4,2078,1,332,91,11,4,1,1046,95,21584,2272,241212,262796,9/3/2020
8/26/2020,162,30891,9425,470812,501703,3,2504,8,2086,0,332,86,9,5,1,1047,120,21704,2968,244180,265884,9/3/2020
8/27/2020,87,30978,8649,479461,510439,4,2508,13,2099,1,333,76,6,5,2,1049,69,21773,3087,247267,269040,9/3/2020
8/28/2020,100,31078,7899,487360,518438,12,2520,4,2103,0,333,84,9,7,2,1051,77,21850,2326,249593,271443,9/3/2020
8/29/2020,64,31142,5362,492722,523864,6,2526,8,2111,1,334,81,10,6,1,1052,52,21902,1808,251401,273303,9/3/2020
8/30/2020,64,31206,4134,496856,528062,5,2531,4,2115,0,334,82,8,5,1,1053,47,21949,1922,253323,275272,9/3/2020
8/31/2020,79,31285,4429,501285,532570,6,2537,14,2129,0,334,74,8,4,0,1053,78,22027,1989,255312,277339,9/3/2020
9/1/2020,88,31373,6513,507798,539171,3,2540,8,2137,1,335,68,7,4,0,1053,60,22087,2108,257420,279507,9/3/2020
9/2/2020,74,31447,8348,516146,547593,,,,,,,,,,2,1055,56,22143,2070,259490,281633,9/3/2020
2/27/2020,0,0,0,0,0,1,1,0,0,0,0,1,0,0,0,0,0,0,0,0,0,9/4/2020
2/28/2020,0,0,0,0,0,0,1,0,0,0,0,1,1,0,0,0,0,0,0,0,0,9/4/2020
2/29/2020,0,0,0,0,0,0,1,0,0,0,0,1,1,0,0,0,0,0,0,0,0,9/4/2020
3/1/2020,2,2,2,2,4,0,1,0,0,0,0,1,1,1,0,0,2,2,2,2,4,9/4/2020
3/2/2020,0,2,1,3,5,1,2,0,0,0,0,2,2,2,0,0,0,2,1,3,5,9/4/2020
3/3/2020,0,2,2,5,7,0,2,0,0,0,0,2,2,2,0,0,0,2,2,5,7,9/4/2020
3/4/2020,0,2,12,17,19,1,3,0,0,0,0,3,2,2,0,0,0,2,10,15,17,9/4/2020
3/5/2020,0,2,4,21,23,0,3,0,0,0,0,3,2,2,0,0,1,3,4,19,22,9/4/2020
3/6/2020,1,3,12,33,36,0,3,0,0,0,0,3,2,2,0,0,0,3,11,30,33,9/4/2020
3/7/2020,0,3,19,52,55,0,3,0,0,0,0,3,2,1,0,0,0,3,19,49,52,9/4/2020
3/8/2020,0,3,18,70,73,0,3,0,0,0,0,3,2,1,0,0,0,3,18,67,70,9/4/2020
3/9/2020,1,4,15,85,89,0,3,0,0,0,0,3,2,1,0,0,1,4,15,82,86,9/4/2020
3/10/2020,2,6,25,110,116,0,3,0,0,0,0,3,2,1,0,0,1,5,23,105,110,9/4/2020
3/11/2020,0,6,34,144,150,1,4,0,0,0,0,4,1,1,0,0,0,5,34,139,144,9/4/2020
3/12/2020,9,15,41,185,200,1,5,0,0,0,0,5,1,1,0,0,8,13,38,177,190,9/4/2020
3/13/2020,6,21,50,235,256,4,9,1,1,0,0,8,1,1,0,0,6,19,48,225,244,9/4/2020
3/14/2020,0,21,90,325,346,0,9,0,1,0,0,8,1,1,0,0,0,19,86,311,330,9/4/2020
3/15/2020,1,22,54,379,401,1,10,0,1,0,0,9,2,1,0,0,1,20,54,365,385,9/4/2020
3/16/2020,2,24,95,474,498,2,12,0,1,0,0,11,2,0,0,0,2,22,92,457,479,9/4/2020
3/17/2020,16,40,162,636,676,6,18,0,1,0,0,17,2,0,0,0,11,33,151,608,641,9/4/2020
3/18/2020,12,52,116,752,804,3,21,0,1,0,0,20,2,0,0,0,11,44,111,719,763,9/4/2020
3/19/2020,17,69,262,1014,1083,2,23,1,2,0,0,21,3,0,1,1,17,61,251,970,1031,9/4/2020
3/20/2020,14,83,197,1211,1294,5,28,0,2,0,0,26,4,0,0,1,13,74,192,1162,1236,9/4/2020
3/21/2020,21,104,126,1337,1441,3,31,2,4,0,0,27,5,0,0,1,14,88,123,1285,1373,9/4/2020
3/22/2020,30,134,282,1619,1753,2,33,0,4,0,0,29,5,0,0,1,25,113,262,1547,1660,9/4/2020
3/23/2020,14,148,169,1788,1936,15,48,1,5,0,0,43,9,3,0,1,16,129,165,1712,1841,9/4/2020
3/24/2020,20,168,242,2030,2198,7,55,0,5,0,0,50,10,4,0,1,19,148,238,1950,2098,9/4/2020
3/25/2020,26,194,183,2213,2407,5,60,1,6,0,0,54,11,3,0,1,28,176,172,2122,2298,9/4/2020
3/26/2020,35,229,181,2394,2623,10,70,5,11,0,0,59,14,5,0,1,41,217,176,2298,2515,9/4/2020
3/27/2020,27,256,215,2609,2865,9,79,1,12,1,1,66,17,6,2,3,31,248,202,2500,2748,9/4/2020
3/28/2020,59,315,260,2869,3184,13,92,3,15,2,3,74,15,6,1,4,63,311,241,2741,3052,9/4/2020
3/29/2020,106,421,356,3225,3646,8,100,4,19,1,4,77,18,8,2,6,105,416,314,3055,3471,9/4/2020
3/30/2020,62,483,222,3447,3930,20,120,5,24,0,4,92,20,11,3,9,78,494,186,3241,3735,9/4/2020
3/31/2020,71,554,369,3816,4370,11,131,7,31,1,5,95,22,13,2,11,73,567,298,3539,4106,9/4/2020
4/1/2020,99,653,699,4515,5168,18,149,7,38,0,5,106,30,15,1,12,101,668,643,4182,4850,9/4/2020
4/2/2020,52,705,477,4992,5697,22,171,6,44,2,7,120,36,21,4,16,62,730,436,4618,5348,9/4/2020
4/3/2020,108,813,775,5767,6580,23,194,7,51,0,7,136,43,25,3,19,100,830,714,5332,6162,9/4/2020
4/4/2020,143,956,660,6427,7383,22,216,4,55,5,12,149,41,30,9,28,137,967,620,5952,6919,9/4/2020
4/5/2020,187,1143,1156,7583,8726,20,236,9,64,1,13,159,44,36,2,30,182,1149,1070,7022,8171,9/4/2020
4/6/2020,218,1361,1707,9290,10651,26,262,7,71,0,13,178,48,40,7,37,206,1355,1563,8585,9940,9/4/2020
4/7/2020,285,1646,1631,10921,12567,19,281,4,75,2,15,191,50,42,5,42,261,1616,1486,10071,11687,9/4/2020
4/8/2020,290,1936,1723,12644,14580,19,300,7,82,6,21,197,50,38,10,52,272,1888,1567,11638,13526,9/4/2020
4/9/2020,284,2220,1521,14165,16385,32,332,9,91,4,25,216,53,40,7,59,280,2168,1360,12998,15166,9/4/2020
4/10/2020,420,2640,2577,16742,19382,29,361,15,106,5,30,225,59,41,11,70,403,2571,2375,15373,17944,9/4/2020
4/11/2020,299,2939,1911,18653,21592,29,390,11,117,2,32,241,61,48,12,82,281,2852,1720,17093,19945,9/4/2020
4/12/2020,315,3254,1674,20327,23581,35,425,13,130,5,37,258,59,49,9,91,289,3141,1440,18533,21674,9/4/2020
4/13/2020,162,3416,938,21265,24681,35,460,13,143,3,40,277,64,54,9,100,187,3328,841,19374,22702,9/4/2020
4/14/2020,289,3705,1788,23053,26758,27,487,17,160,5,45,282,72,53,8,108,265,3593,1529,20903,24496,9/4/2020
4/15/2020,353,4058,1803,24856,28914,31,518,20,180,3,48,290,72,54,17,125,307,3900,1564,22467,26367,9/4/2020
4/16/2020,449,4507,2500,27356,31863,36,554,25,205,6,54,295,72,53,14,139,391,4291,2084,24551,28842,9/4/2020
4/17/2020,308,4815,1823,29179,33994,32,586,20,225,7,61,300,66,45,21,160,293,4584,1458,26009,30593,9/4/2020
4/18/2020,322,5137,1728,30907,36044,26,612,18,243,4,65,304,63,49,15,175,286,4870,1344,27353,32223,9/4/2020
4/19/2020,382,5519,2059,32966,38485,23,635,26,269,1,66,300,65,55,11,186,338,5208,1746,29099,34307,9/4/2020
4/20/2020,396,5915,1909,34875,40790,46,681,29,298,2,68,315,75,56,10,196,377,5585,1578,30677,36262,9/4/2020
4/21/2020,445,6360,2114,36989,43349,45,726,31,329,5,73,324,72,56,18,214,390,5975,1718,32395,38370,9/4/2020
4/22/2020,420,6780,2398,39387,46167,41,767,32,361,5,78,328,73,58,18,232,385,6360,1917,34312,40672,9/4/2020
4/23/2020,481,7261,2471,41858,49119,32,799,28,389,5,83,327,76,62,15,247,419,6779,1868,36180,42959,9/4/2020
4/24/2020,494,7755,3292,45150,52905,35,834,27,416,4,87,331,85,63,15,262,416,7195,2634,38814,46009,9/4/2020
4/25/2020,394,8149,2210,47360,55509,34,868,17,433,5,92,343,85,62,14,276,304,7499,1777,40591,48090,9/4/2020
4/26/2020,316,8465,2314,49674,58139,33,901,15,448,3,95,358,86,59,14,290,275,7774,1884,42475,50249,9/4/2020
4/27/2020,250,8715,1624,51298,60013,29,930,21,469,4,99,362,86,61,10,300,204,7978,1163,43638,51616,9/4/2020
4/28/2020,411,9126,2268,53566,62692,44,974,24,493,3,102,379,88,59,22,322,330,8308,1769,45407,53715,9/4/2020
4/29/2020,476,9602,3351,56917,66519,36,1010,38,531,11,113,366,78,53,18,340,373,8681,2434,47841,56522,9/4/2020
4/30/2020,432,10034,2772,59689,69723,33,1043,38,569,6,119,355,83,57,24,364,352,9033,1955,49796,58829,9/4/2020
5/1/2020,457,10491,3089,62778,73269,51,1094,39,608,3,122,364,84,58,14,378,320,9353,2217,52013,61366,9/4/2020
5/2/2020,260,10751,1927,64705,75456,36,1130,39,647,5,127,356,91,62,24,402,189,9542,1292,53305,62847,9/4/2020
5/3/2020,284,11035,2168,66873,77908,31,1161,27,674,8,135,352,90,61,21,423,182,9724,1602,54907,64631,9/4/2020
5/4/2020,388,11423,2101,68974,80397,30,1191,31,705,5,140,346,88,57,18,441,293,10017,1570,56477,66494,9/4/2020
5/5/2020,436,11859,2878,71852,83711,29,1220,32,737,6,146,337,82,54,16,457,308,10325,1967,58444,68769,9/4/2020
5/6/2020,490,12349,2836,74688,87037,28,1248,44,781,9,155,312,79,54,21,478,342,10667,1923,60367,71034,9/4/2020
5/7/2020,425,12774,2975,77663,90437,36,1284,42,823,5,160,301,71,52,21,499,274,10941,1978,62345,73286,9/4/2020
5/8/2020,360,13134,2603,80266,93400,30,1314,29,852,5,165,297,71,53,22,521,233,11174,1749,64094,75268,9/4/2020
5/9/2020,470,13604,3356,83622,97226,22,1336,21,873,4,169,294,69,51,15,536,291,11465,2274,66368,77833,9/4/2020
5/10/2020,285,13889,2122,85744,99633,20,1356,23,896,6,175,285,70,49,13,549,187,11652,1525,67893,79545,9/4/2020
5/11/2020,259,14148,1861,87605,101753,31,1387,16,912,6,181,294,71,49,15,564,179,11831,1305,69198,81029,9/4/2020
5/12/2020,387,14535,2622,90227,104762,23,1410,18,930,4,185,295,69,48,22,586,220,12051,1713,70911,82962,9/4/2020
5/13/2020,352,14887,3634,93861,108748,23,1433,25,955,1,186,292,69,49,13,599,199,12250,2014,72925,85175,9/4/2020
5/14/2020,330,15217,3415,97276,112493,19,1452,27,982,3,189,281,64,45,15,614,231,12481,2021,74946,87427,9/4/2020
5/15/2020,382,15599,3470,100746,116345,24,1476,41,1023,5,194,259,62,45,13,627,237,12718,1814,76760,89478,9/4/2020
5/16/2020,453,16052,4168,104914,120966,25,1501,13,1036,5,199,266,61,46,15,642,252,12970,1967,78727,91697,9/4/2020
5/17/2020,240,16292,2775,107689,123981,17,1518,8,1044,5,204,270,59,45,10,652,129,13099,1563,80290,93389,9/4/2020
5/18/2020,251,16543,2007,109696,126239,19,1537,15,1059,5,209,269,57,40,18,670,140,13239,1373,81663,94902,9/4/2020
5/19/2020,416,16959,3178,112874,129833,23,1560,32,1091,5,214,255,56,38,11,681,214,13453,1934,83597,97050,9/4/2020
5/20/2020,328,17287,2775,115649,132936,19,1579,23,1114,7,221,244,52,33,22,703,188,13641,1519,85116,98757,9/4/2020
5/21/2020,374,17661,3764,119413,137074,26,1605,15,1129,3,224,252,53,29,20,723,170,13811,1947,87063,100874,9/4/2020
5/22/2020,353,18014,3172,122585,140599,20,1625,29,1158,5,229,238,52,29,10,733,204,14015,1615,88678,102693,9/4/2020
5/23/2020,253,18267,2748,125333,143600,19,1644,11,1169,3,232,243,52,32,13,746,108,14123,1278,89956,104079,9/4/2020
5/24/2020,165,18432,1372,126705,145137,12,1656,14,1183,2,234,239,53,36,8,754,83,14206,773,90729,104935,9/4/2020
5/25/2020,147,18579,1389,128094,146673,13,1669,14,1197,0,234,238,53,34,10,764,71,14277,762,91491,105768,9/4/2020
5/26/2020,285,18864,2624,130718,149582,24,1693,22,1219,5,239,235,48,33,15,779,165,14442,1782,93273,107715,9/4/2020
5/27/2020,276,19140,2125,132843,151983,20,1713,18,1237,3,242,234,50,33,10,789,134,14576,1136,94409,108985,9/4/2020
5/28/2020,349,19489,3372,136215,155704,17,1730,29,1266,4,246,218,47,32,8,797,134,14710,1124,95533,110243,9/4/2020
5/29/2020,417,19906,3973,140188,160094,19,1749,27,1293,6,252,204,43,31,12,809,177,14887,1576,97109,111996,9/4/2020
5/30/2020,228,20134,3972,144160,164294,15,1764,19,1312,4,256,196,40,29,12,821,109,14996,1822,98931,113927,9/4/2020
5/31/2020,159,20293,1759,145919,166212,11,1775,10,1322,0,256,197,43,26,3,824,77,15073,857,99788,114861,9/4/2020
6/1/2020,215,20508,2823,148742,169250,8,1783,14,1336,1,257,190,44,29,5,829,99,15172,1387,101175,116347,9/4/2020
6/2/2020,273,20781,3076,151818,172599,8,1791,9,1345,3,260,186,37,25,10,839,107,15279,1455,102630,117909,9/4/2020
6/3/2020,260,21041,3514,155332,176373,13,1804,18,1363,6,266,175,34,25,11,850,105,15384,1667,104297,119681,9/4/2020
6/4/2020,281,21322,4536,159868,181190,7,1811,25,1388,3,269,154,31,24,11,861,111,15495,2042,106339,121834,9/4/2020
6/5/2020,216,21538,3586,163454,184992,15,1826,13,1401,6,275,150,27,21,10,871,106,15601,1579,107918,123519,9/4/2020
6/6/2020,203,21741,2630,166084,187825,10,1836,7,1408,2,277,151,29,19,6,877,69,15670,1138,109056,124726,9/4/2020
6/7/2020,83,21824,1629,167713,189537,11,1847,7,1415,1,278,154,25,17,4,881,50,15720,783,109839,125559,9/4/2020
6/8/2020,120,21944,1852,169565,191509,15,1862,12,1427,2,280,155,27,18,4,885,44,15764,964,110803,126567,9/4/2020
6/9/2020,223,22167,2683,172248,194415,10,1872,18,1445,0,280,147,28,21,1,886,67,15831,1261,112064,127895,9/4/2020
6/10/2020,210,22377,2999,175247,197624,13,1885,12,1457,2,282,146,24,17,3,889,105,15936,1469,113533,129469,9/4/2020
6/11/2020,195,22572,3518,178765,201337,7,1892,15,1472,1,283,137,25,16,6,895,88,16024,1540,115073,131097,9/4/2020
6/12/2020,209,22781,4614,183379,206160,9,1901,15,1487,1,284,130,24,16,2,897,82,16106,2188,117261,133367,9/4/2020
6/13/2020,114,22895,3044,186423,209318,6,1907,4,1491,0,284,132,20,15,3,900,50,16156,1376,118637,134793,9/4/2020
6/14/2020,81,22976,2050,188473,211449,6,1913,8,1499,1,285,129,20,14,3,903,32,16188,969,119606,135794,9/4/2020
6/15/2020,189,23165,3117,191590,214755,14,1927,14,1513,0,285,129,20,16,4,907,78,16266,1794,121400,137666,9/4/2020
6/16/2020,111,23276,3024,194614,217890,10,1937,9,1522,1,286,129,22,16,8,915,52,16318,1579,122979,139297,9/4/2020
6/17/2020,128,23404,2843,197457,220861,15,1952,20,1542,4,290,120,18,14,6,921,53,16371,1324,124303,140674,9/4/2020
6/18/2020,149,23553,3056,200513,224066,9,1961,13,1555,1,291,115,19,16,7,928,70,16441,1339,125642,142083,9/4/2020
6/19/2020,141,23694,3773,204286,227980,12,1973,11,1566,1,292,115,20,17,3,931,59,16500,1374,127016,143516,9/4/2020
6/20/2020,84,23778,1896,206182,229960,9,1982,12,1578,0,292,112,20,18,4,935,36,16536,816,127832,144368,9/4/2020
6/21/2020,37,23815,1069,207251,231066,8,1990,5,1583,0,292,115,20,18,2,937,28,16564,692,128524,145088,9/4/2020
6/22/2020,138,23953,3736,210987,234940,12,2002,16,1599,0,292,111,19,18,1,938,69,16633,1711,130235,146868,9/4/2020
6/23/2020,163,24116,3854,214841,238957,3,2005,13,1612,3,295,98,18,18,7,945,83,16716,1788,132023,148739,9/4/2020
6/24/2020,120,24236,3518,218359,242595,9,2014,10,1622,1,296,96,18,18,5,950,46,16762,1690,133713,150475,9/4/2020
6/25/2020,103,24339,2899,221258,245597,6,2020,14,1636,1,297,87,17,17,1,951,54,16816,1518,135231,152047,9/4/2020
6/26/2020,94,24433,2499,223757,248190,2,2022,10,1646,0,297,79,18,18,1,952,63,16879,1336,136567,153446,9/4/2020
6/27/2020,84,24517,3227,226984,251501,5,2027,3,1649,1,298,80,17,17,5,957,37,16916,1221,137788,154704,9/4/2020
6/28/2020,40,24557,1471,228455,253012,4,2031,4,1653,4,302,76,15,14,6,963,19,16935,596,138384,155319,9/4/2020
6/29/2020,85,24642,3689,232144,256786,4,2035,5,1658,0,302,75,14,14,1,964,39,16974,1345,139729,156703,9/4/2020
6/30/2020,59,24701,1964,234108,258809,1,2036,5,1663,1,303,70,12,11,3,967,33,17007,996,140725,157732,9/4/2020
7/1/2020,145,24846,4111,238219,263065,7,2043,9,1672,0,303,68,11,11,1,968,80,17087,1939,142664,159751,9/4/2020
7/2/2020,102,24948,2805,241024,265972,5,2048,5,1677,1,304,67,10,10,1,969,56,17143,1091,143755,160898,9/4/2020
7/3/2020,50,24998,2068,243092,268090,9,2057,6,1683,0,304,70,9,9,3,972,26,17169,774,144529,161698,9/4/2020
7/4/2020,58,25056,2334,245426,270482,2,2059,4,1687,1,305,67,10,9,2,974,34,17203,997,145526,162729,9/4/2020
7/5/2020,51,25107,2939,248365,273472,1,2060,2,1689,1,306,65,8,8,2,976,26,17229,1448,146974,164203,9/4/2020
7/6/2020,102,25209,2820,251185,276394,6,2066,6,1695,0,306,65,9,9,4,980,58,17287,1554,148528,165815,9/4/2020
7/7/2020,82,25291,3458,254643,279934,5,2071,7,1702,0,306,63,8,8,2,982,48,17335,1525,150053,167388,9/4/2020
7/8/2020,105,25396,3401,258044,283440,4,2075,2,1704,0,306,65,9,8,0,982,64,17399,1414,151467,168866,9/4/2020
7/9/2020,94,25490,3676,261720,287210,9,2084,3,1707,0,306,71,9,8,0,982,50,17449,1593,153060,170509,9/4/2020
7/10/2020,131,25621,4445,266165,291786,6,2090,3,1710,2,308,72,7,7,3,985,80,17529,2084,155144,172673,9/4/2020
7/11/2020,63,25684,2906,269071,294755,6,2096,3,1713,1,309,74,6,6,3,988,34,17563,1291,156435,173998,9/4/2020
7/12/2020,45,25729,1785,270856,296585,1,2097,3,1716,1,310,71,6,5,3,991,34,17597,897,157332,174929,9/4/2020
7/13/2020,83,25812,3165,274021,299833,8,2105,10,1726,0,310,69,6,5,1,992,57,17654,1478,158810,176464,9/4/2020
7/14/2020,74,25886,3286,277307,303193,7,2112,4,1730,0,310,72,5,5,1,993,49,17703,1364,160174,177877,9/4/2020
7/15/2020,122,26008,4146,281453,307461,5,2117,7,1737,0,310,70,5,4,0,993,95,17798,1734,161908,179706,9/4/2020
7/16/2020,102,26110,3726,285179,311289,6,2123,9,1746,0,310,67,6,5,1,994,78,17876,1606,163514,181390,9/4/2020
7/17/2020,154,26264,4190,289369,315633,14,2137,3,1749,1,311,77,5,5,1,995,79,17955,1807,165321,183276,9/4/2020
7/18/2020,80,26344,3176,292545,318889,5,2142,9,1758,1,312,72,5,4,4,999,66,18021,1332,166653,184674,9/4/2020
7/19/2020,83,26427,2605,295150,321577,6,2148,3,1761,0,312,75,6,4,2,1001,59,18080,1066,167719,185799,9/4/2020
7/20/2020,71,26498,2657,297807,324305,9,2157,7,1768,0,312,77,7,5,2,1003,69,18149,1461,169180,187329,9/4/2020
7/21/2020,127,26625,4240,302047,328672,9,2166,10,1778,0,312,76,9,6,1,1004,110,18259,1872,171052,189311,9/4/2020
7/22/2020,122,26747,3807,305854,332601,11,2177,11,1789,1,313,75,7,6,1,1005,86,18345,1582,172634,190979,9/4/2020
7/23/2020,120,26867,4205,310059,336926,8,2185,5,1794,0,313,78,8,7,0,1005,105,18450,1837,174471,192921,9/4/2020
7/24/2020,168,27035,5833,315892,342927,13,2198,13,1807,0,313,78,9,7,0,1005,125,18575,2219,176690,195265,9/4/2020
7/25/2020,128,27163,4296,320188,347351,7,2205,7,1814,0,313,78,10,8,1,1006,104,18679,2008,178698,197377,9/4/2020
7/26/2020,56,27219,2985,323173,350392,8,2213,9,1823,0,313,77,11,7,1,1007,53,18732,1300,179998,198730,9/4/2020
7/27/2020,181,27400,3959,327132,354532,12,2225,7,1830,0,313,82,13,8,1,1008,138,18870,2156,182154,201024,9/4/2020
7/28/2020,104,27504,3844,330976,358480,5,2230,5,1835,0,313,82,14,7,1,1009,89,18959,1637,183791,202750,9/4/2020
7/29/2020,170,27674,4894,335870,363544,10,2240,12,1847,0,313,80,15,7,0,1009,150,19109,2126,185917,205026,9/4/2020
7/30/2020,99,27773,4104,339974,367747,6,2246,2,1849,1,314,83,15,6,0,1009,79,19188,1451,187368,206556,9/4/2020
7/31/2020,123,27896,5391,345365,373261,8,2254,9,1858,0,314,82,15,7,0,1009,87,19275,1767,189135,208410,9/4/2020
8/1/2020,101,27997,4108,349473,377470,7,2261,2,1860,0,314,87,14,7,1,1010,85,19360,1426,190561,209921,9/4/2020
8/2/2020,80,28077,2787,352260,380337,12,2273,12,1872,2,316,85,14,8,2,1012,63,19423,1260,191821,211244,9/4/2020
8/3/2020,176,28253,4926,357186,385439,13,2286,12,1884,0,316,86,16,7,1,1013,149,19572,1961,193782,213354,9/4/2020
8/4/2020,125,28378,3613,360799,389177,8,2294,6,1890,1,317,87,12,5,2,1015,105,19677,1712,195494,215171,9/4/2020
8/5/2020,139,28517,5743,366542,395059,12,2306,10,1900,1,318,88,10,5,2,1017,111,19788,2339,197833,217621,9/4/2020
8/6/2020,165,28682,5278,371820,400502,6,2312,9,1909,0,318,85,9,4,0,1017,117,19905,2230,200063,219968,9/4/2020
8/7/2020,112,28794,4586,376406,405200,13,2325,10,1919,1,319,87,9,3,1,1018,85,19990,1942,202005,221995,9/4/2020
8/8/2020,108,28902,3917,380323,409225,19,2344,6,1925,1,320,99,8,3,1,1019,92,20082,1634,203639,223721,9/4/2020
8/9/2020,39,28941,1622,381945,410886,8,2352,11,1936,0,320,96,9,4,0,1019,34,20116,997,204636,224752,9/4/2020
8/10/2020,137,29078,4329,386274,415352,11,2363,11,1947,0,320,96,9,4,1,1020,108,20224,1828,206464,226688,9/4/2020
8/11/2020,105,29183,4220,390494,419677,6,2369,14,1961,0,320,88,10,4,2,1022,95,20319,2188,208652,228971,9/4/2020
8/12/2020,118,29301,5080,395574,424875,8,2377,11,1972,0,320,85,9,3,1,1023,104,20423,2551,211203,231626,9/4/2020
8/13/2020,114,29415,3918,399492,428907,12,2389,11,1983,0,320,86,11,3,0,1023,89,20512,1699,212902,233414,9/4/2020
8/14/2020,137,29552,5371,404863,434415,13,2402,11,1994,0,320,88,11,4,2,1025,97,20609,1874,214776,235385,9/4/2020
8/15/2020,101,29653,4297,409160,438813,8,2410,11,2005,1,321,84,11,5,0,1025,92,20701,1527,216303,237004,9/4/2020
8/16/2020,77,29730,2798,411958,441688,7,2417,6,2011,4,325,81,8,4,5,1030,68,20769,999,217302,238071,9/4/2020
8/17/2020,104,29834,4342,416300,446134,10,2427,7,2018,0,325,84,8,5,2,1032,85,20854,2240,219542,240396,9/4/2020
8/18/2020,125,29959,4913,421213,451172,11,2438,9,2027,1,326,85,8,4,5,1037,93,20947,2702,222244,243191,9/4/2020
8/19/2020,100,30059,5239,426452,456511,8,2446,9,2036,1,327,83,9,5,0,1037,80,21027,2553,224797,245824,9/4/2020
8/20/2020,173,30232,8068,434520,464752,12,2458,6,2042,2,329,87,10,5,3,1040,137,21164,3440,228237,249401,9/4/2020
8/21/2020,141,30373,6616,441136,471509,8,2466,5,2047,1,330,89,9,4,2,1042,116,21280,2825,231062,252342,9/4/2020
8/22/2020,96,30469,5777,446913,477382,10,2476,12,2059,0,330,87,11,4,1,1043,85,21365,2489,233551,254916,9/4/2020
8/23/2020,64,30533,4375,451288,481821,10,2486,6,2065,0,330,91,11,2,1,1044,54,21419,2489,236040,257459,9/4/2020
8/24/2020,90,30623,5341,456629,487252,7,2493,10,2075,1,331,87,13,4,1,1045,74,21493,2870,238910,260403,9/4/2020
8/25/2020,106,30729,4758,461387,492116,10,2503,4,2079,1,332,92,11,4,1,1046,95,21588,2272,241182,262770,9/4/2020
8/26/2020,162,30891,9426,470813,501704,3,2506,8,2087,0,332,87,9,5,1,1047,120,21708,2968,244150,265858,9/4/2020
8/27/2020,87,30978,8651,479464,510442,4,2510,13,2100,1,333,77,6,5,2,1049,69,21777,3089,247239,269016,9/4/2020
8/28/2020,100,31078,7899,487363,518441,13,2523,4,2104,0,333,86,9,7,2,1051,78,21855,2324,249563,271418,9/4/2020
8/29/2020,64,31142,5362,492725,523867,6,2529,8,2112,1,334,83,10,6,1,1052,54,21909,1808,251371,273280,9/4/2020
8/30/2020,64,31206,4134,496859,528065,6,2535,4,2116,0,334,85,8,5,1,1053,50,21959,1922,253293,275252,9/4/2020
8/31/2020,79,31285,4429,501288,532573,10,2545,15,2131,0,334,80,8,4,0,1053,80,22039,1989,255282,277321,9/4/2020
9/1/2020,89,31374,6588,507876,539250,6,2551,9,2140,1,335,76,7,4,0,1053,69,22108,2163,257445,279553,9/4/2020
9/2/2020,102,31476,9300,517176,548652,8,2559,7,2147,1,336,76,8,4,2,1055,77,22185,2471,259916,282101,9/4/2020
9/3/2020,71,31547,8799,525975,557522,,,,,,,,,,0,1055,58,22243,1847,261763,284006,9/4/2020
2/27/2020,0,0,0,0,0,1,1,0,0,0,0,1,0,0,0,0,0,0,0,0,0,9/8/2020
2/28/2020,0,0,0,0,0,0,1,0,0,0,0,1,1,0,0,0,0,0,0,0,0,9/8/2020
2/29/2020,0,0,0,0,0,0,1,0,0,0,0,1,1,0,0,0,0,0,0,0,0,9/8/2020
3/1/2020,2,2,2,2,4,0,1,0,0,0,0,1,1,1,0,0,2,2,2,2,4,9/8/2020
3/2/2020,0,2,1,3,5,1,2,0,0,0,0,2,2,2,0,0,0,2,1,3,5,9/8/2020
3/3/2020,0,2,2,5,7,0,2,0,0,0,0,2,2,2,0,0,0,2,2,5,7,9/8/2020
3/4/2020,0,2,12,17,19,1,3,0,0,0,0,3,2,2,0,0,0,2,10,15,17,9/8/2020
3/5/2020,0,2,4,21,23,0,3,0,0,0,0,3,2,2,0,0,1,3,4,19,22,9/8/2020
3/6/2020,1,3,12,33,36,0,3,0,0,0,0,3,2,2,0,0,0,3,11,30,33,9/8/2020
3/7/2020,0,3,19,52,55,0,3,0,0,0,0,3,2,1,0,0,0,3,19,49,52,9/8/2020
3/8/2020,0,3,18,70,73,0,3,0,0,0,0,3,2,1,0,0,0,3,18,67,70,9/8/2020
3/9/2020,1,4,15,85,89,0,3,0,0,0,0,3,2,1,0,0,1,4,15,82,86,9/8/2020
3/10/2020,2,6,25,110,116,0,3,0,0,0,0,3,2,1,0,0,1,5,23,105,110,9/8/2020
3/11/2020,0,6,34,144,150,1,4,0,0,0,0,4,1,1,0,0,0,5,34,139,144,9/8/2020
3/12/2020,9,15,41,185,200,1,5,0,0,0,0,5,1,1,0,0,8,13,38,177,190,9/8/2020
3/13/2020,6,21,50,235,256,4,9,1,1,0,0,8,1,1,0,0,6,19,48,225,244,9/8/2020
3/14/2020,0,21,90,325,346,0,9,0,1,0,0,8,1,1,0,0,0,19,86,311,330,9/8/2020
3/15/2020,1,22,54,379,401,1,10,0,1,0,0,9,2,1,0,0,1,20,54,365,385,9/8/2020
3/16/2020,2,24,95,474,498,2,12,0,1,0,0,11,2,0,0,0,2,22,92,457,479,9/8/2020
3/17/2020,16,40,162,636,676,6,18,0,1,0,0,17,2,0,0,0,11,33,151,608,641,9/8/2020
3/18/2020,12,52,116,752,804,3,21,0,1,0,0,20,2,0,0,0,11,44,111,719,763,9/8/2020
3/19/2020,17,69,262,1014,1083,2,23,1,2,0,0,21,3,0,1,1,17,61,251,970,1031,9/8/2020
3/20/2020,14,83,197,1211,1294,5,28,0,2,0,0,26,4,0,0,1,13,74,192,1162,1236,9/8/2020
3/21/2020,21,104,126,1337,1441,3,31,2,4,0,0,27,5,0,0,1,14,88,123,1285,1373,9/8/2020
3/22/2020,30,134,282,1619,1753,2,33,0,4,0,0,29,5,0,0,1,25,113,262,1547,1660,9/8/2020
3/23/2020,14,148,169,1788,1936,15,48,1,5,0,0,43,9,3,0,1,16,129,165,1712,1841,9/8/2020
3/24/2020,20,168,242,2030,2198,7,55,0,5,0,0,50,10,4,0,1,19,148,238,1950,2098,9/8/2020
3/25/2020,26,194,183,2213,2407,5,60,1,6,0,0,54,11,3,0,1,28,176,172,2122,2298,9/8/2020
3/26/2020,35,229,181,2394,2623,10,70,5,11,0,0,59,14,5,0,1,41,217,176,2298,2515,9/8/2020
3/27/2020,27,256,215,2609,2865,9,79,1,12,1,1,66,17,6,2,3,31,248,202,2500,2748,9/8/2020
3/28/2020,59,315,260,2869,3184,13,92,3,15,2,3,74,15,6,1,4,63,311,241,2741,3052,9/8/2020
3/29/2020,106,421,356,3225,3646,8,100,4,19,1,4,77,18,8,2,6,105,416,314,3055,3471,9/8/2020
3/30/2020,62,483,222,3447,3930,20,120,5,24,0,4,92,20,11,3,9,78,494,186,3241,3735,9/8/2020
3/31/2020,71,554,369,3816,4370,11,131,7,31,1,5,95,22,13,2,11,73,567,298,3539,4106,9/8/2020
4/1/2020,99,653,699,4515,5168,18,149,7,38,0,5,106,30,15,1,12,102,669,642,4181,4850,9/8/2020
4/2/2020,52,705,477,4992,5697,22,171,6,44,2,7,120,36,21,4,16,62,731,436,4617,5348,9/8/2020
4/3/2020,108,813,775,5767,6580,23,194,7,51,0,7,136,43,25,3,19,100,831,713,5330,6161,9/8/2020
4/4/2020,143,956,660,6427,7383,22,216,4,55,5,12,149,41,30,9,28,137,968,619,5949,6917,9/8/2020
4/5/2020,187,1143,1156,7583,8726,20,236,9,64,1,13,159,44,36,2,30,182,1150,1069,7018,8168,9/8/2020
4/6/2020,218,1361,1707,9290,10651,26,262,7,71,0,13,178,48,40,7,37,206,1356,1560,8578,9934,9/8/2020
4/7/2020,285,1646,1631,10921,12567,19,281,4,75,2,15,191,50,42,5,42,261,1617,1485,10063,11680,9/8/2020
4/8/2020,290,1936,1723,12644,14580,19,300,7,82,6,21,197,50,38,10,52,272,1889,1567,11630,13519,9/8/2020
4/9/2020,284,2220,1521,14165,16385,32,332,9,91,4,25,216,53,40,7,59,280,2169,1360,12990,15159,9/8/2020
4/10/2020,420,2640,2577,16742,19382,29,361,15,106,5,30,225,59,41,11,70,403,2572,2374,15364,17936,9/8/2020
4/11/2020,299,2939,1911,18653,21592,29,390,11,117,2,32,241,61,48,12,82,281,2853,1720,17084,19937,9/8/2020
4/12/2020,315,3254,1674,20327,23581,35,425,13,130,5,37,258,59,49,9,91,289,3142,1440,18524,21666,9/8/2020
4/13/2020,162,3416,938,21265,24681,35,460,13,143,3,40,277,64,54,9,100,187,3329,840,19364,22693,9/8/2020
4/14/2020,289,3705,1788,23053,26758,27,487,17,160,5,45,282,72,53,8,108,265,3594,1529,20893,24487,9/8/2020
4/15/2020,353,4058,1803,24856,28914,31,518,20,180,3,48,290,72,54,17,125,307,3901,1563,22456,26357,9/8/2020
4/16/2020,449,4507,2500,27356,31863,36,554,25,205,6,54,295,72,53,14,139,391,4292,2082,24538,28830,9/8/2020
4/17/2020,308,4815,1823,29179,33994,32,586,20,225,7,61,300,66,45,21,160,293,4585,1455,25993,30578,9/8/2020
4/18/2020,322,5137,1728,30907,36044,26,612,18,243,4,65,304,63,49,15,175,286,4871,1340,27333,32204,9/8/2020
4/19/2020,382,5519,2059,32966,38485,23,635,26,269,1,66,300,65,55,11,186,338,5209,1746,29079,34288,9/8/2020
4/20/2020,396,5915,1909,34875,40790,46,681,29,298,2,68,315,75,56,10,196,377,5586,1578,30657,36243,9/8/2020
4/21/2020,445,6360,2114,36989,43349,45,726,31,329,5,73,324,72,56,18,214,390,5976,1717,32374,38350,9/8/2020
4/22/2020,420,6780,2398,39387,46167,41,767,32,361,5,78,328,73,58,18,232,385,6361,1917,34291,40652,9/8/2020
4/23/2020,481,7261,2471,41858,49119,32,799,28,389,5,83,327,76,62,15,247,419,6780,1866,36157,42937,9/8/2020
4/24/2020,494,7755,3292,45150,52905,35,834,27,416,4,87,331,85,63,15,262,416,7196,2633,38790,45986,9/8/2020
4/25/2020,394,8149,2210,47360,55509,34,868,17,433,5,92,343,85,62,14,276,304,7500,1777,40567,48067,9/8/2020
4/26/2020,316,8465,2314,49674,58139,33,901,15,448,3,95,358,86,59,14,290,275,7775,1883,42450,50225,9/8/2020
4/27/2020,250,8715,1624,51298,60013,29,930,21,469,4,99,362,86,61,10,300,204,7979,1163,43613,51592,9/8/2020
4/28/2020,411,9126,2268,53566,62692,44,974,24,493,3,102,379,88,59,22,322,330,8309,1769,45382,53691,9/8/2020
4/29/2020,476,9602,3351,56917,66519,36,1010,38,531,11,113,366,78,53,18,340,373,8682,2431,47813,56495,9/8/2020
4/30/2020,432,10034,2772,59689,69723,33,1043,38,569,6,119,355,83,57,24,364,352,9034,1955,49768,58802,9/8/2020
5/1/2020,457,10491,3089,62778,73269,51,1094,39,608,3,122,364,84,58,14,378,320,9354,2217,51985,61339,9/8/2020
5/2/2020,260,10751,1927,64705,75456,36,1130,39,647,5,127,356,91,62,24,402,189,9543,1292,53277,62820,9/8/2020
5/3/2020,284,11035,2168,66873,77908,31,1161,27,674,8,135,352,90,61,21,423,182,9725,1602,54879,64604,9/8/2020
5/4/2020,388,11423,2101,68974,80397,30,1191,31,705,5,140,346,88,57,18,441,293,10018,1569,56448,66466,9/8/2020
5/5/2020,436,11859,2878,71852,83711,29,1220,32,737,6,146,337,82,54,16,457,308,10326,1967,58415,68741,9/8/2020
5/6/2020,490,12349,2837,74689,87038,28,1248,44,781,9,155,312,79,54,21,478,342,10668,1924,60339,71007,9/8/2020
5/7/2020,425,12774,2975,77664,90438,36,1284,42,823,5,160,301,71,52,21,499,274,10942,1974,62313,73255,9/8/2020
5/8/2020,360,13134,2603,80267,93401,30,1314,29,852,5,165,297,71,53,22,521,233,11175,1749,64062,75237,9/8/2020
5/9/2020,470,13604,3356,83623,97227,22,1336,21,873,4,169,294,69,51,15,536,291,11466,2272,66334,77800,9/8/2020
5/10/2020,285,13889,2122,85745,99634,20,1356,23,896,6,175,285,70,49,13,549,188,11654,1524,67858,79512,9/8/2020
5/11/2020,259,14148,1861,87606,101754,31,1387,16,912,6,181,294,71,49,15,564,178,11832,1304,69162,80994,9/8/2020
5/12/2020,387,14535,2622,90228,104763,23,1410,18,930,4,185,295,69,48,22,586,219,12051,1712,70874,82925,9/8/2020
5/13/2020,352,14887,3634,93862,108749,23,1433,25,955,1,186,292,69,49,13,599,199,12250,2014,72888,85138,9/8/2020
5/14/2020,330,15217,3415,97277,112494,19,1452,27,982,3,189,281,64,45,15,614,231,12481,2021,74909,87390,9/8/2020
5/15/2020,382,15599,3470,100747,116346,24,1476,41,1023,5,194,259,62,45,13,627,237,12718,1814,76723,89441,9/8/2020
5/16/2020,453,16052,4168,104915,120967,25,1501,13,1036,5,199,266,61,46,15,642,252,12970,1967,78690,91660,9/8/2020
5/17/2020,240,16292,2775,107690,123982,17,1518,8,1044,5,204,270,59,45,10,652,129,13099,1563,80253,93352,9/8/2020
5/18/2020,251,16543,2007,109697,126240,19,1537,15,1059,5,209,269,57,40,18,670,140,13239,1371,81624,94863,9/8/2020
5/19/2020,416,16959,3178,112875,129834,23,1560,32,1091,5,214,255,56,38,11,681,214,13453,1933,83557,97010,9/8/2020
5/20/2020,328,17287,2775,115650,132937,19,1579,23,1114,7,221,244,52,33,22,703,188,13641,1519,85076,98717,9/8/2020
5/21/2020,374,17661,3764,119414,137075,26,1605,15,1129,3,224,252,53,29,20,723,170,13811,1947,87023,100834,9/8/2020
5/22/2020,353,18014,3172,122586,140600,20,1625,29,1158,5,229,238,52,29,10,733,204,14015,1615,88638,102653,9/8/2020
5/23/2020,253,18267,2748,125334,143601,19,1644,11,1169,3,232,243,52,32,13,746,108,14123,1278,89916,104039,9/8/2020
5/24/2020,165,18432,1372,126706,145138,12,1656,14,1183,2,234,239,53,36,8,754,83,14206,773,90689,104895,9/8/2020
5/25/2020,147,18579,1389,128095,146674,13,1669,14,1197,0,234,238,53,34,10,764,72,14278,762,91451,105729,9/8/2020
5/26/2020,285,18864,2624,130719,149583,24,1693,22,1219,5,239,235,48,33,15,779,165,14443,1782,93233,107676,9/8/2020
5/27/2020,276,19140,2125,132844,151984,20,1713,18,1237,3,242,234,50,33,10,789,134,14577,1136,94369,108946,9/8/2020
5/28/2020,349,19489,3372,136216,155705,17,1730,29,1266,4,246,218,47,32,8,797,134,14711,1124,95493,110204,9/8/2020
5/29/2020,417,19906,3973,140189,160095,19,1749,27,1293,6,252,204,43,31,12,809,177,14888,1576,97069,111957,9/8/2020
5/30/2020,228,20134,3972,144161,164295,15,1764,19,1312,4,256,196,40,29,12,821,109,14997,1822,98891,113888,9/8/2020
5/31/2020,159,20293,1759,145920,166213,11,1775,10,1322,0,256,197,43,26,3,824,78,15075,857,99748,114823,9/8/2020
6/1/2020,215,20508,2823,148743,169251,8,1783,14,1336,1,257,190,44,29,5,829,99,15174,1387,101135,116309,9/8/2020
6/2/2020,273,20781,3076,151819,172600,8,1791,9,1345,3,260,186,37,25,10,839,107,15281,1455,102590,117871,9/8/2020
6/3/2020,260,21041,3514,155333,176374,14,1805,18,1363,6,266,176,34,25,11,850,105,15386,1667,104257,119643,9/8/2020
6/4/2020,281,21322,4536,159869,181191,7,1812,25,1388,3,269,155,31,24,11,861,111,15497,2041,106298,121795,9/8/2020
6/5/2020,216,21538,3586,163455,184993,15,1827,13,1401,6,275,151,27,21,10,871,106,15603,1579,107877,123480,9/8/2020
6/6/2020,203,21741,2630,166085,187826,10,1837,7,1408,2,277,152,29,19,6,877,69,15672,1138,109015,124687,9/8/2020
6/7/2020,83,21824,1629,167714,189538,11,1848,7,1415,1,278,155,25,17,4,881,50,15722,783,109798,125520,9/8/2020
6/8/2020,120,21944,1852,169566,191510,15,1863,12,1427,2,280,156,27,18,4,885,44,15766,964,110762,126528,9/8/2020
6/9/2020,223,22167,2683,172249,194416,10,1873,18,1445,0,280,148,28,21,1,886,67,15833,1260,112022,127855,9/8/2020
6/10/2020,210,22377,2999,175248,197625,13,1886,12,1457,2,282,147,24,17,3,889,105,15938,1469,113491,129429,9/8/2020
6/11/2020,195,22572,3518,178766,201338,7,1893,15,1472,1,283,138,25,16,6,895,88,16026,1539,115030,131056,9/8/2020
6/12/2020,209,22781,4614,183380,206161,9,1902,15,1487,1,284,131,24,16,2,897,82,16108,2187,117217,133325,9/8/2020
6/13/2020,114,22895,3044,186424,209319,6,1908,4,1491,0,284,133,20,15,3,900,50,16158,1376,118593,134751,9/8/2020
6/14/2020,81,22976,2050,188474,211450,7,1915,8,1499,1,285,131,20,14,3,903,33,16191,969,119562,135753,9/8/2020
6/15/2020,189,23165,3117,191591,214756,14,1929,14,1513,0,285,131,20,16,4,907,78,16269,1794,121356,137625,9/8/2020
6/16/2020,111,23276,3024,194615,217891,10,1939,9,1522,1,286,131,22,16,8,915,52,16321,1579,122935,139256,9/8/2020
6/17/2020,128,23404,2843,197458,220862,15,1954,20,1542,4,290,122,18,14,6,921,53,16374,1323,124258,140632,9/8/2020
6/18/2020,149,23553,3056,200514,224067,9,1963,13,1555,1,291,117,19,16,7,928,70,16444,1336,125594,142038,9/8/2020
6/19/2020,141,23694,3773,204287,227981,12,1975,11,1566,1,292,117,20,17,3,931,59,16503,1374,126968,143471,9/8/2020
6/20/2020,84,23778,1896,206183,229961,9,1984,12,1578,0,292,114,20,18,4,935,36,16539,816,127784,144323,9/8/2020
6/21/2020,37,23815,1069,207252,231067,8,1992,5,1583,0,292,117,20,18,2,937,28,16567,692,128476,145043,9/8/2020
6/22/2020,138,23953,3736,210988,234941,12,2004,16,1599,0,292,113,19,18,1,938,69,16636,1710,130186,146822,9/8/2020
6/23/2020,163,24116,3854,214842,238958,3,2007,13,1612,3,295,100,18,18,7,945,83,16719,1788,131974,148693,9/8/2020
6/24/2020,120,24236,3518,218360,242596,9,2016,10,1622,1,296,98,18,18,5,950,46,16765,1690,133664,150429,9/8/2020
6/25/2020,103,24339,2899,221259,245598,6,2022,14,1636,1,297,89,17,17,1,951,54,16819,1518,135182,152001,9/8/2020
6/26/2020,94,24433,2499,223758,248191,2,2024,10,1646,0,297,81,18,18,1,952,63,16882,1334,136516,153398,9/8/2020
6/27/2020,84,24517,3227,226985,251502,5,2029,3,1649,1,298,82,17,17,5,957,37,16919,1221,137737,154656,9/8/2020
6/28/2020,40,24557,1471,228456,253013,4,2033,4,1653,4,302,78,15,14,6,963,19,16938,596,138333,155271,9/8/2020
6/29/2020,85,24642,3689,232145,256787,4,2037,5,1658,0,302,77,14,14,1,964,39,16977,1345,139678,156655,9/8/2020
6/30/2020,59,24701,1964,234109,258810,1,2038,5,1663,1,303,72,12,11,3,967,33,17010,996,140674,157684,9/8/2020
7/1/2020,145,24846,4111,238220,263066,7,2045,9,1672,0,303,70,11,11,1,968,80,17090,1939,142613,159703,9/8/2020
7/2/2020,102,24948,2805,241025,265973,5,2050,5,1677,1,304,69,10,10,1,969,56,17146,1090,143703,160849,9/8/2020
7/3/2020,50,24998,2068,243093,268091,9,2059,6,1683,0,304,72,9,9,3,972,27,17173,774,144477,161650,9/8/2020
7/4/2020,58,25056,2334,245427,270483,2,2061,4,1687,1,305,69,10,9,2,974,34,17207,997,145474,162681,9/8/2020
7/5/2020,51,25107,2939,248366,273473,1,2062,2,1689,1,306,67,8,8,2,976,26,17233,1448,146922,164155,9/8/2020
7/6/2020,102,25209,2820,251186,276395,6,2068,6,1695,0,306,67,9,9,4,980,58,17291,1553,148475,165766,9/8/2020
7/7/2020,82,25291,3458,254644,279935,5,2073,7,1702,0,306,65,8,8,2,982,48,17339,1525,150000,167339,9/8/2020
7/8/2020,105,25396,3401,258045,283441,4,2077,2,1704,0,306,67,9,8,0,982,64,17403,1414,151414,168817,9/8/2020
7/9/2020,94,25490,3676,261721,287211,9,2086,3,1707,0,306,73,9,8,0,982,51,17454,1593,153007,170461,9/8/2020
7/10/2020,131,25621,4445,266166,291787,6,2092,3,1710,2,308,74,7,7,3,985,80,17534,2084,155091,172625,9/8/2020
7/11/2020,63,25684,2906,269072,294756,6,2098,3,1713,1,309,76,6,6,3,988,34,17568,1291,156382,173950,9/8/2020
7/12/2020,45,25729,1785,270857,296586,1,2099,3,1716,1,310,73,6,5,3,991,34,17602,897,157279,174881,9/8/2020
7/13/2020,83,25812,3165,274022,299834,8,2107,10,1726,0,310,71,6,5,1,992,57,17659,1477,158756,176415,9/8/2020
7/14/2020,74,25886,3286,277308,303194,7,2114,4,1730,0,310,74,5,5,1,993,49,17708,1364,160120,177828,9/8/2020
7/15/2020,122,26008,4146,281454,307462,5,2119,7,1737,0,310,72,5,4,0,993,99,17807,1733,161853,179660,9/8/2020
7/16/2020,102,26110,3726,285180,311290,6,2125,9,1746,0,310,69,6,5,1,994,78,17885,1604,163457,181342,9/8/2020
7/17/2020,154,26264,4190,289370,315634,14,2139,3,1749,1,311,79,5,5,1,995,81,17966,1807,165264,183230,9/8/2020
7/18/2020,80,26344,3176,292546,318890,5,2144,9,1758,1,312,74,5,4,4,999,68,18034,1330,166594,184628,9/8/2020
7/19/2020,83,26427,2605,295151,321578,7,2151,3,1761,0,312,78,6,4,2,1001,59,18093,1066,167660,185753,9/8/2020
7/20/2020,71,26498,2657,297808,324306,9,2160,7,1768,0,312,80,7,5,2,1003,69,18162,1460,169120,187282,9/8/2020
7/21/2020,127,26625,4240,302048,328673,9,2169,11,1779,0,312,78,9,6,1,1004,109,18271,1872,170992,189263,9/8/2020
7/22/2020,122,26747,3807,305855,332602,11,2180,11,1790,1,313,77,7,6,1,1005,90,18361,1582,172574,190935,9/8/2020
7/23/2020,120,26867,4205,310060,336927,8,2188,6,1796,0,313,79,8,7,0,1005,112,18473,1837,174411,192884,9/8/2020
7/24/2020,168,27035,5833,315893,342928,13,2201,13,1809,0,313,79,9,7,0,1005,126,18599,2219,176630,195229,9/8/2020
7/25/2020,128,27163,4296,320189,347352,7,2208,7,1816,0,313,79,10,8,1,1006,105,18704,2008,178638,197342,9/8/2020
7/26/2020,56,27219,2985,323174,350393,8,2216,9,1825,0,313,78,11,7,1,1007,54,18758,1300,179938,198696,9/8/2020
7/27/2020,181,27400,3959,327133,354533,12,2228,7,1832,0,313,83,13,8,1,1008,139,18897,2155,182093,200990,9/8/2020
7/28/2020,104,27504,3844,330977,358481,5,2233,5,1837,0,313,83,14,7,1,1009,90,18987,1636,183729,202716,9/8/2020
7/29/2020,170,27674,4894,335871,363545,10,2243,12,1849,0,313,81,15,7,0,1009,158,19145,2126,185855,205000,9/8/2020
7/30/2020,99,27773,4104,339975,367748,6,2249,2,1851,1,314,84,15,6,1,1010,93,19238,1451,187306,206544,9/8/2020
7/31/2020,123,27896,5391,345366,373262,8,2257,9,1860,0,314,83,15,7,0,1010,90,19328,1767,189073,208401,9/8/2020
8/1/2020,101,27997,4108,349474,377471,7,2264,2,1862,0,314,88,14,7,1,1011,85,19413,1426,190499,209912,9/8/2020
8/2/2020,80,28077,2787,352261,380338,12,2276,12,1874,2,316,86,14,8,2,1013,64,19477,1260,191759,211236,9/8/2020
8/3/2020,176,28253,4926,357187,385440,13,2289,12,1886,0,316,87,16,7,1,1014,153,19630,1961,193720,213350,9/8/2020
8/4/2020,125,28378,3613,360800,389178,8,2297,6,1892,1,317,88,12,5,2,1016,105,19735,1712,195432,215167,9/8/2020
8/5/2020,139,28517,5743,366543,395060,12,2309,10,1902,1,318,89,10,5,2,1018,115,19850,2339,197771,217621,9/8/2020
8/6/2020,165,28682,5278,371821,400503,7,2316,9,1911,0,318,87,9,4,0,1018,118,19968,2229,200000,219968,9/8/2020
8/7/2020,112,28794,4586,376407,405201,13,2329,10,1921,1,319,89,9,3,1,1019,93,20061,1942,201942,222003,9/8/2020
8/8/2020,108,28902,3917,380324,409226,19,2348,6,1927,1,320,101,8,3,1,1020,98,20159,1633,203575,223734,9/8/2020
8/9/2020,39,28941,1622,381946,410887,8,2356,11,1938,0,320,98,9,4,0,1020,35,20194,996,204571,224765,9/8/2020
8/10/2020,137,29078,4329,386275,415353,11,2367,11,1949,0,320,98,9,4,1,1021,112,20306,1828,206399,226705,9/8/2020
8/11/2020,105,29183,4220,390495,419678,6,2373,14,1963,0,320,90,10,4,2,1023,95,20401,2188,208587,228988,9/8/2020
8/12/2020,118,29301,5080,395575,424876,8,2381,11,1974,0,320,87,9,3,1,1024,105,20506,2550,211137,231643,9/8/2020
8/13/2020,114,29415,3918,399493,428908,12,2393,11,1985,0,320,88,11,3,0,1024,95,20601,1699,212836,233437,9/8/2020
8/14/2020,137,29552,5371,404864,434416,13,2406,11,1996,0,320,90,11,4,2,1026,100,20701,1874,214710,235411,9/8/2020
8/15/2020,101,29653,4297,409161,438814,8,2414,11,2007,1,321,86,11,5,0,1026,95,20796,1526,216236,237032,9/8/2020
8/16/2020,77,29730,2798,411959,441689,7,2421,6,2013,4,325,83,8,4,5,1031,68,20864,995,217231,238095,9/8/2020
8/17/2020,104,29834,4342,416301,446135,10,2431,7,2020,0,325,86,8,5,2,1033,87,20951,2240,219471,240422,9/8/2020
8/18/2020,125,29959,4913,421214,451173,11,2442,9,2029,1,326,87,8,4,5,1038,98,21049,2702,222173,243222,9/8/2020
8/19/2020,100,30059,5239,426453,456512,8,2450,9,2038,1,327,85,9,5,0,1038,85,21134,2552,224725,245859,9/8/2020
8/20/2020,173,30232,8068,434521,464753,12,2462,6,2044,2,329,89,10,5,3,1041,139,21273,3440,228165,249438,9/8/2020
8/21/2020,141,30373,6616,441137,471510,8,2470,5,2049,1,330,91,9,4,2,1043,123,21396,2823,230988,252384,9/8/2020
8/22/2020,96,30469,5777,446914,477383,10,2480,12,2061,0,330,89,11,4,1,1044,86,21482,2487,233475,254957,9/8/2020
8/23/2020,64,30533,4375,451289,481822,11,2491,5,2066,0,330,95,11,2,1,1045,57,21539,2489,235964,257503,9/8/2020
8/24/2020,90,30623,5341,456630,487253,7,2498,10,2076,1,331,91,13,4,1,1046,75,21614,2868,238832,260446,9/8/2020
8/25/2020,106,30729,4758,461388,492117,10,2508,4,2080,1,332,96,11,4,1,1047,98,21712,2272,241104,262816,9/8/2020
8/26/2020,162,30891,9427,470815,501706,3,2511,8,2088,0,332,91,9,5,1,1048,124,21836,2967,244071,265907,9/8/2020
8/27/2020,88,30979,8652,479467,510446,5,2516,14,2102,1,333,81,6,5,2,1050,72,21908,3089,247160,269068,9/8/2020
8/28/2020,100,31079,7901,487368,518447,13,2529,4,2106,0,333,90,9,7,2,1052,82,21990,2323,249483,271473,9/8/2020
8/29/2020,64,31143,5368,492736,523879,6,2535,8,2114,1,334,87,10,6,1,1053,56,22046,1812,251295,273341,9/8/2020
8/30/2020,65,31208,4259,496995,528203,6,2541,4,2118,0,334,89,8,5,1,1054,50,22096,1964,253259,275355,9/8/2020
8/31/2020,81,31289,4634,501629,532918,10,2551,15,2133,0,334,84,8,4,0,1054,80,22176,2028,255287,277463,9/8/2020
9/1/2020,91,31380,7143,508772,540152,6,2557,9,2142,1,335,80,7,4,1,1055,70,22246,2362,257649,279895,9/8/2020
9/2/2020,112,31492,10293,519065,550557,8,2565,9,2151,1,336,78,8,4,2,1057,90,22336,2770,260419,282755,9/8/2020
9/3/2020,85,31577,11171,530236,561813,8,2573,8,2159,0,336,78,9,4,1,1058,76,22412,2481,262900,285312,9/8/2020
9/4/2020,90,31667,9026,539262,570929,8,2581,4,2163,0,336,82,9,4,0,1058,72,22484,2303,265203,287687,9/8/2020
9/5/2020,48,31715,6186,545448,577163,6,2587,9,2172,0,336,79,7,3,0,1058,35,22519,1486,266689,289208,9/8/2020
9/6/2020,71,31786,3940,549388,581174,2,2589,7,2179,1,337,73,5,3,1,1059,53,22572,1768,268457,291029,9/8/2020
9/7/2020,29,31815,1409,550797,582612,,,,,,,,,,0,1059,20,22592,390,268847,291439,9/8/2020
2/27/2020,0,0,0,0,0,1,1,0,0,0,0,1,0,0,0,0,0,0,0,0,0,9/9/2020
2/28/2020,0,0,0,0,0,0,1,0,0,0,0,1,1,0,0,0,0,0,0,0,0,9/9/2020
2/29/2020,0,0,0,0,0,0,1,0,0,0,0,1,1,0,0,0,0,0,0,0,0,9/9/2020
3/1/2020,2,2,2,2,4,0,1,0,0,0,0,1,1,1,0,0,2,2,2,2,4,9/9/2020
3/2/2020,0,2,1,3,5,1,2,0,0,0,0,2,2,2,0,0,0,2,1,3,5,9/9/2020
3/3/2020,0,2,2,5,7,0,2,0,0,0,0,2,2,2,0,0,0,2,2,5,7,9/9/2020
3/4/2020,0,2,12,17,19,1,3,0,0,0,0,3,2,2,0,0,0,2,10,15,17,9/9/2020
3/5/2020,0,2,4,21,23,0,3,0,0,0,0,3,2,2,0,0,1,3,4,19,22,9/9/2020
3/6/2020,1,3,12,33,36,0,3,0,0,0,0,3,2,2,0,0,0,3,11,30,33,9/9/2020
3/7/2020,0,3,19,52,55,0,3,0,0,0,0,3,2,1,0,0,0,3,19,49,52,9/9/2020
3/8/2020,0,3,18,70,73,0,3,0,0,0,0,3,2,1,0,0,0,3,18,67,70,9/9/2020
3/9/2020,1,4,15,85,89,0,3,0,0,0,0,3,2,1,0,0,1,4,15,82,86,9/9/2020
3/10/2020,2,6,25,110,116,0,3,0,0,0,0,3,2,1,0,0,1,5,23,105,110,9/9/2020
3/11/2020,0,6,34,144,150,1,4,0,0,0,0,4,1,1,0,0,0,5,34,139,144,9/9/2020
3/12/2020,9,15,41,185,200,1,5,0,0,0,0,5,1,1,0,0,8,13,38,177,190,9/9/2020
3/13/2020,6,21,50,235,256,4,9,1,1,0,0,8,1,1,0,0,6,19,48,225,244,9/9/2020
3/14/2020,0,21,90,325,346,0,9,0,1,0,0,8,1,1,0,0,0,19,86,311,330,9/9/2020
3/15/2020,1,22,54,379,401,1,10,0,1,0,0,9,2,1,0,0,1,20,54,365,385,9/9/2020
3/16/2020,2,24,95,474,498,2,12,0,1,0,0,11,2,0,0,0,2,22,92,457,479,9/9/2020
3/17/2020,16,40,162,636,676,6,18,0,1,0,0,17,2,0,0,0,11,33,151,608,641,9/9/2020
3/18/2020,12,52,116,752,804,3,21,0,1,0,0,20,2,0,0,0,11,44,110,718,762,9/9/2020
3/19/2020,17,69,262,1014,1083,2,23,1,2,0,0,21,3,0,1,1,17,61,251,969,1030,9/9/2020
3/20/2020,14,83,197,1211,1294,5,28,0,2,0,0,26,4,0,0,1,13,74,192,1161,1235,9/9/2020
3/21/2020,21,104,126,1337,1441,3,31,2,4,0,0,27,5,0,0,1,14,88,123,1284,1372,9/9/2020
3/22/2020,30,134,282,1619,1753,2,33,0,4,0,0,29,5,0,0,1,25,113,262,1546,1659,9/9/2020
3/23/2020,14,148,169,1788,1936,15,48,1,5,0,0,43,9,3,0,1,16,129,165,1711,1840,9/9/2020
3/24/2020,20,168,242,2030,2198,7,55,0,5,0,0,50,10,4,0,1,19,148,238,1949,2097,9/9/2020
3/25/2020,26,194,183,2213,2407,5,60,1,6,0,0,54,11,3,0,1,28,176,172,2121,2297,9/9/2020
3/26/2020,35,229,181,2394,2623,10,70,5,11,0,0,59,14,5,0,1,41,217,176,2297,2514,9/9/2020
3/27/2020,27,256,215,2609,2865,9,79,1,12,1,1,66,17,6,2,3,31,248,202,2499,2747,9/9/2020
3/28/2020,59,315,260,2869,3184,13,92,3,15,2,3,74,15,6,1,4,63,311,241,2740,3051,9/9/2020
3/29/2020,106,421,356,3225,3646,8,100,4,19,1,4,77,18,8,2,6,105,416,314,3054,3470,9/9/2020
3/30/2020,62,483,222,3447,3930,20,120,5,24,0,4,92,20,11,3,9,78,494,185,3239,3733,9/9/2020
3/31/2020,71,554,369,3816,4370,11,131,7,31,1,5,95,22,13,2,11,73,567,298,3537,4104,9/9/2020
4/1/2020,99,653,699,4515,5168,18,149,7,38,0,5,106,30,15,1,12,102,669,642,4179,4848,9/9/2020
4/2/2020,52,705,477,4992,5697,22,171,6,44,2,7,120,36,21,4,16,62,731,436,4615,5346,9/9/2020
4/3/2020,108,813,775,5767,6580,23,194,7,51,0,7,136,43,25,3,19,100,831,713,5328,6159,9/9/2020
4/4/2020,143,956,660,6427,7383,22,216,4,55,5,12,149,41,30,9,28,137,968,619,5947,6915,9/9/2020
4/5/2020,187,1143,1156,7583,8726,20,236,9,64,1,13,159,44,36,2,30,182,1150,1069,7016,8166,9/9/2020
4/6/2020,218,1361,1707,9290,10651,26,262,7,71,0,13,178,48,40,7,37,206,1356,1560,8576,9932,9/9/2020
4/7/2020,285,1646,1631,10921,12567,19,281,4,75,2,15,191,50,42,5,42,261,1617,1484,10060,11677,9/9/2020
4/8/2020,290,1936,1723,12644,14580,19,300,7,82,6,21,197,50,38,10,52,272,1889,1567,11627,13516,9/9/2020
4/9/2020,284,2220,1521,14165,16385,32,332,9,91,4,25,216,53,40,7,59,280,2169,1359,12986,15155,9/9/2020
4/10/2020,420,2640,2577,16742,19382,29,361,15,106,5,30,225,59,41,11,70,403,2572,2373,15359,17931,9/9/2020
4/11/2020,299,2939,1911,18653,21592,29,390,11,117,2,32,241,61,48,12,82,281,2853,1720,17079,19932,9/9/2020
4/12/2020,315,3254,1674,20327,23581,35,425,13,130,5,37,258,59,49,9,91,289,3142,1439,18518,21660,9/9/2020
4/13/2020,162,3416,938,21265,24681,35,460,13,143,3,40,277,64,54,9,100,187,3329,840,19358,22687,9/9/2020
4/14/2020,289,3705,1788,23053,26758,27,487,17,160,5,45,282,72,53,8,108,265,3594,1529,20887,24481,9/9/2020
4/15/2020,353,4058,1803,24856,28914,31,518,20,180,3,48,290,72,54,17,125,307,3901,1562,22449,26350,9/9/2020
4/16/2020,449,4507,2500,27356,31863,36,554,25,205,6,54,295,72,53,14,139,391,4292,2081,24530,28822,9/9/2020
4/17/2020,308,4815,1823,29179,33994,32,586,20,225,7,61,300,66,45,21,160,293,4585,1454,25984,30569,9/9/2020
4/18/2020,322,5137,1728,30907,36044,26,612,18,243,4,65,304,63,49,15,175,286,4871,1340,27324,32195,9/9/2020
4/19/2020,382,5519,2059,32966,38485,23,635,26,269,1,66,300,65,55,11,186,338,5209,1746,29070,34279,9/9/2020
4/20/2020,396,5915,1909,34875,40790,46,681,29,298,2,68,315,75,56,10,196,377,5586,1578,30648,36234,9/9/2020
4/21/2020,445,6360,2114,36989,43349,45,726,31,329,5,73,324,72,56,18,214,390,5976,1717,32365,38341,9/9/2020
4/22/2020,420,6780,2398,39387,46167,41,767,32,361,5,78,328,73,58,18,232,385,6361,1917,34282,40643,9/9/2020
4/23/2020,481,7261,2471,41858,49119,32,799,28,389,5,83,327,76,62,15,247,419,6780,1864,36146,42926,9/9/2020
4/24/2020,494,7755,3292,45150,52905,35,834,27,416,4,87,331,85,63,15,262,416,7196,2632,38778,45974,9/9/2020
4/25/2020,394,8149,2210,47360,55509,34,868,17,433,5,92,343,85,62,14,276,304,7500,1775,40553,48053,9/9/2020
4/26/2020,316,8465,2314,49674,58139,33,901,15,448,3,95,358,86,59,14,290,275,7775,1883,42436,50211,9/9/2020
4/27/2020,250,8715,1624,51298,60013,29,930,21,469,4,99,362,86,61,10,300,204,7979,1163,43599,51578,9/9/2020
4/28/2020,411,9126,2268,53566,62692,44,974,24,493,3,102,379,88,59,22,322,330,8309,1767,45366,53675,9/9/2020
4/29/2020,476,9602,3351,56917,66519,36,1010,38,531,11,113,366,78,53,18,340,373,8682,2429,47795,56477,9/9/2020
4/30/2020,432,10034,2772,59689,69723,33,1043,38,569,6,119,355,83,57,24,364,352,9034,1955,49750,58784,9/9/2020
5/1/2020,457,10491,3089,62778,73269,51,1094,39,608,3,122,364,84,58,14,378,320,9354,2217,51967,61321,9/9/2020
5/2/2020,260,10751,1927,64705,75456,36,1130,39,647,5,127,356,91,62,24,402,189,9543,1292,53259,62802,9/9/2020
5/3/2020,284,11035,2168,66873,77908,31,1161,27,674,8,135,352,90,61,21,423,182,9725,1602,54861,64586,9/9/2020
5/4/2020,388,11423,2101,68974,80397,30,1191,31,705,5,140,346,88,57,18,441,293,10018,1569,56430,66448,9/9/2020
5/5/2020,436,11859,2878,71852,83711,29,1220,32,737,6,146,337,82,54,16,457,308,10326,1966,58396,68722,9/9/2020
5/6/2020,490,12349,2837,74689,87038,28,1248,44,781,9,155,312,79,54,21,478,342,10668,1924,60320,70988,9/9/2020
5/7/2020,425,12774,2975,77664,90438,36,1284,42,823,5,160,301,71,52,21,499,274,10942,1974,62294,73236,9/9/2020
5/8/2020,360,13134,2603,80267,93401,30,1314,29,852,5,165,297,71,53,22,521,233,11175,1748,64042,75217,9/9/2020
5/9/2020,470,13604,3356,83623,97227,22,1336,21,873,4,169,294,69,51,15,536,291,11466,2272,66314,77780,9/9/2020
5/10/2020,285,13889,2122,85745,99634,20,1356,23,896,6,175,285,70,49,13,549,188,11654,1524,67838,79492,9/9/2020
5/11/2020,259,14148,1861,87606,101754,31,1387,16,912,6,181,294,71,49,15,564,178,11832,1304,69142,80974,9/9/2020
5/12/2020,387,14535,2622,90228,104763,23,1410,18,930,4,185,295,69,48,22,586,219,12051,1712,70854,82905,9/9/2020
5/13/2020,352,14887,3634,93862,108749,23,1433,25,955,1,186,292,69,49,13,599,199,12250,2013,72867,85117,9/9/2020
5/14/2020,330,15217,3415,97277,112494,19,1452,27,982,3,189,281,64,45,15,614,231,12481,2021,74888,87369,9/9/2020
5/15/2020,382,15599,3470,100747,116346,24,1476,41,1023,5,194,259,62,45,13,627,237,12718,1814,76702,89420,9/9/2020
5/16/2020,453,16052,4168,104915,120967,25,1501,13,1036,5,199,266,61,46,15,642,252,12970,1966,78668,91638,9/9/2020
5/17/2020,240,16292,2775,107690,123982,17,1518,8,1044,5,204,270,59,45,10,652,129,13099,1561,80229,93328,9/9/2020
5/18/2020,251,16543,2007,109697,126240,19,1537,15,1059,5,209,269,57,40,18,670,140,13239,1371,81600,94839,9/9/2020
5/19/2020,416,16959,3178,112875,129834,23,1560,32,1091,5,214,255,56,38,11,681,214,13453,1933,83533,96986,9/9/2020
5/20/2020,328,17287,2775,115650,132937,19,1579,23,1114,7,221,244,52,33,22,703,188,13641,1518,85051,98692,9/9/2020
5/21/2020,374,17661,3764,119414,137075,26,1605,15,1129,3,224,252,53,29,20,723,170,13811,1946,86997,100808,9/9/2020
5/22/2020,353,18014,3172,122586,140600,20,1625,29,1158,5,229,238,52,29,10,733,204,14015,1615,88612,102627,9/9/2020
5/23/2020,253,18267,2748,125334,143601,19,1644,11,1169,3,232,243,52,32,13,746,108,14123,1277,89889,104012,9/9/2020
5/24/2020,165,18432,1372,126706,145138,12,1656,14,1183,2,234,239,53,36,8,754,83,14206,773,90662,104868,9/9/2020
5/25/2020,147,18579,1389,128095,146674,13,1669,14,1197,0,234,238,53,34,10,764,72,14278,762,91424,105702,9/9/2020
5/26/2020,285,18864,2624,130719,149583,24,1693,22,1219,5,239,235,48,33,15,779,165,14443,1781,93205,107648,9/9/2020
5/27/2020,276,19140,2125,132844,151984,20,1713,18,1237,3,242,234,50,33,10,789,134,14577,1136,94341,108918,9/9/2020
5/28/2020,349,19489,3372,136216,155705,17,1730,29,1266,4,246,218,47,32,8,797,134,14711,1124,95465,110176,9/9/2020
5/29/2020,417,19906,3973,140189,160095,19,1749,27,1293,6,252,204,43,31,12,809,177,14888,1576,97041,111929,9/9/2020
5/30/2020,228,20134,3972,144161,164295,15,1764,19,1312,4,256,196,40,29,12,821,109,14997,1821,98862,113859,9/9/2020
5/31/2020,159,20293,1759,145920,166213,11,1775,10,1322,0,256,197,43,26,3,824,78,15075,857,99719,114794,9/9/2020
6/1/2020,215,20508,2823,148743,169251,8,1783,14,1336,1,257,190,44,29,5,829,99,15174,1387,101106,116280,9/9/2020
6/2/2020,273,20781,3076,151819,172600,8,1791,9,1345,3,260,186,37,25,10,839,107,15281,1454,102560,117841,9/9/2020
6/3/2020,260,21041,3514,155333,176374,14,1805,18,1363,6,266,176,34,25,11,850,105,15386,1667,104227,119613,9/9/2020
6/4/2020,281,21322,4536,159869,181191,7,1812,25,1388,3,269,155,31,24,11,861,111,15497,2041,106268,121765,9/9/2020
6/5/2020,216,21538,3586,163455,184993,15,1827,13,1401,6,275,151,27,21,10,871,106,15603,1578,107846,123449,9/9/2020
6/6/2020,203,21741,2630,166085,187826,10,1837,7,1408,2,277,152,29,19,6,877,69,15672,1138,108984,124656,9/9/2020
6/7/2020,83,21824,1629,167714,189538,11,1848,7,1415,1,278,155,25,17,4,881,50,15722,783,109767,125489,9/9/2020
6/8/2020,120,21944,1852,169566,191510,15,1863,12,1427,2,280,156,27,18,4,885,44,15766,963,110730,126496,9/9/2020
6/9/2020,223,22167,2683,172249,194416,10,1873,18,1445,0,280,148,28,21,1,886,67,15833,1260,111990,127823,9/9/2020
6/10/2020,210,22377,2999,175248,197625,13,1886,12,1457,2,282,147,24,17,3,889,105,15938,1469,113459,129397,9/9/2020
6/11/2020,195,22572,3518,178766,201338,7,1893,15,1472,1,283,138,25,16,6,895,88,16026,1539,114998,131024,9/9/2020
6/12/2020,209,22781,4614,183380,206161,9,1902,15,1487,1,284,131,24,16,2,897,82,16108,2187,117185,133293,9/9/2020
6/13/2020,114,22895,3044,186424,209319,6,1908,4,1491,0,284,133,20,15,3,900,50,16158,1376,118561,134719,9/9/2020
6/14/2020,81,22976,2050,188474,211450,7,1915,8,1499,1,285,131,20,14,3,903,33,16191,969,119530,135721,9/9/2020
6/15/2020,189,23165,3117,191591,214756,14,1929,14,1513,0,285,131,20,16,4,907,78,16269,1794,121324,137593,9/9/2020
6/16/2020,111,23276,3024,194615,217891,10,1939,9,1522,1,286,131,22,16,8,915,52,16321,1579,122903,139224,9/9/2020
6/17/2020,128,23404,2843,197458,220862,15,1954,20,1542,4,290,122,18,14,6,921,53,16374,1323,124226,140600,9/9/2020
6/18/2020,149,23553,3056,200514,224067,9,1963,13,1555,1,291,117,19,16,7,928,70,16444,1334,125560,142004,9/9/2020
6/19/2020,141,23694,3773,204287,227981,12,1975,11,1566,1,292,117,20,17,3,931,59,16503,1373,126933,143436,9/9/2020
6/20/2020,84,23778,1896,206183,229961,9,1984,12,1578,0,292,114,20,18,4,935,36,16539,816,127749,144288,9/9/2020
6/21/2020,37,23815,1069,207252,231067,8,1992,5,1583,0,292,117,20,18,2,937,28,16567,692,128441,145008,9/9/2020
6/22/2020,138,23953,3739,210991,234944,12,2004,16,1599,0,292,113,19,18,1,938,69,16636,1711,130152,146788,9/9/2020
6/23/2020,163,24116,3854,214845,238961,3,2007,13,1612,3,295,100,18,18,7,945,83,16719,1787,131939,148658,9/9/2020
6/24/2020,120,24236,3518,218363,242599,9,2016,10,1622,1,296,98,18,18,5,950,46,16765,1689,133628,150393,9/9/2020
6/25/2020,103,24339,2899,221262,245601,6,2022,14,1636,1,297,89,17,17,1,951,54,16819,1517,135145,151964,9/9/2020
6/26/2020,94,24433,2499,223761,248194,2,2024,10,1646,0,297,81,18,18,1,952,63,16882,1333,136478,153360,9/9/2020
6/27/2020,84,24517,3227,226988,251505,5,2029,3,1649,1,298,82,17,17,5,957,37,16919,1221,137699,154618,9/9/2020
6/28/2020,40,24557,1471,228459,253016,4,2033,4,1653,4,302,78,15,14,6,963,19,16938,596,138295,155233,9/9/2020
6/29/2020,85,24642,3701,232160,256802,4,2037,5,1658,0,302,77,14,14,1,964,39,16977,1355,139650,156627,9/9/2020
6/30/2020,59,24701,1964,234124,258825,1,2038,5,1663,1,303,72,12,11,3,967,33,17010,996,140646,157656,9/9/2020
7/1/2020,145,24846,4111,238235,263081,7,2045,9,1672,0,303,70,11,11,1,968,80,17090,1938,142584,159674,9/9/2020
7/2/2020,103,24949,2806,241041,265990,5,2050,5,1677,1,304,69,10,10,1,969,56,17146,1091,143675,160821,9/9/2020
7/3/2020,50,24999,2080,243121,268120,9,2059,6,1683,0,304,72,9,9,3,972,27,17173,781,144456,161629,9/9/2020
7/4/2020,58,25057,2350,245471,270528,2,2061,4,1687,1,305,69,10,9,2,974,34,17207,1012,145468,162675,9/9/2020
7/5/2020,51,25108,2939,248410,273518,1,2062,2,1689,1,306,67,8,8,2,976,26,17233,1448,146916,164149,9/9/2020
7/6/2020,102,25210,2820,251230,276440,6,2068,6,1695,0,306,67,9,9,4,980,58,17291,1553,148469,165760,9/9/2020
7/7/2020,82,25292,3470,254700,279992,5,2073,7,1702,0,306,65,8,8,2,982,48,17339,1537,150006,167345,9/9/2020
7/8/2020,105,25397,3415,258115,283512,4,2077,2,1704,0,306,67,9,8,0,982,64,17403,1427,151433,168836,9/9/2020
7/9/2020,95,25492,3725,261840,287332,9,2086,3,1707,0,306,73,9,8,0,982,51,17454,1632,153065,170519,9/9/2020
7/10/2020,131,25623,4445,266285,291908,6,2092,3,1710,2,308,74,7,7,3,985,80,17534,2084,155149,172683,9/9/2020
7/11/2020,64,25687,2943,269228,294915,6,2098,3,1713,1,309,76,6,6,3,988,34,17568,1320,156469,174037,9/9/2020
7/12/2020,47,25734,1842,271070,296804,1,2099,3,1716,1,310,73,6,5,3,991,34,17602,943,157412,175014,9/9/2020
7/13/2020,84,25818,3166,274236,300054,8,2107,10,1726,0,310,71,6,5,1,992,57,17659,1477,158889,176548,9/9/2020
7/14/2020,74,25892,3300,277536,303428,7,2114,4,1730,0,310,74,5,5,1,993,49,17708,1375,160264,177972,9/9/2020
7/15/2020,130,26022,4180,281716,307738,5,2119,7,1737,0,310,72,5,4,0,993,99,17807,1759,162023,179830,9/9/2020
7/16/2020,102,26124,3745,285461,311585,6,2125,9,1746,0,310,69,6,5,1,994,78,17885,1621,163644,181529,9/9/2020
7/17/2020,157,26281,4244,289705,315986,14,2139,3,1749,1,311,79,5,5,1,995,81,17966,1851,165495,183461,9/9/2020
7/18/2020,85,26366,3276,292981,319347,5,2144,9,1758,1,312,74,5,4,4,999,68,18034,1403,166898,184932,9/9/2020
7/19/2020,83,26449,2709,295690,322139,7,2151,3,1761,0,312,78,6,4,2,1001,59,18093,1151,168049,186142,9/9/2020
7/20/2020,71,26520,2666,298356,324876,9,2160,7,1768,0,312,80,7,5,2,1003,69,18162,1468,169517,187679,9/9/2020
7/21/2020,131,26651,4312,302668,329319,9,2169,11,1779,0,312,78,9,6,1,1004,109,18271,1927,171444,189715,9/9/2020
7/22/2020,130,26781,3938,306606,333387,11,2180,11,1790,1,313,77,7,6,1,1005,90,18361,1685,173129,191490,9/9/2020
7/23/2020,142,26923,4388,310994,337917,8,2188,6,1796,0,313,79,8,7,0,1005,112,18473,1972,175101,193574,9/9/2020
7/24/2020,173,27096,5968,316962,344058,13,2201,13,1809,0,313,79,9,7,0,1005,126,18599,2326,177427,196026,9/9/2020
7/25/2020,135,27231,4415,321377,348608,7,2208,7,1816,0,313,79,10,8,1,1006,105,18704,2101,179528,198232,9/9/2020
7/26/2020,62,27293,3041,324418,351711,8,2216,9,1825,0,313,78,11,7,1,1007,54,18758,1342,180870,199628,9/9/2020
7/27/2020,186,27479,4184,328602,356081,12,2228,7,1832,0,313,83,13,8,1,1008,139,18897,2337,183207,202104,9/9/2020
7/28/2020,105,27584,3844,332446,360030,5,2233,5,1837,0,313,83,14,7,1,1009,90,18987,1636,184843,203830,9/9/2020
7/29/2020,191,27775,5143,337589,365364,10,2243,12,1849,0,313,81,15,7,0,1009,158,19145,2327,187170,206315,9/9/2020
7/30/2020,121,27896,4357,341946,369842,6,2249,2,1851,1,314,84,15,6,1,1010,93,19238,1651,188821,208059,9/9/2020
7/31/2020,132,28028,5519,347465,375493,8,2257,9,1860,0,314,83,15,7,0,1010,90,19328,1862,190683,210011,9/9/2020
8/1/2020,109,28137,4295,351760,379897,7,2264,2,1862,0,314,88,14,7,1,1011,85,19413,1560,192243,211656,9/9/2020
8/2/2020,84,28221,2811,354571,382792,12,2276,12,1874,2,316,86,14,8,2,1013,64,19477,1278,193521,212998,9/9/2020
8/3/2020,187,28408,5214,359785,388193,13,2289,12,1886,0,316,87,16,7,1,1014,153,19630,2188,195709,215339,9/9/2020
8/4/2020,126,28534,3694,363479,392013,8,2297,6,1892,1,317,88,12,5,2,1016,105,19735,1776,197485,217220,9/9/2020
8/5/2020,150,28684,5939,369418,398102,12,2309,10,1902,1,318,89,10,5,2,1018,115,19850,2477,199962,219812,9/9/2020
8/6/2020,170,28854,5546,374964,403818,7,2316,9,1911,0,318,87,9,4,0,1018,118,19968,2430,202392,222360,9/9/2020
8/7/2020,122,28976,4855,379819,408795,13,2329,10,1921,1,319,89,9,3,1,1019,92,20060,2165,204557,224617,9/9/2020
8/8/2020,122,29098,4117,383936,413034,19,2348,6,1927,1,320,101,8,3,1,1020,98,20158,1784,206341,226499,9/9/2020
8/9/2020,42,29140,1729,385665,414805,8,2356,11,1938,0,320,98,9,4,0,1020,35,20193,1077,207418,227611,9/9/2020
8/10/2020,150,29290,4590,390255,419545,11,2367,11,1949,0,320,98,9,4,1,1021,112,20305,2032,209450,229755,9/9/2020
8/11/2020,105,29395,4327,394582,423977,6,2373,14,1963,0,320,90,10,4,2,1023,95,20400,2274,211724,232124,9/9/2020
8/12/2020,121,29516,5198,399780,429296,8,2381,11,1974,0,320,87,9,3,1,1024,105,20505,2631,214355,234860,9/9/2020
8/13/2020,135,29651,4198,403978,433629,12,2393,11,1985,0,320,88,11,3,0,1024,94,20599,1911,216266,236865,9/9/2020
8/14/2020,146,29797,5474,409452,439249,13,2406,11,1996,0,320,90,11,4,2,1026,101,20700,1956,218222,238922,9/9/2020
8/15/2020,105,29902,4539,413991,443893,8,2414,11,2007,1,321,86,11,5,0,1026,94,20794,1703,219925,240719,9/9/2020
8/16/2020,83,29985,2798,416789,446774,7,2421,6,2013,4,325,83,8,4,5,1031,68,20862,989,220914,241776,9/9/2020
8/17/2020,107,30092,4554,421343,451435,10,2431,7,2020,0,325,86,8,5,2,1033,87,20949,2389,223303,244252,9/9/2020
8/18/2020,129,30221,5054,426397,456618,11,2442,9,2029,1,326,87,8,4,5,1038,98,21047,2796,226099,247146,9/9/2020
8/19/2020,114,30335,5417,431814,462149,8,2450,9,2038,1,327,85,9,5,0,1038,88,21135,2688,228787,249922,9/9/2020
8/20/2020,174,30509,8275,440089,470598,12,2462,6,2044,2,329,89,10,5,3,1041,138,21273,3575,232362,253635,9/9/2020
8/21/2020,156,30665,6828,446917,477582,8,2470,5,2049,1,330,91,9,4,2,1043,123,21396,2982,235344,256740,9/9/2020
8/22/2020,96,30761,5980,452897,483658,10,2480,12,2061,0,330,89,11,4,1,1044,85,21481,2636,237980,259461,9/9/2020
8/23/2020,72,30833,4375,457272,488105,11,2491,5,2066,0,330,95,11,2,1,1045,57,21538,2481,240461,261999,9/9/2020
8/24/2020,105,30938,5784,463056,493994,7,2498,10,2076,1,331,91,13,4,1,1046,75,21613,3170,243631,265244,9/9/2020
8/25/2020,108,31046,4821,467877,498923,10,2508,4,2080,1,332,96,11,4,1,1047,97,21710,2313,245944,267654,9/9/2020
8/26/2020,171,31217,9622,477499,508716,3,2511,8,2088,0,332,91,9,5,1,1048,123,21833,3096,249040,270873,9/9/2020
8/27/2020,94,31311,8915,486414,517725,5,2516,14,2102,1,333,81,6,5,2,1050,73,21906,3271,252311,274217,9/9/2020
8/28/2020,113,31424,8122,494536,525960,13,2529,4,2106,0,333,90,9,7,2,1052,81,21987,2461,254772,276759,9/9/2020
8/29/2020,65,31489,5536,500072,531561,6,2535,8,2114,1,334,87,10,6,1,1053,56,22043,1923,256695,278738,9/9/2020
8/30/2020,67,31556,4336,504408,535964,7,2542,4,2118,0,334,90,8,5,1,1054,50,22093,2001,258696,280789,9/9/2020
8/31/2020,106,31662,4874,509282,540944,10,2552,15,2133,0,334,85,8,4,0,1054,81,22174,2198,260894,283068,9/9/2020
9/1/2020,99,31761,7213,516495,548256,6,2558,9,2142,1,335,81,7,4,1,1055,64,22238,2390,263284,285522,9/9/2020
9/2/2020,123,31884,10608,527103,558987,8,2566,10,2152,1,336,78,8,4,2,1057,101,22339,2956,266240,288579,9/9/2020
9/3/2020,90,31974,11364,538467,570441,8,2574,8,2160,0,336,78,9,4,1,1058,75,22414,2595,268835,291249,9/9/2020
9/4/2020,103,32077,9218,547685,579762,10,2584,4,2164,0,336,84,9,4,1,1059,84,22498,2411,271246,293744,9/9/2020
9/5/2020,52,32129,6350,554035,586164,6,2590,9,2173,0,336,81,7,3,1,1060,42,22540,1589,272835,295375,9/9/2020
9/6/2020,78,32207,4120,558155,590362,4,2594,8,2181,1,337,76,5,3,1,1061,59,22599,1858,274693,297292,9/9/2020
9/7/2020,32,32239,2738,560893,593132,10,2604,4,2185,0,337,82,4,3,1,1062,23,22622,472,275165,297787,9/9/2020
9/8/2020,64,32303,5121,566014,598317,,,,,,,,,,0,1062,54,22676,1173,276338,299014,9/9/2020
2/27/2020,0,0,0,0,0,1,1,0,0,0,0,1,0,0,0,0,0,0,0,0,0,9/10/2020
2/28/2020,0,0,0,0,0,0,1,0,0,0,0,1,1,0,0,0,0,0,0,0,0,9/10/2020
2/29/2020,0,0,0,0,0,0,1,0,0,0,0,1,1,0,0,0,0,0,0,0,0,9/10/2020
3/1/2020,2,2,2,2,4,0,1,0,0,0,0,1,1,1,0,0,2,2,2,2,4,9/10/2020
3/2/2020,0,2,1,3,5,1,2,0,0,0,0,2,2,2,0,0,0,2,1,3,5,9/10/2020
3/3/2020,0,2,2,5,7,0,2,0,0,0,0,2,2,2,0,0,0,2,2,5,7,9/10/2020
3/4/2020,0,2,12,17,19,1,3,0,0,0,0,3,2,2,0,0,0,2,10,15,17,9/10/2020
3/5/2020,0,2,4,21,23,0,3,0,0,0,0,3,2,2,0,0,1,3,4,19,22,9/10/2020
3/6/2020,1,3,12,33,36,0,3,0,0,0,0,3,2,2,0,0,0,3,11,30,33,9/10/2020
3/7/2020,0,3,19,52,55,0,3,0,0,0,0,3,2,1,0,0,0,3,19,49,52,9/10/2020
3/8/2020,0,3,18,70,73,0,3,0,0,0,0,3,2,1,0,0,0,3,18,67,70,9/10/2020
3/9/2020,1,4,15,85,89,0,3,0,0,0,0,3,2,1,0,0,1,4,15,82,86,9/10/2020
3/10/2020,2,6,25,110,116,0,3,0,0,0,0,3,2,1,0,0,1,5,23,105,110,9/10/2020
3/11/2020,0,6,34,144,150,1,4,0,0,0,0,4,1,1,0,0,0,5,34,139,144,9/10/2020
3/12/2020,9,15,41,185,200,1,5,0,0,0,0,5,1,1,0,0,8,13,38,177,190,9/10/2020
3/13/2020,6,21,50,235,256,4,9,1,1,0,0,8,1,1,0,0,6,19,48,225,244,9/10/2020
3/14/2020,0,21,90,325,346,0,9,0,1,0,0,8,1,1,0,0,0,19,86,311,330,9/10/2020
3/15/2020,1,22,54,379,401,1,10,0,1,0,0,9,2,1,0,0,1,20,54,365,385,9/10/2020
3/16/2020,2,24,95,474,498,2,12,0,1,0,0,11,2,0,0,0,2,22,92,457,479,9/10/2020
3/17/2020,16,40,162,636,676,6,18,0,1,0,0,17,2,0,0,0,11,33,151,608,641,9/10/2020
3/18/2020,12,52,116,752,804,3,21,0,1,0,0,20,2,0,0,0,11,44,110,718,762,9/10/2020
3/19/2020,17,69,262,1014,1083,2,23,1,2,0,0,21,3,0,1,1,17,61,251,969,1030,9/10/2020
3/20/2020,14,83,197,1211,1294,5,28,0,2,0,0,26,4,0,0,1,13,74,192,1161,1235,9/10/2020
3/21/2020,21,104,126,1337,1441,3,31,2,4,0,0,27,5,0,0,1,14,88,123,1284,1372,9/10/2020
3/22/2020,30,134,282,1619,1753,2,33,0,4,0,0,29,5,0,0,1,25,113,262,1546,1659,9/10/2020
3/23/2020,14,148,169,1788,1936,15,48,1,5,0,0,43,9,3,0,1,16,129,165,1711,1840,9/10/2020
3/24/2020,20,168,242,2030,2198,7,55,0,5,0,0,50,10,4,0,1,19,148,238,1949,2097,9/10/2020
3/25/2020,26,194,183,2213,2407,5,60,1,6,0,0,54,11,3,0,1,28,176,172,2121,2297,9/10/2020
3/26/2020,35,229,181,2394,2623,10,70,5,11,0,0,59,14,5,0,1,41,217,176,2297,2514,9/10/2020
3/27/2020,27,256,215,2609,2865,9,79,1,12,1,1,66,17,6,2,3,31,248,202,2499,2747,9/10/2020
3/28/2020,59,315,260,2869,3184,13,92,3,15,2,3,74,15,6,1,4,63,311,241,2740,3051,9/10/2020
3/29/2020,106,421,356,3225,3646,8,100,4,19,1,4,77,18,8,2,6,105,416,314,3054,3470,9/10/2020
3/30/2020,62,483,222,3447,3930,20,120,5,24,0,4,92,20,11,3,9,78,494,185,3239,3733,9/10/2020
3/31/2020,71,554,369,3816,4370,11,131,7,31,1,5,95,22,13,2,11,73,567,298,3537,4104,9/10/2020
4/1/2020,99,653,699,4515,5168,18,149,7,38,0,5,106,30,15,1,12,102,669,642,4179,4848,9/10/2020
4/2/2020,52,705,477,4992,5697,22,171,6,44,2,7,120,36,21,4,16,62,731,436,4615,5346,9/10/2020
4/3/2020,108,813,775,5767,6580,23,194,7,51,0,7,136,43,25,3,19,100,831,713,5328,6159,9/10/2020
4/4/2020,143,956,660,6427,7383,22,216,4,55,5,12,149,41,30,9,28,137,968,619,5947,6915,9/10/2020
4/5/2020,187,1143,1156,7583,8726,20,236,9,64,1,13,159,44,36,2,30,182,1150,1069,7016,8166,9/10/2020
4/6/2020,218,1361,1707,9290,10651,26,262,7,71,0,13,178,48,40,7,37,206,1356,1560,8576,9932,9/10/2020
4/7/2020,285,1646,1631,10921,12567,19,281,4,75,2,15,191,50,42,5,42,261,1617,1484,10060,11677,9/10/2020
4/8/2020,290,1936,1723,12644,14580,19,300,7,82,6,21,197,50,38,10,52,272,1889,1566,11626,13515,9/10/2020
4/9/2020,284,2220,1521,14165,16385,32,332,9,91,4,25,216,53,40,7,59,280,2169,1359,12985,15154,9/10/2020
4/10/2020,420,2640,2577,16742,19382,29,361,15,106,5,30,225,59,41,11,70,403,2572,2373,15358,17930,9/10/2020
4/11/2020,299,2939,1911,18653,21592,29,390,11,117,2,32,241,61,48,12,82,281,2853,1720,17078,19931,9/10/2020
4/12/2020,315,3254,1674,20327,23581,35,425,13,130,5,37,258,59,49,9,91,289,3142,1439,18517,21659,9/10/2020
4/13/2020,162,3416,938,21265,24681,35,460,13,143,3,40,277,64,54,9,100,187,3329,840,19357,22686,9/10/2020
4/14/2020,289,3705,1788,23053,26758,27,487,17,160,5,45,282,72,53,8,108,265,3594,1528,20885,24479,9/10/2020
4/15/2020,353,4058,1803,24856,28914,31,518,20,180,3,48,290,72,54,17,125,307,3901,1562,22447,26348,9/10/2020
4/16/2020,449,4507,2500,27356,31863,36,554,25,205,6,54,295,72,53,14,139,391,4292,2081,24528,28820,9/10/2020
4/17/2020,308,4815,1823,29179,33994,32,586,20,225,7,61,300,66,45,21,160,293,4585,1454,25982,30567,9/10/2020
4/18/2020,322,5137,1728,30907,36044,26,612,18,243,4,65,304,63,49,15,175,286,4871,1338,27320,32191,9/10/2020
4/19/2020,382,5519,2059,32966,38485,23,635,26,269,1,66,300,65,55,11,186,338,5209,1746,29066,34275,9/10/2020
4/20/2020,396,5915,1909,34875,40790,46,681,29,298,2,68,315,75,56,10,196,377,5586,1578,30644,36230,9/10/2020
4/21/2020,445,6360,2114,36989,43349,45,726,31,329,5,73,324,72,56,18,214,390,5976,1717,32361,38337,9/10/2020
4/22/2020,420,6780,2398,39387,46167,41,767,32,361,5,78,328,73,58,18,232,385,6361,1917,34278,40639,9/10/2020
4/23/2020,481,7261,2471,41858,49119,32,799,28,389,5,83,327,76,62,15,247,419,6780,1864,36142,42922,9/10/2020
4/24/2020,494,7755,3292,45150,52905,35,834,27,416,4,87,331,85,63,15,262,416,7196,2632,38774,45970,9/10/2020
4/25/2020,394,8149,2210,47360,55509,34,868,17,433,5,92,343,85,62,14,276,304,7500,1775,40549,48049,9/10/2020
4/26/2020,316,8465,2314,49674,58139,33,901,15,448,3,95,358,86,59,14,290,275,7775,1882,42431,50206,9/10/2020
4/27/2020,250,8715,1624,51298,60013,29,930,21,469,4,99,362,86,61,10,300,204,7979,1163,43594,51573,9/10/2020
4/28/2020,411,9126,2268,53566,62692,44,974,24,493,3,102,379,88,59,22,322,330,8309,1767,45361,53670,9/10/2020
4/29/2020,476,9602,3351,56917,66519,36,1010,38,531,11,113,366,78,53,18,340,373,8682,2429,47790,56472,9/10/2020
4/30/2020,432,10034,2772,59689,69723,33,1043,38,569,6,119,355,83,57,24,364,352,9034,1952,49742,58776,9/10/2020
5/1/2020,457,10491,3089,62778,73269,51,1094,39,608,3,122,364,84,58,14,378,320,9354,2214,51956,61310,9/10/2020
5/2/2020,260,10751,1927,64705,75456,36,1130,39,647,5,127,356,91,62,24,402,189,9543,1292,53248,62791,9/10/2020
5/3/2020,284,11035,2168,66873,77908,31,1161,27,674,8,135,352,90,61,21,423,182,9725,1602,54850,64575,9/10/2020
5/4/2020,388,11423,2101,68974,80397,30,1191,31,705,5,140,346,88,57,18,441,293,10018,1569,56419,66437,9/10/2020
5/5/2020,436,11859,2878,71852,83711,29,1220,32,737,6,146,337,82,54,16,457,308,10326,1966,58385,68711,9/10/2020
5/6/2020,490,12349,2837,74689,87038,28,1248,44,781,9,155,312,79,54,21,478,342,10668,1924,60309,70977,9/10/2020
5/7/2020,425,12774,2975,77664,90438,36,1284,42,823,5,160,301,71,52,21,499,274,10942,1973,62282,73224,9/10/2020
5/8/2020,360,13134,2603,80267,93401,30,1314,29,852,5,165,297,71,53,22,521,233,11175,1748,64030,75205,9/10/2020
5/9/2020,470,13604,3356,83623,97227,22,1336,21,873,4,169,294,69,51,15,536,291,11466,2272,66302,77768,9/10/2020
5/10/2020,285,13889,2122,85745,99634,20,1356,23,896,6,175,285,70,49,13,549,188,11654,1524,67826,79480,9/10/2020
5/11/2020,259,14148,1861,87606,101754,31,1387,16,912,6,181,294,71,49,15,564,178,11832,1304,69130,80962,9/10/2020
5/12/2020,387,14535,2622,90228,104763,23,1410,18,930,4,185,295,69,48,22,586,219,12051,1712,70842,82893,9/10/2020
5/13/2020,352,14887,3634,93862,108749,23,1433,25,955,1,186,292,69,49,13,599,199,12250,2013,72855,85105,9/10/2020
5/14/2020,330,15217,3415,97277,112494,19,1452,27,982,3,189,281,64,45,15,614,231,12481,2021,74876,87357,9/10/2020
5/15/2020,382,15599,3470,100747,116346,24,1476,41,1023,5,194,259,62,45,13,627,237,12718,1813,76689,89407,9/10/2020
5/16/2020,453,16052,4168,104915,120967,25,1501,13,1036,5,199,266,61,46,15,642,252,12970,1964,78653,91623,9/10/2020
5/17/2020,240,16292,2775,107690,123982,17,1518,8,1044,5,204,270,59,45,10,652,129,13099,1561,80214,93313,9/10/2020
5/18/2020,251,16543,2007,109697,126240,19,1537,15,1059,5,209,269,57,40,18,670,140,13239,1371,81585,94824,9/10/2020
5/19/2020,416,16959,3178,112875,129834,23,1560,32,1091,5,214,255,56,38,11,681,214,13453,1933,83518,96971,9/10/2020
5/20/2020,328,17287,2775,115650,132937,19,1579,23,1114,7,221,244,52,33,22,703,188,13641,1518,85036,98677,9/10/2020
5/21/2020,374,17661,3764,119414,137075,26,1605,15,1129,3,224,252,53,29,20,723,170,13811,1945,86981,100792,9/10/2020
5/22/2020,353,18014,3172,122586,140600,20,1625,29,1158,5,229,238,52,29,10,733,204,14015,1615,88596,102611,9/10/2020
5/23/2020,253,18267,2748,125334,143601,19,1644,11,1169,3,232,243,52,32,13,746,108,14123,1275,89871,103994,9/10/2020
5/24/2020,165,18432,1372,126706,145138,12,1656,14,1183,2,234,239,53,36,8,754,83,14206,773,90644,104850,9/10/2020
5/25/2020,147,18579,1389,128095,146674,13,1669,14,1197,0,234,238,53,34,10,764,72,14278,762,91406,105684,9/10/2020
5/26/2020,285,18864,2624,130719,149583,24,1693,22,1219,5,239,235,48,33,15,779,165,14443,1781,93187,107630,9/10/2020
5/27/2020,276,19140,2125,132844,151984,20,1713,18,1237,3,242,234,50,33,10,789,134,14577,1136,94323,108900,9/10/2020
5/28/2020,349,19489,3372,136216,155705,17,1730,29,1266,4,246,218,47,32,8,797,134,14711,1124,95447,110158,9/10/2020
5/29/2020,417,19906,3973,140189,160095,19,1749,27,1293,6,252,204,43,31,12,809,177,14888,1575,97022,111910,9/10/2020
5/30/2020,228,20134,3972,144161,164295,15,1764,19,1312,4,256,196,40,29,12,821,109,14997,1821,98843,113840,9/10/2020
5/31/2020,159,20293,1759,145920,166213,11,1775,10,1322,0,256,197,43,26,3,824,78,15075,857,99700,114775,9/10/2020
6/1/2020,215,20508,2823,148743,169251,8,1783,14,1336,1,257,190,44,29,5,829,99,15174,1387,101087,116261,9/10/2020
6/2/2020,273,20781,3076,151819,172600,8,1791,9,1345,3,260,186,37,25,10,839,107,15281,1454,102541,117822,9/10/2020
6/3/2020,260,21041,3514,155333,176374,14,1805,18,1363,6,266,176,34,25,11,850,105,15386,1667,104208,119594,9/10/2020
6/4/2020,281,21322,4536,159869,181191,7,1812,25,1388,3,269,155,31,24,11,861,111,15497,2041,106249,121746,9/10/2020
6/5/2020,216,21538,3586,163455,184993,15,1827,13,1401,6,275,151,27,21,11,872,106,15603,1578,107827,123430,9/10/2020
6/6/2020,203,21741,2630,166085,187826,10,1837,7,1408,2,277,152,29,19,6,878,69,15672,1137,108964,124636,9/10/2020
6/7/2020,83,21824,1629,167714,189538,11,1848,7,1415,1,278,155,25,17,4,882,50,15722,782,109746,125468,9/10/2020
6/8/2020,120,21944,1852,169566,191510,15,1863,12,1427,2,280,156,27,18,4,886,44,15766,963,110709,126475,9/10/2020
6/9/2020,223,22167,2683,172249,194416,10,1873,18,1445,0,280,148,28,21,1,887,67,15833,1260,111969,127802,9/10/2020
6/10/2020,210,22377,2999,175248,197625,13,1886,12,1457,2,282,147,24,17,3,890,105,15938,1468,113437,129375,9/10/2020
6/11/2020,195,22572,3518,178766,201338,7,1893,15,1472,1,283,138,25,16,6,896,88,16026,1539,114976,131002,9/10/2020
6/12/2020,209,22781,4614,183380,206161,9,1902,15,1487,1,284,131,24,16,2,898,82,16108,2187,117163,133271,9/10/2020
6/13/2020,114,22895,3044,186424,209319,6,1908,4,1491,0,284,133,20,15,3,901,50,16158,1376,118539,134697,9/10/2020
6/14/2020,81,22976,2050,188474,211450,7,1915,8,1499,1,285,131,20,14,3,904,33,16191,969,119508,135699,9/10/2020
6/15/2020,189,23165,3117,191591,214756,14,1929,14,1513,0,285,131,20,16,4,908,78,16269,1794,121302,137571,9/10/2020
6/16/2020,111,23276,3024,194615,217891,10,1939,9,1522,1,286,131,22,16,8,916,52,16321,1579,122881,139202,9/10/2020
6/17/2020,128,23404,2843,197458,220862,15,1954,20,1542,4,290,122,18,14,6,922,53,16374,1321,124202,140576,9/10/2020
6/18/2020,149,23553,3056,200514,224067,9,1963,13,1555,1,291,117,19,16,7,929,70,16444,1329,125531,141975,9/10/2020
6/19/2020,141,23694,3773,204287,227981,12,1975,11,1566,1,292,117,20,17,3,932,59,16503,1373,126904,143407,9/10/2020
6/20/2020,84,23778,1896,206183,229961,9,1984,12,1578,0,292,114,20,18,4,936,36,16539,816,127720,144259,9/10/2020
6/21/2020,37,23815,1069,207252,231067,8,1992,5,1583,0,292,117,20,18,2,938,28,16567,692,128412,144979,9/10/2020
6/22/2020,138,23953,3739,210991,234944,12,2004,16,1599,0,292,113,19,18,1,939,69,16636,1710,130122,146758,9/10/2020
6/23/2020,163,24116,3854,214845,238961,3,2007,13,1612,3,295,100,18,18,7,946,83,16719,1786,131908,148627,9/10/2020
6/24/2020,120,24236,3518,218363,242599,9,2016,10,1622,1,296,98,18,18,5,951,46,16765,1689,133597,150362,9/10/2020
6/25/2020,103,24339,2899,221262,245601,6,2022,14,1636,1,297,89,17,17,1,952,54,16819,1517,135114,151933,9/10/2020
6/26/2020,94,24433,2499,223761,248194,2,2024,10,1646,0,297,81,18,18,1,953,63,16882,1333,136447,153329,9/10/2020
6/27/2020,84,24517,3227,226988,251505,5,2029,3,1649,1,298,82,17,17,5,958,37,16919,1221,137668,154587,9/10/2020
6/28/2020,40,24557,1471,228459,253016,4,2033,4,1653,4,302,78,15,14,6,964,19,16938,596,138264,155202,9/10/2020
6/29/2020,85,24642,3701,232160,256802,4,2037,5,1658,0,302,77,14,14,1,965,39,16977,1355,139619,156596,9/10/2020
6/30/2020,59,24701,1964,234124,258825,1,2038,5,1663,1,303,72,12,11,3,968,33,17010,996,140615,157625,9/10/2020
7/1/2020,145,24846,4111,238235,263081,7,2045,9,1672,0,303,70,11,11,1,969,80,17090,1938,142553,159643,9/10/2020
7/2/2020,103,24949,2806,241041,265990,5,2050,5,1677,1,304,69,10,10,1,970,57,17147,1091,143644,160791,9/10/2020
7/3/2020,50,24999,2080,243121,268120,9,2059,6,1683,0,304,72,9,9,3,973,26,17173,781,144425,161598,9/10/2020
7/4/2020,58,25057,2350,245471,270528,2,2061,4,1687,1,305,69,10,9,2,975,34,17207,1012,145437,162644,9/10/2020
7/5/2020,51,25108,2939,248410,273518,1,2062,2,1689,1,306,67,8,8,2,977,26,17233,1448,146885,164118,9/10/2020
7/6/2020,102,25210,2820,251230,276440,6,2068,6,1695,0,306,67,9,9,4,981,58,17291,1553,148438,165729,9/10/2020
7/7/2020,82,25292,3470,254700,279992,5,2073,7,1702,0,306,65,8,8,2,983,48,17339,1537,149975,167314,9/10/2020
7/8/2020,105,25397,3415,258115,283512,4,2077,2,1704,0,306,67,9,8,0,983,64,17403,1427,151402,168805,9/10/2020
7/9/2020,95,25492,3725,261840,287332,9,2086,3,1707,0,306,73,9,8,0,983,51,17454,1631,153033,170487,9/10/2020
7/10/2020,131,25623,4445,266285,291908,6,2092,3,1710,2,308,74,7,7,3,986,80,17534,2084,155117,172651,9/10/2020
7/11/2020,64,25687,2943,269228,294915,6,2098,3,1713,1,309,76,6,6,3,989,34,17568,1320,156437,174005,9/10/2020
7/12/2020,47,25734,1842,271070,296804,1,2099,3,1716,1,310,73,6,5,3,992,34,17602,943,157380,174982,9/10/2020
7/13/2020,84,25818,3166,274236,300054,8,2107,10,1726,0,310,71,6,5,1,993,57,17659,1477,158857,176516,9/10/2020
7/14/2020,74,25892,3300,277536,303428,7,2114,4,1730,0,310,74,5,5,1,994,49,17708,1375,160232,177940,9/10/2020
7/15/2020,130,26022,4180,281716,307738,5,2119,7,1737,0,310,72,5,4,0,994,100,17808,1758,161990,179798,9/10/2020
7/16/2020,102,26124,3745,285461,311585,6,2125,9,1746,0,310,69,6,5,1,995,78,17886,1621,163611,181497,9/10/2020
7/17/2020,157,26281,4244,289705,315986,14,2139,3,1749,1,311,79,5,5,1,996,81,17967,1851,165462,183429,9/10/2020
7/18/2020,85,26366,3276,292981,319347,5,2144,9,1758,1,312,74,5,4,4,1000,69,18036,1403,166865,184901,9/10/2020
7/19/2020,83,26449,2709,295690,322139,7,2151,3,1761,0,312,78,6,4,2,1002,59,18095,1151,168016,186111,9/10/2020
7/20/2020,71,26520,2666,298356,324876,9,2160,7,1768,0,312,80,7,5,2,1004,69,18164,1467,169483,187647,9/10/2020
7/21/2020,131,26651,4312,302668,329319,9,2169,11,1779,0,312,78,9,6,1,1005,109,18273,1927,171410,189683,9/10/2020
7/22/2020,130,26781,3938,306606,333387,11,2180,11,1790,1,313,77,7,6,1,1006,87,18360,1685,173095,191455,9/10/2020
7/23/2020,142,26923,4388,310994,337917,8,2188,6,1796,0,313,79,8,7,0,1006,116,18476,1972,175067,193543,9/10/2020
7/24/2020,173,27096,5968,316962,344058,13,2201,13,1809,0,313,79,9,7,0,1006,123,18599,2326,177393,195992,9/10/2020
7/25/2020,135,27231,4415,321377,348608,7,2208,7,1816,0,313,79,10,8,2,1008,107,18706,2101,179494,198200,9/10/2020
7/26/2020,62,27293,3041,324418,351711,8,2216,9,1825,0,313,78,11,7,1,1009,54,18760,1341,180835,199595,9/10/2020
7/27/2020,186,27479,4184,328602,356081,12,2228,7,1832,0,313,83,13,8,1,1010,140,18900,2336,183171,202071,9/10/2020
7/28/2020,105,27584,3844,332446,360030,5,2233,5,1837,0,313,83,14,7,1,1011,89,18989,1636,184807,203796,9/10/2020
7/29/2020,191,27775,5143,337589,365364,10,2243,12,1849,0,313,81,15,7,0,1011,156,19145,2327,187134,206279,9/10/2020
7/30/2020,121,27896,4357,341946,369842,6,2249,2,1851,1,314,84,15,6,1,1012,96,19241,1651,188785,208026,9/10/2020
7/31/2020,132,28028,5519,347465,375493,8,2257,9,1860,0,314,83,15,7,0,1012,90,19331,1862,190647,209978,9/10/2020
8/1/2020,109,28137,4295,351760,379897,7,2264,2,1862,0,314,88,14,7,1,1013,88,19419,1559,192206,211625,9/10/2020
8/2/2020,84,28221,2811,354571,382792,12,2276,12,1874,2,316,86,14,8,2,1015,62,19481,1278,193484,212965,9/10/2020
8/3/2020,187,28408,5214,359785,388193,13,2289,12,1886,0,316,87,16,7,1,1016,155,19636,2188,195672,215308,9/10/2020
8/4/2020,126,28534,3694,363479,392013,8,2297,6,1892,1,317,88,12,5,2,1018,99,19735,1776,197448,217183,9/10/2020
8/5/2020,150,28684,5939,369418,398102,12,2309,10,1902,1,318,89,10,5,2,1020,118,19853,2477,199925,219778,9/10/2020
8/6/2020,170,28854,5546,374964,403818,7,2316,9,1911,0,318,87,9,4,0,1020,121,19974,2429,202354,222328,9/10/2020
8/7/2020,122,28976,4855,379819,408795,13,2329,10,1921,1,319,89,9,3,1,1021,90,20064,2165,204519,224583,9/10/2020
8/8/2020,122,29098,4117,383936,413034,19,2348,6,1927,1,320,101,8,3,1,1022,96,20160,1783,206302,226462,9/10/2020
8/9/2020,42,29140,1729,385665,414805,8,2356,11,1938,0,320,98,9,4,0,1022,36,20196,1077,207379,227575,9/10/2020
8/10/2020,150,29290,4590,390255,419545,11,2367,11,1949,0,320,98,9,4,1,1023,112,20308,2031,209410,229718,9/10/2020
8/11/2020,105,29395,4327,394582,423977,6,2373,14,1963,0,320,90,10,4,2,1025,93,20401,2274,211684,232085,9/10/2020
8/12/2020,121,29516,5198,399780,429296,8,2381,11,1974,0,320,87,9,3,1,1026,103,20504,2631,214315,234819,9/10/2020
8/13/2020,135,29651,4198,403978,433629,13,2394,12,1986,0,320,88,11,3,0,1026,97,20601,1911,216226,236827,9/10/2020
8/14/2020,146,29797,5474,409452,439249,13,2407,11,1997,0,320,90,11,4,3,1029,101,20702,1956,218182,238884,9/10/2020
8/15/2020,105,29902,4539,413991,443893,8,2415,11,2008,1,321,86,11,5,0,1029,89,20791,1703,219885,240676,9/10/2020
8/16/2020,83,29985,2798,416789,446774,7,2422,6,2014,4,325,83,8,4,5,1034,71,20862,989,220874,241736,9/10/2020
8/17/2020,107,30092,4554,421343,451435,10,2432,7,2021,0,325,86,8,5,2,1036,87,20949,2389,223263,244212,9/10/2020
8/18/2020,129,30221,5054,426397,456618,11,2443,9,2030,1,326,87,8,4,5,1041,97,21046,2794,226057,247103,9/10/2020
8/19/2020,114,30335,5417,431814,462149,8,2451,9,2039,1,327,85,9,5,0,1041,90,21136,2688,228745,249881,9/10/2020
8/20/2020,174,30509,8275,440089,470598,12,2463,6,2045,2,329,89,10,5,3,1044,137,21273,3576,232321,253594,9/10/2020
8/21/2020,156,30665,6828,446917,477582,8,2471,5,2050,1,330,91,9,4,2,1046,125,21398,2982,235303,256701,9/10/2020
8/22/2020,96,30761,5980,452897,483658,10,2481,12,2062,0,330,89,11,4,1,1047,84,21482,2635,237938,259420,9/10/2020
8/23/2020,72,30833,4375,457272,488105,11,2492,6,2068,0,330,94,11,2,1,1048,57,21539,2481,240419,261958,9/10/2020
8/24/2020,105,30938,5784,463056,493994,7,2499,10,2078,1,331,90,13,4,1,1049,75,21614,3169,243588,265202,9/10/2020
8/25/2020,108,31046,4822,467878,498924,10,2509,4,2082,1,332,95,11,4,1,1050,93,21707,2313,245901,267608,9/10/2020
8/26/2020,171,31217,9622,477500,508717,3,2512,8,2090,0,332,90,9,5,1,1051,126,21833,3096,248997,270830,9/10/2020
8/27/2020,94,31311,8915,486415,517726,5,2517,13,2103,1,333,81,6,5,2,1053,71,21904,3271,252268,274172,9/10/2020
8/28/2020,113,31424,8122,494537,525961,13,2530,4,2107,0,333,90,9,7,2,1055,85,21989,2461,254729,276718,9/10/2020
8/29/2020,65,31489,5536,500073,531562,6,2536,8,2115,1,334,87,10,6,1,1056,53,22042,1923,256652,278694,9/10/2020
8/30/2020,67,31556,4336,504409,535965,7,2543,4,2119,0,334,90,8,5,1,1057,49,22091,2000,258652,280743,9/10/2020
8/31/2020,106,31662,4874,509283,540945,10,2553,15,2134,0,334,85,8,4,0,1057,82,22173,2197,260849,283022,9/10/2020
9/1/2020,99,31761,7213,516496,548257,6,2559,9,2143,1,335,81,7,4,1,1058,67,22240,2389,263238,285478,9/10/2020
9/2/2020,123,31884,10609,527105,558989,8,2567,10,2153,1,336,78,8,4,2,1060,101,22341,2956,266194,288535,9/10/2020
9/3/2020,90,31974,11366,538471,570445,8,2575,8,2161,0,336,78,9,4,1,1061,77,22418,2595,268789,291207,9/10/2020
9/4/2020,103,32077,9218,547689,579766,10,2585,4,2165,0,336,84,9,4,1,1062,82,22500,2411,271200,293700,9/10/2020
9/5/2020,52,32129,6359,554048,586177,6,2591,9,2174,0,336,81,7,3,1,1063,42,22542,1593,272793,295335,9/10/2020
9/6/2020,88,32217,4328,558376,590593,4,2595,8,2182,1,337,76,5,3,1,1064,66,22608,1959,274752,297360,9/10/2020
9/7/2020,34,32251,2828,561204,593455,10,2605,4,2186,0,337,82,4,3,1,1065,27,22635,537,275289,297924,9/10/2020
9/8/2020,71,32322,5547,566751,599073,6,2611,11,2197,1,338,76,5,3,2,1067,63,22698,1347,276636,299334,9/10/2020
9/9/2020,103,32425,7730,574481,606906,,,,,,,,,,0,1067,84,22782,1895,278531,301313,9/10/2020
2/27/2020,0,0,0,0,0,1,1,0,0,0,0,1,0,0,0,0,0,0,0,0,0,9/11/2020
2/28/2020,0,0,0,0,0,0,1,0,0,0,0,1,1,0,0,0,0,0,0,0,0,9/11/2020
2/29/2020,0,0,0,0,0,0,1,0,0,0,0,1,1,0,0,0,0,0,0,0,0,9/11/2020
3/1/2020,2,2,2,2,4,0,1,0,0,0,0,1,1,1,0,0,2,2,2,2,4,9/11/2020
3/2/2020,0,2,1,3,5,1,2,0,0,0,0,2,2,2,0,0,0,2,1,3,5,9/11/2020
3/3/2020,0,2,2,5,7,0,2,0,0,0,0,2,2,2,0,0,0,2,2,5,7,9/11/2020
3/4/2020,0,2,12,17,19,1,3,0,0,0,0,3,2,2,0,0,0,2,10,15,17,9/11/2020
3/5/2020,0,2,4,21,23,0,3,0,0,0,0,3,2,2,0,0,1,3,4,19,22,9/11/2020
3/6/2020,1,3,12,33,36,0,3,0,0,0,0,3,2,2,0,0,0,3,11,30,33,9/11/2020
3/7/2020,0,3,19,52,55,0,3,0,0,0,0,3,2,1,0,0,0,3,19,49,52,9/11/2020
3/8/2020,0,3,18,70,73,0,3,0,0,0,0,3,2,1,0,0,0,3,18,67,70,9/11/2020
3/9/2020,1,4,15,85,89,0,3,0,0,0,0,3,2,1,0,0,1,4,15,82,86,9/11/2020
3/10/2020,2,6,25,110,116,0,3,0,0,0,0,3,2,1,0,0,1,5,23,105,110,9/11/2020
3/11/2020,0,6,34,144,150,1,4,0,0,0,0,4,1,1,0,0,0,5,34,139,144,9/11/2020
3/12/2020,9,15,41,185,200,1,5,0,0,0,0,5,1,1,0,0,8,13,38,177,190,9/11/2020
3/13/2020,6,21,50,235,256,4,9,1,1,0,0,8,1,1,0,0,6,19,48,225,244,9/11/2020
3/14/2020,0,21,90,325,346,0,9,0,1,0,0,8,1,1,0,0,0,19,86,311,330,9/11/2020
3/15/2020,1,22,54,379,401,1,10,0,1,0,0,9,2,1,0,0,1,20,54,365,385,9/11/2020
3/16/2020,2,24,95,474,498,2,12,0,1,0,0,11,2,0,0,0,2,22,92,457,479,9/11/2020
3/17/2020,16,40,162,636,676,6,18,0,1,0,0,17,2,0,0,0,11,33,151,608,641,9/11/2020
3/18/2020,12,52,116,752,804,3,21,0,1,0,0,20,2,0,0,0,11,44,110,718,762,9/11/2020
3/19/2020,17,69,262,1014,1083,2,23,1,2,0,0,21,3,0,1,1,17,61,251,969,1030,9/11/2020
3/20/2020,14,83,197,1211,1294,5,28,0,2,0,0,26,4,0,0,1,13,74,192,1161,1235,9/11/2020
3/21/2020,21,104,126,1337,1441,3,31,2,4,0,0,27,5,0,0,1,14,88,123,1284,1372,9/11/2020
3/22/2020,30,134,282,1619,1753,2,33,0,4,0,0,29,5,0,0,1,25,113,262,1546,1659,9/11/2020
3/23/2020,14,148,169,1788,1936,15,48,1,5,0,0,43,9,3,0,1,16,129,165,1711,1840,9/11/2020
3/24/2020,20,168,242,2030,2198,7,55,0,5,0,0,50,10,4,0,1,19,148,238,1949,2097,9/11/2020
3/25/2020,26,194,183,2213,2407,5,60,1,6,0,0,54,11,3,0,1,28,176,172,2121,2297,9/11/2020
3/26/2020,35,229,181,2394,2623,10,70,5,11,0,0,59,14,5,0,1,41,217,176,2297,2514,9/11/2020
3/27/2020,27,256,215,2609,2865,9,79,1,12,1,1,66,17,6,2,3,31,248,202,2499,2747,9/11/2020
3/28/2020,59,315,260,2869,3184,13,92,3,15,2,3,74,15,6,1,4,63,311,241,2740,3051,9/11/2020
3/29/2020,106,421,356,3225,3646,8,100,4,19,1,4,77,18,8,2,6,105,416,314,3054,3470,9/11/2020
3/30/2020,62,483,222,3447,3930,20,120,5,24,0,4,92,20,11,3,9,78,494,185,3239,3733,9/11/2020
3/31/2020,71,554,369,3816,4370,11,131,7,31,1,5,95,22,13,2,11,73,567,298,3537,4104,9/11/2020
4/1/2020,99,653,699,4515,5168,18,149,7,38,0,5,106,30,15,1,12,102,669,642,4179,4848,9/11/2020
4/2/2020,52,705,477,4992,5697,22,171,6,44,2,7,120,36,21,4,16,62,731,436,4615,5346,9/11/2020
4/3/2020,108,813,775,5767,6580,23,194,7,51,0,7,136,43,25,3,19,100,831,713,5328,6159,9/11/2020
4/4/2020,143,956,660,6427,7383,22,216,4,55,5,12,149,41,30,9,28,137,968,619,5947,6915,9/11/2020
4/5/2020,187,1143,1156,7583,8726,20,236,9,64,1,13,159,44,36,2,30,182,1150,1069,7016,8166,9/11/2020
4/6/2020,218,1361,1707,9290,10651,26,262,7,71,0,13,178,48,40,7,37,206,1356,1557,8573,9929,9/11/2020
4/7/2020,285,1646,1631,10921,12567,19,281,3,74,2,15,192,50,42,5,42,261,1617,1484,10057,11674,9/11/2020
4/8/2020,290,1936,1723,12644,14580,19,300,7,81,6,21,198,50,38,10,52,272,1889,1566,11623,13512,9/11/2020
4/9/2020,284,2220,1521,14165,16385,32,332,9,90,4,25,217,53,40,7,59,280,2169,1359,12982,15151,9/11/2020
4/10/2020,420,2640,2577,16742,19382,29,361,16,106,5,30,225,59,41,11,70,403,2572,2373,15355,17927,9/11/2020
4/11/2020,299,2939,1911,18653,21592,29,390,11,117,2,32,241,61,48,12,82,281,2853,1720,17075,19928,9/11/2020
4/12/2020,315,3254,1674,20327,23581,35,425,13,130,5,37,258,59,49,9,91,289,3142,1439,18514,21656,9/11/2020
4/13/2020,162,3416,938,21265,24681,35,460,13,143,3,40,277,64,54,9,100,187,3329,839,19353,22682,9/11/2020
4/14/2020,289,3705,1788,23053,26758,27,487,17,160,5,45,282,72,53,8,108,265,3594,1528,20881,24475,9/11/2020
4/15/2020,353,4058,1803,24856,28914,31,518,20,180,3,48,290,72,54,17,125,307,3901,1560,22441,26342,9/11/2020
4/16/2020,449,4507,2500,27356,31863,36,554,25,205,6,54,295,72,53,14,139,389,4290,2081,24522,28812,9/11/2020
4/17/2020,308,4815,1823,29179,33994,32,586,20,225,7,61,300,66,45,21,160,293,4583,1452,25974,30557,9/11/2020
4/18/2020,322,5137,1728,30907,36044,26,612,18,243,4,65,304,63,49,15,175,286,4869,1333,27307,32176,9/11/2020
4/19/2020,382,5519,2059,32966,38485,23,635,26,269,1,66,300,65,55,11,186,338,5207,1745,29052,34259,9/11/2020
4/20/2020,396,5915,1909,34875,40790,46,681,29,298,2,68,315,75,56,10,196,377,5584,1577,30629,36213,9/11/2020
4/21/2020,445,6360,2114,36989,43349,45,726,31,329,5,73,324,72,56,18,214,391,5975,1715,32344,38319,9/11/2020
4/22/2020,420,6780,2398,39387,46167,41,767,32,361,5,78,328,73,58,18,232,385,6360,1917,34261,40621,9/11/2020
4/23/2020,481,7261,2471,41858,49119,32,799,28,389,5,83,327,76,62,15,247,419,6779,1864,36125,42904,9/11/2020
4/24/2020,494,7755,3292,45150,52905,35,834,27,416,4,87,331,85,63,15,262,416,7195,2632,38757,45952,9/11/2020
4/25/2020,394,8149,2210,47360,55509,34,868,17,433,5,92,343,85,62,14,276,304,7499,1775,40532,48031,9/11/2020
4/26/2020,316,8465,2314,49674,58139,33,901,15,448,3,95,358,86,59,14,290,275,7774,1882,42414,50188,9/11/2020
4/27/2020,250,8715,1624,51298,60013,29,930,21,469,4,99,362,86,61,10,300,204,7978,1163,43577,51555,9/11/2020
4/28/2020,411,9126,2268,53566,62692,44,974,24,493,3,102,379,88,59,22,322,330,8308,1767,45344,53652,9/11/2020
4/29/2020,476,9602,3351,56917,66519,36,1010,38,531,11,113,366,78,53,18,340,373,8681,2429,47773,56454,9/11/2020
4/30/2020,432,10034,2772,59689,69723,33,1043,38,569,6,119,355,83,57,24,364,352,9033,1945,49718,58751,9/11/2020
5/1/2020,457,10491,3089,62778,73269,51,1094,39,608,3,122,364,84,58,14,378,320,9353,2204,51922,61275,9/11/2020
5/2/2020,260,10751,1927,64705,75456,36,1130,39,647,5,127,356,91,62,24,402,189,9542,1291,53213,62755,9/11/2020
5/3/2020,284,11035,2168,66873,77908,31,1161,27,674,8,135,352,90,61,21,423,182,9724,1602,54815,64539,9/11/2020
5/4/2020,388,11423,2101,68974,80397,30,1191,31,705,5,140,346,88,57,18,441,293,10017,1569,56384,66401,9/11/2020
5/5/2020,436,11859,2878,71852,83711,29,1220,32,737,6,146,337,82,54,16,457,308,10325,1966,58350,68675,9/11/2020
5/6/2020,490,12349,2837,74689,87038,28,1248,44,781,9,155,312,79,54,21,478,342,10667,1924,60274,70941,9/11/2020
5/7/2020,425,12774,2975,77664,90438,36,1284,42,823,5,160,301,71,52,21,499,274,10941,1972,62246,73187,9/11/2020
5/8/2020,360,13134,2603,80267,93401,30,1314,29,852,5,165,297,71,53,22,521,233,11174,1747,63993,75167,9/11/2020
5/9/2020,470,13604,3356,83623,97227,22,1336,21,873,4,169,294,69,51,15,536,291,11465,2270,66263,77728,9/11/2020
5/10/2020,285,13889,2122,85745,99634,20,1356,23,896,6,175,285,70,49,13,549,188,11653,1524,67787,79440,9/11/2020
5/11/2020,259,14148,1861,87606,101754,31,1387,16,912,6,181,294,71,49,15,564,178,11831,1304,69091,80922,9/11/2020
5/12/2020,387,14535,2622,90228,104763,23,1410,18,930,4,185,295,69,48,22,586,218,12049,1712,70803,82852,9/11/2020
5/13/2020,352,14887,3634,93862,108749,23,1433,25,955,1,186,292,69,49,13,599,199,12248,2012,72815,85063,9/11/2020
5/14/2020,330,15217,3415,97277,112494,19,1452,27,982,3,189,281,64,45,15,614,232,12480,2021,74836,87316,9/11/2020
5/15/2020,382,15599,3470,100747,116346,24,1476,41,1023,5,194,259,62,45,13,627,237,12717,1813,76649,89366,9/11/2020
5/16/2020,453,16052,4168,104915,120967,25,1501,13,1036,5,199,266,61,46,15,642,252,12969,1964,78613,91582,9/11/2020
5/17/2020,240,16292,2775,107690,123982,17,1518,8,1044,5,204,270,59,45,10,652,129,13098,1561,80174,93272,9/11/2020
5/18/2020,251,16543,2007,109697,126240,19,1537,15,1059,5,209,269,57,40,18,670,140,13238,1371,81545,94783,9/11/2020
5/19/2020,416,16959,3178,112875,129834,23,1560,32,1091,5,214,255,56,38,11,681,214,13452,1933,83478,96930,9/11/2020
5/20/2020,328,17287,2775,115650,132937,19,1579,23,1114,7,221,244,52,33,22,703,188,13640,1518,84996,98636,9/11/2020
5/21/2020,374,17661,3764,119414,137075,26,1605,15,1129,3,224,252,53,29,20,723,170,13810,1945,86941,100751,9/11/2020
5/22/2020,353,18014,3172,122586,140600,20,1625,29,1158,5,229,238,52,29,10,733,204,14014,1615,88556,102570,9/11/2020
5/23/2020,253,18267,2748,125334,143601,19,1644,11,1169,3,232,243,52,32,13,746,108,14122,1275,89831,103953,9/11/2020
5/24/2020,165,18432,1372,126706,145138,12,1656,14,1183,2,234,239,53,36,8,754,82,14204,773,90604,104808,9/11/2020
5/25/2020,147,18579,1389,128095,146674,13,1669,14,1197,0,234,238,53,34,10,764,72,14276,762,91366,105642,9/11/2020
5/26/2020,285,18864,2624,130719,149583,24,1693,22,1219,5,239,235,48,33,15,779,165,14441,1781,93147,107588,9/11/2020
5/27/2020,276,19140,2125,132844,151984,20,1713,18,1237,3,242,234,50,33,10,789,134,14575,1136,94283,108858,9/11/2020
5/28/2020,349,19489,3372,136216,155705,17,1730,29,1266,4,246,218,47,32,8,797,134,14709,1122,95405,110114,9/11/2020
5/29/2020,417,19906,3973,140189,160095,19,1749,27,1293,6,252,204,43,31,12,809,177,14886,1575,96980,111866,9/11/2020
5/30/2020,228,20134,3972,144161,164295,15,1764,19,1312,4,256,196,40,29,12,821,109,14995,1821,98801,113796,9/11/2020
5/31/2020,159,20293,1759,145920,166213,11,1775,10,1322,0,256,197,43,26,3,824,78,15073,857,99658,114731,9/11/2020
6/1/2020,215,20508,2823,148743,169251,8,1783,14,1336,1,257,190,44,29,5,829,99,15172,1387,101045,116217,9/11/2020
6/2/2020,273,20781,3076,151819,172600,8,1791,9,1345,3,260,186,37,25,10,839,107,15279,1454,102499,117778,9/11/2020
6/3/2020,260,21041,3514,155333,176374,14,1805,18,1363,6,266,176,34,25,11,850,105,15384,1667,104166,119550,9/11/2020
6/4/2020,281,21322,4536,159869,181191,7,1812,25,1388,3,269,155,31,24,11,861,111,15495,2041,106207,121702,9/11/2020
6/5/2020,216,21538,3586,163455,184993,15,1827,13,1401,6,275,151,27,21,11,872,106,15601,1578,107785,123386,9/11/2020
6/6/2020,203,21741,2630,166085,187826,10,1837,7,1408,2,277,152,29,19,6,878,69,15670,1137,108922,124592,9/11/2020
6/7/2020,83,21824,1629,167714,189538,11,1848,7,1415,1,278,155,25,17,4,882,50,15720,782,109704,125424,9/11/2020
6/8/2020,120,21944,1852,169566,191510,15,1863,12,1427,2,280,156,27,18,4,886,44,15764,963,110667,126431,9/11/2020
6/9/2020,223,22167,2683,172249,194416,10,1873,18,1445,0,280,148,28,21,1,887,67,15831,1260,111927,127758,9/11/2020
6/10/2020,210,22377,2999,175248,197625,13,1886,12,1457,2,282,147,24,17,3,890,105,15936,1468,113395,129331,9/11/2020
6/11/2020,195,22572,3518,178766,201338,7,1893,15,1472,1,283,138,25,16,6,896,88,16024,1539,114934,130958,9/11/2020
6/12/2020,209,22781,4614,183380,206161,9,1902,15,1487,1,284,131,24,16,2,898,82,16106,2187,117121,133227,9/11/2020
6/13/2020,114,22895,3044,186424,209319,6,1908,4,1491,0,284,133,20,15,3,901,50,16156,1376,118497,134653,9/11/2020
6/14/2020,81,22976,2050,188474,211450,7,1915,8,1499,1,285,131,20,14,3,904,33,16189,969,119466,135655,9/11/2020
6/15/2020,189,23165,3117,191591,214756,14,1929,14,1513,0,285,131,20,16,5,909,78,16267,1794,121260,137527,9/11/2020
6/16/2020,111,23276,3024,194615,217891,10,1939,9,1522,1,286,131,22,16,8,917,52,16319,1579,122839,139158,9/11/2020
6/17/2020,128,23404,2843,197458,220862,15,1954,20,1542,4,290,122,18,14,6,923,53,16372,1321,124160,140532,9/11/2020
6/18/2020,149,23553,3056,200514,224067,9,1963,13,1555,1,291,117,19,16,7,930,70,16442,1328,125488,141930,9/11/2020
6/19/2020,141,23694,3773,204287,227981,12,1975,11,1566,1,292,117,20,17,3,933,59,16501,1372,126860,143361,9/11/2020
6/20/2020,84,23778,1896,206183,229961,9,1984,12,1578,0,292,114,20,18,4,937,36,16537,816,127676,144213,9/11/2020
6/21/2020,37,23815,1069,207252,231067,8,1992,5,1583,0,292,117,20,18,2,939,28,16565,692,128368,144933,9/11/2020
6/22/2020,138,23953,3739,210991,234944,12,2004,16,1599,0,292,113,19,18,1,940,69,16634,1710,130078,146712,9/11/2020
6/23/2020,163,24116,3854,214845,238961,3,2007,13,1612,3,295,100,18,18,7,947,83,16717,1786,131864,148581,9/11/2020
6/24/2020,120,24236,3518,218363,242599,9,2016,10,1622,1,296,98,18,18,5,952,46,16763,1689,133553,150316,9/11/2020
6/25/2020,103,24339,2899,221262,245601,6,2022,14,1636,1,297,89,17,17,1,953,54,16817,1517,135070,151887,9/11/2020
6/26/2020,94,24433,2499,223761,248194,2,2024,10,1646,0,297,81,18,18,1,954,63,16880,1332,136402,153282,9/11/2020
6/27/2020,84,24517,3227,226988,251505,5,2029,3,1649,1,298,82,17,17,5,959,37,16917,1221,137623,154540,9/11/2020
6/28/2020,40,24557,1471,228459,253016,4,2033,4,1653,4,302,78,15,14,6,965,19,16936,596,138219,155155,9/11/2020
6/29/2020,85,24642,3701,232160,256802,4,2037,5,1658,0,302,77,14,14,1,966,39,16975,1355,139574,156549,9/11/2020
6/30/2020,59,24701,1964,234124,258825,1,2038,5,1663,1,303,72,12,11,3,969,33,17008,996,140570,157578,9/11/2020
7/1/2020,145,24846,4111,238235,263081,7,2045,9,1672,0,303,70,11,11,1,970,80,17088,1938,142508,159596,9/11/2020
7/2/2020,103,24949,2806,241041,265990,5,2050,5,1677,1,304,69,10,10,2,972,57,17145,1091,143599,160744,9/11/2020
7/3/2020,50,24999,2080,243121,268120,9,2059,6,1683,0,304,72,9,9,3,975,26,17171,781,144380,161551,9/11/2020
7/4/2020,58,25057,2350,245471,270528,2,2061,4,1687,1,305,69,10,9,2,977,34,17205,1012,145392,162597,9/11/2020
7/5/2020,51,25108,2939,248410,273518,1,2062,2,1689,1,306,67,8,8,2,979,26,17231,1448,146840,164071,9/11/2020
7/6/2020,102,25210,2820,251230,276440,6,2068,6,1695,0,306,67,9,9,4,983,58,17289,1553,148393,165682,9/11/2020
7/7/2020,82,25292,3470,254700,279992,5,2073,7,1702,0,306,65,8,8,2,985,48,17337,1537,149930,167267,9/11/2020
7/8/2020,105,25397,3415,258115,283512,4,2077,2,1704,0,306,67,9,8,0,985,65,17402,1427,151357,168759,9/11/2020
7/9/2020,95,25492,3725,261840,287332,9,2086,3,1707,0,306,73,9,8,0,985,51,17453,1631,152988,170441,9/11/2020
7/10/2020,131,25623,4445,266285,291908,6,2092,3,1710,2,308,74,7,7,3,988,80,17533,2084,155072,172605,9/11/2020
7/11/2020,64,25687,2943,269228,294915,6,2098,3,1713,1,309,76,6,6,3,991,34,17567,1320,156392,173959,9/11/2020
7/12/2020,47,25734,1842,271070,296804,1,2099,3,1716,1,310,73,6,5,3,994,34,17601,943,157335,174936,9/11/2020
7/13/2020,84,25818,3166,274236,300054,8,2107,10,1726,0,310,71,6,5,1,995,61,17662,1477,158812,176474,9/11/2020
7/14/2020,74,25892,3300,277536,303428,7,2114,4,1730,0,310,74,5,5,1,996,49,17711,1375,160187,177898,9/11/2020
7/15/2020,130,26022,4180,281716,307738,5,2119,7,1737,0,310,72,5,4,0,996,100,17811,1758,161945,179756,9/11/2020
7/16/2020,102,26124,3745,285461,311585,6,2125,9,1746,0,310,69,6,5,1,997,78,17889,1621,163566,181455,9/11/2020
7/17/2020,157,26281,4244,289705,315986,14,2139,3,1749,1,311,79,5,5,2,999,81,17970,1851,165417,183387,9/11/2020
7/18/2020,85,26366,3276,292981,319347,5,2144,9,1758,1,312,74,5,4,4,1003,69,18039,1403,166820,184859,9/11/2020
7/19/2020,83,26449,2709,295690,322139,7,2151,3,1761,0,312,78,6,4,2,1005,59,18098,1151,167971,186069,9/11/2020
7/20/2020,71,26520,2666,298356,324876,9,2160,7,1768,0,312,80,7,5,2,1007,69,18167,1467,169438,187605,9/11/2020
7/21/2020,131,26651,4312,302668,329319,9,2169,11,1779,0,312,78,9,6,1,1008,109,18276,1927,171365,189641,9/11/2020
7/22/2020,130,26781,3938,306606,333387,11,2180,11,1790,1,313,77,7,6,1,1009,87,18363,1685,173050,191413,9/11/2020
7/23/2020,142,26923,4388,310994,337917,8,2188,6,1796,0,313,79,8,7,0,1009,116,18479,1972,175022,193501,9/11/2020
7/24/2020,173,27096,5968,316962,344058,13,2201,13,1809,0,313,79,9,7,0,1009,123,18602,2326,177348,195950,9/11/2020
7/25/2020,135,27231,4415,321377,348608,7,2208,7,1816,0,313,79,10,8,2,1011,107,18709,2101,179449,198158,9/11/2020
7/26/2020,62,27293,3041,324418,351711,8,2216,9,1825,0,313,78,11,7,1,1012,54,18763,1341,180790,199553,9/11/2020
7/27/2020,186,27479,4184,328602,356081,12,2228,7,1832,0,313,83,13,8,1,1013,141,18904,2336,183126,202030,9/11/2020
7/28/2020,105,27584,3844,332446,360030,5,2233,5,1837,0,313,83,14,7,1,1014,94,18998,1636,184762,203760,9/11/2020
7/29/2020,191,27775,5143,337589,365364,10,2243,12,1849,0,313,81,15,7,0,1014,156,19154,2326,187088,206242,9/11/2020
7/30/2020,121,27896,4357,341946,369842,6,2249,2,1851,1,314,84,15,6,1,1015,96,19250,1651,188739,207989,9/11/2020
7/31/2020,132,28028,5519,347465,375493,8,2257,9,1860,0,314,83,15,7,0,1015,90,19340,1862,190601,209941,9/11/2020
8/1/2020,109,28137,4295,351760,379897,7,2264,2,1862,0,314,88,14,7,1,1016,88,19428,1559,192160,211588,9/11/2020
8/2/2020,84,28221,2811,354571,382792,12,2276,12,1874,2,316,86,14,8,2,1018,62,19490,1278,193438,212928,9/11/2020
8/3/2020,187,28408,5214,359785,388193,13,2289,12,1886,0,316,87,16,7,1,1019,154,19644,2188,195626,215270,9/11/2020
8/4/2020,126,28534,3694,363479,392013,8,2297,6,1892,1,317,88,12,5,2,1021,99,19743,1775,197401,217144,9/11/2020
8/5/2020,150,28684,5939,369418,398102,12,2309,10,1902,1,318,89,10,5,2,1023,118,19861,2477,199878,219739,9/11/2020
8/6/2020,170,28854,5546,374964,403818,7,2316,9,1911,0,318,87,9,4,0,1023,122,19983,2429,202307,222290,9/11/2020
8/7/2020,122,28976,4855,379819,408795,13,2329,10,1921,1,319,89,9,3,1,1024,90,20073,2164,204471,224544,9/11/2020
8/8/2020,122,29098,4117,383936,413034,19,2348,6,1927,1,320,101,8,3,1,1025,96,20169,1783,206254,226423,9/11/2020
8/9/2020,42,29140,1729,385665,414805,8,2356,11,1938,0,320,98,9,4,0,1025,36,20205,1077,207331,227536,9/11/2020
8/10/2020,150,29290,4590,390255,419545,11,2367,11,1949,0,320,98,9,4,1,1026,112,20317,2031,209362,229679,9/11/2020
8/11/2020,105,29395,4327,394582,423977,6,2373,14,1963,0,320,90,10,4,2,1028,93,20410,2274,211636,232046,9/11/2020
8/12/2020,121,29516,5198,399780,429296,8,2381,11,1974,0,320,87,9,3,1,1029,103,20513,2631,214267,234780,9/11/2020
8/13/2020,135,29651,4198,403978,433629,13,2394,12,1986,0,320,88,11,3,0,1029,97,20610,1911,216178,236788,9/11/2020
8/14/2020,146,29797,5474,409452,439249,13,2407,11,1997,0,320,90,11,4,3,1032,101,20711,1956,218134,238845,9/11/2020
8/15/2020,105,29902,4539,413991,443893,8,2415,11,2008,1,321,86,11,5,0,1032,90,20801,1703,219837,240638,9/11/2020
8/16/2020,83,29985,2798,416789,446774,7,2422,6,2014,4,325,83,8,4,5,1037,71,20872,987,220824,241696,9/11/2020
8/17/2020,107,30092,4554,421343,451435,10,2432,7,2021,0,325,86,8,5,2,1039,87,20959,2389,223213,244172,9/11/2020
8/18/2020,129,30221,5054,426397,456618,11,2443,9,2030,1,326,87,8,4,5,1044,97,21056,2793,226006,247062,9/11/2020
8/19/2020,114,30335,5417,431814,462149,8,2451,9,2039,1,327,85,9,5,0,1044,90,21146,2688,228694,249840,9/11/2020
8/20/2020,174,30509,8275,440089,470598,12,2463,6,2045,2,329,89,10,5,3,1047,137,21283,3576,232270,253553,9/11/2020
8/21/2020,156,30665,6828,446917,477582,8,2471,5,2050,1,330,91,9,4,2,1049,125,21408,2982,235252,256660,9/11/2020
8/22/2020,96,30761,5980,452897,483658,10,2481,12,2062,0,330,89,11,4,1,1050,84,21492,2635,237887,259379,9/11/2020
8/23/2020,72,30833,4375,457272,488105,11,2492,5,2067,0,330,95,11,2,1,1051,57,21549,2481,240368,261917,9/11/2020
8/24/2020,105,30938,5784,463056,493994,7,2499,10,2077,1,331,91,13,4,1,1052,75,21624,3168,243536,265160,9/11/2020
8/25/2020,108,31046,4823,467879,498925,10,2509,4,2081,1,332,96,11,4,1,1053,93,21717,2314,245850,267567,9/11/2020
8/26/2020,171,31217,9622,477501,508718,4,2513,8,2089,0,332,92,9,5,1,1054,128,21845,3098,248948,270793,9/11/2020
8/27/2020,94,31311,8916,486417,517728,5,2518,14,2103,1,333,82,6,5,2,1056,71,21916,3272,252220,274136,9/11/2020
8/28/2020,113,31424,8122,494539,525963,14,2532,4,2107,0,333,92,9,7,2,1058,86,22002,2460,254680,276682,9/11/2020
8/29/2020,65,31489,5536,500075,531564,6,2538,8,2115,1,334,89,10,6,1,1059,53,22055,1923,256603,278658,9/11/2020
8/30/2020,67,31556,4336,504411,535967,7,2545,4,2119,0,334,92,8,5,1,1060,49,22104,2000,258603,280707,9/11/2020
8/31/2020,106,31662,4874,509285,540947,10,2555,15,2134,0,334,87,8,4,0,1060,82,22186,2197,260800,282986,9/11/2020
9/1/2020,99,31761,7213,516498,548259,6,2561,9,2143,1,335,83,7,4,1,1061,66,22252,2389,263189,285441,9/11/2020
9/2/2020,123,31884,10610,527108,558992,8,2569,10,2153,1,336,80,8,4,2,1063,101,22353,2956,266145,288498,9/11/2020
9/3/2020,90,31974,11367,538475,570449,8,2577,8,2161,0,336,80,9,4,1,1064,76,22429,2595,268740,291169,9/11/2020
9/4/2020,103,32077,9218,547693,579770,10,2587,4,2165,0,336,86,9,4,1,1065,81,22510,2411,271151,293661,9/11/2020
9/5/2020,52,32129,6359,554052,586181,6,2593,9,2174,0,336,83,7,3,1,1066,42,22552,1593,272744,295296,9/11/2020
9/6/2020,88,32217,4328,558380,590597,4,2597,8,2182,1,337,78,5,3,1,1067,66,22618,1959,274703,297321,9/11/2020
9/7/2020,34,32251,2828,561208,593459,11,2608,3,2185,0,337,86,4,3,1,1068,27,22645,537,275240,297885,9/11/2020
9/8/2020,71,32322,5547,566755,599077,6,2614,12,2197,1,338,79,5,3,2,1070,63,22708,1347,276587,299295,9/11/2020
9/9/2020,118,32440,8796,575551,607991,6,2620,4,2201,1,339,80,8,3,1,1071,97,22805,2121,278708,301513,9/11/2020
9/10/2020,149,32589,7543,583094,615683,,,,,,,,,,0,1071,100,22905,1410,280118,303023,9/11/2020
2/27/2020,0,0,0,0,0,1,1,0,0,0,0,1,0,0,0,0,0,0,0,0,0,9/14/2020
2/28/2020,0,0,0,0,0,0,1,0,0,0,0,1,1,0,0,0,0,0,0,0,0,9/14/2020
2/29/2020,0,0,0,0,0,0,1,0,0,0,0,1,1,0,0,0,0,0,0,0,0,9/14/2020
3/1/2020,2,2,2,2,4,0,1,0,0,0,0,1,1,1,0,0,2,2,2,2,4,9/14/2020
3/2/2020,0,2,1,3,5,1,2,0,0,0,0,2,2,2,0,0,0,2,1,3,5,9/14/2020
3/3/2020,0,2,2,5,7,0,2,0,0,0,0,2,2,2,0,0,0,2,2,5,7,9/14/2020
3/4/2020,0,2,12,17,19,1,3,0,0,0,0,3,2,2,0,0,0,2,10,15,17,9/14/2020
3/5/2020,0,2,4,21,23,0,3,0,0,0,0,3,2,2,0,0,1,3,4,19,22,9/14/2020
3/6/2020,1,3,12,33,36,0,3,0,0,0,0,3,2,2,0,0,0,3,11,30,33,9/14/2020
3/7/2020,0,3,19,52,55,0,3,0,0,0,0,3,2,1,0,0,0,3,19,49,52,9/14/2020
3/8/2020,0,3,18,70,73,0,3,0,0,0,0,3,2,1,0,0,0,3,18,67,70,9/14/2020
3/9/2020,1,4,15,85,89,0,3,0,0,0,0,3,2,1,0,0,1,4,15,82,86,9/14/2020
3/10/2020,2,6,25,110,116,0,3,0,0,0,0,3,2,1,0,0,1,5,23,105,110,9/14/2020
3/11/2020,0,6,34,144,150,1,4,0,0,0,0,4,1,1,0,0,0,5,34,139,144,9/14/2020
3/12/2020,9,15,41,185,200,1,5,0,0,0,0,5,1,1,0,0,8,13,38,177,190,9/14/2020
3/13/2020,6,21,50,235,256,4,9,1,1,0,0,8,1,1,0,0,6,19,48,225,244,9/14/2020
3/14/2020,0,21,90,325,346,0,9,0,1,0,0,8,1,1,0,0,0,19,86,311,330,9/14/2020
3/15/2020,1,22,54,379,401,1,10,0,1,0,0,9,2,1,0,0,1,20,54,365,385,9/14/2020
3/16/2020,2,24,95,474,498,2,12,0,1,0,0,11,2,0,0,0,2,22,92,457,479,9/14/2020
3/17/2020,12,36,162,636,672,6,18,0,1,0,0,17,2,0,0,0,11,33,151,608,641,9/14/2020
3/18/2020,9,45,116,752,797,3,21,0,1,0,0,20,2,0,0,0,11,44,110,718,762,9/14/2020
3/19/2020,15,60,262,1014,1074,2,23,1,2,0,0,21,3,0,1,1,17,61,251,969,1030,9/14/2020
3/20/2020,13,73,197,1211,1284,5,28,0,2,0,0,26,4,0,0,1,13,74,192,1161,1235,9/14/2020
3/21/2020,12,85,126,1337,1422,3,31,2,4,0,0,27,5,0,0,1,14,88,123,1284,1372,9/14/2020
3/22/2020,27,112,282,1619,1731,2,33,0,4,0,0,29,5,0,0,1,25,113,262,1546,1659,9/14/2020
3/23/2020,14,126,169,1788,1914,15,48,1,5,0,0,43,9,3,0,1,16,129,165,1711,1840,9/14/2020
3/24/2020,20,146,242,2030,2176,7,55,0,5,0,0,50,10,4,0,1,19,148,238,1949,2097,9/14/2020
3/25/2020,26,172,182,2212,2384,5,60,1,6,0,0,54,11,3,0,1,28,176,172,2121,2297,9/14/2020
3/26/2020,35,207,181,2393,2600,10,70,5,11,0,0,59,14,5,0,1,41,217,176,2297,2514,9/14/2020
3/27/2020,27,234,214,2607,2841,9,79,1,12,1,1,66,17,6,2,3,31,248,202,2499,2747,9/14/2020
3/28/2020,59,293,260,2867,3160,13,92,3,15,2,3,74,15,6,1,4,63,311,241,2740,3051,9/14/2020
3/29/2020,100,393,350,3217,3610,8,100,4,19,1,4,77,18,8,2,6,105,416,314,3054,3470,9/14/2020
3/30/2020,62,455,222,3439,3894,20,120,5,24,0,4,92,20,11,3,9,78,494,185,3239,3733,9/14/2020
3/31/2020,71,526,369,3808,4334,11,131,7,31,1,5,95,22,13,2,11,73,567,298,3537,4104,9/14/2020
4/1/2020,99,625,698,4506,5131,18,149,7,38,0,5,106,30,15,1,12,102,669,642,4179,4848,9/14/2020
4/2/2020,52,677,477,4983,5660,22,171,6,44,2,7,120,36,21,4,16,62,731,436,4615,5346,9/14/2020
4/3/2020,108,785,774,5757,6542,23,194,7,51,0,7,136,43,25,3,19,100,831,713,5328,6159,9/14/2020
4/4/2020,143,928,660,6417,7345,22,216,4,55,5,12,149,41,30,9,28,137,968,619,5947,6915,9/14/2020
4/5/2020,187,1115,1156,7573,8688,20,236,9,64,1,13,159,44,36,2,30,182,1150,1069,7016,8166,9/14/2020
4/6/2020,218,1333,1706,9279,10612,26,262,7,71,0,13,178,48,40,7,37,206,1356,1557,8573,9929,9/14/2020
4/7/2020,284,1617,1629,10908,12525,20,282,4,75,2,15,192,50,42,5,42,261,1617,1484,10057,11674,9/14/2020
4/8/2020,290,1907,1720,12628,14535,19,301,7,82,6,21,198,50,38,10,52,272,1889,1566,11623,13512,9/14/2020
4/9/2020,283,2190,1516,14144,16334,32,333,9,91,4,25,217,53,40,7,59,280,2169,1359,12982,15151,9/14/2020
4/10/2020,419,2609,2574,16718,19327,28,361,16,107,5,30,224,59,41,11,70,403,2572,2373,15355,17927,9/14/2020
4/11/2020,297,2906,1905,18623,21529,29,390,11,118,2,32,240,61,48,12,82,280,2852,1720,17075,19927,9/14/2020
4/12/2020,314,3220,1670,20293,23513,35,425,13,131,5,37,257,59,49,9,91,289,3141,1439,18514,21655,9/14/2020
4/13/2020,161,3381,935,21228,24609,35,460,13,144,3,40,276,64,54,9,100,187,3328,839,19353,22681,9/14/2020
4/14/2020,289,3670,1787,23015,26685,27,487,17,161,5,45,281,72,53,8,108,265,3593,1528,20881,24474,9/14/2020
4/15/2020,351,4021,1799,24814,28835,31,518,20,181,3,48,289,72,54,17,125,307,3900,1560,22441,26341,9/14/2020
4/16/2020,447,4468,2494,27308,31776,36,554,24,205,6,54,295,72,53,14,139,389,4289,2081,24522,28811,9/14/2020
4/17/2020,304,4772,1821,29129,33901,32,586,20,225,7,61,300,66,45,21,160,293,4582,1452,25974,30556,9/14/2020
4/18/2020,321,5093,1725,30854,35947,26,612,18,243,4,65,304,63,49,15,175,286,4868,1333,27307,32175,9/14/2020
4/19/2020,381,5474,2047,32901,38375,23,635,26,269,1,66,300,65,55,11,186,338,5206,1745,29052,34258,9/14/2020
4/20/2020,394,5868,1907,34808,40676,46,681,29,298,2,68,315,75,56,10,196,377,5583,1577,30629,36212,9/14/2020
4/21/2020,444,6312,2110,36918,43230,45,726,31,329,5,73,324,72,56,18,214,391,5974,1715,32344,38318,9/14/2020
4/22/2020,418,6730,2390,39308,46038,41,767,32,361,5,78,328,73,58,18,232,385,6359,1917,34261,40620,9/14/2020
4/23/2020,479,7209,2469,41777,48986,32,799,28,389,5,83,327,76,62,15,247,419,6778,1864,36125,42903,9/14/2020
4/24/2020,491,7700,3284,45061,52761,35,834,27,416,4,87,331,85,63,15,262,416,7194,2632,38757,45951,9/14/2020
4/25/2020,393,8093,2206,47267,55360,34,868,17,433,5,92,343,85,62,14,276,304,7498,1775,40532,48030,9/14/2020
4/26/2020,316,8409,2309,49576,57985,33,901,15,448,3,95,358,86,59,14,290,275,7773,1882,42414,50187,9/14/2020
4/27/2020,249,8658,1620,51196,59854,29,930,21,469,4,99,362,86,61,10,300,204,7977,1163,43577,51554,9/14/2020
4/28/2020,410,9068,2263,53459,62527,44,974,24,493,3,102,379,88,59,22,322,330,8307,1767,45344,53651,9/14/2020
4/29/2020,476,9544,3343,56802,66346,36,1010,38,531,11,113,366,78,53,18,340,373,8680,2429,47773,56453,9/14/2020
4/30/2020,432,9976,2769,59571,69547,33,1043,38,569,6,119,355,83,57,24,364,353,9033,1945,49718,58751,9/14/2020
5/1/2020,454,10430,3086,62657,73087,51,1094,39,608,3,122,364,84,58,14,378,320,9353,2204,51922,61275,9/14/2020
5/2/2020,257,10687,1926,64583,75270,36,1130,39,647,5,127,356,91,62,24,402,189,9542,1291,53213,62755,9/14/2020
5/3/2020,283,10970,2160,66743,77713,31,1161,27,674,8,135,352,90,61,21,423,182,9724,1602,54815,64539,9/14/2020
5/4/2020,387,11357,2098,68841,80198,30,1191,31,705,5,140,346,88,57,18,441,293,10017,1569,56384,66401,9/14/2020
5/5/2020,433,11790,2873,71714,83504,29,1220,32,737,6,146,337,82,54,16,457,308,10325,1966,58350,68675,9/14/2020
5/6/2020,488,12278,2830,74544,86822,28,1248,44,781,9,155,312,79,54,21,478,342,10667,1924,60274,70941,9/14/2020
5/7/2020,425,12703,2969,77513,90216,36,1284,42,823,5,160,301,71,52,21,499,274,10941,1972,62246,73187,9/14/2020
5/8/2020,359,13062,2598,80111,93173,30,1314,29,852,5,165,297,71,53,22,521,233,11174,1747,63993,75167,9/14/2020
5/9/2020,467,13529,3346,83457,96986,22,1336,21,873,4,169,294,69,51,15,536,291,11465,2270,66263,77728,9/14/2020
5/10/2020,285,13814,2117,85574,99388,20,1356,23,896,6,175,285,70,49,13,549,188,11653,1524,67787,79440,9/14/2020
5/11/2020,257,14071,1857,87431,101502,31,1387,16,912,6,181,294,71,49,15,564,178,11831,1304,69091,80922,9/14/2020
5/12/2020,387,14458,2611,90042,104500,23,1410,18,930,4,185,295,69,48,22,586,218,12049,1712,70803,82852,9/14/2020
5/13/2020,351,14809,3630,93672,108481,23,1433,25,955,1,186,292,69,49,13,599,199,12248,2012,72815,85063,9/14/2020
5/14/2020,329,15138,3408,97080,112218,19,1452,27,982,3,189,281,64,45,15,614,230,12478,2021,74836,87314,9/14/2020
5/15/2020,381,15519,3458,100538,116057,24,1476,41,1023,5,194,259,62,45,13,627,237,12715,1813,76649,89364,9/14/2020
5/16/2020,449,15968,4156,104694,120662,25,1501,13,1036,5,199,266,61,46,15,642,252,12967,1964,78613,91580,9/14/2020
5/17/2020,240,16208,2768,107462,123670,17,1518,8,1044,5,204,270,59,45,10,652,129,13096,1561,80174,93270,9/14/2020
5/18/2020,250,16458,2001,109463,125921,19,1537,15,1059,5,209,269,57,40,18,670,140,13236,1371,81545,94781,9/14/2020
5/19/2020,415,16873,3168,112631,129504,23,1560,32,1091,5,214,255,56,38,11,681,214,13450,1933,83478,96928,9/14/2020
5/20/2020,326,17199,2771,115402,132601,19,1579,23,1114,7,221,244,52,33,22,703,188,13638,1518,84996,98634,9/14/2020
5/21/2020,374,17573,3757,119159,136732,25,1604,15,1129,3,224,251,53,29,20,723,170,13808,1945,86941,100749,9/14/2020
5/22/2020,351,17924,3161,122320,140244,20,1624,29,1158,5,229,237,52,29,10,733,204,14012,1615,88556,102568,9/14/2020
5/23/2020,253,18177,2742,125062,143239,19,1643,11,1169,3,232,242,52,32,13,746,108,14120,1275,89831,103951,9/14/2020
5/24/2020,163,18340,1370,126432,144772,12,1655,14,1183,2,234,238,53,36,8,754,82,14202,773,90604,104806,9/14/2020
5/25/2020,147,18487,1385,127817,146304,13,1668,14,1197,0,234,237,53,34,10,764,72,14274,762,91366,105640,9/14/2020
5/26/2020,285,18772,2620,130437,149209,24,1692,21,1218,5,239,235,48,33,15,779,163,14437,1781,93147,107584,9/14/2020
5/27/2020,276,19048,2057,132494,151542,20,1712,18,1236,3,242,234,50,33,10,789,134,14571,1136,94283,108854,9/14/2020
5/28/2020,348,19396,3359,135853,155249,17,1729,29,1265,4,246,218,47,32,8,797,134,14705,1122,95405,110110,9/14/2020
5/29/2020,410,19806,3914,139767,159573,19,1748,27,1292,6,252,204,43,31,12,809,177,14882,1575,96980,111862,9/14/2020
5/30/2020,225,20031,3915,143682,163713,15,1763,19,1311,4,256,196,40,29,12,821,109,14991,1821,98801,113792,9/14/2020
5/31/2020,155,20186,1688,145370,165556,11,1774,10,1321,0,256,197,43,26,3,824,78,15069,857,99658,114727,9/14/2020
6/1/2020,212,20398,2792,148162,168560,8,1782,14,1335,1,257,190,44,29,5,829,99,15168,1387,101045,116213,9/14/2020
6/2/2020,273,20671,3022,151184,171855,8,1790,9,1344,3,260,186,37,25,10,839,107,15275,1452,102497,117772,9/14/2020
6/3/2020,254,20925,3486,154670,175595,14,1804,18,1362,6,266,176,34,25,11,850,105,15380,1666,104163,119543,9/14/2020
6/4/2020,276,21201,4471,159141,180342,7,1811,25,1387,3,269,155,31,24,11,861,111,15491,2041,106204,121695,9/14/2020
6/5/2020,215,21416,3513,162654,184070,15,1826,13,1400,6,275,151,27,21,11,872,106,15597,1578,107782,123379,9/14/2020
6/6/2020,201,21617,2616,165270,186887,10,1836,7,1407,2,277,152,29,19,6,878,69,15666,1137,108919,124585,9/14/2020
6/7/2020,83,21700,1625,166895,188595,11,1847,7,1414,1,278,155,25,17,4,882,50,15716,782,109701,125417,9/14/2020
6/8/2020,119,21819,1849,168744,190563,14,1861,12,1426,2,280,155,27,18,4,886,44,15760,963,110664,126424,9/14/2020
6/9/2020,223,22042,2673,171417,193459,10,1871,18,1444,0,280,147,28,21,1,887,67,15827,1260,111924,127751,9/14/2020
6/10/2020,209,22251,2987,174404,196655,13,1884,12,1456,2,282,146,24,17,3,890,105,15932,1468,113392,129324,9/14/2020
6/11/2020,195,22446,3513,177917,200363,7,1891,15,1471,1,283,137,25,16,6,896,88,16020,1539,114931,130951,9/14/2020
6/12/2020,209,22655,4601,182518,205173,9,1900,15,1486,1,284,130,24,16,2,898,82,16102,2187,117118,133220,9/14/2020
6/13/2020,113,22768,3036,185554,208322,6,1906,4,1490,0,284,132,20,15,3,901,50,16152,1374,118492,134644,9/14/2020
6/14/2020,81,22849,2046,187600,210449,7,1913,8,1498,1,285,130,20,14,3,904,33,16185,969,119461,135646,9/14/2020
6/15/2020,188,23037,3108,190708,213745,14,1927,14,1512,0,285,130,20,16,5,909,78,16263,1793,121254,137517,9/14/2020
6/16/2020,110,23147,3017,193725,216872,10,1937,8,1520,1,286,131,22,16,8,917,52,16315,1579,122833,139148,9/14/2020
6/17/2020,127,23274,2835,196560,219834,15,1952,20,1540,4,290,122,18,14,6,923,53,16368,1320,124153,140521,9/14/2020
6/18/2020,149,23423,3047,199607,223030,9,1961,13,1553,1,291,117,19,16,7,930,70,16438,1324,125477,141915,9/14/2020
6/19/2020,141,23564,3769,203376,226940,12,1973,11,1564,1,292,117,20,17,3,933,59,16497,1372,126849,143346,9/14/2020
6/20/2020,84,23648,1891,205267,228915,9,1982,12,1576,0,292,114,20,18,4,937,36,16533,816,127665,144198,9/14/2020
6/21/2020,37,23685,1064,206331,230016,8,1990,5,1581,0,292,117,20,18,2,939,28,16561,692,128357,144918,9/14/2020
6/22/2020,138,23823,3730,210061,233884,12,2002,16,1597,0,292,113,19,18,1,940,69,16630,1710,130067,146697,9/14/2020
6/23/2020,163,23986,3831,213892,237878,3,2005,13,1610,3,295,100,18,18,7,947,83,16713,1786,131853,148566,9/14/2020
6/24/2020,120,24106,3502,217394,241500,9,2014,10,1620,1,296,98,18,18,5,952,46,16759,1688,133541,150300,9/14/2020
6/25/2020,103,24209,2883,220277,244486,6,2020,14,1634,1,297,89,17,17,1,953,54,16813,1516,135057,151870,9/14/2020
6/26/2020,94,24303,2488,222765,247068,2,2022,10,1644,0,297,81,18,18,1,954,63,16876,1332,136389,153265,9/14/2020
6/27/2020,84,24387,3214,225979,250366,5,2027,3,1647,1,298,82,17,17,5,959,37,16913,1221,137610,154523,9/14/2020
6/28/2020,39,24426,1469,227448,251874,4,2031,4,1651,4,302,78,15,14,6,965,19,16932,596,138206,155138,9/14/2020
6/29/2020,85,24511,3697,231145,255656,4,2035,5,1656,0,302,77,14,14,1,966,39,16971,1355,139561,156532,9/14/2020
6/30/2020,57,24568,1956,233101,257669,1,2036,5,1661,1,303,72,12,11,3,969,33,17004,996,140557,157561,9/14/2020
7/1/2020,144,24712,4098,237199,261911,7,2043,9,1670,0,303,70,11,11,1,970,80,17084,1938,142495,159579,9/14/2020
7/2/2020,103,24815,2803,240002,264817,5,2048,5,1675,1,304,69,10,10,2,972,57,17141,1091,143586,160727,9/14/2020
7/3/2020,50,24865,2076,242078,266943,9,2057,6,1681,0,304,72,9,9,3,975,26,17167,780,144366,161533,9/14/2020
7/4/2020,57,24922,2345,244423,269345,2,2059,4,1685,1,305,69,10,9,2,977,34,17201,1012,145378,162579,9/14/2020
7/5/2020,49,24971,2932,247355,272326,1,2060,2,1687,1,306,67,8,8,2,979,26,17227,1448,146826,164053,9/14/2020
7/6/2020,101,25072,2811,250166,275238,6,2066,6,1693,0,306,67,9,9,4,983,58,17285,1553,148379,165664,9/14/2020
7/7/2020,81,25153,3457,253623,278776,5,2071,7,1700,0,306,65,8,8,2,985,48,17333,1537,149916,167249,9/14/2020
7/8/2020,105,25258,3403,257026,282284,4,2075,2,1702,0,306,67,9,8,0,985,65,17398,1427,151343,168741,9/14/2020
7/9/2020,94,25352,3712,260738,286090,9,2084,3,1705,0,306,73,9,8,0,985,51,17449,1631,152974,170423,9/14/2020
7/10/2020,131,25483,4431,265169,290652,6,2090,3,1708,2,308,74,7,7,3,988,80,17529,2084,155058,172587,9/14/2020
7/11/2020,63,25546,2932,268101,293647,6,2096,3,1711,1,309,76,6,6,3,991,34,17563,1320,156378,173941,9/14/2020
7/12/2020,47,25593,1836,269937,295530,1,2097,3,1714,1,310,73,6,5,3,994,34,17597,943,157321,174918,9/14/2020
7/13/2020,84,25677,3157,273094,298771,8,2105,10,1724,0,310,71,6,5,1,995,61,17658,1476,158797,176455,9/14/2020
7/14/2020,73,25750,3289,276383,302133,7,2112,4,1728,0,310,74,5,5,1,996,49,17707,1375,160172,177879,9/14/2020
7/15/2020,130,25880,4168,280551,306431,5,2117,7,1735,0,310,72,5,4,0,996,100,17807,1756,161928,179735,9/14/2020
7/16/2020,102,25982,3733,284284,310266,6,2123,9,1744,0,310,69,6,5,1,997,78,17885,1621,163549,181434,9/14/2020
7/17/2020,156,26138,4235,288519,314657,14,2137,3,1747,1,311,79,5,5,2,999,81,17966,1851,165400,183366,9/14/2020
7/18/2020,85,26223,3267,291786,318009,5,2142,9,1756,1,312,74,5,4,4,1003,69,18035,1402,166802,184837,9/14/2020
7/19/2020,82,26305,2693,294479,320784,7,2149,3,1759,0,312,78,6,4,2,1005,59,18094,1151,167953,186047,9/14/2020
7/20/2020,71,26376,2664,297143,323519,9,2158,7,1766,0,312,80,7,5,2,1007,69,18163,1467,169420,187583,9/14/2020
7/21/2020,130,26506,4298,301441,327947,9,2167,11,1777,0,312,78,9,6,1,1008,109,18272,1927,171347,189619,9/14/2020
7/22/2020,130,26636,3926,305367,332003,11,2178,11,1788,1,313,77,7,6,1,1009,87,18359,1684,173031,191390,9/14/2020
7/23/2020,141,26777,4376,309743,336520,8,2186,6,1794,0,313,79,8,7,0,1009,116,18475,1972,175003,193478,9/14/2020
7/24/2020,172,26949,5959,315702,342651,14,2200,14,1808,0,313,79,9,7,0,1009,123,18598,2326,177329,195927,9/14/2020
7/25/2020,134,27083,4398,320100,347183,7,2207,7,1815,0,313,79,10,8,2,1011,107,18705,2101,179430,198135,9/14/2020
7/26/2020,62,27145,3027,323127,350272,8,2215,9,1824,0,313,78,11,7,1,1012,54,18759,1341,180771,199530,9/14/2020
7/27/2020,186,27331,4163,327290,354621,12,2227,7,1831,0,313,83,13,8,1,1013,141,18900,2335,183106,202006,9/14/2020
7/28/2020,105,27436,3831,331121,358557,5,2232,5,1836,0,313,83,14,7,1,1014,94,18994,1635,184741,203735,9/14/2020
7/29/2020,191,27627,5123,336244,363871,10,2242,12,1848,0,313,81,15,7,0,1014,156,19150,2326,187067,206217,9/14/2020
7/30/2020,121,27748,4344,340588,368336,6,2248,2,1850,1,314,84,15,6,1,1015,96,19246,1651,188718,207964,9/14/2020
7/31/2020,131,27879,5508,346096,373975,8,2256,9,1859,0,314,83,15,7,0,1015,90,19336,1861,190579,209915,9/14/2020
8/1/2020,108,27987,4288,350384,378371,7,2263,2,1861,0,314,88,14,7,1,1016,88,19424,1559,192138,211562,9/14/2020
8/2/2020,84,28071,2802,353186,381257,12,2275,12,1873,2,316,86,14,8,2,1018,62,19486,1276,193414,212900,9/14/2020
8/3/2020,187,28258,5203,358389,386647,13,2288,12,1885,0,316,87,16,7,1,1019,154,19640,2187,195601,215241,9/14/2020
8/4/2020,126,28384,3687,362076,390460,8,2296,6,1891,1,317,88,12,5,2,1021,99,19739,1775,197376,217115,9/14/2020
8/5/2020,148,28532,5914,367990,396522,12,2308,10,1901,1,318,89,10,5,2,1023,118,19857,2475,199851,219708,9/14/2020
8/6/2020,169,28701,5533,373523,402224,7,2315,9,1910,0,318,87,9,4,0,1023,122,19979,2428,202279,222258,9/14/2020
8/7/2020,122,28823,4845,378368,407191,13,2328,10,1920,1,319,89,9,3,2,1025,90,20069,2163,204442,224511,9/14/2020
8/8/2020,122,28945,4105,382473,411418,19,2347,6,1926,1,320,101,8,3,1,1026,96,20165,1783,206225,226390,9/14/2020
8/9/2020,42,28987,1722,384195,413182,8,2355,11,1937,0,320,98,9,4,0,1026,36,20201,1076,207301,227502,9/14/2020
8/10/2020,149,29136,4577,388772,417908,11,2366,11,1948,0,320,98,9,4,1,1027,112,20313,2031,209332,229645,9/14/2020
8/11/2020,105,29241,4320,393092,422333,6,2372,14,1962,0,320,90,10,4,2,1029,93,20406,2272,211604,232010,9/14/2020
8/12/2020,121,29362,5184,398276,427638,8,2380,11,1973,0,320,87,9,3,1,1030,103,20509,2631,214235,234744,9/14/2020
8/13/2020,135,29497,4190,402466,431963,13,2393,12,1985,0,320,88,11,3,0,1030,97,20606,1911,216146,236752,9/14/2020
8/14/2020,145,29642,5461,407927,437569,13,2406,11,1996,0,320,90,11,4,3,1033,101,20707,1956,218102,238809,9/14/2020
8/15/2020,105,29747,4532,412459,442206,8,2414,11,2007,1,321,86,11,5,0,1033,89,20796,1703,219805,240601,9/14/2020
8/16/2020,83,29830,2794,415253,445083,7,2421,6,2013,4,325,83,8,4,5,1038,71,20867,987,220792,241659,9/14/2020
8/17/2020,106,29936,4547,419800,449736,10,2431,7,2020,0,325,86,8,5,2,1040,87,20954,2389,223181,244135,9/14/2020
8/18/2020,128,30064,5042,424842,454906,11,2442,9,2029,1,326,87,8,4,5,1045,97,21051,2791,225972,247023,9/14/2020
8/19/2020,114,30178,5407,430249,460427,8,2450,9,2038,1,327,85,9,5,0,1045,90,21141,2688,228660,249801,9/14/2020
8/20/2020,174,30352,8224,438473,468825,12,2462,6,2044,2,329,89,10,5,3,1048,137,21278,3576,232236,253514,9/14/2020
8/21/2020,154,30506,6807,445280,475786,8,2470,5,2049,1,330,91,9,4,2,1050,125,21403,2982,235218,256621,9/14/2020
8/22/2020,96,30602,5958,451238,481840,10,2480,12,2061,0,330,89,11,4,1,1051,84,21487,2634,237852,259339,9/14/2020
8/23/2020,70,30672,4365,455603,486275,11,2491,6,2067,0,330,94,11,2,1,1052,57,21544,2480,240332,261876,9/14/2020
8/24/2020,105,30777,5775,461378,492155,7,2498,10,2077,1,331,90,13,4,1,1053,75,21619,3168,243500,265119,9/14/2020
8/25/2020,108,30885,4809,466187,497072,10,2508,4,2081,1,332,95,11,4,1,1054,93,21712,2313,245813,267525,9/14/2020
8/26/2020,170,31055,9605,475792,506847,4,2512,8,2089,0,332,91,9,5,1,1055,128,21840,3098,248911,270751,9/14/2020
8/27/2020,94,31149,8891,484683,515832,5,2517,13,2102,1,333,82,6,5,2,1057,71,21911,3271,252182,274093,9/14/2020
8/28/2020,112,31261,8109,492792,524053,14,2531,4,2106,0,333,92,9,7,2,1059,87,21998,2459,254641,276639,9/14/2020
8/29/2020,65,31326,5518,498310,529636,6,2537,8,2114,1,334,89,10,6,1,1060,53,22051,1923,256564,278615,9/14/2020
8/30/2020,66,31392,4319,502629,534021,7,2544,4,2118,0,334,92,8,5,1,1061,48,22099,2000,258564,280663,9/14/2020
8/31/2020,105,31497,4859,507488,538985,10,2554,15,2133,0,334,87,8,4,0,1061,82,22181,2195,260759,282940,9/14/2020
9/1/2020,98,31595,7202,514690,546285,6,2560,9,2142,1,335,83,7,4,1,1062,66,22247,2389,263148,285395,9/14/2020
9/2/2020,124,31719,10608,525298,557017,9,2569,10,2152,1,336,81,8,4,2,1064,101,22348,2971,266119,288467,9/14/2020
9/3/2020,89,31808,11348,536646,568454,8,2577,8,2160,0,336,81,9,4,1,1065,78,22426,2595,268714,291140,9/14/2020
9/4/2020,102,31910,9198,545844,577754,10,2587,4,2164,0,336,87,9,4,1,1066,83,22509,2411,271125,293634,9/14/2020
9/5/2020,52,31962,6325,552169,584131,6,2593,9,2173,0,336,84,8,3,1,1067,42,22551,1593,272718,295269,9/14/2020
9/6/2020,87,32049,4310,556479,588528,4,2597,8,2181,1,337,79,6,3,1,1068,66,22617,1958,274676,297293,9/14/2020
9/7/2020,35,32084,2999,559478,591562,11,2608,3,2184,0,337,87,5,3,1,1069,27,22644,649,275325,297969,9/14/2020
9/8/2020,74,32158,6373,565851,598009,6,2614,12,2196,1,338,80,6,3,2,1071,66,22710,1596,276921,299631,9/14/2020
9/9/2020,118,32276,8833,574684,606960,9,2623,5,2201,1,339,83,9,3,1,1072,95,22805,2157,279078,301883,9/14/2020
9/10/2020,167,32443,11758,586442,618885,6,2629,8,2209,0,339,81,9,3,0,1072,113,22918,2286,281364,304282,9/14/2020
9/11/2020,115,32558,9091,595533,628091,10,2639,11,2220,0,339,80,8,4,0,1072,81,22999,1773,283137,306136,9/14/2020
9/12/2020,102,32660,5317,600850,633510,5,2644,3,2223,2,341,80,7,4,3,1075,99,23098,1248,284385,307483,9/14/2020
9/13/2020,46,32706,2162,603012,635718,,,,,,,,,,0,1075,32,23130,682,285067,308197,9/14/2020
2/27/2020,0,0,0,0,0,1,1,0,0,0,0,1,0,0,0,0,0,0,0,0,0,9/15/2020
2/28/2020,0,0,0,0,0,0,1,0,0,0,0,1,1,0,0,0,0,0,0,0,0,9/15/2020
2/29/2020,0,0,0,0,0,0,1,0,0,0,0,1,1,0,0,0,0,0,0,0,0,9/15/2020
3/1/2020,2,2,2,2,4,0,1,0,0,0,0,1,1,1,0,0,2,2,2,2,4,9/15/2020
3/2/2020,0,2,1,3,5,1,2,0,0,0,0,2,2,2,0,0,0,2,1,3,5,9/15/2020
3/3/2020,0,2,2,5,7,0,2,0,0,0,0,2,2,2,0,0,0,2,2,5,7,9/15/2020
3/4/2020,0,2,12,17,19,1,3,0,0,0,0,3,2,2,0,0,0,2,10,15,17,9/15/2020
3/5/2020,0,2,4,21,23,0,3,0,0,0,0,3,2,2,0,0,1,3,4,19,22,9/15/2020
3/6/2020,1,3,12,33,36,0,3,0,0,0,0,3,2,2,0,0,0,3,11,30,33,9/15/2020
3/7/2020,0,3,19,52,55,0,3,0,0,0,0,3,2,1,0,0,0,3,19,49,52,9/15/2020
3/8/2020,0,3,18,70,73,0,3,0,0,0,0,3,2,1,0,0,0,3,18,67,70,9/15/2020
3/9/2020,1,4,15,85,89,0,3,0,0,0,0,3,2,1,0,0,1,4,15,82,86,9/15/2020
3/10/2020,2,6,25,110,116,0,3,0,0,0,0,3,2,1,0,0,1,5,23,105,110,9/15/2020
3/11/2020,0,6,34,144,150,1,4,0,0,0,0,4,1,1,0,0,0,5,34,139,144,9/15/2020
3/12/2020,9,15,41,185,200,1,5,0,0,0,0,5,1,1,0,0,8,13,38,177,190,9/15/2020
3/13/2020,6,21,50,235,256,4,9,1,1,0,0,8,1,1,0,0,6,19,48,225,244,9/15/2020
3/14/2020,0,21,90,325,346,0,9,0,1,0,0,8,1,1,0,0,0,19,86,311,330,9/15/2020
3/15/2020,1,22,54,379,401,1,10,0,1,0,0,9,2,1,0,0,1,20,54,365,385,9/15/2020
3/16/2020,2,24,95,474,498,2,12,0,1,0,0,11,2,0,0,0,2,22,92,457,479,9/15/2020
3/17/2020,12,36,162,636,672,6,18,0,1,0,0,17,2,0,0,0,11,33,151,608,641,9/15/2020
3/18/2020,9,45,116,752,797,3,21,0,1,0,0,20,2,0,0,0,11,44,110,718,762,9/15/2020
3/19/2020,15,60,262,1014,1074,2,23,1,2,0,0,21,3,0,1,1,17,61,251,969,1030,9/15/2020
3/20/2020,13,73,197,1211,1284,5,28,0,2,0,0,26,4,0,0,1,13,74,191,1160,1234,9/15/2020
3/21/2020,12,85,126,1337,1422,3,31,2,4,0,0,27,5,0,0,1,14,88,123,1283,1371,9/15/2020
3/22/2020,27,112,282,1619,1731,2,33,0,4,0,0,29,5,0,0,1,25,113,262,1545,1658,9/15/2020
3/23/2020,14,126,169,1788,1914,15,48,1,5,0,0,43,9,3,0,1,16,129,165,1710,1839,9/15/2020
3/24/2020,20,146,242,2030,2176,7,55,0,5,0,0,50,10,4,0,1,19,148,238,1948,2096,9/15/2020
3/25/2020,26,172,182,2212,2384,5,60,1,6,0,0,54,11,3,0,1,28,176,172,2120,2296,9/15/2020
3/26/2020,35,207,181,2393,2600,10,70,5,11,0,0,59,14,5,0,1,41,217,176,2296,2513,9/15/2020
3/27/2020,27,234,214,2607,2841,9,79,1,12,1,1,66,17,6,2,3,31,248,202,2498,2746,9/15/2020
3/28/2020,59,293,260,2867,3160,13,92,3,15,2,3,74,15,6,1,4,63,311,241,2739,3050,9/15/2020
3/29/2020,100,393,350,3217,3610,8,100,4,19,1,4,77,18,8,2,6,105,416,314,3053,3469,9/15/2020
3/30/2020,62,455,222,3439,3894,20,120,5,24,0,4,92,20,11,3,9,78,494,184,3237,3731,9/15/2020
3/31/2020,71,526,369,3808,4334,11,131,7,31,1,5,95,22,13,2,11,73,567,297,3534,4101,9/15/2020
4/1/2020,99,625,698,4506,5131,18,149,7,38,0,5,106,30,15,1,12,102,669,642,4176,4845,9/15/2020
4/2/2020,52,677,477,4983,5660,22,171,6,44,2,7,120,36,21,4,16,62,731,436,4612,5343,9/15/2020
4/3/2020,108,785,774,5757,6542,23,194,7,51,0,7,136,43,25,3,19,100,831,712,5324,6155,9/15/2020
4/4/2020,143,928,660,6417,7345,22,216,4,55,5,12,149,41,30,9,28,137,968,619,5943,6911,9/15/2020
4/5/2020,187,1115,1156,7573,8688,20,236,9,64,1,13,159,44,36,2,30,182,1150,1069,7012,8162,9/15/2020
4/6/2020,218,1333,1706,9279,10612,26,262,7,71,0,13,178,48,40,7,37,206,1356,1557,8569,9925,9/15/2020
4/7/2020,284,1617,1629,10908,12525,20,282,4,75,2,15,192,50,42,5,42,261,1617,1484,10053,11670,9/15/2020
4/8/2020,290,1907,1720,12628,14535,19,301,7,82,6,21,198,50,38,10,52,272,1889,1565,11618,13507,9/15/2020
4/9/2020,283,2190,1516,14144,16334,32,333,9,91,4,25,217,53,40,7,59,280,2169,1356,12974,15143,9/15/2020
4/10/2020,419,2609,2574,16718,19327,28,361,16,107,5,30,224,59,41,11,70,403,2572,2372,15346,17918,9/15/2020
4/11/2020,297,2906,1905,18623,21529,29,390,11,118,2,32,240,61,48,12,82,280,2852,1720,17066,19918,9/15/2020
4/12/2020,314,3220,1670,20293,23513,35,425,13,131,5,37,257,59,49,9,91,289,3141,1438,18504,21645,9/15/2020
4/13/2020,161,3381,935,21228,24609,35,460,13,144,3,40,276,64,54,9,100,187,3328,838,19342,22670,9/15/2020
4/14/2020,289,3670,1787,23015,26685,27,487,17,161,5,45,281,72,53,8,108,265,3593,1528,20870,24463,9/15/2020
4/15/2020,351,4021,1799,24814,28835,31,518,20,181,3,48,289,72,54,17,125,307,3900,1560,22430,26330,9/15/2020
4/16/2020,447,4468,2494,27308,31776,36,554,24,205,6,54,295,72,53,14,139,389,4289,2081,24511,28800,9/15/2020
4/17/2020,304,4772,1821,29129,33901,32,586,20,225,7,61,300,66,45,21,160,293,4582,1450,25961,30543,9/15/2020
4/18/2020,321,5093,1725,30854,35947,26,612,18,243,4,65,304,63,49,15,175,286,4868,1331,27292,32160,9/15/2020
4/19/2020,381,5474,2047,32901,38375,23,635,26,269,1,66,300,65,55,11,186,338,5206,1744,29036,34242,9/15/2020
4/20/2020,394,5868,1907,34808,40676,46,681,29,298,2,68,315,75,56,10,196,377,5583,1574,30610,36193,9/15/2020
4/21/2020,444,6312,2110,36918,43230,45,726,31,329,5,73,324,72,56,18,214,391,5974,1715,32325,38299,9/15/2020
4/22/2020,418,6730,2390,39308,46038,41,767,32,361,5,78,328,73,58,18,232,385,6359,1917,34242,40601,9/15/2020
4/23/2020,479,7209,2469,41777,48986,32,799,28,389,5,83,327,76,62,15,247,420,6779,1863,36105,42884,9/15/2020
4/24/2020,491,7700,3284,45061,52761,35,834,27,416,4,87,331,85,63,15,262,416,7195,2630,38735,45930,9/15/2020
4/25/2020,393,8093,2206,47267,55360,34,868,17,433,5,92,343,85,62,14,276,304,7499,1774,40509,48008,9/15/2020
4/26/2020,316,8409,2309,49576,57985,33,901,15,448,3,95,358,86,59,14,290,275,7774,1882,42391,50165,9/15/2020
4/27/2020,249,8658,1620,51196,59854,29,930,21,469,4,99,362,86,61,10,300,204,7978,1163,43554,51532,9/15/2020
4/28/2020,410,9068,2263,53459,62527,44,974,24,493,3,102,379,88,59,22,322,330,8308,1765,45319,53627,9/15/2020
4/29/2020,476,9544,3343,56802,66346,36,1010,38,531,11,113,366,78,53,18,340,373,8681,2427,47746,56427,9/15/2020
4/30/2020,432,9976,2769,59571,69547,33,1043,38,569,6,119,355,83,57,24,364,353,9034,1943,49689,58723,9/15/2020
5/1/2020,454,10430,3086,62657,73087,51,1094,39,608,3,122,364,84,58,14,378,320,9354,2203,51892,61246,9/15/2020
5/2/2020,257,10687,1926,64583,75270,36,1130,39,647,5,127,356,91,62,24,402,189,9543,1289,53181,62724,9/15/2020
5/3/2020,283,10970,2160,66743,77713,31,1161,27,674,8,135,352,90,61,21,423,182,9725,1599,54780,64505,9/15/2020
5/4/2020,387,11357,2098,68841,80198,30,1191,31,705,5,140,346,88,57,18,441,293,10018,1569,56349,66367,9/15/2020
5/5/2020,433,11790,2873,71714,83504,29,1220,32,737,6,146,337,82,54,16,457,308,10326,1966,58315,68641,9/15/2020
5/6/2020,488,12278,2830,74544,86822,28,1248,44,781,9,155,312,79,54,21,478,342,10668,1923,60238,70906,9/15/2020
5/7/2020,425,12703,2969,77513,90216,36,1284,42,823,5,160,301,71,52,21,499,274,10942,1971,62209,73151,9/15/2020
5/8/2020,359,13062,2598,80111,93173,30,1314,29,852,5,165,297,71,53,22,521,233,11175,1744,63953,75128,9/15/2020
5/9/2020,467,13529,3346,83457,96986,22,1336,21,873,4,169,294,69,51,15,536,291,11466,2266,66219,77685,9/15/2020
5/10/2020,285,13814,2117,85574,99388,20,1356,23,896,6,175,285,70,49,13,549,188,11654,1523,67742,79396,9/15/2020
5/11/2020,257,14071,1857,87431,101502,31,1387,16,912,6,181,294,71,49,15,564,178,11832,1304,69046,80878,9/15/2020
5/12/2020,387,14458,2611,90042,104500,23,1410,18,930,4,185,295,69,48,22,586,218,12050,1712,70758,82808,9/15/2020
5/13/2020,351,14809,3630,93672,108481,23,1433,25,955,1,186,292,69,49,13,599,199,12249,2010,72768,85017,9/15/2020
5/14/2020,329,15138,3408,97080,112218,19,1452,27,982,3,189,281,64,45,15,614,232,12481,2021,74789,87270,9/15/2020
5/15/2020,381,15519,3458,100538,116057,24,1476,41,1023,5,194,259,62,45,13,627,237,12718,1813,76602,89320,9/15/2020
5/16/2020,449,15968,4156,104694,120662,25,1501,13,1036,5,199,266,61,46,15,642,252,12970,1964,78566,91536,9/15/2020
5/17/2020,240,16208,2768,107462,123670,17,1518,8,1044,5,204,270,59,45,10,652,129,13099,1559,80125,93224,9/15/2020
5/18/2020,250,16458,2001,109463,125921,19,1537,15,1059,5,209,269,57,40,18,670,140,13239,1371,81496,94735,9/15/2020
5/19/2020,415,16873,3168,112631,129504,23,1560,32,1091,5,214,255,56,38,11,681,214,13453,1932,83428,96881,9/15/2020
5/20/2020,326,17199,2771,115402,132601,19,1579,23,1114,7,221,244,52,33,22,703,188,13641,1517,84945,98586,9/15/2020
5/21/2020,374,17573,3757,119159,136732,25,1604,15,1129,3,224,251,53,29,20,723,170,13811,1944,86889,100700,9/15/2020
5/22/2020,351,17924,3161,122320,140244,20,1624,29,1158,5,229,237,52,29,10,733,204,14015,1614,88503,102518,9/15/2020
5/23/2020,253,18177,2742,125062,143239,19,1643,11,1169,3,232,242,52,32,13,746,108,14123,1273,89776,103899,9/15/2020
5/24/2020,163,18340,1370,126432,144772,12,1655,14,1183,2,234,238,53,36,8,754,82,14205,773,90549,104754,9/15/2020
5/25/2020,147,18487,1385,127817,146304,13,1668,14,1197,0,234,237,53,34,10,764,72,14277,762,91311,105588,9/15/2020
5/26/2020,285,18772,2620,130437,149209,24,1692,21,1218,5,239,235,48,33,15,779,163,14440,1781,93092,107532,9/15/2020
5/27/2020,276,19048,2057,132494,151542,20,1712,18,1236,3,242,234,50,33,10,789,134,14574,1136,94228,108802,9/15/2020
5/28/2020,348,19396,3359,135853,155249,17,1729,29,1265,4,246,218,47,32,8,797,134,14708,1120,95348,110056,9/15/2020
5/29/2020,410,19806,3914,139767,159573,19,1748,27,1292,6,252,204,43,31,12,809,177,14885,1574,96922,111807,9/15/2020
5/30/2020,225,20031,3915,143682,163713,15,1763,19,1311,4,256,196,40,29,12,821,109,14994,1821,98743,113737,9/15/2020
5/31/2020,155,20186,1688,145370,165556,11,1774,10,1321,0,256,197,43,26,3,824,78,15072,857,99600,114672,9/15/2020
6/1/2020,212,20398,2792,148162,168560,8,1782,14,1335,1,257,190,44,29,5,829,99,15171,1387,100987,116158,9/15/2020
6/2/2020,273,20671,3022,151184,171855,8,1790,9,1344,3,260,186,37,25,10,839,107,15278,1451,102438,117716,9/15/2020
6/3/2020,254,20925,3486,154670,175595,14,1804,18,1362,6,266,176,34,25,11,850,105,15383,1666,104104,119487,9/15/2020
6/4/2020,276,21201,4471,159141,180342,7,1811,25,1387,3,269,155,31,24,11,861,111,15494,2041,106145,121639,9/15/2020
6/5/2020,215,21416,3513,162654,184070,15,1826,13,1400,6,275,151,27,21,11,872,106,15600,1578,107723,123323,9/15/2020
6/6/2020,201,21617,2616,165270,186887,10,1836,7,1407,2,277,152,29,19,6,878,69,15669,1137,108860,124529,9/15/2020
6/7/2020,83,21700,1625,166895,188595,11,1847,7,1414,1,278,155,25,17,4,882,50,15719,782,109642,125361,9/15/2020
6/8/2020,119,21819,1849,168744,190563,14,1861,12,1426,2,280,155,27,18,4,886,44,15763,963,110605,126368,9/15/2020
6/9/2020,223,22042,2673,171417,193459,10,1871,18,1444,0,280,147,28,21,1,887,67,15830,1260,111865,127695,9/15/2020
6/10/2020,209,22251,2987,174404,196655,13,1884,12,1456,2,282,146,24,17,4,891,105,15935,1468,113333,129268,9/15/2020
6/11/2020,195,22446,3513,177917,200363,7,1891,15,1471,1,283,137,25,16,6,897,88,16023,1539,114872,130895,9/15/2020
6/12/2020,209,22655,4601,182518,205173,9,1900,15,1486,1,284,130,24,16,2,899,82,16105,2187,117059,133164,9/15/2020
6/13/2020,113,22768,3036,185554,208322,6,1906,4,1490,0,284,132,20,15,3,902,50,16155,1374,118433,134588,9/15/2020
6/14/2020,81,22849,2046,187600,210449,7,1913,8,1498,1,285,130,20,14,3,905,33,16188,969,119402,135590,9/15/2020
6/15/2020,188,23037,3108,190708,213745,14,1927,14,1512,0,285,130,20,16,5,910,78,16266,1793,121195,137461,9/15/2020
6/16/2020,110,23147,3017,193725,216872,10,1937,8,1520,1,286,131,22,16,8,918,52,16318,1579,122774,139092,9/15/2020
6/17/2020,127,23274,2835,196560,219834,15,1952,20,1540,4,290,122,18,14,6,924,53,16371,1320,124094,140465,9/15/2020
6/18/2020,149,23423,3047,199607,223030,9,1961,13,1553,1,291,117,19,16,7,931,70,16441,1323,125417,141858,9/15/2020
6/19/2020,141,23564,3769,203376,226940,12,1973,11,1564,1,292,117,20,17,3,934,59,16500,1372,126789,143289,9/15/2020
6/20/2020,84,23648,1891,205267,228915,9,1982,12,1576,0,292,114,20,18,4,938,36,16536,814,127603,144139,9/15/2020
6/21/2020,37,23685,1064,206331,230016,8,1990,5,1581,0,292,117,20,18,2,940,28,16564,692,128295,144859,9/15/2020
6/22/2020,138,23823,3730,210061,233884,12,2002,16,1597,0,292,113,19,18,1,941,69,16633,1710,130005,146638,9/15/2020
6/23/2020,163,23986,3831,213892,237878,3,2005,13,1610,3,295,100,18,18,7,948,83,16716,1785,131790,148506,9/15/2020
6/24/2020,120,24106,3502,217394,241500,9,2014,10,1620,1,296,98,18,18,5,953,46,16762,1688,133478,150240,9/15/2020
6/25/2020,103,24209,2883,220277,244486,6,2020,14,1634,1,297,89,17,17,1,954,54,16816,1516,134994,151810,9/15/2020
6/26/2020,94,24303,2488,222765,247068,2,2022,10,1644,0,297,81,18,18,1,955,63,16879,1332,136326,153205,9/15/2020
6/27/2020,84,24387,3214,225979,250366,5,2027,3,1647,1,298,82,17,17,5,960,37,16916,1221,137547,154463,9/15/2020
6/28/2020,39,24426,1469,227448,251874,4,2031,4,1651,4,302,78,15,14,6,966,19,16935,596,138143,155078,9/15/2020
6/29/2020,85,24511,3697,231145,255656,4,2035,5,1656,0,302,77,14,14,1,967,39,16974,1355,139498,156472,9/15/2020
6/30/2020,57,24568,1956,233101,257669,1,2036,5,1661,1,303,72,12,11,4,971,33,17007,996,140494,157501,9/15/2020
7/1/2020,144,24712,4098,237199,261911,7,2043,9,1670,0,303,70,11,11,1,972,80,17087,1938,142432,159519,9/15/2020
7/2/2020,103,24815,2803,240002,264817,5,2048,5,1675,1,304,69,10,10,2,974,57,17144,1091,143523,160667,9/15/2020
7/3/2020,50,24865,2076,242078,266943,9,2057,6,1681,0,304,72,9,9,3,977,26,17170,780,144303,161473,9/15/2020
7/4/2020,57,24922,2345,244423,269345,2,2059,4,1685,1,305,69,10,9,2,979,34,17204,1012,145315,162519,9/15/2020
7/5/2020,49,24971,2932,247355,272326,1,2060,2,1687,1,306,67,8,8,2,981,26,17230,1448,146763,163993,9/15/2020
7/6/2020,101,25072,2811,250166,275238,6,2066,6,1693,0,306,67,9,9,4,985,58,17288,1553,148316,165604,9/15/2020
7/7/2020,81,25153,3457,253623,278776,5,2071,7,1700,0,306,65,8,8,2,987,48,17336,1537,149853,167189,9/15/2020
7/8/2020,105,25258,3403,257026,282284,4,2075,2,1702,0,306,67,9,8,0,987,65,17401,1426,151279,168680,9/15/2020
7/9/2020,94,25352,3712,260738,286090,9,2084,3,1705,0,306,73,9,8,0,987,51,17452,1631,152910,170362,9/15/2020
7/10/2020,131,25483,4431,265169,290652,6,2090,3,1708,2,308,74,7,7,3,990,80,17532,2084,154994,172526,9/15/2020
7/11/2020,63,25546,2932,268101,293647,6,2096,3,1711,1,309,76,6,6,3,993,34,17566,1320,156314,173880,9/15/2020
7/12/2020,47,25593,1836,269937,295530,1,2097,3,1714,1,310,73,6,5,3,996,34,17600,943,157257,174857,9/15/2020
7/13/2020,84,25677,3157,273094,298771,8,2105,10,1724,0,310,71,6,5,1,997,61,17661,1476,158733,176394,9/15/2020
7/14/2020,73,25750,3289,276383,302133,7,2112,4,1728,0,310,74,5,5,1,998,49,17710,1375,160108,177818,9/15/2020
7/15/2020,130,25880,4168,280551,306431,5,2117,7,1735,0,310,72,5,4,0,998,100,17810,1756,161864,179674,9/15/2020
7/16/2020,102,25982,3733,284284,310266,6,2123,9,1744,0,310,69,6,5,1,999,78,17888,1621,163485,181373,9/15/2020
7/17/2020,156,26138,4235,288519,314657,14,2137,3,1747,1,311,79,5,5,2,1001,81,17969,1851,165336,183305,9/15/2020
7/18/2020,85,26223,3267,291786,318009,5,2142,9,1756,1,312,74,5,4,4,1005,69,18038,1402,166738,184776,9/15/2020
7/19/2020,82,26305,2693,294479,320784,7,2149,3,1759,0,312,78,6,4,2,1007,59,18097,1151,167889,185986,9/15/2020
7/20/2020,71,26376,2664,297143,323519,9,2158,7,1766,0,312,80,7,5,2,1009,69,18166,1467,169356,187522,9/15/2020
7/21/2020,130,26506,4298,301441,327947,9,2167,11,1777,0,312,78,9,6,1,1010,109,18275,1927,171283,189558,9/15/2020
7/22/2020,130,26636,3926,305367,332003,11,2178,11,1788,1,313,77,7,6,1,1011,87,18362,1684,172967,191329,9/15/2020
7/23/2020,141,26777,4376,309743,336520,8,2186,6,1794,0,313,79,8,7,0,1011,116,18478,1972,174939,193417,9/15/2020
7/24/2020,172,26949,5959,315702,342651,14,2200,14,1808,0,313,79,9,7,0,1011,123,18601,2326,177265,195866,9/15/2020
7/25/2020,134,27083,4398,320100,347183,7,2207,7,1815,0,313,79,10,8,2,1013,107,18708,2101,179366,198074,9/15/2020
7/26/2020,62,27145,3027,323127,350272,8,2215,9,1824,0,313,78,11,7,1,1014,54,18762,1341,180707,199469,9/15/2020
7/27/2020,186,27331,4163,327290,354621,12,2227,7,1831,0,313,83,13,8,1,1015,141,18903,2335,183042,201945,9/15/2020
7/28/2020,105,27436,3831,331121,358557,5,2232,5,1836,0,313,83,14,7,1,1016,94,18997,1635,184677,203674,9/15/2020
7/29/2020,191,27627,5123,336244,363871,10,2242,12,1848,0,313,81,15,7,0,1016,156,19153,2326,187003,206156,9/15/2020
7/30/2020,121,27748,4344,340588,368336,6,2248,2,1850,1,314,84,15,6,1,1017,96,19249,1651,188654,207903,9/15/2020
7/31/2020,131,27879,5508,346096,373975,8,2256,9,1859,0,314,83,15,7,0,1017,90,19339,1860,190514,209853,9/15/2020
8/1/2020,108,27987,4288,350384,378371,7,2263,2,1861,0,314,88,14,7,1,1018,88,19427,1559,192073,211500,9/15/2020
8/2/2020,84,28071,2802,353186,381257,12,2275,12,1873,2,316,86,14,8,2,1020,62,19489,1276,193349,212838,9/15/2020
8/3/2020,187,28258,5203,358389,386647,13,2288,12,1885,0,316,87,16,7,1,1021,154,19643,2187,195536,215179,9/15/2020
8/4/2020,126,28384,3687,362076,390460,8,2296,6,1891,1,317,88,12,5,2,1023,99,19742,1775,197311,217053,9/15/2020
8/5/2020,148,28532,5914,367990,396522,12,2308,10,1901,1,318,89,10,5,2,1025,118,19860,2474,199785,219645,9/15/2020
8/6/2020,169,28701,5533,373523,402224,7,2315,9,1910,0,318,87,9,4,0,1025,122,19982,2428,202213,222195,9/15/2020
8/7/2020,122,28823,4845,378368,407191,13,2328,10,1920,1,319,89,9,3,2,1027,90,20072,2160,204373,224445,9/15/2020
8/8/2020,122,28945,4105,382473,411418,19,2347,6,1926,1,320,101,8,3,1,1028,96,20168,1782,206155,226323,9/15/2020
8/9/2020,42,28987,1722,384195,413182,8,2355,11,1937,0,320,98,9,4,0,1028,36,20204,1076,207231,227435,9/15/2020
8/10/2020,149,29136,4577,388772,417908,11,2366,11,1948,0,320,98,9,4,1,1029,112,20316,2030,209261,229577,9/15/2020
8/11/2020,105,29241,4320,393092,422333,6,2372,14,1962,0,320,90,10,4,3,1032,93,20409,2272,211533,231942,9/15/2020
8/12/2020,121,29362,5184,398276,427638,8,2380,11,1973,0,320,87,9,3,1,1033,103,20512,2631,214164,234676,9/15/2020
8/13/2020,135,29497,4190,402466,431963,13,2393,12,1985,0,320,88,11,3,0,1033,97,20609,1911,216075,236684,9/15/2020
8/14/2020,145,29642,5461,407927,437569,13,2406,11,1996,0,320,90,11,4,3,1036,101,20710,1956,218031,238741,9/15/2020
8/15/2020,105,29747,4532,412459,442206,8,2414,11,2007,1,321,86,11,5,0,1036,89,20799,1703,219734,240533,9/15/2020
8/16/2020,83,29830,2794,415253,445083,7,2421,6,2013,4,325,83,8,4,5,1041,71,20870,987,220721,241591,9/15/2020
8/17/2020,106,29936,4547,419800,449736,10,2431,7,2020,0,325,86,8,5,2,1043,87,20957,2389,223110,244067,9/15/2020
8/18/2020,128,30064,5042,424842,454906,11,2442,9,2029,1,326,87,8,4,5,1048,97,21054,2789,225899,246953,9/15/2020
8/19/2020,114,30178,5407,430249,460427,8,2450,9,2038,1,327,85,9,5,0,1048,91,21145,2688,228587,249732,9/15/2020
8/20/2020,174,30352,8224,438473,468825,12,2462,6,2044,2,329,89,10,5,3,1051,137,21282,3576,232163,253445,9/15/2020
8/21/2020,154,30506,6807,445280,475786,8,2470,5,2049,1,330,91,9,4,2,1053,125,21407,2981,235144,256551,9/15/2020
8/22/2020,96,30602,5958,451238,481840,10,2480,12,2061,0,330,89,11,4,1,1054,84,21491,2632,237776,259267,9/15/2020
8/23/2020,70,30672,4365,455603,486275,11,2491,6,2067,0,330,94,11,2,1,1055,57,21548,2480,240256,261804,9/15/2020
8/24/2020,105,30777,5775,461378,492155,7,2498,10,2077,1,331,90,13,4,1,1056,75,21623,3168,243424,265047,9/15/2020
8/25/2020,108,30885,4810,466188,497073,10,2508,4,2081,1,332,95,11,4,1,1057,94,21717,2313,245737,267454,9/15/2020
8/26/2020,170,31055,9606,475794,506849,4,2512,8,2089,0,332,91,9,5,1,1058,128,21845,3098,248835,270680,9/15/2020
8/27/2020,94,31149,8893,484687,515836,5,2517,13,2102,1,333,82,6,5,2,1060,71,21916,3273,252108,274024,9/15/2020
8/28/2020,112,31261,8109,492796,524057,14,2531,4,2106,0,333,92,9,7,2,1062,87,22003,2459,254567,276570,9/15/2020
8/29/2020,65,31326,5519,498315,529641,6,2537,8,2114,1,334,89,10,6,1,1063,53,22056,1925,256492,278548,9/15/2020
8/30/2020,66,31392,4319,502634,534026,7,2544,4,2118,0,334,92,8,5,1,1064,48,22104,2000,258492,280596,9/15/2020
8/31/2020,105,31497,4859,507493,538990,10,2554,15,2133,0,334,87,8,4,0,1064,82,22186,2195,260687,282873,9/15/2020
9/1/2020,98,31595,7204,514697,546292,6,2560,9,2142,1,335,83,7,4,1,1065,67,22253,2389,263076,285329,9/15/2020
9/2/2020,124,31719,10613,525310,557029,9,2569,10,2152,1,336,81,8,4,2,1067,102,22355,2971,266047,288402,9/15/2020
9/3/2020,89,31808,11346,536656,568464,8,2577,8,2160,0,336,81,9,4,1,1068,77,22432,2595,268642,291074,9/15/2020
9/4/2020,102,31910,9197,545853,577763,11,2588,4,2164,0,336,88,9,4,1,1069,83,22515,2411,271053,293568,9/15/2020
9/5/2020,52,31962,6327,552180,584142,6,2594,9,2173,0,336,85,8,3,1,1070,42,22557,1592,272645,295202,9/15/2020
9/6/2020,87,32049,4310,556490,588539,4,2598,8,2181,1,337,80,6,3,1,1071,66,22623,1958,274603,297226,9/15/2020
9/7/2020,35,32084,2999,559489,591573,11,2609,3,2184,0,337,88,5,3,1,1072,26,22649,649,275252,297901,9/15/2020
9/8/2020,74,32158,6373,565862,598020,6,2615,12,2196,1,338,81,6,3,2,1074,67,22716,1596,276848,299564,9/15/2020
9/9/2020,118,32276,8833,574695,606971,9,2624,5,2201,1,339,84,9,3,1,1075,98,22814,2157,279005,301819,9/15/2020
9/10/2020,168,32444,11748,586443,618887,7,2631,8,2209,0,339,83,10,3,0,1075,115,22929,2280,281285,304214,9/15/2020
9/11/2020,121,32565,9297,595740,628305,11,2642,11,2220,0,339,83,10,5,0,1075,93,23022,1846,283131,306153,9/15/2020
9/12/2020,107,32672,6135,601875,634547,5,2647,5,2225,2,341,81,9,5,3,1078,98,23120,1471,284602,307722,9/15/2020
9/13/2020,58,32730,2590,604465,637195,3,2650,3,2228,0,341,81,9,5,0,1078,48,23168,796,285398,308566,9/15/2020
9/14/2020,90,32820,5282,609747,642567,,,,,,,,,,0,1078,82,23250,1393,286791,310041,9/15/2020
2/27/2020,0,0,0,0,0,1,1,0,0,0,0,1,0,0,0,0,0,0,0,0,0,9/16/2020
2/28/2020,0,0,0,0,0,0,1,0,0,0,0,1,1,0,0,0,0,0,0,0,0,9/16/2020
2/29/2020,0,0,0,0,0,0,1,0,0,0,0,1,1,0,0,0,0,0,0,0,0,9/16/2020
3/1/2020,2,2,3,3,5,0,1,0,0,0,0,1,1,1,0,0,2,2,2,2,4,9/16/2020
3/2/2020,0,2,1,4,6,1,2,0,0,0,0,2,2,2,0,0,0,2,1,3,5,9/16/2020
3/3/2020,0,2,2,6,8,0,2,0,0,0,0,2,2,2,0,0,0,2,2,5,7,9/16/2020
3/4/2020,0,2,12,18,20,1,3,0,0,0,0,3,2,2,0,0,0,2,10,15,17,9/16/2020
3/5/2020,0,2,5,23,25,0,3,0,0,0,0,3,2,2,0,0,1,3,4,19,22,9/16/2020
3/6/2020,1,3,12,35,38,0,3,0,0,0,0,3,2,2,0,0,0,3,11,30,33,9/16/2020
3/7/2020,0,3,19,54,57,0,3,0,0,0,0,3,2,1,0,0,0,3,19,49,52,9/16/2020
3/8/2020,0,3,19,73,76,0,3,0,0,0,0,3,2,1,0,0,0,3,18,67,70,9/16/2020
3/9/2020,1,4,27,100,104,0,3,0,0,0,0,3,2,1,0,0,1,4,15,82,86,9/16/2020
3/10/2020,2,6,25,125,131,0,3,0,0,0,0,3,2,1,0,0,1,5,23,105,110,9/16/2020
3/11/2020,0,6,34,159,165,1,4,0,0,0,0,4,1,1,0,0,0,5,34,139,144,9/16/2020
3/12/2020,9,15,41,200,215,1,5,0,0,0,0,5,1,1,0,0,8,13,38,177,190,9/16/2020
3/13/2020,6,21,50,250,271,4,9,1,1,0,0,8,1,1,0,0,6,19,48,225,244,9/16/2020
3/14/2020,0,21,90,340,361,0,9,0,1,0,0,8,1,1,0,0,0,19,86,311,330,9/16/2020
3/15/2020,1,22,54,394,416,1,10,0,1,0,0,9,2,1,0,0,1,20,54,365,385,9/16/2020
3/16/2020,2,24,95,489,513,2,12,0,1,0,0,11,2,0,0,0,2,22,92,457,479,9/16/2020
3/17/2020,16,40,162,651,691,6,18,0,1,0,0,17,2,0,0,0,11,33,151,608,641,9/16/2020
3/18/2020,12,52,116,767,819,3,21,0,1,0,0,20,2,0,0,0,11,44,110,718,762,9/16/2020
3/19/2020,17,69,262,1029,1098,2,23,1,2,0,0,21,3,0,1,1,17,61,251,969,1030,9/16/2020
3/20/2020,14,83,197,1226,1309,5,28,0,2,0,0,26,4,0,0,1,13,74,191,1160,1234,9/16/2020
3/21/2020,21,104,126,1352,1456,3,31,2,4,0,0,27,5,0,0,1,14,88,123,1283,1371,9/16/2020
3/22/2020,30,134,282,1634,1768,2,33,0,4,0,0,29,5,0,0,1,25,113,262,1545,1658,9/16/2020
3/23/2020,15,149,169,1803,1952,15,48,1,5,0,0,43,9,3,0,1,16,129,165,1710,1839,9/16/2020
3/24/2020,20,169,243,2046,2215,7,55,0,5,0,0,50,10,4,0,1,19,148,238,1948,2096,9/16/2020
3/25/2020,26,195,184,2230,2425,5,60,1,6,0,0,54,11,3,0,1,28,176,172,2120,2296,9/16/2020
3/26/2020,35,230,181,2411,2641,10,70,5,11,0,0,59,14,5,0,1,41,217,176,2296,2513,9/16/2020
3/27/2020,27,257,215,2626,2883,9,79,1,12,1,1,66,17,6,2,3,31,248,202,2498,2746,9/16/2020
3/28/2020,59,316,260,2886,3202,13,92,3,15,2,3,74,15,6,1,4,63,311,241,2739,3050,9/16/2020
3/29/2020,106,422,356,3242,3664,8,100,4,19,1,4,77,18,8,2,6,105,416,314,3053,3469,9/16/2020
3/30/2020,62,484,222,3464,3948,20,120,5,24,0,4,92,20,11,3,9,78,494,184,3237,3731,9/16/2020
3/31/2020,71,555,369,3833,4388,11,131,7,31,1,5,95,22,13,2,11,73,567,297,3534,4101,9/16/2020
4/1/2020,99,654,699,4532,5186,18,149,7,38,0,5,106,30,15,1,12,102,669,642,4176,4845,9/16/2020
4/2/2020,52,706,478,5010,5716,22,171,6,44,2,7,120,36,21,4,16,62,731,436,4612,5343,9/16/2020
4/3/2020,108,814,776,5786,6600,23,194,7,51,0,7,136,43,25,3,19,100,831,712,5324,6155,9/16/2020
4/4/2020,143,957,660,6446,7403,22,216,4,55,5,12,149,41,30,9,28,137,968,619,5943,6911,9/16/2020
4/5/2020,187,1144,1156,7602,8746,20,236,9,64,1,13,159,44,36,2,30,182,1150,1069,7012,8162,9/16/2020
4/6/2020,218,1362,1707,9309,10671,26,262,7,71,0,13,178,48,40,7,37,206,1356,1555,8567,9923,9/16/2020
4/7/2020,285,1647,1632,10941,12588,20,282,4,75,2,15,192,50,42,5,42,261,1617,1484,10051,11668,9/16/2020
4/8/2020,291,1938,1724,12665,14603,19,301,7,82,6,21,198,50,38,10,52,273,1890,1565,11616,13506,9/16/2020
4/9/2020,284,2222,1521,14186,16408,32,333,9,91,4,25,217,53,40,7,59,280,2170,1355,12971,15141,9/16/2020
4/10/2020,420,2642,2578,16764,19406,29,362,16,107,5,30,225,59,41,11,70,403,2573,2372,15343,17916,9/16/2020
4/11/2020,299,2941,1912,18676,21617,29,391,11,118,2,32,241,61,48,12,82,280,2853,1720,17063,19916,9/16/2020
4/12/2020,315,3256,1677,20353,23609,35,426,13,131,5,37,258,59,49,9,91,289,3142,1438,18501,21643,9/16/2020
4/13/2020,162,3418,940,21293,24711,35,461,13,144,3,40,277,64,54,9,100,187,3329,838,19339,22668,9/16/2020
4/14/2020,290,3708,1805,23098,26806,27,488,17,161,5,45,282,72,53,8,108,265,3594,1528,20867,24461,9/16/2020
4/15/2020,353,4061,1805,24903,28964,31,519,20,181,3,48,290,72,54,17,125,307,3901,1560,22427,26328,9/16/2020
4/16/2020,449,4510,2503,27406,31916,36,555,25,206,6,54,295,72,53,14,139,389,4290,2080,24507,28797,9/16/2020
4/17/2020,309,4819,1826,29232,34051,32,587,20,226,7,61,300,66,45,21,160,293,4583,1449,25956,30539,9/16/2020
4/18/2020,323,5142,1730,30962,36104,26,613,18,244,4,65,304,63,49,15,175,286,4869,1331,27287,32156,9/16/2020
4/19/2020,383,5525,2060,33022,38547,23,636,26,270,1,66,300,65,55,11,186,338,5207,1744,29031,34238,9/16/2020
4/20/2020,396,5921,1909,34931,40852,46,682,29,299,2,68,315,75,56,10,196,377,5584,1574,30605,36189,9/16/2020
4/21/2020,445,6366,2117,37048,43414,45,727,31,330,5,73,324,72,56,18,214,391,5975,1715,32320,38295,9/16/2020
4/22/2020,421,6787,2401,39449,46236,41,768,32,362,5,78,328,73,58,18,232,385,6360,1917,34237,40597,9/16/2020
4/23/2020,482,7269,2473,41922,49191,32,800,28,390,5,83,327,76,62,15,247,420,6780,1861,36098,42878,9/16/2020
4/24/2020,494,7763,3294,45216,52979,35,835,27,417,4,87,331,85,63,15,262,416,7196,2630,38728,45924,9/16/2020
4/25/2020,395,8158,2210,47426,55584,34,869,17,434,5,92,343,85,62,14,276,304,7500,1774,40502,48002,9/16/2020
4/26/2020,316,8474,2314,49740,58214,33,902,15,449,3,95,358,86,59,14,290,275,7775,1882,42384,50159,9/16/2020
4/27/2020,250,8724,1625,51365,60089,29,931,21,470,4,99,362,86,61,10,300,204,7979,1163,43547,51526,9/16/2020
4/28/2020,411,9135,2270,53635,62770,44,975,24,494,3,102,379,88,59,22,322,330,8309,1765,45312,53621,9/16/2020
4/29/2020,476,9611,3352,56987,66598,36,1011,38,532,11,113,366,78,53,18,340,373,8682,2426,47738,56420,9/16/2020
4/30/2020,432,10043,2775,59762,69805,33,1044,38,570,6,119,355,83,57,24,364,353,9035,1942,49680,58715,9/16/2020
5/1/2020,457,10500,3091,62853,73353,51,1095,39,609,3,122,364,84,58,14,378,320,9355,2202,51882,61237,9/16/2020
5/2/2020,260,10760,1930,64783,75543,36,1131,39,648,5,127,356,91,62,24,402,189,9544,1289,53171,62715,9/16/2020
5/3/2020,284,11044,2169,66952,77996,31,1162,27,675,8,135,352,90,61,21,423,182,9726,1598,54769,64495,9/16/2020
5/4/2020,388,11432,2103,69055,80487,30,1192,31,706,5,140,346,88,57,18,441,293,10019,1569,56338,66357,9/16/2020
5/5/2020,436,11868,2878,71933,83801,29,1221,32,738,6,146,337,82,54,16,457,308,10327,1966,58304,68631,9/16/2020
5/6/2020,490,12358,2838,74771,87129,28,1249,44,782,9,155,312,79,54,21,478,342,10669,1922,60226,70895,9/16/2020
5/7/2020,425,12783,2976,77747,90530,36,1285,42,824,5,160,301,71,52,21,499,274,10943,1970,62196,73139,9/16/2020
5/8/2020,360,13143,2605,80352,93495,30,1315,29,853,5,165,297,71,53,22,521,233,11176,1744,63940,75116,9/16/2020
5/9/2020,470,13613,3361,83713,97326,22,1337,21,874,4,169,294,69,51,15,536,291,11467,2266,66206,77673,9/16/2020
5/10/2020,285,13898,2124,85837,99735,20,1357,23,897,6,175,285,70,49,13,549,188,11655,1523,67729,79384,9/16/2020
5/11/2020,259,14157,1863,87700,101857,31,1388,16,913,6,181,294,71,49,15,564,178,11833,1304,69033,80866,9/16/2020
5/12/2020,387,14544,2623,90323,104867,23,1411,18,931,4,185,295,69,48,22,586,218,12051,1712,70745,82796,9/16/2020
5/13/2020,352,14896,3638,93961,108857,23,1434,25,956,1,186,292,69,49,13,599,199,12250,2010,72755,85005,9/16/2020
5/14/2020,330,15226,3421,97382,112608,19,1453,27,983,3,189,281,64,45,15,614,232,12482,2021,74776,87258,9/16/2020
5/15/2020,382,15608,3473,100855,116463,24,1477,41,1024,5,194,259,62,45,13,627,237,12719,1812,76588,89307,9/16/2020
5/16/2020,454,16062,4172,105027,121089,25,1502,13,1037,5,199,266,61,46,15,642,252,12971,1964,78552,91523,9/16/2020
5/17/2020,240,16302,2775,107802,124104,17,1519,8,1045,5,204,270,59,45,10,652,129,13100,1559,80111,93211,9/16/2020
5/18/2020,251,16553,2007,109809,126362,19,1538,15,1060,5,209,269,57,40,18,670,140,13240,1371,81482,94722,9/16/2020
5/19/2020,416,16969,3178,112987,129956,23,1561,32,1092,5,214,255,56,38,11,681,214,13454,1932,83414,96868,9/16/2020
5/20/2020,328,17297,2777,115764,133061,19,1580,23,1115,7,221,244,52,33,22,703,188,13642,1517,84931,98573,9/16/2020
5/21/2020,374,17671,3764,119528,137199,26,1606,15,1130,3,224,252,53,29,20,723,170,13812,1944,86875,100687,9/16/2020
5/22/2020,353,18024,3174,122702,140726,20,1626,29,1159,5,229,238,52,29,10,733,204,14016,1612,88487,102503,9/16/2020
5/23/2020,254,18278,2749,125451,143729,19,1645,11,1170,3,232,243,52,32,13,746,108,14124,1273,89760,103884,9/16/2020
5/24/2020,165,18443,1373,126824,145267,12,1657,14,1184,2,234,239,53,36,8,754,82,14206,773,90533,104739,9/16/2020
5/25/2020,151,18594,1389,128213,146807,13,1670,14,1198,0,234,238,53,34,10,764,72,14278,762,91295,105573,9/16/2020
5/26/2020,286,18880,2625,130838,149718,24,1694,22,1220,5,239,235,48,33,15,779,163,14441,1781,93076,107517,9/16/2020
5/27/2020,276,19156,2126,132964,152120,20,1714,18,1238,3,242,234,50,33,10,789,134,14575,1136,94212,108787,9/16/2020
5/28/2020,349,19505,3372,136336,155841,17,1731,29,1267,4,246,218,47,32,8,797,134,14709,1120,95332,110041,9/16/2020
5/29/2020,417,19922,3973,140309,160231,19,1750,27,1294,6,252,204,43,31,12,809,177,14886,1573,96905,111791,9/16/2020
5/30/2020,229,20151,3974,144283,164434,15,1765,19,1313,4,256,196,40,29,12,821,109,14995,1820,98725,113720,9/16/2020
5/31/2020,163,20314,1759,146042,166356,11,1776,10,1323,0,256,197,43,26,3,824,78,15073,857,99582,114655,9/16/2020
6/1/2020,215,20529,2824,148866,169395,8,1784,14,1337,1,257,190,44,29,5,829,99,15172,1387,100969,116141,9/16/2020
6/2/2020,273,20802,3077,151943,172745,8,1792,9,1346,3,260,186,37,25,10,839,107,15279,1451,102420,117699,9/16/2020
6/3/2020,260,21062,3516,155459,176521,14,1806,18,1364,6,266,176,34,25,11,850,105,15384,1666,104086,119470,9/16/2020
6/4/2020,281,21343,4542,160001,181344,7,1813,25,1389,3,269,155,31,24,11,861,111,15495,2041,106127,121622,9/16/2020
6/5/2020,216,21559,3596,163597,185156,15,1828,13,1402,6,275,151,27,21,11,872,106,15601,1578,107705,123306,9/16/2020
6/6/2020,203,21762,2630,166227,187989,10,1838,7,1409,2,277,152,29,19,6,878,69,15670,1137,108842,124512,9/16/2020
6/7/2020,84,21846,1632,167859,189705,11,1849,7,1416,1,278,155,25,17,4,882,50,15720,782,109624,125344,9/16/2020
6/8/2020,120,21966,1854,169713,191679,15,1864,12,1428,2,280,156,27,18,4,886,44,15764,962,110586,126350,9/16/2020
6/9/2020,223,22189,2685,172398,194587,10,1874,18,1446,0,280,148,28,21,1,887,67,15831,1260,111846,127677,9/16/2020
6/10/2020,211,22400,3005,175403,197803,13,1887,12,1458,2,282,147,24,17,4,891,105,15936,1468,113314,129250,9/16/2020
6/11/2020,195,22595,3578,178981,201576,7,1894,15,1473,1,283,138,25,16,6,897,88,16024,1537,114851,130875,9/16/2020
6/12/2020,209,22804,4618,183599,206403,9,1903,15,1488,1,284,131,24,16,2,899,82,16106,2187,117038,133144,9/16/2020
6/13/2020,114,22918,3048,186647,209565,6,1909,4,1492,0,284,133,20,15,3,902,50,16156,1374,118412,134568,9/16/2020
6/14/2020,83,23001,2053,188700,211701,7,1916,8,1500,1,285,131,20,14,3,905,33,16189,969,119381,135570,9/16/2020
6/15/2020,189,23190,3117,191817,215007,14,1930,14,1514,0,285,131,20,16,5,910,78,16267,1793,121174,137441,9/16/2020
6/16/2020,112,23302,3041,194858,218160,10,1940,9,1523,1,286,131,22,16,8,918,52,16319,1579,122753,139072,9/16/2020
6/17/2020,128,23430,2848,197706,221136,15,1955,20,1543,4,290,122,18,14,6,924,53,16372,1320,124073,140445,9/16/2020
6/18/2020,149,23579,3059,200765,224344,9,1964,13,1556,1,291,117,19,16,7,931,70,16442,1319,125392,141834,9/16/2020
6/19/2020,142,23721,3776,204541,228262,12,1976,11,1567,1,292,117,20,17,3,934,59,16501,1372,126764,143265,9/16/2020
6/20/2020,84,23805,1898,206439,230244,9,1985,12,1579,0,292,114,20,18,4,938,36,16537,814,127578,144115,9/16/2020
6/21/2020,37,23842,1071,207510,231352,8,1993,5,1584,0,292,117,20,18,2,940,28,16565,692,128270,144835,9/16/2020
6/22/2020,138,23980,3739,211249,235229,12,2005,16,1600,0,292,113,19,18,1,941,69,16634,1710,129980,146614,9/16/2020
6/23/2020,164,24144,3864,215113,239257,3,2008,13,1613,3,295,100,18,18,7,948,83,16717,1785,131765,148482,9/16/2020
6/24/2020,120,24264,3521,218634,242898,9,2017,10,1623,1,296,98,18,18,5,953,46,16763,1688,133453,150216,9/16/2020
6/25/2020,103,24367,2909,221543,245910,6,2023,14,1637,1,297,89,17,17,1,954,54,16817,1516,134969,151786,9/16/2020
6/26/2020,94,24461,2506,224049,248510,2,2025,10,1647,0,297,81,18,18,1,955,63,16880,1332,136301,153181,9/16/2020
6/27/2020,84,24545,3231,227280,251825,5,2030,3,1650,1,298,82,17,17,5,960,37,16917,1221,137522,154439,9/16/2020
6/28/2020,40,24585,1474,228754,253339,4,2034,4,1654,4,302,78,15,14,6,966,19,16936,596,138118,155054,9/16/2020
6/29/2020,85,24670,3706,232460,257130,4,2038,5,1659,0,302,77,14,14,1,967,39,16975,1355,139473,156448,9/16/2020
6/30/2020,59,24729,1966,234426,259155,1,2039,5,1664,1,303,72,12,11,4,971,33,17008,996,140469,157477,9/16/2020
7/1/2020,145,24874,4113,238539,263413,7,2046,9,1673,0,303,70,11,11,1,972,80,17088,1938,142407,159495,9/16/2020
7/2/2020,103,24977,2812,241351,266328,5,2051,5,1678,1,304,69,10,10,2,974,57,17145,1090,143497,160642,9/16/2020
7/3/2020,50,25027,2081,243432,268459,9,2060,6,1684,0,304,72,9,9,3,977,26,17171,780,144277,161448,9/16/2020
7/4/2020,58,25085,2353,245785,270870,2,2062,4,1688,1,305,69,10,9,2,979,34,17205,1012,145289,162494,9/16/2020
7/5/2020,51,25136,2939,248724,273860,1,2063,2,1690,1,306,67,8,8,2,981,26,17231,1448,146737,163968,9/16/2020
7/6/2020,102,25238,2821,251545,276783,6,2069,6,1696,0,306,67,9,9,4,985,58,17289,1553,148290,165579,9/16/2020
7/7/2020,82,25320,3470,255015,280335,5,2074,7,1703,0,306,65,8,8,2,987,48,17337,1537,149827,167164,9/16/2020
7/8/2020,105,25425,3417,258432,283857,4,2078,2,1705,0,306,67,9,8,0,987,65,17402,1426,151253,168655,9/16/2020
7/9/2020,96,25521,3730,262162,287683,9,2087,3,1708,0,306,73,9,8,0,987,51,17453,1631,152884,170337,9/16/2020
7/10/2020,131,25652,4454,266616,292268,6,2093,3,1711,2,308,74,7,7,3,990,80,17533,2084,154968,172501,9/16/2020
7/11/2020,64,25716,2944,269560,295276,6,2099,3,1714,1,309,76,6,6,3,993,34,17567,1320,156288,173855,9/16/2020
7/12/2020,47,25763,1846,271406,297169,1,2100,3,1717,1,310,73,6,5,3,996,34,17601,943,157231,174832,9/16/2020
7/13/2020,84,25847,3170,274576,300423,8,2108,10,1727,0,310,71,6,5,1,997,61,17662,1476,158707,176369,9/16/2020
7/14/2020,74,25921,3301,277877,303798,7,2115,4,1731,0,310,74,5,5,1,998,49,17711,1375,160082,177793,9/16/2020
7/15/2020,130,26051,4185,282062,308113,5,2120,7,1738,0,310,72,5,4,0,998,100,17811,1756,161838,179649,9/16/2020
7/16/2020,102,26153,3749,285811,311964,6,2126,9,1747,0,310,69,6,5,1,999,78,17889,1621,163459,181348,9/16/2020
7/17/2020,158,26311,4248,290059,316370,14,2140,3,1750,1,311,79,5,5,2,1001,81,17970,1851,165310,183280,9/16/2020
7/18/2020,85,26396,3277,293336,319732,5,2145,9,1759,1,312,74,5,4,4,1005,69,18039,1402,166712,184751,9/16/2020
7/19/2020,83,26479,2709,296045,322524,7,2152,3,1762,0,312,78,6,4,2,1007,59,18098,1151,167863,185961,9/16/2020
7/20/2020,71,26550,2668,298713,325263,9,2161,7,1769,0,312,80,7,5,2,1009,69,18167,1467,169330,187497,9/16/2020
7/21/2020,131,26681,4317,303030,329711,9,2170,11,1780,0,312,78,9,6,1,1010,109,18276,1925,171255,189531,9/16/2020
7/22/2020,130,26811,3939,306969,333780,11,2181,11,1791,1,313,77,7,6,1,1011,87,18363,1684,172939,191302,9/16/2020
7/23/2020,142,26953,4393,311362,338315,8,2189,6,1797,0,313,79,8,7,0,1011,116,18479,1972,174911,193390,9/16/2020
7/24/2020,175,27128,5979,317341,344469,14,2203,14,1811,0,313,79,9,7,0,1011,123,18602,2326,177237,195839,9/16/2020
7/25/2020,136,27264,4417,321758,349022,7,2210,7,1818,0,313,79,10,8,2,1013,107,18709,2101,179338,198047,9/16/2020
7/26/2020,63,27327,3046,324804,352131,8,2218,9,1827,0,313,78,11,7,1,1014,54,18763,1340,180678,199441,9/16/2020
7/27/2020,186,27513,4195,328999,356512,12,2230,7,1834,0,313,83,13,8,1,1015,141,18904,2335,183013,201917,9/16/2020
7/28/2020,105,27618,3866,332865,360483,5,2235,5,1839,0,313,83,14,7,1,1016,94,18998,1635,184648,203646,9/16/2020
7/29/2020,191,27809,5236,338101,365910,11,2246,12,1851,0,313,82,15,7,0,1016,157,19155,2326,186974,206129,9/16/2020
7/30/2020,121,27930,4358,342459,370389,6,2252,2,1853,1,314,85,15,6,1,1017,96,19251,1651,188625,207876,9/16/2020
7/31/2020,132,28062,5527,347986,376048,8,2260,10,1863,0,314,83,15,7,0,1017,90,19341,1860,190485,209826,9/16/2020
8/1/2020,109,28171,4320,352306,380477,7,2267,2,1865,0,314,88,14,7,1,1018,88,19429,1559,192044,211473,9/16/2020
8/2/2020,84,28255,2818,355124,383379,12,2279,12,1877,2,316,86,14,8,2,1020,62,19491,1276,193320,212811,9/16/2020
8/3/2020,187,28442,5218,360342,388784,13,2292,12,1889,0,316,87,16,7,1,1021,154,19645,2187,195507,215152,9/16/2020
8/4/2020,126,28568,3708,364050,392618,8,2300,6,1895,1,317,88,12,5,2,1023,99,19744,1775,197282,217026,9/16/2020
8/5/2020,151,28719,5948,369998,398717,12,2312,10,1905,1,318,89,10,5,2,1025,118,19862,2473,199755,219617,9/16/2020
8/6/2020,171,28890,5557,375555,404445,7,2319,9,1914,0,318,87,9,4,0,1025,122,19984,2428,202183,222167,9/16/2020
8/7/2020,122,29012,4858,380413,409425,13,2332,10,1924,1,319,89,9,3,2,1027,90,20074,2159,204342,224416,9/16/2020
8/8/2020,122,29134,4122,384535,413669,19,2351,6,1930,1,320,101,8,3,1,1028,96,20170,1781,206123,226293,9/16/2020
8/9/2020,43,29177,1736,386271,415448,8,2359,10,1940,0,320,99,9,4,0,1028,36,20206,1076,207199,227405,9/16/2020
8/10/2020,150,29327,4595,390866,420193,11,2370,12,1952,0,320,98,9,4,1,1029,112,20318,2030,209229,229547,9/16/2020
8/11/2020,105,29432,4354,395220,424652,6,2376,14,1966,0,320,90,10,4,3,1032,93,20411,2272,211501,231912,9/16/2020
8/12/2020,121,29553,5213,400433,429986,8,2384,11,1977,0,320,87,9,3,1,1033,103,20514,2631,214132,234646,9/16/2020
8/13/2020,135,29688,4225,404658,434346,13,2397,12,1989,0,320,88,11,3,0,1033,97,20611,1911,216043,236654,9/16/2020
8/14/2020,146,29834,5490,410148,439982,13,2410,11,2000,0,320,90,11,4,3,1036,101,20712,1955,217998,238710,9/16/2020
8/15/2020,105,29939,4545,414693,444632,8,2418,11,2011,1,321,86,11,5,0,1036,90,20802,1703,219701,240503,9/16/2020
8/16/2020,83,30022,2799,417492,447514,7,2425,6,2017,4,325,83,8,4,5,1041,71,20873,987,220688,241561,9/16/2020
8/17/2020,108,30130,4557,422049,452179,10,2435,7,2024,0,325,86,8,5,2,1043,87,20960,2389,223077,244037,9/16/2020
8/18/2020,130,30260,5058,427107,457367,11,2446,9,2033,1,326,87,8,4,5,1048,97,21057,2789,225866,246923,9/16/2020
8/19/2020,116,30376,5428,432535,462911,8,2454,9,2042,1,327,85,9,5,0,1048,90,21147,2688,228554,249701,9/16/2020
8/20/2020,174,30550,8287,440822,471372,12,2466,6,2048,2,329,89,10,5,3,1051,137,21284,3576,232130,253414,9/16/2020
8/21/2020,156,30706,6832,447654,478360,8,2474,5,2053,1,330,91,9,4,2,1053,125,21409,2981,235111,256520,9/16/2020
8/22/2020,96,30802,5982,453636,484438,10,2484,12,2065,0,330,89,11,4,1,1054,84,21493,2632,237743,259236,9/16/2020
8/23/2020,73,30875,4387,458023,488898,11,2495,6,2071,0,330,94,11,2,1,1055,57,21550,2479,240222,261772,9/16/2020
8/24/2020,105,30980,5787,463810,494790,7,2502,10,2081,1,331,90,13,4,1,1056,75,21625,3168,243390,265015,9/16/2020
8/25/2020,111,31091,4828,468638,499729,10,2512,4,2085,1,332,95,11,4,1,1057,94,21719,2313,245703,267422,9/16/2020
8/26/2020,171,31262,9634,478272,509534,4,2516,8,2093,0,332,91,9,5,1,1058,128,21847,3098,248801,270648,9/16/2020
8/27/2020,94,31356,8924,487196,518552,6,2522,13,2106,1,333,83,6,5,2,1060,71,21918,3274,252075,273993,9/16/2020
8/28/2020,113,31469,8132,495328,526797,14,2536,4,2110,0,333,93,9,7,2,1062,87,22005,2458,254533,276538,9/16/2020
8/29/2020,65,31534,5553,500881,532415,6,2542,8,2118,1,334,90,10,6,1,1063,53,22058,1925,256458,278516,9/16/2020
8/30/2020,68,31602,4339,505220,536822,7,2549,4,2122,0,334,93,8,5,1,1064,48,22106,2000,258458,280564,9/16/2020
8/31/2020,107,31709,4883,510103,541812,10,2559,15,2137,0,334,88,8,4,0,1064,82,22188,2195,260653,282841,9/16/2020
9/1/2020,99,31808,7333,517436,549244,6,2565,9,2146,1,335,84,7,4,1,1065,67,22255,2388,263041,285296,9/16/2020
9/2/2020,124,31932,10845,528281,560213,9,2574,10,2156,1,336,82,8,4,2,1067,102,22357,2971,266012,288369,9/16/2020
9/3/2020,90,32022,11370,539651,571673,8,2582,8,2164,0,336,82,9,4,1,1068,77,22434,2595,268607,291041,9/16/2020
9/4/2020,103,32125,9248,548899,581024,11,2593,4,2168,0,336,89,9,4,1,1069,83,22517,2411,271018,293535,9/16/2020
9/5/2020,52,32177,6681,555580,587757,6,2599,9,2177,0,336,86,8,3,1,1070,42,22559,1592,272610,295169,9/16/2020
9/6/2020,89,32266,4664,560244,592510,4,2603,8,2185,1,337,81,6,3,1,1071,66,22625,1958,274568,297193,9/16/2020
9/7/2020,35,32301,3007,563251,595552,11,2614,3,2188,0,337,89,5,3,1,1072,26,22651,649,275217,297868,9/16/2020
9/8/2020,77,32378,6384,569635,602013,6,2620,12,2200,1,338,82,6,3,2,1074,67,22718,1596,276813,299531,9/16/2020
9/9/2020,123,32501,8853,578488,610989,9,2629,5,2205,1,339,85,9,3,1,1075,98,22816,2157,278970,301786,9/16/2020
9/10/2020,171,32672,12421,590909,623581,8,2637,8,2213,0,339,85,10,3,0,1075,115,22931,2280,281250,304181,9/16/2020
9/11/2020,126,32798,9432,600341,633139,11,2648,11,2224,0,339,85,10,5,0,1075,93,23024,1847,283097,306121,9/16/2020
9/12/2020,109,32907,7450,607791,640698,7,2655,5,2229,2,341,85,9,5,3,1078,101,23125,1471,284568,307693,9/16/2020
9/13/2020,58,32965,2853,610644,643609,3,2658,3,2232,0,341,85,9,5,0,1078,54,23179,796,285364,308543,9/16/2020
9/14/2020,97,33062,5696,616340,649402,4,2662,3,2235,2,343,84,9,5,1,1079,93,23272,1465,286829,310101,9/16/2020
9/15/2020,97,33159,4604,620944,654103,,,,,,,,,,2,1081,86,23358,1157,287986,311344,9/16/2020
2/27/2020,0,0,0,0,0,1,1,0,0,0,0,1,0,0,0,0,0,0,0,0,0,9/17/2020
2/28/2020,0,0,0,0,0,0,1,0,0,0,0,1,1,0,0,0,0,0,0,0,0,9/17/2020
2/29/2020,0,0,0,0,0,0,1,0,0,0,0,1,1,0,0,0,0,0,0,0,0,9/17/2020
3/1/2020,2,2,3,3,5,0,1,0,0,0,0,1,1,1,0,0,2,2,2,2,4,9/17/2020
3/2/2020,0,2,1,4,6,1,2,0,0,0,0,2,2,2,0,0,0,2,1,3,5,9/17/2020
3/3/2020,0,2,2,6,8,0,2,0,0,0,0,2,2,2,0,0,0,2,2,5,7,9/17/2020
3/4/2020,0,2,12,18,20,1,3,0,0,0,0,3,2,2,0,0,0,2,10,15,17,9/17/2020
3/5/2020,0,2,5,23,25,0,3,0,0,0,0,3,2,2,0,0,1,3,4,19,22,9/17/2020
3/6/2020,1,3,12,35,38,0,3,0,0,0,0,3,2,2,0,0,0,3,11,30,33,9/17/2020
3/7/2020,0,3,19,54,57,0,3,0,0,0,0,3,2,1,0,0,0,3,19,49,52,9/17/2020
3/8/2020,0,3,19,73,76,0,3,0,0,0,0,3,2,1,0,0,0,3,18,67,70,9/17/2020
3/9/2020,1,4,27,100,104,0,3,0,0,0,0,3,2,1,0,0,1,4,15,82,86,9/17/2020
3/10/2020,2,6,25,125,131,0,3,0,0,0,0,3,2,1,0,0,1,5,23,105,110,9/17/2020
3/11/2020,0,6,34,159,165,1,4,0,0,0,0,4,1,1,0,0,0,5,34,139,144,9/17/2020
3/12/2020,9,15,41,200,215,1,5,0,0,0,0,5,1,1,0,0,8,13,38,177,190,9/17/2020
3/13/2020,6,21,50,250,271,4,9,1,1,0,0,8,1,1,0,0,6,19,48,225,244,9/17/2020
3/14/2020,0,21,90,340,361,0,9,0,1,0,0,8,1,1,0,0,0,19,86,311,330,9/17/2020
3/15/2020,1,22,54,394,416,1,10,0,1,0,0,9,2,1,0,0,1,20,54,365,385,9/17/2020
3/16/2020,2,24,95,489,513,2,12,0,1,0,0,11,2,0,0,0,2,22,92,457,479,9/17/2020
3/17/2020,16,40,162,651,691,6,18,0,1,0,0,17,2,0,0,0,11,33,151,608,641,9/17/2020
3/18/2020,12,52,116,767,819,3,21,0,1,0,0,20,2,0,0,0,11,44,110,718,762,9/17/2020
3/19/2020,17,69,262,1029,1098,2,23,1,2,0,0,21,3,0,1,1,17,61,251,969,1030,9/17/2020
3/20/2020,14,83,197,1226,1309,5,28,0,2,0,0,26,4,0,0,1,13,74,191,1160,1234,9/17/2020
3/21/2020,21,104,126,1352,1456,3,31,2,4,0,0,27,5,0,0,1,14,88,123,1283,1371,9/17/2020
3/22/2020,30,134,282,1634,1768,2,33,0,4,0,0,29,5,0,0,1,25,113,262,1545,1658,9/17/2020
3/23/2020,15,149,169,1803,1952,15,48,1,5,0,0,43,9,3,0,1,16,129,165,1710,1839,9/17/2020
3/24/2020,20,169,243,2046,2215,7,55,0,5,0,0,50,10,4,0,1,19,148,238,1948,2096,9/17/2020
3/25/2020,26,195,184,2230,2425,5,60,1,6,0,0,54,11,3,0,1,28,176,172,2120,2296,9/17/2020
3/26/2020,35,230,181,2411,2641,10,70,5,11,0,0,59,14,5,0,1,41,217,176,2296,2513,9/17/2020
3/27/2020,27,257,215,2626,2883,9,79,1,12,1,1,66,17,6,2,3,31,248,202,2498,2746,9/17/2020
3/28/2020,59,316,260,2886,3202,13,92,3,15,2,3,74,15,6,1,4,63,311,241,2739,3050,9/17/2020
3/29/2020,106,422,356,3242,3664,8,100,4,19,1,4,77,18,8,2,6,105,416,314,3053,3469,9/17/2020
3/30/2020,62,484,222,3464,3948,20,120,5,24,0,4,92,20,11,3,9,78,494,184,3237,3731,9/17/2020
3/31/2020,71,555,369,3833,4388,11,131,7,31,1,5,95,22,13,2,11,73,567,297,3534,4101,9/17/2020
4/1/2020,99,654,699,4532,5186,18,149,7,38,0,5,106,30,15,1,12,102,669,642,4176,4845,9/17/2020
4/2/2020,52,706,478,5010,5716,22,171,6,44,2,7,120,36,21,4,16,62,731,436,4612,5343,9/17/2020
4/3/2020,108,814,776,5786,6600,23,194,7,51,0,7,136,43,25,3,19,100,831,712,5324,6155,9/17/2020
4/4/2020,143,957,660,6446,7403,22,216,4,55,5,12,149,41,30,9,28,137,968,619,5943,6911,9/17/2020
4/5/2020,187,1144,1156,7602,8746,20,236,9,64,1,13,159,44,36,2,30,182,1150,1069,7012,8162,9/17/2020
4/6/2020,218,1362,1707,9309,10671,26,262,7,71,0,13,178,48,40,7,37,206,1356,1555,8567,9923,9/17/2020
4/7/2020,285,1647,1632,10941,12588,20,282,3,74,2,15,193,50,42,5,42,261,1617,1484,10051,11668,9/17/2020
4/8/2020,291,1938,1724,12665,14603,19,301,7,81,6,21,199,50,38,10,52,273,1890,1564,11615,13505,9/17/2020
4/9/2020,284,2222,1521,14186,16408,32,333,9,90,4,25,218,53,40,7,59,280,2170,1355,12970,15140,9/17/2020
4/10/2020,420,2642,2578,16764,19406,29,362,17,107,5,30,225,59,41,11,70,403,2573,2372,15342,17915,9/17/2020
4/11/2020,299,2941,1912,18676,21617,29,391,11,118,2,32,241,61,48,12,82,280,2853,1720,17062,19915,9/17/2020
4/12/2020,315,3256,1677,20353,23609,35,426,13,131,5,37,258,59,49,9,91,289,3142,1438,18500,21642,9/17/2020
4/13/2020,162,3418,940,21293,24711,35,461,13,144,3,40,277,64,54,9,100,187,3329,838,19338,22667,9/17/2020
4/14/2020,290,3708,1805,23098,26806,27,488,17,161,5,45,282,72,53,8,108,265,3594,1528,20866,24460,9/17/2020
4/15/2020,353,4061,1805,24903,28964,31,519,20,181,3,48,290,72,54,17,125,307,3901,1559,22425,26326,9/17/2020
4/16/2020,449,4510,2503,27406,31916,36,555,25,206,6,54,295,72,53,14,139,389,4290,2080,24505,28795,9/17/2020
4/17/2020,309,4819,1826,29232,34051,32,587,20,226,7,61,300,66,45,21,160,293,4583,1449,25954,30537,9/17/2020
4/18/2020,323,5142,1730,30962,36104,26,613,18,244,4,65,304,63,49,15,175,286,4869,1328,27282,32151,9/17/2020
4/19/2020,383,5525,2060,33022,38547,23,636,26,270,1,66,300,65,55,11,186,338,5207,1743,29025,34232,9/17/2020
4/20/2020,396,5921,1909,34931,40852,46,682,29,299,2,68,315,75,56,10,196,377,5584,1574,30599,36183,9/17/2020
4/21/2020,445,6366,2117,37048,43414,45,727,31,330,5,73,324,72,56,18,214,391,5975,1715,32314,38289,9/17/2020
4/22/2020,421,6787,2401,39449,46236,41,768,32,362,5,78,328,73,58,18,232,385,6360,1916,34230,40590,9/17/2020
4/23/2020,482,7269,2473,41922,49191,32,800,28,390,5,83,327,76,62,15,247,420,6780,1861,36091,42871,9/17/2020
4/24/2020,494,7763,3294,45216,52979,35,835,27,417,4,87,331,85,63,15,262,416,7196,2629,38720,45916,9/17/2020
4/25/2020,395,8158,2210,47426,55584,34,869,17,434,5,92,343,85,62,14,276,304,7500,1774,40494,47994,9/17/2020
4/26/2020,316,8474,2314,49740,58214,33,902,15,449,3,95,358,86,59,14,290,275,7775,1881,42375,50150,9/17/2020
4/27/2020,250,8724,1625,51365,60089,29,931,21,470,4,99,362,86,61,10,300,204,7979,1163,43538,51517,9/17/2020
4/28/2020,411,9135,2270,53635,62770,44,975,24,494,3,102,379,88,59,22,322,330,8309,1765,45303,53612,9/17/2020
4/29/2020,476,9611,3352,56987,66598,36,1011,38,532,11,113,366,78,53,18,340,373,8682,2426,47729,56411,9/17/2020
4/30/2020,432,10043,2775,59762,69805,33,1044,38,570,6,119,355,83,57,24,364,353,9035,1942,49671,58706,9/17/2020
5/1/2020,457,10500,3091,62853,73353,51,1095,39,609,3,122,364,84,58,14,378,320,9355,2201,51872,61227,9/17/2020
5/2/2020,260,10760,1930,64783,75543,36,1131,39,648,5,127,356,91,62,24,402,189,9544,1289,53161,62705,9/17/2020
5/3/2020,284,11044,2169,66952,77996,31,1162,27,675,8,135,352,90,61,21,423,182,9726,1598,54759,64485,9/17/2020
5/4/2020,388,11432,2103,69055,80487,30,1192,31,706,5,140,346,88,57,18,441,293,10019,1569,56328,66347,9/17/2020
5/5/2020,436,11868,2878,71933,83801,29,1221,32,738,6,146,337,82,54,16,457,308,10327,1966,58294,68621,9/17/2020
5/6/2020,490,12358,2838,74771,87129,28,1249,44,782,9,155,312,79,54,21,478,342,10669,1921,60215,70884,9/17/2020
5/7/2020,425,12783,2976,77747,90530,36,1285,42,824,5,160,301,71,52,21,499,274,10943,1970,62185,73128,9/17/2020
5/8/2020,360,13143,2605,80352,93495,30,1315,29,853,5,165,297,71,53,22,521,233,11176,1742,63927,75103,9/17/2020
5/9/2020,470,13613,3361,83713,97326,22,1337,21,874,4,169,294,69,51,15,536,291,11467,2264,66191,77658,9/17/2020
5/10/2020,285,13898,2124,85837,99735,20,1357,23,897,6,175,285,70,49,13,549,188,11655,1523,67714,79369,9/17/2020
5/11/2020,259,14157,1863,87700,101857,31,1388,16,913,6,181,294,71,49,15,564,178,11833,1304,69018,80851,9/17/2020
5/12/2020,387,14544,2623,90323,104867,23,1411,18,931,4,185,295,69,48,22,586,218,12051,1711,70729,82780,9/17/2020
5/13/2020,352,14896,3638,93961,108857,23,1434,25,956,1,186,292,69,49,13,599,199,12250,2009,72738,84988,9/17/2020
5/14/2020,330,15226,3421,97382,112608,19,1453,27,983,3,189,281,64,45,15,614,232,12482,2019,74757,87239,9/17/2020
5/15/2020,382,15608,3473,100855,116463,24,1477,41,1024,5,194,259,62,45,13,627,237,12719,1811,76568,89287,9/17/2020
5/16/2020,454,16062,4172,105027,121089,25,1502,13,1037,5,199,266,61,46,15,642,252,12971,1964,78532,91503,9/17/2020
5/17/2020,240,16302,2775,107802,124104,17,1519,8,1045,5,204,270,59,45,10,652,129,13100,1559,80091,93191,9/17/2020
5/18/2020,251,16553,2007,109809,126362,19,1538,15,1060,5,209,269,57,40,18,670,140,13240,1371,81462,94702,9/17/2020
5/19/2020,416,16969,3178,112987,129956,23,1561,32,1092,5,214,255,56,38,11,681,214,13454,1932,83394,96848,9/17/2020
5/20/2020,328,17297,2777,115764,133061,19,1580,23,1115,7,221,244,52,33,22,703,188,13642,1517,84911,98553,9/17/2020
5/21/2020,374,17671,3764,119528,137199,26,1606,15,1130,3,224,252,53,29,20,723,170,13812,1941,86852,100664,9/17/2020
5/22/2020,353,18024,3174,122702,140726,20,1626,29,1159,5,229,238,52,29,10,733,204,14016,1612,88464,102480,9/17/2020
5/23/2020,254,18278,2749,125451,143729,19,1645,11,1170,3,232,243,52,32,13,746,108,14124,1273,89737,103861,9/17/2020
5/24/2020,165,18443,1373,126824,145267,12,1657,14,1184,2,234,239,53,36,8,754,82,14206,773,90510,104716,9/17/2020
5/25/2020,151,18594,1389,128213,146807,13,1670,14,1198,0,234,238,53,34,10,764,72,14278,762,91272,105550,9/17/2020
5/26/2020,286,18880,2625,130838,149718,24,1694,22,1220,5,239,235,48,33,15,779,163,14441,1781,93053,107494,9/17/2020
5/27/2020,276,19156,2126,132964,152120,20,1714,18,1238,3,242,234,50,33,10,789,134,14575,1135,94188,108763,9/17/2020
5/28/2020,349,19505,3372,136336,155841,17,1731,29,1267,4,246,218,47,32,8,797,134,14709,1120,95308,110017,9/17/2020
5/29/2020,417,19922,3973,140309,160231,19,1750,27,1294,6,252,204,43,31,12,809,177,14886,1572,96880,111766,9/17/2020
5/30/2020,229,20151,3974,144283,164434,15,1765,19,1313,4,256,196,40,29,12,821,109,14995,1820,98700,113695,9/17/2020
5/31/2020,163,20314,1759,146042,166356,11,1776,10,1323,0,256,197,43,26,3,824,78,15073,857,99557,114630,9/17/2020
6/1/2020,215,20529,2824,148866,169395,8,1784,14,1337,1,257,190,44,29,5,829,99,15172,1386,100943,116115,9/17/2020
6/2/2020,273,20802,3077,151943,172745,8,1792,9,1346,3,260,186,37,25,10,839,107,15279,1451,102394,117673,9/17/2020
6/3/2020,260,21062,3516,155459,176521,14,1806,18,1364,6,266,176,34,25,11,850,105,15384,1665,104059,119443,9/17/2020
6/4/2020,281,21343,4542,160001,181344,7,1813,25,1389,3,269,155,31,24,11,861,111,15495,2041,106100,121595,9/17/2020
6/5/2020,216,21559,3596,163597,185156,15,1828,13,1402,6,275,151,27,21,11,872,106,15601,1578,107678,123279,9/17/2020
6/6/2020,203,21762,2630,166227,187989,10,1838,7,1409,2,277,152,29,19,6,878,69,15670,1136,108814,124484,9/17/2020
6/7/2020,84,21846,1632,167859,189705,11,1849,7,1416,1,278,155,25,17,4,882,50,15720,782,109596,125316,9/17/2020
6/8/2020,120,21966,1854,169713,191679,15,1864,12,1428,2,280,156,27,18,4,886,44,15764,962,110558,126322,9/17/2020
6/9/2020,223,22189,2685,172398,194587,10,1874,18,1446,0,280,148,28,21,1,887,67,15831,1260,111818,127649,9/17/2020
6/10/2020,211,22400,3005,175403,197803,13,1887,12,1458,2,282,147,24,17,4,891,105,15936,1468,113286,129222,9/17/2020
6/11/2020,195,22595,3578,178981,201576,7,1894,15,1473,1,283,138,25,16,6,897,88,16024,1537,114823,130847,9/17/2020
6/12/2020,209,22804,4618,183599,206403,9,1903,15,1488,1,284,131,24,16,2,899,82,16106,2187,117010,133116,9/17/2020
6/13/2020,114,22918,3048,186647,209565,6,1909,4,1492,0,284,133,20,15,3,902,50,16156,1373,118383,134539,9/17/2020
6/14/2020,83,23001,2053,188700,211701,7,1916,8,1500,1,285,131,20,14,3,905,33,16189,969,119352,135541,9/17/2020
6/15/2020,189,23190,3117,191817,215007,14,1930,14,1514,0,285,131,20,16,5,910,78,16267,1793,121145,137412,9/17/2020
6/16/2020,112,23302,3041,194858,218160,10,1940,9,1523,1,286,131,22,16,8,918,52,16319,1579,122724,139043,9/17/2020
6/17/2020,128,23430,2848,197706,221136,15,1955,20,1543,4,290,122,18,14,6,924,53,16372,1320,124044,140416,9/17/2020
6/18/2020,149,23579,3059,200765,224344,9,1964,13,1556,1,291,117,19,16,7,931,70,16442,1319,125363,141805,9/17/2020
6/19/2020,142,23721,3776,204541,228262,12,1976,11,1567,1,292,117,20,17,3,934,59,16501,1372,126735,143236,9/17/2020
6/20/2020,84,23805,1898,206439,230244,9,1985,12,1579,0,292,114,20,18,4,938,36,16537,814,127549,144086,9/17/2020
6/21/2020,37,23842,1071,207510,231352,8,1993,5,1584,0,292,117,20,18,2,940,28,16565,692,128241,144806,9/17/2020
6/22/2020,138,23980,3739,211249,235229,12,2005,16,1600,0,292,113,19,18,1,941,69,16634,1710,129951,146585,9/17/2020
6/23/2020,164,24144,3864,215113,239257,3,2008,13,1613,3,295,100,18,18,7,948,83,16717,1785,131736,148453,9/17/2020
6/24/2020,120,24264,3521,218634,242898,9,2017,10,1623,1,296,98,18,18,5,953,46,16763,1687,133423,150186,9/17/2020
6/25/2020,103,24367,2909,221543,245910,6,2023,14,1637,1,297,89,17,17,1,954,54,16817,1516,134939,151756,9/17/2020
6/26/2020,94,24461,2506,224049,248510,2,2025,10,1647,0,297,81,18,18,1,955,63,16880,1332,136271,153151,9/17/2020
6/27/2020,84,24545,3231,227280,251825,5,2030,3,1650,1,298,82,17,17,5,960,37,16917,1221,137492,154409,9/17/2020
6/28/2020,40,24585,1474,228754,253339,4,2034,4,1654,4,302,78,15,14,6,966,19,16936,596,138088,155024,9/17/2020
6/29/2020,85,24670,3706,232460,257130,4,2038,5,1659,0,302,77,14,14,1,967,39,16975,1355,139443,156418,9/17/2020
6/30/2020,59,24729,1966,234426,259155,1,2039,5,1664,1,303,72,12,11,4,971,33,17008,996,140439,157447,9/17/2020
7/1/2020,145,24874,4113,238539,263413,7,2046,9,1673,0,303,70,11,11,1,972,80,17088,1938,142377,159465,9/17/2020
7/2/2020,103,24977,2812,241351,266328,5,2051,5,1678,1,304,69,10,10,2,974,57,17145,1089,143466,160611,9/17/2020
7/3/2020,50,25027,2081,243432,268459,9,2060,6,1684,0,304,72,9,9,3,977,26,17171,779,144245,161416,9/17/2020
7/4/2020,58,25085,2353,245785,270870,2,2062,4,1688,1,305,69,10,9,2,979,34,17205,1011,145256,162461,9/17/2020
7/5/2020,51,25136,2939,248724,273860,1,2063,2,1690,1,306,67,8,8,2,981,26,17231,1448,146704,163935,9/17/2020
7/6/2020,102,25238,2821,251545,276783,6,2069,6,1696,0,306,67,9,9,4,985,58,17289,1553,148257,165546,9/17/2020
7/7/2020,82,25320,3470,255015,280335,5,2074,7,1703,0,306,65,8,8,2,987,48,17337,1536,149793,167130,9/17/2020
7/8/2020,105,25425,3417,258432,283857,4,2078,2,1705,0,306,67,9,8,0,987,65,17402,1426,151219,168621,9/17/2020
7/9/2020,96,25521,3730,262162,287683,9,2087,3,1708,0,306,73,9,8,0,987,51,17453,1631,152850,170303,9/17/2020
7/10/2020,131,25652,4454,266616,292268,6,2093,3,1711,2,308,74,7,7,3,990,80,17533,2083,154933,172466,9/17/2020
7/11/2020,64,25716,2944,269560,295276,6,2099,3,1714,1,309,76,6,6,3,993,34,17567,1319,156252,173819,9/17/2020
7/12/2020,47,25763,1846,271406,297169,1,2100,3,1717,1,310,73,6,5,3,996,34,17601,943,157195,174796,9/17/2020
7/13/2020,84,25847,3170,274576,300423,8,2108,10,1727,0,310,71,6,5,1,997,61,17662,1475,158670,176332,9/17/2020
7/14/2020,74,25921,3301,277877,303798,7,2115,4,1731,0,310,74,5,5,1,998,49,17711,1375,160045,177756,9/17/2020
7/15/2020,130,26051,4185,282062,308113,5,2120,7,1738,0,310,72,5,4,0,998,100,17811,1753,161798,179609,9/17/2020
7/16/2020,102,26153,3749,285811,311964,6,2126,9,1747,0,310,69,6,5,1,999,78,17889,1620,163418,181307,9/17/2020
7/17/2020,158,26311,4248,290059,316370,14,2140,3,1750,1,311,79,5,5,2,1001,81,17970,1850,165268,183238,9/17/2020
7/18/2020,85,26396,3277,293336,319732,5,2145,9,1759,1,312,74,5,4,4,1005,69,18039,1402,166670,184709,9/17/2020
7/19/2020,83,26479,2709,296045,322524,7,2152,3,1762,0,312,78,6,4,2,1007,59,18098,1151,167821,185919,9/17/2020
7/20/2020,71,26550,2668,298713,325263,9,2161,7,1769,0,312,80,7,5,2,1009,69,18167,1467,169288,187455,9/17/2020
7/21/2020,131,26681,4317,303030,329711,9,2170,11,1780,0,312,78,9,6,1,1010,109,18276,1924,171212,189488,9/17/2020
7/22/2020,130,26811,3939,306969,333780,11,2181,11,1791,1,313,77,7,6,1,1011,87,18363,1684,172896,191259,9/17/2020
7/23/2020,142,26953,4393,311362,338315,8,2189,6,1797,0,313,79,8,7,0,1011,116,18479,1972,174868,193347,9/17/2020
7/24/2020,175,27128,5979,317341,344469,14,2203,14,1811,0,313,79,9,7,0,1011,123,18602,2326,177194,195796,9/17/2020
7/25/2020,136,27264,4417,321758,349022,7,2210,7,1818,0,313,79,10,8,2,1013,107,18709,2101,179295,198004,9/17/2020
7/26/2020,63,27327,3046,324804,352131,8,2218,9,1827,0,313,78,11,7,1,1014,54,18763,1340,180635,199398,9/17/2020
7/27/2020,186,27513,4195,328999,356512,12,2230,7,1834,0,313,83,13,8,1,1015,141,18904,2334,182969,201873,9/17/2020
7/28/2020,105,27618,3866,332865,360483,5,2235,5,1839,0,313,83,14,7,1,1016,94,18998,1635,184604,203602,9/17/2020
7/29/2020,191,27809,5236,338101,365910,11,2246,12,1851,0,313,82,15,7,0,1016,157,19155,2325,186929,206084,9/17/2020
7/30/2020,121,27930,4358,342459,370389,6,2252,2,1853,1,314,85,15,6,1,1017,96,19251,1651,188580,207831,9/17/2020
7/31/2020,132,28062,5527,347986,376048,8,2260,10,1863,0,314,83,15,7,0,1017,90,19341,1859,190439,209780,9/17/2020
8/1/2020,109,28171,4320,352306,380477,7,2267,2,1865,0,314,88,14,7,1,1018,88,19429,1559,191998,211427,9/17/2020
8/2/2020,84,28255,2818,355124,383379,12,2279,12,1877,2,316,86,14,8,2,1020,62,19491,1276,193274,212765,9/17/2020
8/3/2020,187,28442,5218,360342,388784,13,2292,12,1889,0,316,87,16,7,1,1021,154,19645,2187,195461,215106,9/17/2020
8/4/2020,126,28568,3708,364050,392618,8,2300,6,1895,1,317,88,12,5,2,1023,99,19744,1775,197236,216980,9/17/2020
8/5/2020,151,28719,5948,369998,398717,12,2312,10,1905,1,318,89,10,5,2,1025,118,19862,2472,199708,219570,9/17/2020
8/6/2020,171,28890,5557,375555,404445,7,2319,9,1914,0,318,87,9,4,0,1025,122,19984,2428,202136,222120,9/17/2020
8/7/2020,122,29012,4858,380413,409425,13,2332,10,1924,1,319,89,9,3,2,1027,90,20074,2159,204295,224369,9/17/2020
8/8/2020,122,29134,4122,384535,413669,19,2351,6,1930,1,320,101,8,3,1,1028,96,20170,1781,206076,226246,9/17/2020
8/9/2020,43,29177,1736,386271,415448,8,2359,10,1940,0,320,99,9,4,0,1028,36,20206,1076,207152,227358,9/17/2020
8/10/2020,150,29327,4595,390866,420193,11,2370,12,1952,0,320,98,9,4,1,1029,112,20318,2030,209182,229500,9/17/2020
8/11/2020,105,29432,4354,395220,424652,6,2376,14,1966,0,320,90,10,4,3,1032,93,20411,2272,211454,231865,9/17/2020
8/12/2020,121,29553,5213,400433,429986,8,2384,11,1977,0,320,87,9,3,1,1033,103,20514,2631,214085,234599,9/17/2020
8/13/2020,135,29688,4225,404658,434346,13,2397,12,1989,0,320,88,11,3,0,1033,97,20611,1911,215996,236607,9/17/2020
8/14/2020,146,29834,5490,410148,439982,13,2410,11,2000,0,320,90,11,4,3,1036,101,20712,1955,217951,238663,9/17/2020
8/15/2020,105,29939,4545,414693,444632,8,2418,11,2011,1,321,86,11,5,0,1036,90,20802,1703,219654,240456,9/17/2020
8/16/2020,83,30022,2799,417492,447514,7,2425,6,2017,4,325,83,8,4,5,1041,71,20873,987,220641,241514,9/17/2020
8/17/2020,108,30130,4557,422049,452179,10,2435,7,2024,0,325,86,8,5,2,1043,87,20960,2387,223028,243988,9/17/2020
8/18/2020,130,30260,5058,427107,457367,11,2446,9,2033,1,326,87,8,4,5,1048,97,21057,2788,225816,246873,9/17/2020
8/19/2020,116,30376,5428,432535,462911,8,2454,9,2042,1,327,85,9,5,0,1048,90,21147,2685,228501,249648,9/17/2020
8/20/2020,174,30550,8287,440822,471372,12,2466,6,2048,2,329,89,10,5,3,1051,137,21284,3575,232076,253360,9/17/2020
8/21/2020,156,30706,6832,447654,478360,8,2474,5,2053,1,330,91,9,4,2,1053,125,21409,2980,235056,256465,9/17/2020
8/22/2020,96,30802,5982,453636,484438,10,2484,12,2065,0,330,89,11,4,1,1054,84,21493,2631,237687,259180,9/17/2020
8/23/2020,73,30875,4387,458023,488898,11,2495,5,2070,0,330,95,11,2,1,1055,57,21550,2478,240165,261715,9/17/2020
8/24/2020,105,30980,5787,463810,494790,7,2502,10,2080,1,331,91,13,4,1,1056,75,21625,3164,243329,264954,9/17/2020
8/25/2020,111,31091,4828,468638,499729,10,2512,4,2084,1,332,96,11,4,1,1057,94,21719,2313,245642,267361,9/17/2020
8/26/2020,171,31262,9634,478272,509534,4,2516,8,2092,0,332,92,9,5,1,1058,128,21847,3095,248737,270584,9/17/2020
8/27/2020,94,31356,8924,487196,518552,6,2522,14,2106,1,333,83,6,5,2,1060,71,21918,3274,252011,273929,9/17/2020
8/28/2020,113,31469,8132,495328,526797,14,2536,4,2110,0,333,93,9,7,2,1062,88,22006,2456,254467,276473,9/17/2020
8/29/2020,65,31534,5553,500881,532415,6,2542,8,2118,1,334,90,10,6,1,1063,53,22059,1925,256392,278451,9/17/2020
8/30/2020,68,31602,4339,505220,536822,7,2549,4,2122,0,334,93,8,5,1,1064,48,22107,2000,258392,280499,9/17/2020
8/31/2020,107,31709,4883,510103,541812,10,2559,15,2137,0,334,88,8,4,0,1064,82,22189,2194,260586,282775,9/17/2020
9/1/2020,99,31808,7333,517436,549244,6,2565,9,2146,1,335,84,7,4,1,1065,67,22256,2385,262971,285227,9/17/2020
9/2/2020,124,31932,10845,528281,560213,9,2574,10,2156,1,336,82,8,4,2,1067,102,22358,2969,265940,288298,9/17/2020
9/3/2020,90,32022,11370,539651,571673,8,2582,8,2164,0,336,82,9,4,1,1068,77,22435,2591,268531,290966,9/17/2020
9/4/2020,103,32125,9248,548899,581024,11,2593,4,2168,0,336,89,9,4,1,1069,83,22518,2410,270941,293459,9/17/2020
9/5/2020,52,32177,6683,555582,587759,6,2599,9,2177,0,336,86,8,3,1,1070,42,22560,1593,272534,295094,9/17/2020
9/6/2020,89,32266,4664,560246,592512,4,2603,8,2185,1,337,81,6,3,1,1071,66,22626,1957,274491,297117,9/17/2020
9/7/2020,35,32301,3007,563253,595554,11,2614,3,2188,0,337,89,5,3,1,1072,26,22652,649,275140,297792,9/17/2020
9/8/2020,77,32378,6384,569637,602015,6,2620,12,2200,1,338,82,6,3,2,1074,68,22720,1594,276734,299454,9/17/2020
9/9/2020,123,32501,8853,578490,610991,9,2629,5,2205,1,339,85,9,3,1,1075,98,22818,2156,278890,301708,9/17/2020
9/10/2020,171,32672,12421,590911,623583,8,2637,8,2213,0,339,85,10,3,0,1075,116,22934,2278,281168,304102,9/17/2020
9/11/2020,126,32798,9432,600343,633141,11,2648,11,2224,0,339,85,10,5,0,1075,97,23031,1846,283014,306045,9/17/2020
9/12/2020,109,32907,7450,607793,640700,7,2655,5,2229,2,341,85,9,5,3,1078,102,23133,1471,284485,307618,9/17/2020
9/13/2020,58,32965,2853,610646,643611,4,2659,3,2232,0,341,86,9,5,0,1078,54,23187,796,285281,308468,9/17/2020
9/14/2020,102,33067,6405,617051,650118,5,2664,3,2235,2,343,86,9,5,1,1079,91,23278,1587,286868,310146,9/17/2020
9/15/2020,138,33205,7509,624560,657765,4,2668,1,2236,1,344,88,9,5,2,1081,109,23387,1501,288369,311756,9/17/2020
9/16/2020,130,33335,8031,632591,665926,,,,,,,,,,4,1085,101,23488,1418,289787,313275,9/17/2020
2/27/2020,0,0,0,0,0,1,1,0,0,0,0,1,0,0,0,0,0,0,0,0,0,9/18/2020
2/28/2020,0,0,0,0,0,0,1,0,0,0,0,1,1,0,0,0,0,0,0,0,0,9/18/2020
2/29/2020,0,0,0,0,0,0,1,0,0,0,0,1,1,0,0,0,0,0,0,0,0,9/18/2020
3/1/2020,2,2,3,3,5,0,1,0,0,0,0,1,1,1,0,0,2,2,2,2,4,9/18/2020
3/2/2020,0,2,1,4,6,1,2,0,0,0,0,2,2,2,0,0,0,2,1,3,5,9/18/2020
3/3/2020,0,2,2,6,8,0,2,0,0,0,0,2,2,2,0,0,0,2,2,5,7,9/18/2020
3/4/2020,0,2,12,18,20,1,3,0,0,0,0,3,2,2,0,0,0,2,10,15,17,9/18/2020
3/5/2020,0,2,5,23,25,0,3,0,0,0,0,3,2,2,0,0,1,3,4,19,22,9/18/2020
3/6/2020,1,3,12,35,38,0,3,0,0,0,0,3,2,2,0,0,0,3,11,30,33,9/18/2020
3/7/2020,0,3,19,54,57,0,3,0,0,0,0,3,2,1,0,0,0,3,19,49,52,9/18/2020
3/8/2020,0,3,19,73,76,0,3,0,0,0,0,3,2,1,0,0,0,3,18,67,70,9/18/2020
3/9/2020,1,4,27,100,104,0,3,0,0,0,0,3,2,1,0,0,1,4,15,82,86,9/18/2020
3/10/2020,2,6,25,125,131,0,3,0,0,0,0,3,2,1,0,0,1,5,23,105,110,9/18/2020
3/11/2020,0,6,34,159,165,1,4,0,0,0,0,4,1,1,0,0,0,5,34,139,144,9/18/2020
3/12/2020,9,15,41,200,215,1,5,0,0,0,0,5,1,1,0,0,8,13,38,177,190,9/18/2020
3/13/2020,6,21,50,250,271,4,9,1,1,0,0,8,1,1,0,0,6,19,48,225,244,9/18/2020
3/14/2020,0,21,90,340,361,0,9,0,1,0,0,8,1,1,0,0,0,19,86,311,330,9/18/2020
3/15/2020,1,22,54,394,416,1,10,0,1,0,0,9,2,1,0,0,1,20,54,365,385,9/18/2020
3/16/2020,2,24,95,489,513,2,12,0,1,0,0,11,2,0,0,0,2,22,92,457,479,9/18/2020
3/17/2020,16,40,162,651,691,6,18,0,1,0,0,17,2,0,0,0,11,33,151,608,641,9/18/2020
3/18/2020,12,52,116,767,819,3,21,0,1,0,0,20,2,0,0,0,11,44,110,718,762,9/18/2020
3/19/2020,17,69,262,1029,1098,2,23,1,2,0,0,21,3,0,1,1,17,61,251,969,1030,9/18/2020
3/20/2020,14,83,197,1226,1309,5,28,0,2,0,0,26,4,0,0,1,13,74,191,1160,1234,9/18/2020
3/21/2020,21,104,126,1352,1456,3,31,2,4,0,0,27,5,0,0,1,14,88,123,1283,1371,9/18/2020
3/22/2020,30,134,282,1634,1768,2,33,0,4,0,0,29,5,0,0,1,25,113,262,1545,1658,9/18/2020
3/23/2020,15,149,169,1803,1952,15,48,1,5,0,0,43,9,3,0,1,16,129,165,1710,1839,9/18/2020
3/24/2020,20,169,243,2046,2215,7,55,0,5,0,0,50,10,4,0,1,19,148,238,1948,2096,9/18/2020
3/25/2020,26,195,184,2230,2425,5,60,1,6,0,0,54,11,3,0,1,28,176,172,2120,2296,9/18/2020
3/26/2020,35,230,181,2411,2641,10,70,5,11,0,0,59,14,5,0,1,41,217,176,2296,2513,9/18/2020
3/27/2020,27,257,215,2626,2883,9,79,1,12,1,1,66,17,6,2,3,31,248,202,2498,2746,9/18/2020
3/28/2020,59,316,260,2886,3202,13,92,3,15,2,3,74,15,6,1,4,63,311,241,2739,3050,9/18/2020
3/29/2020,106,422,356,3242,3664,8,100,4,19,1,4,77,18,8,2,6,105,416,314,3053,3469,9/18/2020
3/30/2020,62,484,222,3464,3948,20,120,5,24,0,4,92,20,11,3,9,78,494,184,3237,3731,9/18/2020
3/31/2020,71,555,369,3833,4388,11,131,7,31,1,5,95,22,13,2,11,73,567,297,3534,4101,9/18/2020
4/1/2020,99,654,699,4532,5186,18,149,7,38,0,5,106,30,15,1,12,102,669,642,4176,4845,9/18/2020
4/2/2020,52,706,478,5010,5716,22,171,6,44,2,7,120,36,21,4,16,62,731,436,4612,5343,9/18/2020
4/3/2020,108,814,776,5786,6600,23,194,7,51,0,7,136,43,25,3,19,100,831,712,5324,6155,9/18/2020
4/4/2020,143,957,660,6446,7403,22,216,4,55,5,12,149,41,30,9,28,137,968,619,5943,6911,9/18/2020
4/5/2020,187,1144,1156,7602,8746,20,236,9,64,1,13,159,44,36,2,30,182,1150,1069,7012,8162,9/18/2020
4/6/2020,218,1362,1707,9309,10671,26,262,7,71,0,13,178,48,40,7,37,206,1356,1555,8567,9923,9/18/2020
4/7/2020,285,1647,1632,10941,12588,20,282,3,74,2,15,193,50,42,5,42,261,1617,1484,10051,11668,9/18/2020
4/8/2020,291,1938,1724,12665,14603,19,301,7,81,6,21,199,50,38,10,52,273,1890,1564,11615,13505,9/18/2020
4/9/2020,284,2222,1521,14186,16408,32,333,9,90,4,25,218,53,40,7,59,280,2170,1355,12970,15140,9/18/2020
4/10/2020,420,2642,2578,16764,19406,29,362,17,107,5,30,225,59,41,11,70,403,2573,2372,15342,17915,9/18/2020
4/11/2020,299,2941,1912,18676,21617,29,391,11,118,2,32,241,61,48,12,82,280,2853,1720,17062,19915,9/18/2020
4/12/2020,315,3256,1677,20353,23609,35,426,13,131,5,37,258,59,49,9,91,289,3142,1438,18500,21642,9/18/2020
4/13/2020,162,3418,940,21293,24711,35,461,13,144,3,40,277,64,54,9,100,187,3329,838,19338,22667,9/18/2020
4/14/2020,290,3708,1805,23098,26806,27,488,17,161,5,45,282,72,53,8,108,265,3594,1528,20866,24460,9/18/2020
4/15/2020,353,4061,1805,24903,28964,31,519,20,181,3,48,290,72,54,17,125,307,3901,1559,22425,26326,9/18/2020
4/16/2020,449,4510,2503,27406,31916,36,555,25,206,6,54,295,72,53,14,139,390,4291,2080,24505,28796,9/18/2020
4/17/2020,309,4819,1826,29232,34051,32,587,20,226,7,61,300,66,45,21,160,293,4584,1449,25954,30538,9/18/2020
4/18/2020,323,5142,1730,30962,36104,26,613,18,244,4,65,304,63,49,15,175,286,4870,1328,27282,32152,9/18/2020
4/19/2020,383,5525,2060,33022,38547,23,636,26,270,1,66,300,65,55,11,186,338,5208,1743,29025,34233,9/18/2020
4/20/2020,396,5921,1909,34931,40852,46,682,29,299,2,68,315,75,56,10,196,377,5585,1574,30599,36184,9/18/2020
4/21/2020,445,6366,2117,37048,43414,45,727,31,330,5,73,324,72,56,18,214,391,5976,1715,32314,38290,9/18/2020
4/22/2020,421,6787,2401,39449,46236,41,768,32,362,5,78,328,73,58,18,232,384,6360,1916,34230,40590,9/18/2020
4/23/2020,482,7269,2473,41922,49191,32,800,28,390,5,83,327,76,62,15,247,420,6780,1861,36091,42871,9/18/2020
4/24/2020,494,7763,3294,45216,52979,35,835,27,417,4,87,331,85,63,15,262,416,7196,2629,38720,45916,9/18/2020
4/25/2020,395,8158,2210,47426,55584,34,869,17,434,5,92,343,85,62,14,276,304,7500,1774,40494,47994,9/18/2020
4/26/2020,316,8474,2314,49740,58214,33,902,15,449,3,95,358,86,59,14,290,275,7775,1881,42375,50150,9/18/2020
4/27/2020,250,8724,1625,51365,60089,29,931,21,470,4,99,362,86,61,10,300,204,7979,1163,43538,51517,9/18/2020
4/28/2020,411,9135,2270,53635,62770,44,975,24,494,3,102,379,88,59,22,322,330,8309,1765,45303,53612,9/18/2020
4/29/2020,476,9611,3352,56987,66598,36,1011,38,532,11,113,366,78,53,18,340,373,8682,2426,47729,56411,9/18/2020
4/30/2020,432,10043,2775,59762,69805,33,1044,38,570,6,119,355,83,57,24,364,353,9035,1942,49671,58706,9/18/2020
5/1/2020,457,10500,3091,62853,73353,51,1095,39,609,3,122,364,84,58,14,378,320,9355,2201,51872,61227,9/18/2020
5/2/2020,260,10760,1930,64783,75543,36,1131,39,648,5,127,356,91,62,24,402,189,9544,1289,53161,62705,9/18/2020
5/3/2020,284,11044,2169,66952,77996,31,1162,27,675,8,135,352,90,61,21,423,182,9726,1598,54759,64485,9/18/2020
5/4/2020,388,11432,2103,69055,80487,30,1192,31,706,5,140,346,88,57,18,441,293,10019,1569,56328,66347,9/18/2020
5/5/2020,436,11868,2878,71933,83801,29,1221,32,738,6,146,337,82,54,16,457,308,10327,1966,58294,68621,9/18/2020
5/6/2020,490,12358,2838,74771,87129,28,1249,44,782,9,155,312,79,54,21,478,342,10669,1921,60215,70884,9/18/2020
5/7/2020,425,12783,2976,77747,90530,36,1285,42,824,5,160,301,71,52,21,499,274,10943,1970,62185,73128,9/18/2020
5/8/2020,360,13143,2605,80352,93495,30,1315,29,853,5,165,297,71,53,22,521,233,11176,1742,63927,75103,9/18/2020
5/9/2020,470,13613,3361,83713,97326,22,1337,21,874,4,169,294,69,51,15,536,291,11467,2264,66191,77658,9/18/2020
5/10/2020,285,13898,2124,85837,99735,20,1357,23,897,6,175,285,70,49,13,549,188,11655,1523,67714,79369,9/18/2020
5/11/2020,259,14157,1863,87700,101857,31,1388,16,913,6,181,294,71,49,15,564,178,11833,1304,69018,80851,9/18/2020
5/12/2020,387,14544,2623,90323,104867,23,1411,18,931,4,185,295,69,48,22,586,218,12051,1711,70729,82780,9/18/2020
5/13/2020,352,14896,3638,93961,108857,23,1434,25,956,1,186,292,69,49,13,599,199,12250,2009,72738,84988,9/18/2020
5/14/2020,330,15226,3421,97382,112608,19,1453,27,983,3,189,281,64,45,15,614,232,12482,2019,74757,87239,9/18/2020
5/15/2020,382,15608,3473,100855,116463,24,1477,41,1024,5,194,259,62,45,14,628,237,12719,1811,76568,89287,9/18/2020
5/16/2020,454,16062,4172,105027,121089,25,1502,13,1037,5,199,266,61,46,15,643,252,12971,1964,78532,91503,9/18/2020
5/17/2020,240,16302,2775,107802,124104,17,1519,8,1045,5,204,270,59,45,10,653,129,13100,1559,80091,93191,9/18/2020
5/18/2020,251,16553,2007,109809,126362,19,1538,15,1060,5,209,269,57,40,18,671,140,13240,1371,81462,94702,9/18/2020
5/19/2020,416,16969,3178,112987,129956,23,1561,32,1092,5,214,255,56,38,11,682,214,13454,1932,83394,96848,9/18/2020
5/20/2020,328,17297,2777,115764,133061,19,1580,23,1115,7,221,244,52,33,22,704,188,13642,1517,84911,98553,9/18/2020
5/21/2020,374,17671,3764,119528,137199,26,1606,15,1130,3,224,252,53,29,20,724,170,13812,1941,86852,100664,9/18/2020
5/22/2020,353,18024,3174,122702,140726,20,1626,29,1159,5,229,238,52,29,10,734,204,14016,1612,88464,102480,9/18/2020
5/23/2020,254,18278,2749,125451,143729,19,1645,11,1170,3,232,243,52,32,13,747,108,14124,1273,89737,103861,9/18/2020
5/24/2020,165,18443,1373,126824,145267,12,1657,14,1184,2,234,239,53,36,8,755,82,14206,773,90510,104716,9/18/2020
5/25/2020,151,18594,1389,128213,146807,13,1670,14,1198,0,234,238,53,34,10,765,72,14278,762,91272,105550,9/18/2020
5/26/2020,286,18880,2625,130838,149718,24,1694,22,1220,5,239,235,48,33,15,780,163,14441,1781,93053,107494,9/18/2020
5/27/2020,276,19156,2126,132964,152120,20,1714,18,1238,3,242,234,50,33,10,790,134,14575,1135,94188,108763,9/18/2020
5/28/2020,349,19505,3372,136336,155841,17,1731,29,1267,4,246,218,47,32,8,798,134,14709,1120,95308,110017,9/18/2020
5/29/2020,417,19922,3973,140309,160231,19,1750,27,1294,6,252,204,43,31,12,810,177,14886,1572,96880,111766,9/18/2020
5/30/2020,229,20151,3974,144283,164434,15,1765,19,1313,4,256,196,40,29,12,822,109,14995,1820,98700,113695,9/18/2020
5/31/2020,163,20314,1759,146042,166356,11,1776,10,1323,0,256,197,43,26,3,825,78,15073,857,99557,114630,9/18/2020
6/1/2020,215,20529,2824,148866,169395,8,1784,14,1337,1,257,190,44,29,5,830,99,15172,1386,100943,116115,9/18/2020
6/2/2020,273,20802,3077,151943,172745,8,1792,9,1346,3,260,186,37,25,10,840,107,15279,1451,102394,117673,9/18/2020
6/3/2020,260,21062,3516,155459,176521,14,1806,18,1364,6,266,176,34,25,11,851,105,15384,1665,104059,119443,9/18/2020
6/4/2020,281,21343,4542,160001,181344,7,1813,25,1389,3,269,155,31,24,11,862,111,15495,2041,106100,121595,9/18/2020
6/5/2020,216,21559,3596,163597,185156,15,1828,13,1402,6,275,151,27,21,11,873,106,15601,1578,107678,123279,9/18/2020
6/6/2020,203,21762,2630,166227,187989,10,1838,7,1409,2,277,152,29,19,6,879,69,15670,1136,108814,124484,9/18/2020
6/7/2020,84,21846,1632,167859,189705,11,1849,7,1416,1,278,155,25,17,4,883,50,15720,782,109596,125316,9/18/2020
6/8/2020,120,21966,1854,169713,191679,15,1864,12,1428,2,280,156,27,18,4,887,44,15764,962,110558,126322,9/18/2020
6/9/2020,223,22189,2685,172398,194587,10,1874,18,1446,0,280,148,28,21,1,888,67,15831,1260,111818,127649,9/18/2020
6/10/2020,211,22400,3005,175403,197803,13,1887,12,1458,2,282,147,24,17,4,892,105,15936,1468,113286,129222,9/18/2020
6/11/2020,195,22595,3578,178981,201576,7,1894,15,1473,1,283,138,25,16,6,898,88,16024,1537,114823,130847,9/18/2020
6/12/2020,209,22804,4618,183599,206403,9,1903,15,1488,1,284,131,24,16,2,900,82,16106,2187,117010,133116,9/18/2020
6/13/2020,114,22918,3048,186647,209565,6,1909,4,1492,0,284,133,20,15,3,903,50,16156,1373,118383,134539,9/18/2020
6/14/2020,83,23001,2053,188700,211701,7,1916,8,1500,1,285,131,20,14,3,906,33,16189,969,119352,135541,9/18/2020
6/15/2020,189,23190,3117,191817,215007,14,1930,14,1514,0,285,131,20,16,5,911,78,16267,1793,121145,137412,9/18/2020
6/16/2020,112,23302,3041,194858,218160,10,1940,9,1523,1,286,131,22,16,8,919,52,16319,1579,122724,139043,9/18/2020
6/17/2020,128,23430,2848,197706,221136,15,1955,20,1543,4,290,122,18,14,6,925,53,16372,1320,124044,140416,9/18/2020
6/18/2020,149,23579,3059,200765,224344,9,1964,13,1556,1,291,117,19,16,7,932,70,16442,1319,125363,141805,9/18/2020
6/19/2020,142,23721,3776,204541,228262,12,1976,11,1567,1,292,117,20,17,3,935,59,16501,1372,126735,143236,9/18/2020
6/20/2020,84,23805,1898,206439,230244,9,1985,12,1579,0,292,114,20,18,4,939,36,16537,814,127549,144086,9/18/2020
6/21/2020,37,23842,1071,207510,231352,8,1993,5,1584,0,292,117,20,18,2,941,28,16565,692,128241,144806,9/18/2020
6/22/2020,138,23980,3739,211249,235229,12,2005,16,1600,0,292,113,19,18,1,942,69,16634,1710,129951,146585,9/18/2020
6/23/2020,164,24144,3864,215113,239257,3,2008,13,1613,3,295,100,18,18,7,949,83,16717,1785,131736,148453,9/18/2020
6/24/2020,120,24264,3521,218634,242898,9,2017,10,1623,1,296,98,18,18,5,954,46,16763,1687,133423,150186,9/18/2020
6/25/2020,103,24367,2909,221543,245910,6,2023,14,1637,1,297,89,17,17,1,955,54,16817,1516,134939,151756,9/18/2020
6/26/2020,94,24461,2506,224049,248510,2,2025,10,1647,0,297,81,18,18,1,956,63,16880,1332,136271,153151,9/18/2020
6/27/2020,84,24545,3231,227280,251825,5,2030,3,1650,1,298,82,17,17,5,961,37,16917,1221,137492,154409,9/18/2020
6/28/2020,40,24585,1474,228754,253339,4,2034,4,1654,4,302,78,15,14,6,967,19,16936,596,138088,155024,9/18/2020
6/29/2020,85,24670,3706,232460,257130,4,2038,5,1659,0,302,77,14,14,1,968,39,16975,1355,139443,156418,9/18/2020
6/30/2020,59,24729,1966,234426,259155,1,2039,5,1664,1,303,72,12,11,4,972,33,17008,996,140439,157447,9/18/2020
7/1/2020,145,24874,4113,238539,263413,7,2046,9,1673,0,303,70,11,11,1,973,80,17088,1937,142376,159464,9/18/2020
7/2/2020,103,24977,2812,241351,266328,5,2051,5,1678,1,304,69,10,10,2,975,57,17145,1089,143465,160610,9/18/2020
7/3/2020,50,25027,2081,243432,268459,9,2060,6,1684,0,304,72,9,9,3,978,26,17171,779,144244,161415,9/18/2020
7/4/2020,58,25085,2353,245785,270870,2,2062,4,1688,1,305,69,10,9,2,980,34,17205,1011,145255,162460,9/18/2020
7/5/2020,51,25136,2939,248724,273860,1,2063,2,1690,1,306,67,8,8,2,982,26,17231,1447,146702,163933,9/18/2020
7/6/2020,102,25238,2821,251545,276783,6,2069,6,1696,0,306,67,9,9,4,986,58,17289,1553,148255,165544,9/18/2020
7/7/2020,82,25320,3470,255015,280335,5,2074,7,1703,0,306,65,8,8,2,988,48,17337,1536,149791,167128,9/18/2020
7/8/2020,105,25425,3417,258432,283857,4,2078,2,1705,0,306,67,9,8,0,988,65,17402,1426,151217,168619,9/18/2020
7/9/2020,96,25521,3730,262162,287683,9,2087,3,1708,0,306,73,9,8,0,988,51,17453,1631,152848,170301,9/18/2020
7/10/2020,131,25652,4454,266616,292268,6,2093,3,1711,2,308,74,7,7,3,991,80,17533,2082,154930,172463,9/18/2020
7/11/2020,64,25716,2944,269560,295276,6,2099,3,1714,1,309,76,6,6,3,994,34,17567,1319,156249,173816,9/18/2020
7/12/2020,47,25763,1846,271406,297169,1,2100,3,1717,1,310,73,6,5,3,997,34,17601,943,157192,174793,9/18/2020
7/13/2020,84,25847,3170,274576,300423,8,2108,10,1727,0,310,71,6,5,1,998,61,17662,1474,158666,176328,9/18/2020
7/14/2020,74,25921,3301,277877,303798,7,2115,4,1731,0,310,74,5,5,1,999,49,17711,1375,160041,177752,9/18/2020
7/15/2020,130,26051,4185,282062,308113,5,2120,7,1738,0,310,72,5,4,0,999,100,17811,1750,161791,179602,9/18/2020
7/16/2020,102,26153,3749,285811,311964,6,2126,9,1747,0,310,69,6,5,1,1000,78,17889,1620,163411,181300,9/18/2020
7/17/2020,158,26311,4248,290059,316370,14,2140,3,1750,1,311,79,5,5,2,1002,81,17970,1850,165261,183231,9/18/2020
7/18/2020,85,26396,3277,293336,319732,5,2145,9,1759,1,312,74,5,4,4,1006,69,18039,1402,166663,184702,9/18/2020
7/19/2020,83,26479,2709,296045,322524,7,2152,3,1762,0,312,78,6,4,2,1008,59,18098,1150,167813,185911,9/18/2020
7/20/2020,71,26550,2668,298713,325263,9,2161,7,1769,0,312,80,7,5,2,1010,69,18167,1467,169280,187447,9/18/2020
7/21/2020,131,26681,4317,303030,329711,9,2170,11,1780,0,312,78,9,6,1,1011,109,18276,1923,171203,189479,9/18/2020
7/22/2020,130,26811,3939,306969,333780,11,2181,11,1791,1,313,77,7,6,1,1012,87,18363,1684,172887,191250,9/18/2020
7/23/2020,142,26953,4393,311362,338315,8,2189,6,1797,0,313,79,8,7,0,1012,116,18479,1970,174857,193336,9/18/2020
7/24/2020,175,27128,5979,317341,344469,14,2203,14,1811,0,313,79,9,7,0,1012,123,18602,2326,177183,195785,9/18/2020
7/25/2020,136,27264,4417,321758,349022,7,2210,7,1818,0,313,79,10,8,2,1014,107,18709,2101,179284,197993,9/18/2020
7/26/2020,63,27327,3046,324804,352131,8,2218,9,1827,0,313,78,11,7,1,1015,54,18763,1340,180624,199387,9/18/2020
7/27/2020,186,27513,4195,328999,356512,12,2230,7,1834,0,313,83,13,8,1,1016,141,18904,2334,182958,201862,9/18/2020
7/28/2020,105,27618,3866,332865,360483,5,2235,5,1839,0,313,83,14,7,1,1017,94,18998,1635,184593,203591,9/18/2020
7/29/2020,191,27809,5236,338101,365910,11,2246,12,1851,0,313,82,15,7,0,1017,157,19155,2324,186917,206072,9/18/2020
7/30/2020,121,27930,4358,342459,370389,6,2252,2,1853,1,314,85,15,6,1,1018,96,19251,1651,188568,207819,9/18/2020
7/31/2020,132,28062,5527,347986,376048,8,2260,10,1863,0,314,83,15,7,1,1019,90,19341,1859,190427,209768,9/18/2020
8/1/2020,109,28171,4320,352306,380477,7,2267,2,1865,0,314,88,14,7,1,1020,88,19429,1559,191986,211415,9/18/2020
8/2/2020,84,28255,2818,355124,383379,12,2279,12,1877,2,316,86,14,8,2,1022,62,19491,1276,193262,212753,9/18/2020
8/3/2020,187,28442,5218,360342,388784,13,2292,12,1889,0,316,87,16,7,1,1023,154,19645,2187,195449,215094,9/18/2020
8/4/2020,126,28568,3708,364050,392618,8,2300,6,1895,1,317,88,12,5,2,1025,99,19744,1775,197224,216968,9/18/2020
8/5/2020,151,28719,5948,369998,398717,12,2312,10,1905,1,318,89,10,5,2,1027,118,19862,2472,199696,219558,9/18/2020
8/6/2020,171,28890,5557,375555,404445,7,2319,9,1914,0,318,87,9,4,0,1027,122,19984,2428,202124,222108,9/18/2020
8/7/2020,122,29012,4858,380413,409425,13,2332,10,1924,1,319,89,9,3,2,1029,90,20074,2158,204282,224356,9/18/2020
8/8/2020,122,29134,4122,384535,413669,19,2351,6,1930,1,320,101,8,3,1,1030,95,20169,1781,206063,226232,9/18/2020
8/9/2020,43,29177,1736,386271,415448,8,2359,10,1940,0,320,99,9,4,0,1030,36,20205,1076,207139,227344,9/18/2020
8/10/2020,150,29327,4595,390866,420193,11,2370,12,1952,0,320,98,9,4,1,1031,112,20317,2030,209169,229486,9/18/2020
8/11/2020,105,29432,4354,395220,424652,6,2376,14,1966,0,320,90,10,4,3,1034,93,20410,2272,211441,231851,9/18/2020
8/12/2020,121,29553,5213,400433,429986,8,2384,11,1977,0,320,87,9,3,1,1035,103,20513,2631,214072,234585,9/18/2020
8/13/2020,135,29688,4225,404658,434346,13,2397,12,1989,0,320,88,11,3,0,1035,97,20610,1911,215983,236593,9/18/2020
8/14/2020,146,29834,5490,410148,439982,13,2410,11,2000,0,320,90,11,4,3,1038,101,20711,1955,217938,238649,9/18/2020
8/15/2020,105,29939,4545,414693,444632,8,2418,11,2011,1,321,86,11,5,0,1038,89,20800,1703,219641,240441,9/18/2020
8/16/2020,83,30022,2799,417492,447514,7,2425,6,2017,4,325,83,8,4,6,1044,71,20871,985,220626,241497,9/18/2020
8/17/2020,108,30130,4557,422049,452179,10,2435,7,2024,0,325,86,8,5,2,1046,87,20958,2387,223013,243971,9/18/2020
8/18/2020,130,30260,5058,427107,457367,11,2446,9,2033,1,326,87,8,4,5,1051,97,21055,2787,225800,246855,9/18/2020
8/19/2020,116,30376,5428,432535,462911,8,2454,9,2042,1,327,85,9,5,0,1051,90,21145,2682,228482,249627,9/18/2020
8/20/2020,174,30550,8287,440822,471372,12,2466,6,2048,2,329,89,10,5,3,1054,137,21282,3571,232053,253335,9/18/2020
8/21/2020,156,30706,6832,447654,478360,8,2474,5,2053,1,330,91,9,4,2,1056,125,21407,2978,235031,256438,9/18/2020
8/22/2020,96,30802,5982,453636,484438,10,2484,12,2065,0,330,89,11,4,1,1057,84,21491,2629,237660,259151,9/18/2020
8/23/2020,73,30875,4387,458023,488898,11,2495,5,2070,0,330,95,11,2,1,1058,57,21548,2474,240134,261682,9/18/2020
8/24/2020,105,30980,5787,463810,494790,7,2502,10,2080,1,331,91,13,4,1,1059,75,21623,3163,243297,264920,9/18/2020
8/25/2020,111,31091,4828,468638,499729,10,2512,4,2084,1,332,96,11,4,1,1060,94,21717,2300,245597,267314,9/18/2020
8/26/2020,171,31262,9634,478272,509534,4,2516,8,2092,0,332,92,9,5,1,1061,128,21845,3081,248678,270523,9/18/2020
8/27/2020,94,31356,8924,487196,518552,6,2522,14,2106,1,333,83,6,5,2,1063,71,21916,3220,251898,273814,9/18/2020
8/28/2020,113,31469,8132,495328,526797,14,2536,4,2110,0,333,93,9,7,2,1065,88,22004,2441,254339,276343,9/18/2020
8/29/2020,65,31534,5553,500881,532415,6,2542,8,2118,1,334,90,10,6,1,1066,53,22057,1908,256247,278304,9/18/2020
8/30/2020,68,31602,4339,505220,536822,7,2549,4,2122,0,334,93,8,5,1,1067,48,22105,2000,258247,280352,9/18/2020
8/31/2020,107,31709,4883,510103,541812,10,2559,15,2137,0,334,88,8,4,0,1067,82,22187,2197,260444,282631,9/18/2020
9/1/2020,99,31808,7333,517436,549244,6,2565,9,2146,1,335,84,7,4,1,1068,67,22254,2378,262822,285076,9/18/2020
9/2/2020,124,31932,10845,528281,560213,9,2574,10,2156,1,336,82,8,4,2,1070,102,22356,2955,265777,288133,9/18/2020
9/3/2020,90,32022,11370,539651,571673,8,2582,8,2164,0,336,82,9,4,1,1071,76,22432,2585,268362,290794,9/18/2020
9/4/2020,103,32125,9248,548899,581024,11,2593,4,2168,0,336,89,9,4,1,1072,82,22514,2406,270768,293282,9/18/2020
9/5/2020,52,32177,6683,555582,587759,6,2599,9,2177,0,336,86,8,3,1,1073,42,22556,1591,272359,294915,9/18/2020
9/6/2020,89,32266,4664,560246,592512,4,2603,8,2185,1,337,81,6,3,1,1074,66,22622,1957,274316,296938,9/18/2020
9/7/2020,35,32301,3007,563253,595554,11,2614,3,2188,0,337,89,5,3,1,1075,26,22648,649,274965,297613,9/18/2020
9/8/2020,77,32378,6384,569637,602015,6,2620,12,2200,1,338,82,6,3,2,1077,67,22715,1594,276559,299274,9/18/2020
9/9/2020,123,32501,8853,578490,610991,9,2629,5,2205,1,339,85,9,3,1,1078,98,22813,2146,278705,301518,9/18/2020
9/10/2020,171,32672,12421,590911,623583,8,2637,8,2213,0,339,85,10,3,0,1078,115,22928,2270,280975,303903,9/18/2020
9/11/2020,126,32798,9432,600343,633141,11,2648,11,2224,0,339,85,10,5,0,1078,98,23026,1840,282815,305841,9/18/2020
9/12/2020,109,32907,7450,607793,640700,7,2655,5,2229,2,341,85,9,5,3,1081,101,23127,1451,284266,307393,9/18/2020
9/13/2020,58,32965,2853,610646,643611,4,2659,3,2232,0,341,86,9,5,0,1081,54,23181,796,285062,308243,9/18/2020
9/14/2020,102,33067,6405,617051,650118,5,2664,3,2235,2,343,86,9,5,1,1082,92,23273,1604,286666,309939,9/18/2020
9/15/2020,138,33205,7509,624560,657765,5,2669,2,2237,1,344,88,9,5,2,1084,115,23388,1956,288622,312010,9/18/2020
9/16/2020,148,33353,8708,633268,666621,6,2675,7,2244,2,346,85,7,6,4,1088,108,23496,1662,290284,313780,9/18/2020
9/17/2020,123,33476,8364,641632,675108,,,,,,,,,,0,1088,124,23620,1651,291935,315555,9/18/2020
2/27/2020,0,0,0,0,0,1,1,0,0,0,0,1,0,0,0,0,0,0,0,0,0,9/21/2020
2/28/2020,0,0,0,0,0,0,1,0,0,0,0,1,1,0,0,0,0,0,0,0,0,9/21/2020
2/29/2020,0,0,0,0,0,0,1,0,0,0,0,1,1,0,0,0,0,0,0,0,0,9/21/2020
3/1/2020,2,2,2,2,4,0,1,0,0,0,0,1,1,1,0,0,2,2,2,2,4,9/21/2020
3/2/2020,0,2,1,3,5,1,2,0,0,0,0,2,2,2,0,0,0,2,1,3,5,9/21/2020
3/3/2020,0,2,2,5,7,0,2,0,0,0,0,2,2,2,0,0,0,2,2,5,7,9/21/2020
3/4/2020,0,2,12,17,19,1,3,0,0,0,0,3,2,2,0,0,0,2,10,15,17,9/21/2020
3/5/2020,0,2,4,21,23,0,3,0,0,0,0,3,2,2,0,0,1,3,4,19,22,9/21/2020
3/6/2020,1,3,12,33,36,0,3,0,0,0,0,3,2,2,0,0,0,3,11,30,33,9/21/2020
3/7/2020,0,3,19,52,55,0,3,0,0,0,0,3,2,1,0,0,0,3,19,49,52,9/21/2020
3/8/2020,0,3,18,70,73,0,3,0,0,0,0,3,2,1,0,0,0,3,18,67,70,9/21/2020
3/9/2020,1,4,15,85,89,0,3,0,0,0,0,3,2,1,0,0,1,4,15,82,86,9/21/2020
3/10/2020,2,6,25,110,116,0,3,0,0,0,0,3,2,1,0,0,1,5,23,105,110,9/21/2020
3/11/2020,0,6,34,144,150,1,4,0,0,0,0,4,1,1,0,0,0,5,34,139,144,9/21/2020
3/12/2020,9,15,41,185,200,1,5,0,0,0,0,5,1,1,0,0,8,13,38,177,190,9/21/2020
3/13/2020,6,21,50,235,256,4,9,1,1,0,0,8,1,1,0,0,6,19,48,225,244,9/21/2020
3/14/2020,0,21,90,325,346,0,9,0,1,0,0,8,1,1,0,0,0,19,86,311,330,9/21/2020
3/15/2020,1,22,54,379,401,1,10,0,1,0,0,9,2,1,0,0,1,20,54,365,385,9/21/2020
3/16/2020,2,24,95,474,498,2,12,0,1,0,0,11,2,0,0,0,2,22,92,457,479,9/21/2020
3/17/2020,12,36,162,636,672,6,18,0,1,0,0,17,2,0,0,0,11,33,151,608,641,9/21/2020
3/18/2020,9,45,116,752,797,3,21,0,1,0,0,20,2,0,0,0,11,44,110,718,762,9/21/2020
3/19/2020,15,60,262,1014,1074,2,23,1,2,0,0,21,3,0,1,1,17,61,251,969,1030,9/21/2020
3/20/2020,13,73,197,1211,1284,5,28,0,2,0,0,26,4,0,0,1,13,74,191,1160,1234,9/21/2020
3/21/2020,12,85,126,1337,1422,3,31,2,4,0,0,27,5,0,0,1,14,88,123,1283,1371,9/21/2020
3/22/2020,27,112,282,1619,1731,2,33,0,4,0,0,29,5,0,0,1,25,113,262,1545,1658,9/21/2020
3/23/2020,14,126,169,1788,1914,15,48,1,5,0,0,43,9,3,0,1,16,129,165,1710,1839,9/21/2020
3/24/2020,20,146,242,2030,2176,7,55,0,5,0,0,50,10,4,0,1,19,148,238,1948,2096,9/21/2020
3/25/2020,26,172,182,2212,2384,5,60,1,6,0,0,54,11,3,0,1,28,176,172,2120,2296,9/21/2020
3/26/2020,35,207,181,2393,2600,10,70,5,11,0,0,59,14,5,0,1,41,217,176,2296,2513,9/21/2020
3/27/2020,27,234,214,2607,2841,9,79,1,12,1,1,66,17,6,2,3,31,248,202,2498,2746,9/21/2020
3/28/2020,59,293,260,2867,3160,13,92,3,15,2,3,74,15,6,1,4,63,311,241,2739,3050,9/21/2020
3/29/2020,100,393,350,3217,3610,8,100,4,19,1,4,77,18,8,2,6,105,416,314,3053,3469,9/21/2020
3/30/2020,62,455,222,3439,3894,20,120,5,24,0,4,92,20,11,3,9,78,494,184,3237,3731,9/21/2020
3/31/2020,71,526,369,3808,4334,11,131,7,31,1,5,95,22,13,2,11,73,567,297,3534,4101,9/21/2020
4/1/2020,99,625,698,4506,5131,18,149,7,38,0,5,106,30,15,1,12,102,669,641,4175,4844,9/21/2020
4/2/2020,52,677,477,4983,5660,22,171,6,44,2,7,120,36,21,4,16,62,731,436,4611,5342,9/21/2020
4/3/2020,108,785,774,5757,6542,23,194,7,51,0,7,136,43,25,3,19,100,831,712,5323,6154,9/21/2020
4/4/2020,143,928,660,6417,7345,22,216,4,55,5,12,149,41,30,9,28,137,968,618,5941,6909,9/21/2020
4/5/2020,187,1115,1156,7573,8688,20,236,9,64,1,13,159,44,36,2,30,182,1150,1069,7010,8160,9/21/2020
4/6/2020,218,1333,1706,9279,10612,26,262,7,71,0,13,178,48,40,7,37,206,1356,1555,8565,9921,9/21/2020
4/7/2020,284,1617,1629,10908,12525,20,282,4,75,2,15,192,50,42,5,42,261,1617,1482,10047,11664,9/21/2020
4/8/2020,290,1907,1720,12628,14535,19,301,7,82,6,21,198,50,38,10,52,273,1890,1561,11608,13498,9/21/2020
4/9/2020,283,2190,1516,14144,16334,32,333,9,91,4,25,217,53,40,7,59,280,2170,1355,12963,15133,9/21/2020
4/10/2020,419,2609,2574,16718,19327,29,362,16,107,5,30,225,59,41,11,70,403,2573,2371,15334,17907,9/21/2020
4/11/2020,297,2906,1905,18623,21529,29,391,11,118,2,32,241,61,48,12,82,280,2853,1720,17054,19907,9/21/2020
4/12/2020,314,3220,1670,20293,23513,35,426,13,131,5,37,258,59,49,9,91,289,3142,1436,18490,21632,9/21/2020
4/13/2020,161,3381,935,21228,24609,35,461,13,144,3,40,277,64,54,9,100,187,3329,838,19328,22657,9/21/2020
4/14/2020,289,3670,1787,23015,26685,27,488,17,161,5,45,282,72,53,8,108,265,3594,1528,20856,24450,9/21/2020
4/15/2020,351,4021,1799,24814,28835,31,519,20,181,3,48,290,72,54,17,125,307,3901,1558,22414,26315,9/21/2020
4/16/2020,447,4468,2494,27308,31776,36,555,25,206,6,54,295,72,53,14,139,390,4291,2078,24492,28783,9/21/2020
4/17/2020,304,4772,1821,29129,33901,32,587,20,226,7,61,300,66,45,21,160,293,4584,1448,25940,30524,9/21/2020
4/18/2020,321,5093,1725,30854,35947,26,613,18,244,4,65,304,63,49,15,175,286,4870,1325,27265,32135,9/21/2020
4/19/2020,381,5474,2047,32901,38375,23,636,26,270,1,66,300,65,55,11,186,338,5208,1742,29007,34215,9/21/2020
4/20/2020,394,5868,1907,34808,40676,46,682,29,299,2,68,315,75,56,10,196,377,5585,1574,30581,36166,9/21/2020
4/21/2020,444,6312,2110,36918,43230,45,727,31,330,5,73,324,72,56,18,214,391,5976,1710,32291,38267,9/21/2020
4/22/2020,418,6730,2390,39308,46038,41,768,32,362,5,78,328,73,58,18,232,384,6360,1915,34206,40566,9/21/2020
4/23/2020,479,7209,2469,41777,48986,32,800,28,390,5,83,327,76,62,15,247,420,6780,1861,36067,42847,9/21/2020
4/24/2020,491,7700,3284,45061,52761,35,835,27,417,4,87,331,85,63,15,262,416,7196,2629,38696,45892,9/21/2020
4/25/2020,393,8093,2206,47267,55360,34,869,17,434,5,92,343,85,62,14,276,304,7500,1772,40468,47968,9/21/2020
4/26/2020,316,8409,2309,49576,57985,33,902,15,449,3,95,358,86,59,14,290,275,7775,1878,42346,50121,9/21/2020
4/27/2020,249,8658,1620,51196,59854,29,931,21,470,4,99,362,86,61,10,300,204,7979,1163,43509,51488,9/21/2020
4/28/2020,410,9068,2263,53459,62527,44,975,24,494,3,102,379,88,59,22,322,330,8309,1763,45272,53581,9/21/2020
4/29/2020,476,9544,3343,56802,66346,36,1011,38,532,11,113,366,78,53,18,340,373,8682,2425,47697,56379,9/21/2020
4/30/2020,432,9976,2769,59571,69547,33,1044,38,570,6,119,355,83,57,24,364,353,9035,1937,49634,58669,9/21/2020
5/1/2020,454,10430,3086,62657,73087,51,1095,39,609,3,122,364,84,58,14,378,320,9355,2199,51833,61188,9/21/2020
5/2/2020,257,10687,1926,64583,75270,36,1131,39,648,5,127,356,91,62,24,402,189,9544,1280,53113,62657,9/21/2020
5/3/2020,283,10970,2160,66743,77713,31,1162,27,675,8,135,352,90,61,21,423,182,9726,1596,54709,64435,9/21/2020
5/4/2020,387,11357,2098,68841,80198,30,1192,31,706,5,140,346,88,57,18,441,293,10019,1568,56277,66296,9/21/2020
5/5/2020,433,11790,2873,71714,83504,29,1221,32,738,6,146,337,82,54,16,457,308,10327,1966,58243,68570,9/21/2020
5/6/2020,488,12278,2830,74544,86822,28,1249,44,782,9,155,312,79,54,21,478,342,10669,1920,60163,70832,9/21/2020
5/7/2020,425,12703,2969,77513,90216,36,1285,42,824,5,160,301,71,52,21,499,274,10943,1969,62132,73075,9/21/2020
5/8/2020,359,13062,2598,80111,93173,30,1315,29,853,5,165,297,71,53,22,521,233,11176,1740,63872,75048,9/21/2020
5/9/2020,467,13529,3346,83457,96986,22,1337,21,874,4,169,294,69,51,15,536,291,11467,2261,66133,77600,9/21/2020
5/10/2020,285,13814,2117,85574,99388,20,1357,23,897,6,175,285,70,49,13,549,188,11655,1523,67656,79311,9/21/2020
5/11/2020,257,14071,1857,87431,101502,31,1388,16,913,6,181,294,71,49,15,564,178,11833,1302,68958,80791,9/21/2020
5/12/2020,387,14458,2611,90042,104500,23,1411,18,931,4,185,295,69,48,22,586,218,12051,1708,70666,82717,9/21/2020
5/13/2020,351,14809,3630,93672,108481,23,1434,25,956,1,186,292,69,49,13,599,199,12250,2008,72674,84924,9/21/2020
5/14/2020,329,15138,3408,97080,112218,19,1453,27,983,3,189,281,64,45,15,614,232,12482,2019,74693,87175,9/21/2020
5/15/2020,381,15519,3458,100538,116057,24,1477,41,1024,5,194,259,62,45,14,628,237,12719,1811,76504,89223,9/21/2020
5/16/2020,449,15968,4156,104694,120662,25,1502,13,1037,5,199,266,61,46,15,643,252,12971,1963,78467,91438,9/21/2020
5/17/2020,240,16208,2768,107462,123670,17,1519,8,1045,5,204,270,59,45,10,653,129,13100,1559,80026,93126,9/21/2020
5/18/2020,250,16458,2001,109463,125921,19,1538,15,1060,5,209,269,57,40,18,671,140,13240,1370,81396,94636,9/21/2020
5/19/2020,415,16873,3168,112631,129504,23,1561,32,1092,5,214,255,56,38,11,682,214,13454,1929,83325,96779,9/21/2020
5/20/2020,326,17199,2771,115402,132601,19,1580,23,1115,7,221,244,52,33,22,704,188,13642,1516,84841,98483,9/21/2020
5/21/2020,374,17573,3757,119159,136732,26,1606,15,1130,3,224,252,53,29,20,724,170,13812,1941,86782,100594,9/21/2020
5/22/2020,351,17924,3161,122320,140244,20,1626,29,1159,5,229,238,52,29,10,734,204,14016,1611,88393,102409,9/21/2020
5/23/2020,253,18177,2742,125062,143239,19,1645,11,1170,3,232,243,52,32,13,747,108,14124,1272,89665,103789,9/21/2020
5/24/2020,163,18340,1370,126432,144772,12,1657,14,1184,2,234,239,53,36,8,755,82,14206,773,90438,104644,9/21/2020
5/25/2020,147,18487,1385,127817,146304,13,1670,14,1198,0,234,238,53,34,10,765,72,14278,762,91200,105478,9/21/2020
5/26/2020,285,18772,2620,130437,149209,24,1694,22,1220,5,239,235,48,33,15,780,163,14441,1781,92981,107422,9/21/2020
5/27/2020,276,19048,2057,132494,151542,20,1714,18,1238,3,242,234,50,33,10,790,134,14575,1135,94116,108691,9/21/2020
5/28/2020,348,19396,3359,135853,155249,17,1731,29,1267,4,246,218,47,32,8,798,134,14709,1120,95236,109945,9/21/2020
5/29/2020,410,19806,3914,139767,159573,19,1750,27,1294,6,252,204,43,31,12,810,177,14886,1571,96807,111693,9/21/2020
5/30/2020,225,20031,3915,143682,163713,15,1765,19,1313,4,256,196,40,29,12,822,109,14995,1820,98627,113622,9/21/2020
5/31/2020,155,20186,1688,145370,165556,11,1776,10,1323,0,256,197,43,26,3,825,78,15073,857,99484,114557,9/21/2020
6/1/2020,212,20398,2792,148162,168560,8,1784,14,1337,1,257,190,44,29,5,830,99,15172,1386,100870,116042,9/21/2020
6/2/2020,273,20671,3022,151184,171855,8,1792,9,1346,3,260,186,37,25,10,840,107,15279,1449,102319,117598,9/21/2020
6/3/2020,254,20925,3486,154670,175595,14,1806,18,1364,6,266,176,34,25,11,851,105,15384,1663,103982,119366,9/21/2020
6/4/2020,276,21201,4471,159141,180342,7,1813,25,1389,3,269,155,31,24,11,862,111,15495,2040,106022,121517,9/21/2020
6/5/2020,215,21416,3513,162654,184070,15,1828,13,1402,6,275,151,27,21,11,873,106,15601,1578,107600,123201,9/21/2020
6/6/2020,201,21617,2616,165270,186887,10,1838,7,1409,2,277,152,29,19,6,879,69,15670,1136,108736,124406,9/21/2020
6/7/2020,83,21700,1625,166895,188595,11,1849,7,1416,1,278,155,25,17,4,883,50,15720,782,109518,125238,9/21/2020
6/8/2020,119,21819,1849,168744,190563,15,1864,12,1428,2,280,156,27,18,4,887,44,15764,962,110480,126244,9/21/2020
6/9/2020,223,22042,2673,171417,193459,10,1874,18,1446,0,280,148,28,21,1,888,67,15831,1258,111738,127569,9/21/2020
6/10/2020,209,22251,2987,174404,196655,13,1887,12,1458,2,282,147,24,17,4,892,105,15936,1468,113206,129142,9/21/2020
6/11/2020,195,22446,3513,177917,200363,7,1894,15,1473,1,283,138,25,16,6,898,88,16024,1537,114743,130767,9/21/2020
6/12/2020,209,22655,4601,182518,205173,9,1903,15,1488,1,284,131,24,16,2,900,82,16106,2185,116928,133034,9/21/2020
6/13/2020,113,22768,3036,185554,208322,6,1909,4,1492,0,284,133,20,15,3,903,50,16156,1373,118301,134457,9/21/2020
6/14/2020,81,22849,2046,187600,210449,7,1916,8,1500,1,285,131,20,14,3,906,33,16189,968,119269,135458,9/21/2020
6/15/2020,188,23037,3108,190708,213745,14,1930,14,1514,0,285,131,20,16,5,911,78,16267,1792,121061,137328,9/21/2020
6/16/2020,110,23147,3017,193725,216872,10,1940,9,1523,1,286,131,22,16,8,919,52,16319,1578,122639,138958,9/21/2020
6/17/2020,127,23274,2835,196560,219834,15,1955,20,1543,4,290,122,18,14,6,925,53,16372,1320,123959,140331,9/21/2020
6/18/2020,149,23423,3047,199607,223030,9,1964,13,1556,1,291,117,19,16,7,932,70,16442,1316,125275,141717,9/21/2020
6/19/2020,141,23564,3769,203376,226940,12,1976,11,1567,1,292,117,20,17,3,935,59,16501,1372,126647,143148,9/21/2020
6/20/2020,84,23648,1891,205267,228915,9,1985,12,1579,0,292,114,20,18,4,939,36,16537,814,127461,143998,9/21/2020
6/21/2020,37,23685,1064,206331,230016,8,1993,5,1584,0,292,117,20,18,2,941,28,16565,692,128153,144718,9/21/2020
6/22/2020,138,23823,3730,210061,233884,12,2005,16,1600,0,292,113,19,18,1,942,69,16634,1708,129861,146495,9/21/2020
6/23/2020,163,23986,3831,213892,237878,3,2008,13,1613,3,295,100,18,18,7,949,83,16717,1784,131645,148362,9/21/2020
6/24/2020,120,24106,3502,217394,241500,9,2017,10,1623,1,296,98,18,18,5,954,46,16763,1687,133332,150095,9/21/2020
6/25/2020,103,24209,2883,220277,244486,6,2023,14,1637,1,297,89,17,17,1,955,54,16817,1513,134845,151662,9/21/2020
6/26/2020,94,24303,2488,222765,247068,2,2025,10,1647,0,297,81,18,18,1,956,63,16880,1332,136177,153057,9/21/2020
6/27/2020,84,24387,3214,225979,250366,5,2030,3,1650,1,298,82,17,17,5,961,37,16917,1221,137398,154315,9/21/2020
6/28/2020,39,24426,1469,227448,251874,4,2034,4,1654,4,302,78,15,14,6,967,19,16936,596,137994,154930,9/21/2020
6/29/2020,85,24511,3697,231145,255656,4,2038,5,1659,0,302,77,14,14,1,968,39,16975,1354,139348,156323,9/21/2020
6/30/2020,57,24568,1956,233101,257669,1,2039,5,1664,1,303,72,12,11,4,972,33,17008,996,140344,157352,9/21/2020
7/1/2020,144,24712,4098,237199,261911,7,2046,9,1673,0,303,70,11,11,1,973,80,17088,1937,142281,159369,9/21/2020
7/2/2020,103,24815,2803,240002,264817,5,2051,5,1678,1,304,69,10,10,2,975,57,17145,1089,143370,160515,9/21/2020
7/3/2020,50,24865,2076,242078,266943,9,2060,6,1684,0,304,72,9,9,3,978,26,17171,779,144149,161320,9/21/2020
7/4/2020,57,24922,2345,244423,269345,2,2062,4,1688,1,305,69,10,9,2,980,34,17205,1011,145160,162365,9/21/2020
7/5/2020,49,24971,2932,247355,272326,1,2063,2,1690,1,306,67,8,8,2,982,26,17231,1447,146607,163838,9/21/2020
7/6/2020,101,25072,2811,250166,275238,6,2069,6,1696,0,306,67,9,9,4,986,58,17289,1553,148160,165449,9/21/2020
7/7/2020,81,25153,3457,253623,278776,5,2074,7,1703,0,306,65,8,8,2,988,48,17337,1536,149696,167033,9/21/2020
7/8/2020,105,25258,3403,257026,282284,4,2078,2,1705,0,306,67,9,8,0,988,65,17402,1426,151122,168524,9/21/2020
7/9/2020,94,25352,3712,260738,286090,9,2087,3,1708,0,306,73,9,8,0,988,51,17453,1630,152752,170205,9/21/2020
7/10/2020,131,25483,4431,265169,290652,6,2093,3,1711,2,308,74,7,7,3,991,80,17533,2080,154832,172365,9/21/2020
7/11/2020,63,25546,2932,268101,293647,6,2099,3,1714,1,309,76,6,6,3,994,34,17567,1319,156151,173718,9/21/2020
7/12/2020,47,25593,1836,269937,295530,1,2100,3,1717,1,310,73,6,5,3,997,34,17601,943,157094,174695,9/21/2020
7/13/2020,84,25677,3157,273094,298771,8,2108,10,1727,0,310,71,6,5,1,998,61,17662,1474,158568,176230,9/21/2020
7/14/2020,73,25750,3289,276383,302133,7,2115,4,1731,0,310,74,5,5,1,999,49,17711,1374,159942,177653,9/21/2020
7/15/2020,130,25880,4168,280551,306431,5,2120,7,1738,0,310,72,5,4,0,999,100,17811,1750,161692,179503,9/21/2020
7/16/2020,102,25982,3733,284284,310266,6,2126,9,1747,0,310,69,6,5,1,1000,78,17889,1618,163310,181199,9/21/2020
7/17/2020,156,26138,4235,288519,314657,14,2140,3,1750,1,311,79,5,5,2,1002,81,17970,1849,165159,183129,9/21/2020
7/18/2020,85,26223,3267,291786,318009,5,2145,9,1759,1,312,74,5,4,4,1006,69,18039,1402,166561,184600,9/21/2020
7/19/2020,82,26305,2693,294479,320784,7,2152,3,1762,0,312,78,6,4,2,1008,59,18098,1149,167710,185808,9/21/2020
7/20/2020,71,26376,2664,297143,323519,9,2161,7,1769,0,312,80,7,5,2,1010,69,18167,1467,169177,187344,9/21/2020
7/21/2020,130,26506,4298,301441,327947,9,2170,11,1780,0,312,78,9,6,1,1011,109,18276,1922,171099,189375,9/21/2020
7/22/2020,130,26636,3926,305367,332003,11,2181,11,1791,1,313,77,7,6,1,1012,87,18363,1684,172783,191146,9/21/2020
7/23/2020,141,26777,4376,309743,336520,8,2189,6,1797,0,313,79,8,7,0,1012,116,18479,1970,174753,193232,9/21/2020
7/24/2020,172,26949,5959,315702,342651,14,2203,14,1811,0,313,79,9,7,0,1012,123,18602,2323,177076,195678,9/21/2020
7/25/2020,134,27083,4398,320100,347183,7,2210,7,1818,0,313,79,10,8,2,1014,107,18709,2101,179177,197886,9/21/2020
7/26/2020,62,27145,3027,323127,350272,8,2218,9,1827,0,313,78,11,7,1,1015,54,18763,1340,180517,199280,9/21/2020
7/27/2020,186,27331,4163,327290,354621,12,2230,7,1834,0,313,83,13,8,1,1016,141,18904,2334,182851,201755,9/21/2020
7/28/2020,105,27436,3831,331121,358557,5,2235,5,1839,0,313,83,14,7,1,1017,94,18998,1634,184485,203483,9/21/2020
7/29/2020,191,27627,5123,336244,363871,11,2246,12,1851,0,313,82,15,7,0,1017,157,19155,2324,186809,205964,9/21/2020
7/30/2020,121,27748,4344,340588,368336,6,2252,2,1853,1,314,85,15,6,1,1018,96,19251,1651,188460,207711,9/21/2020
7/31/2020,131,27879,5508,346096,373975,8,2260,10,1863,0,314,83,15,7,1,1019,90,19341,1859,190319,209660,9/21/2020
8/1/2020,108,27987,4288,350384,378371,7,2267,2,1865,0,314,88,14,7,1,1020,88,19429,1558,191877,211306,9/21/2020
8/2/2020,84,28071,2802,353186,381257,12,2279,12,1877,2,316,86,14,8,2,1022,62,19491,1276,193153,212644,9/21/2020
8/3/2020,187,28258,5203,358389,386647,13,2292,12,1889,0,316,87,16,7,1,1023,154,19645,2186,195339,214984,9/21/2020
8/4/2020,126,28384,3687,362076,390460,8,2300,6,1895,1,317,88,12,5,2,1025,99,19744,1771,197110,216854,9/21/2020
8/5/2020,148,28532,5914,367990,396522,12,2312,10,1905,1,318,89,10,5,2,1027,118,19862,2470,199580,219442,9/21/2020
8/6/2020,169,28701,5533,373523,402224,7,2319,9,1914,0,318,87,9,4,0,1027,122,19984,2425,202005,221989,9/21/2020
8/7/2020,122,28823,4845,378368,407191,13,2332,10,1924,1,319,89,9,3,2,1029,90,20074,2158,204163,224237,9/21/2020
8/8/2020,122,28945,4105,382473,411418,19,2351,6,1930,1,320,101,8,3,1,1030,95,20169,1781,205944,226113,9/21/2020
8/9/2020,42,28987,1722,384195,413182,8,2359,10,1940,0,320,99,9,4,0,1030,36,20205,1076,207020,227225,9/21/2020
8/10/2020,149,29136,4577,388772,417908,11,2370,12,1952,0,320,98,9,4,1,1031,112,20317,2029,209049,229366,9/21/2020
8/11/2020,105,29241,4320,393092,422333,6,2376,14,1966,0,320,90,10,4,3,1034,93,20410,2270,211319,231729,9/21/2020
8/12/2020,121,29362,5184,398276,427638,8,2384,11,1977,0,320,87,9,3,1,1035,103,20513,2629,213948,234461,9/21/2020
8/13/2020,135,29497,4190,402466,431963,13,2397,12,1989,0,320,88,11,3,0,1035,97,20610,1910,215858,236468,9/21/2020
8/14/2020,145,29642,5461,407927,437569,13,2410,11,2000,0,320,90,11,4,3,1038,101,20711,1955,217813,238524,9/21/2020
8/15/2020,105,29747,4532,412459,442206,8,2418,11,2011,1,321,86,11,5,0,1038,90,20801,1703,219516,240317,9/21/2020
8/16/2020,83,29830,2786,415245,445075,7,2425,6,2017,4,325,83,8,4,6,1044,71,20872,984,220500,241372,9/21/2020
8/17/2020,106,29936,4547,419792,449728,10,2435,7,2024,0,325,86,8,5,2,1046,87,20959,2385,222885,243844,9/21/2020
8/18/2020,128,30064,5049,424841,454905,11,2446,9,2033,1,326,87,8,4,5,1051,97,21056,2783,225668,246724,9/21/2020
8/19/2020,114,30178,5407,430248,460426,8,2454,9,2042,1,327,85,9,5,0,1051,90,21146,2679,228347,249493,9/21/2020
8/20/2020,174,30352,8220,438468,468820,12,2466,6,2048,2,329,89,10,5,3,1054,137,21283,3570,231917,253200,9/21/2020
8/21/2020,154,30506,6811,445279,475785,8,2474,5,2053,1,330,91,9,4,2,1056,125,21408,2973,234890,256298,9/21/2020
8/22/2020,96,30602,5958,451237,481839,10,2484,12,2065,0,330,89,11,4,1,1057,84,21492,2626,237516,259008,9/21/2020
8/23/2020,70,30672,4365,455602,486274,11,2495,5,2070,0,330,95,11,2,1,1058,57,21549,2471,239987,261536,9/21/2020
8/24/2020,105,30777,5775,461377,492154,7,2502,10,2080,1,331,91,13,4,1,1059,75,21624,3160,243147,264771,9/21/2020
8/25/2020,108,30885,4776,466153,497038,10,2512,4,2084,1,332,96,11,4,1,1060,94,21718,2300,245447,267165,9/21/2020
8/26/2020,170,31055,9563,475716,506771,4,2516,8,2092,0,332,92,9,5,1,1061,128,21846,3078,248525,270371,9/21/2020
8/27/2020,93,31148,8800,484516,515664,6,2522,14,2106,1,333,83,6,5,2,1063,71,21917,3218,251743,273660,9/21/2020
8/28/2020,112,31260,8057,492573,523833,14,2536,4,2110,0,333,93,9,7,2,1065,88,22005,2433,254176,276181,9/21/2020
8/29/2020,65,31325,5414,497987,529312,6,2542,8,2118,1,334,90,10,6,1,1066,53,22058,1907,256083,278141,9/21/2020
8/30/2020,66,31391,4319,502306,533697,7,2549,4,2122,0,334,93,8,5,1,1067,48,22106,1995,258078,280184,9/21/2020
8/31/2020,105,31496,4867,507173,538669,10,2559,15,2137,0,334,88,8,4,0,1067,82,22188,2197,260275,282463,9/21/2020
9/1/2020,98,31594,7114,514287,545881,6,2565,9,2146,1,335,84,7,4,1,1068,67,22255,2376,262651,284906,9/21/2020
9/2/2020,124,31718,10554,524841,556559,9,2574,10,2156,1,336,82,8,4,2,1070,102,22357,2954,265605,287962,9/21/2020
9/3/2020,89,31807,11168,536009,567816,8,2582,8,2164,0,336,82,9,4,2,1072,76,22433,2582,268187,290620,9/21/2020
9/4/2020,102,31909,9027,545036,576945,11,2593,4,2168,0,336,89,9,4,1,1073,83,22516,2403,270590,293106,9/21/2020
9/5/2020,52,31961,6280,551316,583277,6,2599,9,2177,0,336,86,8,3,1,1074,42,22558,1589,272179,294737,9/21/2020
9/6/2020,87,32048,4310,555626,587674,4,2603,8,2185,1,337,81,6,3,1,1075,66,22624,1955,274134,296758,9/21/2020
9/7/2020,35,32083,2999,558625,590708,11,2614,3,2188,0,337,89,5,3,1,1076,26,22650,649,274783,297433,9/21/2020
9/8/2020,74,32157,6341,564966,597123,6,2620,12,2200,1,338,82,6,3,2,1078,67,22717,1592,276375,299092,9/21/2020
9/9/2020,118,32275,8794,573760,606035,9,2629,5,2205,1,339,85,9,3,1,1079,99,22816,2134,278509,301325,9/21/2020
9/10/2020,166,32441,11396,585156,617597,8,2637,8,2213,0,339,85,10,3,0,1079,115,22931,2271,280780,303711,9/21/2020
9/11/2020,119,32560,9418,594574,627134,11,2648,11,2224,0,339,85,10,5,0,1079,98,23029,1954,282734,305763,9/21/2020
9/12/2020,107,32667,6071,600645,633312,8,2656,5,2229,2,341,86,9,5,3,1082,101,23130,1450,284184,307314,9/21/2020
9/13/2020,58,32725,2614,603259,635984,4,2660,3,2232,0,341,87,9,5,0,1082,56,23186,805,284989,308175,9/21/2020
9/14/2020,101,32826,6238,609497,642323,5,2665,3,2235,2,343,87,9,5,1,1083,92,23278,1611,286600,309878,9/21/2020
9/15/2020,138,32964,8248,617745,650709,5,2670,2,2237,1,344,89,9,5,2,1085,117,23395,1961,288561,311956,9/21/2020
9/16/2020,151,33115,9532,627277,660392,7,2677,7,2244,2,346,87,7,6,5,1090,115,23510,1830,290391,313901,9/21/2020
9/17/2020,136,33251,9179,636456,669707,7,2684,14,2258,0,346,80,8,4,0,1090,158,23668,1882,292273,315941,9/21/2020
9/18/2020,198,33449,9949,646405,679854,3,2687,7,2265,1,347,75,11,4,1,1091,130,23798,1945,294218,318016,9/21/2020
9/19/2020,158,33607,8133,654538,688145,6,2693,3,2268,0,347,78,10,4,3,1094,82,23880,1705,295923,319803,9/21/2020
9/20/2020,64,33671,2072,656610,690281,,,,,,,,,,3,1097,52,23932,711,296634,320566,9/21/2020
2/27/2020,0,0,0,0,0,1,1,0,0,0,0,1,0,0,0,0,0,0,0,0,0,9/22/2020
2/28/2020,0,0,0,0,0,0,1,0,0,0,0,1,1,0,0,0,0,0,0,0,0,9/22/2020
2/29/2020,0,0,0,0,0,0,1,0,0,0,0,1,1,0,0,0,0,0,0,0,0,9/22/2020
3/1/2020,2,2,2,2,4,0,1,0,0,0,0,1,1,1,0,0,2,2,2,2,4,9/22/2020
3/2/2020,0,2,1,3,5,1,2,0,0,0,0,2,2,2,0,0,0,2,1,3,5,9/22/2020
3/3/2020,0,2,2,5,7,0,2,0,0,0,0,2,2,2,0,0,0,2,2,5,7,9/22/2020
3/4/2020,0,2,12,17,19,1,3,0,0,0,0,3,2,2,0,0,0,2,10,15,17,9/22/2020
3/5/2020,0,2,4,21,23,0,3,0,0,0,0,3,2,2,0,0,1,3,4,19,22,9/22/2020
3/6/2020,1,3,12,33,36,0,3,0,0,0,0,3,2,2,0,0,0,3,11,30,33,9/22/2020
3/7/2020,0,3,19,52,55,0,3,0,0,0,0,3,2,1,0,0,0,3,19,49,52,9/22/2020
3/8/2020,0,3,18,70,73,0,3,0,0,0,0,3,2,1,0,0,0,3,18,67,70,9/22/2020
3/9/2020,1,4,15,85,89,0,3,0,0,0,0,3,2,1,0,0,1,4,15,82,86,9/22/2020
3/10/2020,2,6,25,110,116,0,3,0,0,0,0,3,2,1,0,0,1,5,23,105,110,9/22/2020
3/11/2020,0,6,34,144,150,1,4,0,0,0,0,4,1,1,0,0,0,5,34,139,144,9/22/2020
3/12/2020,9,15,41,185,200,1,5,0,0,0,0,5,1,1,0,0,8,13,38,177,190,9/22/2020
3/13/2020,6,21,50,235,256,4,9,1,1,0,0,8,1,1,0,0,6,19,48,225,244,9/22/2020
3/14/2020,0,21,90,325,346,0,9,0,1,0,0,8,1,1,0,0,0,19,86,311,330,9/22/2020
3/15/2020,1,22,54,379,401,1,10,0,1,0,0,9,2,1,0,0,1,20,54,365,385,9/22/2020
3/16/2020,2,24,95,474,498,2,12,0,1,0,0,11,2,0,0,0,2,22,92,457,479,9/22/2020
3/17/2020,12,36,162,636,672,6,18,0,1,0,0,17,2,0,0,0,11,33,151,608,641,9/22/2020
3/18/2020,9,45,116,752,797,3,21,0,1,0,0,20,2,0,0,0,11,44,110,718,762,9/22/2020
3/19/2020,15,60,262,1014,1074,2,23,1,2,0,0,21,3,0,1,1,17,61,251,969,1030,9/22/2020
3/20/2020,13,73,197,1211,1284,5,28,0,2,0,0,26,4,0,0,1,13,74,191,1160,1234,9/22/2020
3/21/2020,12,85,126,1337,1422,3,31,2,4,0,0,27,5,0,0,1,14,88,123,1283,1371,9/22/2020
3/22/2020,27,112,282,1619,1731,2,33,0,4,0,0,29,5,0,0,1,25,113,262,1545,1658,9/22/2020
3/23/2020,14,126,169,1788,1914,15,48,1,5,0,0,43,9,3,0,1,16,129,165,1710,1839,9/22/2020
3/24/2020,20,146,242,2030,2176,7,55,0,5,0,0,50,10,4,0,1,19,148,238,1948,2096,9/22/2020
3/25/2020,26,172,182,2212,2384,5,60,1,6,0,0,54,11,3,0,1,28,176,172,2120,2296,9/22/2020
3/26/2020,35,207,181,2393,2600,10,70,5,11,0,0,59,14,5,0,1,41,217,176,2296,2513,9/22/2020
3/27/2020,27,234,214,2607,2841,9,79,1,12,1,1,66,17,6,2,3,31,248,202,2498,2746,9/22/2020
3/28/2020,59,293,260,2867,3160,13,92,3,15,2,3,74,15,6,1,4,63,311,241,2739,3050,9/22/2020
3/29/2020,100,393,350,3217,3610,8,100,4,19,1,4,77,18,8,2,6,105,416,314,3053,3469,9/22/2020
3/30/2020,62,455,222,3439,3894,20,120,5,24,0,4,92,20,11,3,9,78,494,184,3237,3731,9/22/2020
3/31/2020,71,526,369,3808,4334,11,131,7,31,1,5,95,22,13,2,11,73,567,297,3534,4101,9/22/2020
4/1/2020,99,625,698,4506,5131,18,149,7,38,0,5,106,30,15,1,12,102,669,641,4175,4844,9/22/2020
4/2/2020,52,677,477,4983,5660,22,171,6,44,2,7,120,36,21,4,16,62,731,436,4611,5342,9/22/2020
4/3/2020,108,785,774,5757,6542,23,194,7,51,0,7,136,43,25,3,19,100,831,712,5323,6154,9/22/2020
4/4/2020,143,928,660,6417,7345,22,216,4,55,5,12,149,41,30,9,28,137,968,618,5941,6909,9/22/2020
4/5/2020,187,1115,1156,7573,8688,20,236,9,64,1,13,159,44,36,2,30,182,1150,1069,7010,8160,9/22/2020
4/6/2020,218,1333,1706,9279,10612,26,262,7,71,0,13,178,48,40,7,37,206,1356,1555,8565,9921,9/22/2020
4/7/2020,284,1617,1629,10908,12525,20,282,3,74,2,15,193,50,42,5,42,261,1617,1481,10046,11663,9/22/2020
4/8/2020,290,1907,1720,12628,14535,19,301,7,81,6,21,199,50,38,10,52,273,1890,1561,11607,13497,9/22/2020
4/9/2020,283,2190,1516,14144,16334,32,333,9,90,4,25,218,53,40,7,59,280,2170,1355,12962,15132,9/22/2020
4/10/2020,419,2609,2574,16718,19327,29,362,17,107,5,30,225,59,41,11,70,403,2573,2371,15333,17906,9/22/2020
4/11/2020,297,2906,1905,18623,21529,29,391,11,118,2,32,241,61,48,12,82,280,2853,1720,17053,19906,9/22/2020
4/12/2020,314,3220,1670,20293,23513,35,426,13,131,5,37,258,59,49,9,91,289,3142,1436,18489,21631,9/22/2020
4/13/2020,161,3381,935,21228,24609,35,461,13,144,3,40,277,64,54,9,100,187,3329,838,19327,22656,9/22/2020
4/14/2020,289,3670,1787,23015,26685,27,488,17,161,5,45,282,72,53,8,108,265,3594,1528,20855,24449,9/22/2020
4/15/2020,351,4021,1799,24814,28835,31,519,20,181,3,48,290,72,54,17,125,307,3901,1558,22413,26314,9/22/2020
4/16/2020,447,4468,2494,27308,31776,36,555,25,206,6,54,295,72,53,14,139,390,4291,2077,24490,28781,9/22/2020
4/17/2020,304,4772,1821,29129,33901,32,587,20,226,7,61,300,66,45,21,160,293,4584,1447,25937,30521,9/22/2020
4/18/2020,321,5093,1725,30854,35947,26,613,18,244,4,65,304,63,49,15,175,286,4870,1325,27262,32132,9/22/2020
4/19/2020,381,5474,2047,32901,38375,23,636,26,270,1,66,300,65,55,11,186,338,5208,1742,29004,34212,9/22/2020
4/20/2020,394,5868,1907,34808,40676,46,682,29,299,2,68,315,75,56,10,196,377,5585,1574,30578,36163,9/22/2020
4/21/2020,444,6312,2110,36918,43230,45,727,31,330,5,73,324,72,56,18,214,391,5976,1709,32287,38263,9/22/2020
4/22/2020,418,6730,2390,39308,46038,41,768,32,362,5,78,328,73,58,18,232,384,6360,1915,34202,40562,9/22/2020
4/23/2020,479,7209,2469,41777,48986,32,800,28,390,5,83,327,76,62,15,247,420,6780,1860,36062,42842,9/22/2020
4/24/2020,491,7700,3284,45061,52761,35,835,27,417,4,87,331,85,63,15,262,416,7196,2629,38691,45887,9/22/2020
4/25/2020,393,8093,2206,47267,55360,34,869,17,434,5,92,343,85,62,14,276,304,7500,1771,40462,47962,9/22/2020
4/26/2020,316,8409,2309,49576,57985,33,902,15,449,3,95,358,86,59,14,290,275,7775,1878,42340,50115,9/22/2020
4/27/2020,249,8658,1620,51196,59854,29,931,21,470,4,99,362,86,61,10,300,204,7979,1163,43503,51482,9/22/2020
4/28/2020,410,9068,2263,53459,62527,44,975,24,494,3,102,379,88,59,22,322,330,8309,1763,45266,53575,9/22/2020
4/29/2020,476,9544,3343,56802,66346,36,1011,38,532,11,113,366,78,53,18,340,373,8682,2425,47691,56373,9/22/2020
4/30/2020,432,9976,2769,59571,69547,33,1044,38,570,6,119,355,83,57,24,364,353,9035,1937,49628,58663,9/22/2020
5/1/2020,454,10430,3086,62657,73087,51,1095,39,609,3,122,364,84,58,14,378,320,9355,2199,51827,61182,9/22/2020
5/2/2020,257,10687,1926,64583,75270,36,1131,39,648,5,127,356,91,62,24,402,189,9544,1279,53106,62650,9/22/2020
5/3/2020,283,10970,2160,66743,77713,31,1162,26,674,8,135,353,90,61,21,423,182,9726,1594,54700,64426,9/22/2020
5/4/2020,387,11357,2098,68841,80198,30,1192,31,705,6,141,346,88,57,18,441,293,10019,1568,56268,66287,9/22/2020
5/5/2020,433,11790,2873,71714,83504,29,1221,32,737,6,147,337,82,54,16,457,308,10327,1966,58234,68561,9/22/2020
5/6/2020,488,12278,2830,74544,86822,28,1249,44,781,9,156,312,79,54,21,478,342,10669,1919,60153,70822,9/22/2020
5/7/2020,425,12703,2969,77513,90216,36,1285,42,823,5,161,301,71,52,21,499,274,10943,1969,62122,73065,9/22/2020
5/8/2020,359,13062,2598,80111,93173,30,1315,29,852,5,166,297,71,53,22,521,233,11176,1740,63862,75038,9/22/2020
5/9/2020,467,13529,3346,83457,96986,22,1337,21,873,4,170,294,69,51,15,536,291,11467,2261,66123,77590,9/22/2020
5/10/2020,285,13814,2117,85574,99388,20,1357,23,896,6,176,285,70,49,13,549,188,11655,1523,67646,79301,9/22/2020
5/11/2020,257,14071,1857,87431,101502,31,1388,16,912,6,182,294,71,49,15,564,178,11833,1302,68948,80781,9/22/2020
5/12/2020,387,14458,2611,90042,104500,23,1411,18,930,4,186,295,69,48,22,586,218,12051,1708,70656,82707,9/22/2020
5/13/2020,351,14809,3630,93672,108481,23,1434,25,955,1,187,292,69,49,13,599,199,12250,2008,72664,84914,9/22/2020
5/14/2020,329,15138,3408,97080,112218,19,1453,27,982,3,190,281,64,45,15,614,232,12482,2019,74683,87165,9/22/2020
5/15/2020,381,15519,3458,100538,116057,24,1477,41,1023,5,195,259,62,45,14,628,237,12719,1811,76494,89213,9/22/2020
5/16/2020,449,15968,4156,104694,120662,25,1502,13,1036,5,200,266,61,46,15,643,252,12971,1963,78457,91428,9/22/2020
5/17/2020,240,16208,2768,107462,123670,17,1519,8,1044,5,205,270,59,45,10,653,129,13100,1559,80016,93116,9/22/2020
5/18/2020,250,16458,2001,109463,125921,19,1538,15,1059,5,210,269,57,40,18,671,140,13240,1370,81386,94626,9/22/2020
5/19/2020,415,16873,3168,112631,129504,23,1561,32,1091,5,215,255,56,38,11,682,214,13454,1929,83315,96769,9/22/2020
5/20/2020,326,17199,2771,115402,132601,19,1580,23,1114,7,222,244,52,33,22,704,188,13642,1516,84831,98473,9/22/2020
5/21/2020,374,17573,3757,119159,136732,26,1606,15,1129,3,225,252,53,29,20,724,170,13812,1941,86772,100584,9/22/2020
5/22/2020,351,17924,3161,122320,140244,20,1626,29,1158,5,230,238,52,29,10,734,204,14016,1611,88383,102399,9/22/2020
5/23/2020,253,18177,2742,125062,143239,19,1645,11,1169,3,233,243,52,32,13,747,108,14124,1272,89655,103779,9/22/2020
5/24/2020,163,18340,1370,126432,144772,12,1657,14,1183,2,235,239,53,36,8,755,82,14206,773,90428,104634,9/22/2020
5/25/2020,147,18487,1385,127817,146304,13,1670,14,1197,0,235,238,53,34,10,765,72,14278,762,91190,105468,9/22/2020
5/26/2020,285,18772,2620,130437,149209,24,1694,22,1219,5,240,235,48,33,15,780,163,14441,1781,92971,107412,9/22/2020
5/27/2020,276,19048,2057,132494,151542,20,1714,18,1237,3,243,234,50,33,10,790,134,14575,1135,94106,108681,9/22/2020
5/28/2020,348,19396,3359,135853,155249,17,1731,29,1266,4,247,218,47,32,8,798,134,14709,1120,95226,109935,9/22/2020
5/29/2020,410,19806,3914,139767,159573,19,1750,27,1293,6,253,204,43,31,12,810,177,14886,1571,96797,111683,9/22/2020
5/30/2020,225,20031,3915,143682,163713,15,1765,19,1312,4,257,196,40,29,12,822,109,14995,1820,98617,113612,9/22/2020
5/31/2020,155,20186,1688,145370,165556,11,1776,10,1322,0,257,197,43,26,3,825,78,15073,857,99474,114547,9/22/2020
6/1/2020,212,20398,2792,148162,168560,8,1784,14,1336,1,258,190,44,29,5,830,99,15172,1386,100860,116032,9/22/2020
6/2/2020,273,20671,3022,151184,171855,8,1792,9,1345,3,261,186,37,25,10,840,107,15279,1449,102309,117588,9/22/2020
6/3/2020,254,20925,3486,154670,175595,14,1806,18,1363,6,267,176,34,25,11,851,105,15384,1663,103972,119356,9/22/2020
6/4/2020,276,21201,4471,159141,180342,7,1813,25,1388,3,270,155,31,24,11,862,111,15495,2039,106011,121506,9/22/2020
6/5/2020,215,21416,3513,162654,184070,15,1828,13,1401,6,276,151,27,21,11,873,106,15601,1578,107589,123190,9/22/2020
6/6/2020,201,21617,2616,165270,186887,10,1838,7,1408,2,278,152,29,19,6,879,69,15670,1136,108725,124395,9/22/2020
6/7/2020,83,21700,1625,166895,188595,11,1849,7,1415,1,279,155,25,17,4,883,50,15720,782,109507,125227,9/22/2020
6/8/2020,119,21819,1849,168744,190563,15,1864,12,1427,2,281,156,27,18,4,887,44,15764,962,110469,126233,9/22/2020
6/9/2020,223,22042,2673,171417,193459,10,1874,18,1445,0,281,148,28,21,1,888,67,15831,1258,111727,127558,9/22/2020
6/10/2020,209,22251,2987,174404,196655,13,1887,12,1457,2,283,147,24,17,4,892,105,15936,1468,113195,129131,9/22/2020
6/11/2020,195,22446,3513,177917,200363,7,1894,15,1472,1,284,138,25,16,6,898,88,16024,1537,114732,130756,9/22/2020
6/12/2020,209,22655,4601,182518,205173,9,1903,15,1487,1,285,131,24,16,2,900,82,16106,2185,116917,133023,9/22/2020
6/13/2020,113,22768,3036,185554,208322,6,1909,4,1491,0,285,133,20,15,3,903,50,16156,1373,118290,134446,9/22/2020
6/14/2020,81,22849,2046,187600,210449,7,1916,8,1499,1,286,131,20,14,3,906,33,16189,968,119258,135447,9/22/2020
6/15/2020,188,23037,3108,190708,213745,14,1930,14,1513,0,286,131,20,16,5,911,78,16267,1791,121049,137316,9/22/2020
6/16/2020,110,23147,3017,193725,216872,10,1940,9,1522,1,287,131,22,16,8,919,52,16319,1578,122627,138946,9/22/2020
6/17/2020,127,23274,2835,196560,219834,15,1955,20,1542,4,291,122,18,14,6,925,53,16372,1320,123947,140319,9/22/2020
6/18/2020,149,23423,3047,199607,223030,9,1964,13,1555,1,292,117,19,16,7,932,70,16442,1316,125263,141705,9/22/2020
6/19/2020,141,23564,3769,203376,226940,12,1976,11,1566,1,293,117,20,17,3,935,59,16501,1372,126635,143136,9/22/2020
6/20/2020,84,23648,1891,205267,228915,9,1985,12,1578,0,293,114,20,18,4,939,36,16537,813,127448,143985,9/22/2020
6/21/2020,37,23685,1064,206331,230016,8,1993,5,1583,0,293,117,20,18,2,941,28,16565,692,128140,144705,9/22/2020
6/22/2020,138,23823,3730,210061,233884,12,2005,16,1599,0,293,113,19,18,1,942,69,16634,1708,129848,146482,9/22/2020
6/23/2020,163,23986,3831,213892,237878,3,2008,13,1612,3,296,100,18,18,7,949,83,16717,1783,131631,148348,9/22/2020
6/24/2020,120,24106,3502,217394,241500,9,2017,10,1622,1,297,98,18,18,5,954,46,16763,1687,133318,150081,9/22/2020
6/25/2020,103,24209,2883,220277,244486,6,2023,14,1636,1,298,89,17,17,1,955,54,16817,1513,134831,151648,9/22/2020
6/26/2020,94,24303,2488,222765,247068,2,2025,10,1646,0,298,81,18,18,1,956,63,16880,1332,136163,153043,9/22/2020
6/27/2020,84,24387,3214,225979,250366,5,2030,3,1649,1,299,82,17,17,5,961,37,16917,1221,137384,154301,9/22/2020
6/28/2020,39,24426,1469,227448,251874,4,2034,4,1653,4,303,78,15,14,6,967,19,16936,596,137980,154916,9/22/2020
6/29/2020,85,24511,3697,231145,255656,4,2038,5,1658,0,303,77,14,14,1,968,39,16975,1354,139334,156309,9/22/2020
6/30/2020,57,24568,1956,233101,257669,1,2039,5,1663,1,304,72,12,11,4,972,33,17008,996,140330,157338,9/22/2020
7/1/2020,144,24712,4098,237199,261911,7,2046,9,1672,0,304,70,11,11,1,973,80,17088,1937,142267,159355,9/22/2020
7/2/2020,103,24815,2803,240002,264817,5,2051,5,1677,1,305,69,10,10,2,975,57,17145,1089,143356,160501,9/22/2020
7/3/2020,50,24865,2076,242078,266943,9,2060,6,1683,0,305,72,9,9,3,978,26,17171,779,144135,161306,9/22/2020
7/4/2020,57,24922,2345,244423,269345,2,2062,4,1687,1,306,69,10,9,2,980,34,17205,1011,145146,162351,9/22/2020
7/5/2020,49,24971,2932,247355,272326,1,2063,2,1689,1,307,67,8,8,2,982,26,17231,1446,146592,163823,9/22/2020
7/6/2020,101,25072,2811,250166,275238,6,2069,6,1695,0,307,67,9,9,4,986,58,17289,1552,148144,165433,9/22/2020
7/7/2020,81,25153,3457,253623,278776,5,2074,7,1702,0,307,65,8,8,2,988,48,17337,1536,149680,167017,9/22/2020
7/8/2020,105,25258,3403,257026,282284,4,2078,2,1704,0,307,67,9,8,0,988,65,17402,1426,151106,168508,9/22/2020
7/9/2020,94,25352,3712,260738,286090,9,2087,3,1707,0,307,73,9,8,0,988,51,17453,1630,152736,170189,9/22/2020
7/10/2020,131,25483,4431,265169,290652,6,2093,3,1710,2,309,74,7,7,3,991,80,17533,2080,154816,172349,9/22/2020
7/11/2020,63,25546,2932,268101,293647,6,2099,3,1713,1,310,76,6,6,3,994,34,17567,1319,156135,173702,9/22/2020
7/12/2020,47,25593,1836,269937,295530,1,2100,3,1716,1,311,73,6,5,3,997,34,17601,943,157078,174679,9/22/2020
7/13/2020,84,25677,3157,273094,298771,8,2108,10,1726,0,311,71,6,5,1,998,61,17662,1474,158552,176214,9/22/2020
7/14/2020,73,25750,3289,276383,302133,7,2115,4,1730,0,311,74,5,5,1,999,49,17711,1373,159925,177636,9/22/2020
7/15/2020,130,25880,4168,280551,306431,5,2120,7,1737,0,311,72,5,4,0,999,100,17811,1750,161675,179486,9/22/2020
7/16/2020,102,25982,3733,284284,310266,6,2126,9,1746,0,311,69,6,5,1,1000,78,17889,1618,163293,181182,9/22/2020
7/17/2020,156,26138,4235,288519,314657,14,2140,3,1749,1,312,79,5,5,2,1002,81,17970,1849,165142,183112,9/22/2020
7/18/2020,85,26223,3267,291786,318009,5,2145,9,1758,1,313,74,5,4,4,1006,69,18039,1401,166543,184582,9/22/2020
7/19/2020,82,26305,2693,294479,320784,7,2152,3,1761,0,313,78,6,4,2,1008,59,18098,1149,167692,185790,9/22/2020
7/20/2020,71,26376,2664,297143,323519,9,2161,7,1768,0,313,80,7,5,2,1010,69,18167,1467,169159,187326,9/22/2020
7/21/2020,130,26506,4298,301441,327947,9,2170,11,1779,0,313,78,9,6,1,1011,109,18276,1922,171081,189357,9/22/2020
7/22/2020,130,26636,3926,305367,332003,11,2181,11,1790,1,314,77,7,6,1,1012,87,18363,1683,172764,191127,9/22/2020
7/23/2020,141,26777,4376,309743,336520,8,2189,6,1796,0,314,79,8,7,0,1012,116,18479,1970,174734,193213,9/22/2020
7/24/2020,172,26949,5959,315702,342651,14,2203,14,1810,0,314,79,9,7,0,1012,123,18602,2323,177057,195659,9/22/2020
7/25/2020,134,27083,4398,320100,347183,7,2210,7,1817,0,314,79,10,8,2,1014,107,18709,2101,179158,197867,9/22/2020
7/26/2020,62,27145,3027,323127,350272,8,2218,9,1826,0,314,78,11,7,1,1015,54,18763,1340,180498,199261,9/22/2020
7/27/2020,186,27331,4163,327290,354621,12,2230,7,1833,0,314,83,13,8,1,1016,141,18904,2334,182832,201736,9/22/2020
7/28/2020,105,27436,3831,331121,358557,5,2235,5,1838,0,314,83,14,7,1,1017,94,18998,1633,184465,203463,9/22/2020
7/29/2020,191,27627,5123,336244,363871,11,2246,12,1850,0,314,82,15,7,0,1017,157,19155,2324,186789,205944,9/22/2020
7/30/2020,121,27748,4344,340588,368336,6,2252,2,1852,1,315,85,15,6,1,1018,96,19251,1651,188440,207691,9/22/2020
7/31/2020,131,27879,5508,346096,373975,8,2260,10,1862,0,315,83,15,7,1,1019,90,19341,1858,190298,209639,9/22/2020
8/1/2020,108,27987,4288,350384,378371,7,2267,2,1864,0,315,88,14,7,1,1020,88,19429,1558,191856,211285,9/22/2020
8/2/2020,84,28071,2802,353186,381257,12,2279,12,1876,2,317,86,14,8,2,1022,62,19491,1276,193132,212623,9/22/2020
8/3/2020,187,28258,5203,358389,386647,13,2292,12,1888,0,317,87,16,7,1,1023,154,19645,2186,195318,214963,9/22/2020
8/4/2020,126,28384,3687,362076,390460,8,2300,6,1894,1,318,88,12,5,2,1025,99,19744,1771,197089,216833,9/22/2020
8/5/2020,148,28532,5914,367990,396522,12,2312,10,1904,1,319,89,10,5,2,1027,118,19862,2470,199559,219421,9/22/2020
8/6/2020,169,28701,5533,373523,402224,7,2319,9,1913,0,319,87,9,4,0,1027,122,19984,2425,201984,221968,9/22/2020
8/7/2020,122,28823,4845,378368,407191,13,2332,10,1923,1,320,89,9,3,2,1029,90,20074,2156,204140,224214,9/22/2020
8/8/2020,122,28945,4105,382473,411418,19,2351,6,1929,1,321,101,8,3,1,1030,95,20169,1781,205921,226090,9/22/2020
8/9/2020,42,28987,1722,384195,413182,8,2359,10,1939,0,321,99,9,4,0,1030,36,20205,1076,206997,227202,9/22/2020
8/10/2020,149,29136,4577,388772,417908,11,2370,12,1951,0,321,98,9,4,1,1031,112,20317,2029,209026,229343,9/22/2020
8/11/2020,105,29241,4320,393092,422333,6,2376,14,1965,0,321,90,10,4,3,1034,93,20410,2270,211296,231706,9/22/2020
8/12/2020,121,29362,5184,398276,427638,8,2384,11,1976,0,321,87,9,3,1,1035,103,20513,2629,213925,234438,9/22/2020
8/13/2020,135,29497,4190,402466,431963,13,2397,12,1988,0,321,88,11,3,0,1035,97,20610,1910,215835,236445,9/22/2020
8/14/2020,145,29642,5461,407927,437569,13,2410,11,1999,0,321,90,11,4,3,1038,101,20711,1955,217790,238501,9/22/2020
8/15/2020,105,29747,4532,412459,442206,8,2418,11,2010,1,322,86,11,5,0,1038,90,20801,1703,219493,240294,9/22/2020
8/16/2020,83,29830,2786,415245,445075,7,2425,6,2016,4,326,83,8,4,6,1044,71,20872,984,220477,241349,9/22/2020
8/17/2020,106,29936,4547,419792,449728,10,2435,7,2023,0,326,86,8,5,2,1046,87,20959,2384,222861,243820,9/22/2020
8/18/2020,128,30064,5049,424841,454905,11,2446,9,2032,1,327,87,8,4,5,1051,97,21056,2783,225644,246700,9/22/2020
8/19/2020,114,30178,5407,430248,460426,8,2454,9,2041,1,328,85,9,5,0,1051,90,21146,2679,228323,249469,9/22/2020
8/20/2020,174,30352,8220,438468,468820,12,2466,6,2047,2,330,89,10,5,3,1054,137,21283,3569,231892,253175,9/22/2020
8/21/2020,154,30506,6811,445279,475785,8,2474,5,2052,1,331,91,9,4,2,1056,125,21408,2971,234863,256271,9/22/2020
8/22/2020,96,30602,5958,451237,481839,10,2484,12,2064,0,331,89,11,4,1,1057,84,21492,2626,237489,258981,9/22/2020
8/23/2020,70,30672,4365,455602,486274,11,2495,5,2069,0,331,95,11,2,1,1058,57,21549,2469,239958,261507,9/22/2020
8/24/2020,105,30777,5775,461377,492154,7,2502,10,2079,1,332,91,13,4,1,1059,75,21624,3157,243115,264739,9/22/2020
8/25/2020,108,30885,4776,466153,497038,10,2512,4,2083,1,333,96,11,4,1,1060,94,21718,2298,245413,267131,9/22/2020
8/26/2020,170,31055,9563,475716,506771,4,2516,8,2091,0,333,92,9,5,1,1061,128,21846,3077,248490,270336,9/22/2020
8/27/2020,93,31148,8800,484516,515664,6,2522,14,2105,1,334,83,6,5,2,1063,71,21917,3217,251707,273624,9/22/2020
8/28/2020,112,31260,8057,492573,523833,14,2536,4,2109,0,334,93,9,7,2,1065,88,22005,2433,254140,276145,9/22/2020
8/29/2020,65,31325,5414,497987,529312,6,2542,8,2117,1,335,90,10,6,1,1066,53,22058,1907,256047,278105,9/22/2020
8/30/2020,66,31391,4319,502306,533697,7,2549,4,2121,0,335,93,8,5,1,1067,48,22106,1994,258041,280147,9/22/2020
8/31/2020,105,31496,4867,507173,538669,10,2559,15,2136,0,335,88,8,4,0,1067,82,22188,2197,260238,282426,9/22/2020
9/1/2020,98,31594,7114,514287,545881,6,2565,9,2145,1,336,84,7,4,1,1068,67,22255,2376,262614,284869,9/22/2020
9/2/2020,124,31718,10554,524841,556559,9,2574,10,2155,1,337,82,8,4,2,1070,102,22357,2954,265568,287925,9/22/2020
9/3/2020,89,31807,11168,536009,567816,8,2582,8,2163,0,337,82,9,4,2,1072,76,22433,2582,268150,290583,9/22/2020
9/4/2020,102,31909,9027,545036,576945,11,2593,4,2167,0,337,89,9,4,1,1073,83,22516,2403,270553,293069,9/22/2020
9/5/2020,52,31961,6280,551316,583277,6,2599,9,2176,0,337,86,8,3,1,1074,42,22558,1588,272141,294699,9/22/2020
9/6/2020,87,32048,4310,555626,587674,4,2603,8,2184,1,338,81,6,3,1,1075,66,22624,1955,274096,296720,9/22/2020
9/7/2020,35,32083,2999,558625,590708,11,2614,3,2187,0,338,89,5,3,1,1076,26,22650,649,274745,297395,9/22/2020
9/8/2020,74,32157,6341,564966,597123,6,2620,12,2199,1,339,82,6,3,2,1078,67,22717,1592,276337,299054,9/22/2020
9/9/2020,118,32275,8794,573760,606035,9,2629,5,2204,1,340,85,9,3,1,1079,99,22816,2133,278470,301286,9/22/2020
9/10/2020,166,32441,11396,585156,617597,9,2638,8,2212,0,340,86,10,3,0,1079,115,22931,2271,280741,303672,9/22/2020
9/11/2020,119,32560,9418,594574,627134,11,2649,11,2223,0,340,86,10,5,0,1079,98,23029,1953,282694,305723,9/22/2020
9/12/2020,107,32667,6071,600645,633312,8,2657,5,2228,2,342,87,9,5,3,1082,101,23130,1450,284144,307274,9/22/2020
9/13/2020,58,32725,2614,603259,635984,4,2661,3,2231,0,342,88,9,5,0,1082,54,23184,805,284949,308133,9/22/2020
9/14/2020,101,32826,6238,609497,642323,5,2666,3,2234,2,344,88,9,5,1,1083,92,23276,1609,286558,309834,9/22/2020
9/15/2020,138,32964,8248,617745,650709,5,2671,2,2236,1,345,90,9,5,2,1085,118,23394,1960,288518,311912,9/22/2020
9/16/2020,151,33115,9532,627277,660392,7,2678,7,2243,2,347,88,7,6,5,1090,111,23505,1830,290348,313853,9/22/2020
9/17/2020,136,33251,9179,636456,669707,7,2685,14,2257,0,347,81,8,4,0,1090,156,23661,1881,292229,315890,9/22/2020
9/18/2020,199,33450,10035,646491,679941,5,2690,7,2264,1,348,78,11,5,2,1092,132,23793,1995,294224,318017,9/22/2020
9/19/2020,160,33610,8432,654923,688533,8,2698,3,2267,0,348,83,10,5,3,1095,106,23899,1794,296018,319917,9/22/2020
9/20/2020,76,33686,2852,657775,691461,6,2704,5,2272,2,350,82,10,7,3,1098,53,23952,926,296944,320896,9/22/2020
9/21/2020,105,33791,5242,663017,696808,,,,,,,,,,1,1099,92,24044,1403,298347,322391,9/22/2020
2/27/2020,0,0,0,0,0,1,1,0,0,0,0,1,0,0,0,0,0,0,0,0,0,9/23/2020
2/28/2020,0,0,0,0,0,0,1,0,0,0,0,1,1,0,0,0,0,0,0,0,0,9/23/2020
2/29/2020,0,0,0,0,0,0,1,0,0,0,0,1,1,0,0,0,0,0,0,0,0,9/23/2020
3/1/2020,2,2,2,2,4,0,1,0,0,0,0,1,1,1,0,0,2,2,2,2,4,9/23/2020
3/2/2020,0,2,1,3,5,1,2,0,0,0,0,2,2,2,0,0,0,2,1,3,5,9/23/2020
3/3/2020,0,2,2,5,7,0,2,0,0,0,0,2,2,2,0,0,0,2,2,5,7,9/23/2020
3/4/2020,0,2,12,17,19,1,3,0,0,0,0,3,2,2,0,0,0,2,10,15,17,9/23/2020
3/5/2020,0,2,4,21,23,0,3,0,0,0,0,3,2,2,0,0,1,3,4,19,22,9/23/2020
3/6/2020,1,3,12,33,36,0,3,0,0,0,0,3,2,2,0,0,0,3,11,30,33,9/23/2020
3/7/2020,0,3,19,52,55,0,3,0,0,0,0,3,2,1,0,0,0,3,19,49,52,9/23/2020
3/8/2020,0,3,18,70,73,0,3,0,0,0,0,3,2,1,0,0,0,3,18,67,70,9/23/2020
3/9/2020,1,4,15,85,89,0,3,0,0,0,0,3,2,1,0,0,1,4,15,82,86,9/23/2020
3/10/2020,2,6,25,110,116,0,3,0,0,0,0,3,2,1,0,0,1,5,23,105,110,9/23/2020
3/11/2020,0,6,34,144,150,1,4,0,0,0,0,4,1,1,0,0,0,5,34,139,144,9/23/2020
3/12/2020,9,15,41,185,200,1,5,0,0,0,0,5,1,1,0,0,8,13,38,177,190,9/23/2020
3/13/2020,6,21,50,235,256,4,9,1,1,0,0,8,1,1,0,0,6,19,48,225,244,9/23/2020
3/14/2020,0,21,90,325,346,0,9,0,1,0,0,8,1,1,0,0,0,19,86,311,330,9/23/2020
3/15/2020,1,22,54,379,401,1,10,0,1,0,0,9,2,1,0,0,1,20,54,365,385,9/23/2020
3/16/2020,2,24,95,474,498,2,12,0,1,0,0,11,2,0,0,0,2,22,92,457,479,9/23/2020
3/17/2020,12,36,162,636,672,6,18,0,1,0,0,17,2,0,0,0,11,33,151,608,641,9/23/2020
3/18/2020,9,45,116,752,797,3,21,0,1,0,0,20,2,0,0,0,11,44,110,718,762,9/23/2020
3/19/2020,15,60,262,1014,1074,2,23,1,2,0,0,21,3,0,1,1,17,61,251,969,1030,9/23/2020
3/20/2020,13,73,197,1211,1284,5,28,0,2,0,0,26,4,0,0,1,13,74,191,1160,1234,9/23/2020
3/21/2020,12,85,126,1337,1422,3,31,2,4,0,0,27,5,0,0,1,14,88,123,1283,1371,9/23/2020
3/22/2020,27,112,282,1619,1731,2,33,0,4,0,0,29,5,0,0,1,25,113,262,1545,1658,9/23/2020
3/23/2020,14,126,169,1788,1914,15,48,1,5,0,0,43,9,3,0,1,16,129,165,1710,1839,9/23/2020
3/24/2020,20,146,242,2030,2176,7,55,0,5,0,0,50,10,4,0,1,19,148,238,1948,2096,9/23/2020
3/25/2020,26,172,182,2212,2384,5,60,1,6,0,0,54,11,3,0,1,28,176,172,2120,2296,9/23/2020
3/26/2020,35,207,181,2393,2600,10,70,5,11,0,0,59,14,5,0,1,41,217,176,2296,2513,9/23/2020
3/27/2020,27,234,214,2607,2841,9,79,1,12,1,1,66,17,6,2,3,31,248,202,2498,2746,9/23/2020
3/28/2020,59,293,260,2867,3160,13,92,3,15,2,3,74,15,6,1,4,63,311,241,2739,3050,9/23/2020
3/29/2020,100,393,350,3217,3610,8,100,4,19,1,4,77,18,8,2,6,105,416,314,3053,3469,9/23/2020
3/30/2020,62,455,222,3439,3894,20,120,5,24,0,4,92,20,11,3,9,78,494,184,3237,3731,9/23/2020
3/31/2020,71,526,369,3808,4334,11,131,7,31,1,5,95,22,13,2,11,73,567,297,3534,4101,9/23/2020
4/1/2020,99,625,698,4506,5131,18,149,7,38,0,5,106,30,15,1,12,102,669,641,4175,4844,9/23/2020
4/2/2020,52,677,477,4983,5660,22,171,6,44,2,7,120,36,21,4,16,62,731,436,4611,5342,9/23/2020
4/3/2020,108,785,774,5757,6542,23,194,7,51,0,7,136,43,25,3,19,100,831,712,5323,6154,9/23/2020
4/4/2020,143,928,660,6417,7345,22,216,4,55,5,12,149,41,30,9,28,137,968,618,5941,6909,9/23/2020
4/5/2020,187,1115,1156,7573,8688,20,236,9,64,1,13,159,44,36,2,30,182,1150,1069,7010,8160,9/23/2020
4/6/2020,218,1333,1706,9279,10612,26,262,7,71,0,13,178,48,40,7,37,206,1356,1555,8565,9921,9/23/2020
4/7/2020,284,1617,1629,10908,12525,20,282,5,76,2,15,191,50,42,5,42,261,1617,1481,10046,11663,9/23/2020
4/8/2020,290,1907,1720,12628,14535,19,301,7,83,6,21,197,50,38,10,52,273,1890,1561,11607,13497,9/23/2020
4/9/2020,283,2190,1516,14144,16334,32,333,9,92,4,25,216,53,40,7,59,280,2170,1355,12962,15132,9/23/2020
4/10/2020,419,2609,2574,16718,19327,29,362,16,108,5,30,224,59,41,11,70,403,2573,2371,15333,17906,9/23/2020
4/11/2020,297,2906,1905,18623,21529,29,391,11,119,2,32,240,61,48,12,82,280,2853,1720,17053,19906,9/23/2020
4/12/2020,314,3220,1670,20293,23513,35,426,13,132,5,37,257,59,49,9,91,289,3142,1436,18489,21631,9/23/2020
4/13/2020,161,3381,935,21228,24609,35,461,13,145,3,40,276,64,54,9,100,187,3329,838,19327,22656,9/23/2020
4/14/2020,289,3670,1787,23015,26685,27,488,17,162,5,45,281,72,53,8,108,265,3594,1528,20855,24449,9/23/2020
4/15/2020,351,4021,1799,24814,28835,31,519,20,182,3,48,289,72,54,17,125,307,3901,1558,22413,26314,9/23/2020
4/16/2020,447,4468,2494,27308,31776,36,555,25,207,6,54,294,72,53,14,139,390,4291,2077,24490,28781,9/23/2020
4/17/2020,304,4772,1821,29129,33901,32,587,20,227,7,61,299,66,45,21,160,293,4584,1447,25937,30521,9/23/2020
4/18/2020,321,5093,1725,30854,35947,26,613,18,245,4,65,303,63,49,15,175,286,4870,1325,27262,32132,9/23/2020
4/19/2020,381,5474,2047,32901,38375,23,636,26,271,1,66,299,65,55,11,186,338,5208,1742,29004,34212,9/23/2020
4/20/2020,394,5868,1907,34808,40676,46,682,29,300,2,68,314,75,56,10,196,377,5585,1574,30578,36163,9/23/2020
4/21/2020,444,6312,2110,36918,43230,45,727,33,333,5,73,321,72,56,18,214,391,5976,1709,32287,38263,9/23/2020
4/22/2020,418,6730,2390,39308,46038,41,768,32,365,5,78,325,73,58,18,232,384,6360,1915,34202,40562,9/23/2020
4/23/2020,479,7209,2469,41777,48986,32,800,28,393,5,83,324,76,62,15,247,420,6780,1860,36062,42842,9/23/2020
4/24/2020,491,7700,3284,45061,52761,35,835,26,419,4,87,329,85,63,15,262,416,7196,2629,38691,45887,9/23/2020
4/25/2020,393,8093,2206,47267,55360,34,869,17,436,5,92,341,85,62,14,276,304,7500,1771,40462,47962,9/23/2020
4/26/2020,316,8409,2309,49576,57985,33,902,15,451,3,95,356,86,59,14,290,275,7775,1878,42340,50115,9/23/2020
4/27/2020,249,8658,1620,51196,59854,29,931,21,472,4,99,360,86,61,10,300,204,7979,1163,43503,51482,9/23/2020
4/28/2020,410,9068,2263,53459,62527,44,975,24,496,3,102,377,88,59,22,322,330,8309,1763,45266,53575,9/23/2020
4/29/2020,476,9544,3343,56802,66346,36,1011,38,534,11,113,364,78,53,18,340,373,8682,2425,47691,56373,9/23/2020
4/30/2020,432,9976,2769,59571,69547,33,1044,38,572,6,119,353,83,57,24,364,353,9035,1937,49628,58663,9/23/2020
5/1/2020,454,10430,3086,62657,73087,51,1095,40,612,3,122,361,84,58,14,378,320,9355,2194,51822,61177,9/23/2020
5/2/2020,257,10687,1926,64583,75270,36,1131,37,649,5,127,355,91,62,24,402,189,9544,1279,53101,62645,9/23/2020
5/3/2020,283,10970,2160,66743,77713,31,1162,26,675,8,135,352,90,61,21,423,182,9726,1593,54694,64420,9/23/2020
5/4/2020,387,11357,2098,68841,80198,30,1192,31,706,6,141,345,88,57,18,441,293,10019,1568,56262,66281,9/23/2020
5/5/2020,433,11790,2873,71714,83504,29,1221,32,738,6,147,336,82,54,16,457,308,10327,1966,58228,68555,9/23/2020
5/6/2020,488,12278,2830,74544,86822,28,1249,44,782,9,156,311,79,54,21,478,342,10669,1919,60147,70816,9/23/2020
5/7/2020,425,12703,2969,77513,90216,36,1285,41,823,5,161,301,71,52,21,499,274,10943,1969,62116,73059,9/23/2020
5/8/2020,359,13062,2598,80111,93173,30,1315,29,852,5,166,297,71,53,22,521,233,11176,1739,63855,75031,9/23/2020
5/9/2020,467,13529,3346,83457,96986,22,1337,21,873,4,170,294,69,51,15,536,291,11467,2261,66116,77583,9/23/2020
5/10/2020,285,13814,2117,85574,99388,20,1357,23,896,6,176,285,70,49,13,549,188,11655,1523,67639,79294,9/23/2020
5/11/2020,257,14071,1857,87431,101502,31,1388,16,912,6,182,294,71,49,15,564,178,11833,1301,68940,80773,9/23/2020
5/12/2020,387,14458,2611,90042,104500,23,1411,18,930,4,186,295,69,48,22,586,218,12051,1708,70648,82699,9/23/2020
5/13/2020,351,14809,3630,93672,108481,23,1434,25,955,1,187,292,69,49,13,599,199,12250,2006,72654,84904,9/23/2020
5/14/2020,329,15138,3408,97080,112218,19,1453,27,982,3,190,281,64,45,15,614,232,12482,2019,74673,87155,9/23/2020
5/15/2020,381,15519,3458,100538,116057,24,1477,41,1023,5,195,259,62,45,14,628,237,12719,1811,76484,89203,9/23/2020
5/16/2020,449,15968,4156,104694,120662,25,1502,13,1036,5,200,266,61,46,15,643,252,12971,1963,78447,91418,9/23/2020
5/17/2020,240,16208,2768,107462,123670,17,1519,8,1044,5,205,270,59,45,10,653,129,13100,1559,80006,93106,9/23/2020
5/18/2020,250,16458,2001,109463,125921,19,1538,15,1059,5,210,269,57,40,18,671,140,13240,1370,81376,94616,9/23/2020
5/19/2020,415,16873,3168,112631,129504,23,1561,32,1091,5,215,255,56,38,11,682,214,13454,1928,83304,96758,9/23/2020
5/20/2020,326,17199,2771,115402,132601,19,1580,23,1114,7,222,244,52,33,22,704,188,13642,1516,84820,98462,9/23/2020
5/21/2020,374,17573,3757,119159,136732,26,1606,15,1129,3,225,252,53,29,20,724,170,13812,1940,86760,100572,9/23/2020
5/22/2020,351,17924,3161,122320,140244,20,1626,29,1158,5,230,238,52,29,10,734,204,14016,1611,88371,102387,9/23/2020
5/23/2020,253,18177,2742,125062,143239,19,1645,11,1169,3,233,243,52,32,13,747,108,14124,1272,89643,103767,9/23/2020
5/24/2020,163,18340,1370,126432,144772,12,1657,14,1183,2,235,239,53,36,8,755,82,14206,773,90416,104622,9/23/2020
5/25/2020,147,18487,1385,127817,146304,13,1670,14,1197,0,235,238,53,34,10,765,72,14278,762,91178,105456,9/23/2020
5/26/2020,285,18772,2620,130437,149209,24,1694,22,1219,5,240,235,48,33,15,780,163,14441,1781,92959,107400,9/23/2020
5/27/2020,276,19048,2057,132494,151542,20,1714,18,1237,3,243,234,50,33,10,790,134,14575,1135,94094,108669,9/23/2020
5/28/2020,348,19396,3359,135853,155249,17,1731,29,1266,4,247,218,47,32,8,798,134,14709,1120,95214,109923,9/23/2020
5/29/2020,410,19806,3914,139767,159573,19,1750,27,1293,6,253,204,43,31,12,810,177,14886,1571,96785,111671,9/23/2020
5/30/2020,225,20031,3915,143682,163713,15,1765,19,1312,4,257,196,40,29,12,822,109,14995,1820,98605,113600,9/23/2020
5/31/2020,155,20186,1688,145370,165556,11,1776,10,1322,0,257,197,43,26,3,825,78,15073,857,99462,114535,9/23/2020
6/1/2020,212,20398,2792,148162,168560,8,1784,14,1336,1,258,190,44,29,5,830,99,15172,1385,100847,116019,9/23/2020
6/2/2020,273,20671,3022,151184,171855,8,1792,9,1345,3,261,186,37,25,10,840,107,15279,1449,102296,117575,9/23/2020
6/3/2020,254,20925,3486,154670,175595,14,1806,18,1363,6,267,176,34,25,11,851,105,15384,1663,103959,119343,9/23/2020
6/4/2020,276,21201,4471,159141,180342,7,1813,25,1388,3,270,155,31,24,11,862,111,15495,2039,105998,121493,9/23/2020
6/5/2020,215,21416,3513,162654,184070,15,1828,13,1401,6,276,151,27,21,11,873,106,15601,1578,107576,123177,9/23/2020
6/6/2020,201,21617,2616,165270,186887,10,1838,7,1408,2,278,152,29,19,6,879,69,15670,1136,108712,124382,9/23/2020
6/7/2020,83,21700,1625,166895,188595,11,1849,7,1415,1,279,155,25,17,4,883,50,15720,782,109494,125214,9/23/2020
6/8/2020,119,21819,1849,168744,190563,15,1864,12,1427,2,281,156,27,18,4,887,44,15764,962,110456,126220,9/23/2020
6/9/2020,223,22042,2673,171417,193459,10,1874,18,1445,0,281,148,28,21,1,888,67,15831,1258,111714,127545,9/23/2020
6/10/2020,209,22251,2987,174404,196655,13,1887,12,1457,2,283,147,24,17,4,892,105,15936,1468,113182,129118,9/23/2020
6/11/2020,195,22446,3513,177917,200363,7,1894,15,1472,1,284,138,25,16,6,898,88,16024,1535,114717,130741,9/23/2020
6/12/2020,209,22655,4601,182518,205173,9,1903,15,1487,1,285,131,24,16,2,900,82,16106,2185,116902,133008,9/23/2020
6/13/2020,113,22768,3036,185554,208322,6,1909,4,1491,0,285,133,20,15,3,903,50,16156,1373,118275,134431,9/23/2020
6/14/2020,81,22849,2046,187600,210449,7,1916,8,1499,1,286,131,20,14,3,906,33,16189,968,119243,135432,9/23/2020
6/15/2020,188,23037,3108,190708,213745,14,1930,14,1513,0,286,131,20,16,5,911,78,16267,1791,121034,137301,9/23/2020
6/16/2020,110,23147,3017,193725,216872,10,1940,9,1522,1,287,131,22,16,8,919,52,16319,1578,122612,138931,9/23/2020
6/17/2020,127,23274,2835,196560,219834,15,1955,20,1542,4,291,122,18,14,6,925,53,16372,1320,123932,140304,9/23/2020
6/18/2020,149,23423,3047,199607,223030,9,1964,13,1555,1,292,117,19,16,7,932,70,16442,1315,125247,141689,9/23/2020
6/19/2020,141,23564,3769,203376,226940,12,1976,11,1566,1,293,117,20,17,3,935,59,16501,1372,126619,143120,9/23/2020
6/20/2020,84,23648,1891,205267,228915,9,1985,12,1578,0,293,114,20,18,4,939,36,16537,813,127432,143969,9/23/2020
6/21/2020,37,23685,1064,206331,230016,8,1993,5,1583,0,293,117,20,18,2,941,28,16565,692,128124,144689,9/23/2020
6/22/2020,138,23823,3730,210061,233884,12,2005,16,1599,0,293,113,19,18,1,942,69,16634,1708,129832,146466,9/23/2020
6/23/2020,163,23986,3831,213892,237878,3,2008,13,1612,3,296,100,18,18,7,949,83,16717,1782,131614,148331,9/23/2020
6/24/2020,120,24106,3502,217394,241500,9,2017,10,1622,1,297,98,18,18,5,954,46,16763,1687,133301,150064,9/23/2020
6/25/2020,103,24209,2883,220277,244486,6,2023,14,1636,1,298,89,17,17,1,955,54,16817,1512,134813,151630,9/23/2020
6/26/2020,94,24303,2488,222765,247068,2,2025,10,1646,0,298,81,18,18,1,956,63,16880,1332,136145,153025,9/23/2020
6/27/2020,84,24387,3214,225979,250366,5,2030,3,1649,1,299,82,17,17,5,961,37,16917,1221,137366,154283,9/23/2020
6/28/2020,39,24426,1469,227448,251874,4,2034,4,1653,4,303,78,15,14,6,967,19,16936,596,137962,154898,9/23/2020
6/29/2020,85,24511,3697,231145,255656,4,2038,5,1658,0,303,77,14,14,1,968,39,16975,1354,139316,156291,9/23/2020
6/30/2020,57,24568,1956,233101,257669,1,2039,5,1663,1,304,72,12,11,4,972,33,17008,995,140311,157319,9/23/2020
7/1/2020,144,24712,4098,237199,261911,7,2046,9,1672,0,304,70,11,11,1,973,80,17088,1936,142247,159335,9/23/2020
7/2/2020,103,24815,2803,240002,264817,5,2051,5,1677,1,305,69,10,10,2,975,57,17145,1089,143336,160481,9/23/2020
7/3/2020,50,24865,2076,242078,266943,9,2060,6,1683,0,305,72,9,9,3,978,26,17171,779,144115,161286,9/23/2020
7/4/2020,57,24922,2345,244423,269345,2,2062,4,1687,1,306,69,10,9,2,980,34,17205,1010,145125,162330,9/23/2020
7/5/2020,49,24971,2932,247355,272326,1,2063,2,1689,1,307,67,8,8,2,982,26,17231,1446,146571,163802,9/23/2020
7/6/2020,101,25072,2811,250166,275238,6,2069,6,1695,0,307,67,9,9,4,986,58,17289,1552,148123,165412,9/23/2020
7/7/2020,81,25153,3457,253623,278776,5,2074,7,1702,0,307,65,8,8,2,988,48,17337,1536,149659,166996,9/23/2020
7/8/2020,105,25258,3403,257026,282284,4,2078,2,1704,0,307,67,9,8,0,988,65,17402,1426,151085,168487,9/23/2020
7/9/2020,94,25352,3712,260738,286090,9,2087,3,1707,0,307,73,9,8,0,988,51,17453,1630,152715,170168,9/23/2020
7/10/2020,131,25483,4431,265169,290652,6,2093,3,1710,2,309,74,7,7,3,991,80,17533,2080,154795,172328,9/23/2020
7/11/2020,63,25546,2932,268101,293647,6,2099,3,1713,1,310,76,6,6,3,994,34,17567,1318,156113,173680,9/23/2020
7/12/2020,47,25593,1836,269937,295530,1,2100,3,1716,1,311,73,6,5,3,997,34,17601,943,157056,174657,9/23/2020
7/13/2020,84,25677,3157,273094,298771,8,2108,10,1726,0,311,71,6,5,1,998,61,17662,1474,158530,176192,9/23/2020
7/14/2020,73,25750,3289,276383,302133,7,2115,4,1730,0,311,74,5,5,1,999,49,17711,1373,159903,177614,9/23/2020
7/15/2020,130,25880,4168,280551,306431,5,2120,7,1737,0,311,72,5,4,0,999,100,17811,1750,161653,179464,9/23/2020
7/16/2020,102,25982,3733,284284,310266,6,2126,9,1746,0,311,69,6,5,1,1000,78,17889,1618,163271,181160,9/23/2020
7/17/2020,156,26138,4235,288519,314657,14,2140,3,1749,1,312,79,5,5,2,1002,81,17970,1849,165120,183090,9/23/2020
7/18/2020,85,26223,3267,291786,318009,5,2145,9,1758,1,313,74,5,4,4,1006,69,18039,1401,166521,184560,9/23/2020
7/19/2020,82,26305,2693,294479,320784,7,2152,3,1761,0,313,78,6,4,2,1008,59,18098,1149,167670,185768,9/23/2020
7/20/2020,71,26376,2664,297143,323519,9,2161,7,1768,0,313,80,7,5,2,1010,69,18167,1466,169136,187303,9/23/2020
7/21/2020,130,26506,4298,301441,327947,9,2170,11,1779,0,313,78,9,6,1,1011,109,18276,1920,171056,189332,9/23/2020
7/22/2020,130,26636,3926,305367,332003,11,2181,11,1790,1,314,77,7,6,1,1012,87,18363,1683,172739,191102,9/23/2020
7/23/2020,141,26777,4376,309743,336520,8,2189,6,1796,0,314,79,8,7,0,1012,116,18479,1970,174709,193188,9/23/2020
7/24/2020,172,26949,5959,315702,342651,14,2203,14,1810,0,314,79,9,7,0,1012,123,18602,2323,177032,195634,9/23/2020
7/25/2020,134,27083,4398,320100,347183,7,2210,7,1817,0,314,79,10,8,2,1014,107,18709,2100,179132,197841,9/23/2020
7/26/2020,62,27145,3027,323127,350272,8,2218,9,1826,0,314,78,11,7,1,1015,54,18763,1340,180472,199235,9/23/2020
7/27/2020,186,27331,4163,327290,354621,12,2230,7,1833,0,314,83,13,8,1,1016,141,18904,2334,182806,201710,9/23/2020
7/28/2020,105,27436,3831,331121,358557,5,2235,5,1838,0,314,83,14,7,1,1017,94,18998,1632,184438,203436,9/23/2020
7/29/2020,191,27627,5123,336244,363871,11,2246,12,1850,0,314,82,15,7,0,1017,157,19155,2324,186762,205917,9/23/2020
7/30/2020,121,27748,4344,340588,368336,6,2252,2,1852,1,315,85,15,6,1,1018,96,19251,1651,188413,207664,9/23/2020
7/31/2020,131,27879,5508,346096,373975,8,2260,10,1862,0,315,83,15,7,1,1019,90,19341,1858,190271,209612,9/23/2020
8/1/2020,108,27987,4288,350384,378371,7,2267,2,1864,0,315,88,14,7,1,1020,88,19429,1558,191829,211258,9/23/2020
8/2/2020,84,28071,2802,353186,381257,12,2279,12,1876,2,317,86,14,8,2,1022,62,19491,1276,193105,212596,9/23/2020
8/3/2020,187,28258,5203,358389,386647,13,2292,12,1888,0,317,87,16,7,1,1023,154,19645,2186,195291,214936,9/23/2020
8/4/2020,126,28384,3687,362076,390460,8,2300,6,1894,1,318,88,12,5,2,1025,99,19744,1771,197062,216806,9/23/2020
8/5/2020,148,28532,5914,367990,396522,12,2312,10,1904,1,319,89,10,5,2,1027,118,19862,2469,199531,219393,9/23/2020
8/6/2020,169,28701,5533,373523,402224,7,2319,9,1913,0,319,87,9,4,0,1027,122,19984,2424,201955,221939,9/23/2020
8/7/2020,122,28823,4845,378368,407191,13,2332,10,1923,1,320,89,9,3,2,1029,90,20074,2155,204110,224184,9/23/2020
8/8/2020,122,28945,4105,382473,411418,19,2351,6,1929,1,321,101,8,3,1,1030,95,20169,1781,205891,226060,9/23/2020
8/9/2020,42,28987,1722,384195,413182,8,2359,10,1939,0,321,99,9,4,0,1030,36,20205,1076,206967,227172,9/23/2020
8/10/2020,149,29136,4577,388772,417908,11,2370,12,1951,0,321,98,9,4,1,1031,112,20317,2029,208996,229313,9/23/2020
8/11/2020,105,29241,4320,393092,422333,6,2376,14,1965,0,321,90,10,4,3,1034,93,20410,2269,211265,231675,9/23/2020
8/12/2020,121,29362,5184,398276,427638,8,2384,11,1976,0,321,87,9,3,1,1035,103,20513,2629,213894,234407,9/23/2020
8/13/2020,135,29497,4190,402466,431963,13,2397,12,1988,0,321,88,11,3,0,1035,97,20610,1910,215804,236414,9/23/2020
8/14/2020,145,29642,5461,407927,437569,13,2410,11,1999,0,321,90,11,4,3,1038,101,20711,1955,217759,238470,9/23/2020
8/15/2020,105,29747,4532,412459,442206,8,2418,11,2010,1,322,86,11,5,0,1038,90,20801,1703,219462,240263,9/23/2020
8/16/2020,83,29830,2786,415245,445075,7,2425,6,2016,4,326,83,8,4,6,1044,71,20872,983,220445,241317,9/23/2020
8/17/2020,106,29936,4547,419792,449728,10,2435,7,2023,0,326,86,8,5,2,1046,87,20959,2384,222829,243788,9/23/2020
8/18/2020,128,30064,5049,424841,454905,11,2446,9,2032,1,327,87,8,4,5,1051,97,21056,2782,225611,246667,9/23/2020
8/19/2020,114,30178,5407,430248,460426,8,2454,9,2041,1,328,85,9,5,0,1051,90,21146,2677,228288,249434,9/23/2020
8/20/2020,174,30352,8220,438468,468820,12,2466,6,2047,2,330,89,10,5,3,1054,137,21283,3568,231856,253139,9/23/2020
8/21/2020,154,30506,6811,445279,475785,8,2474,5,2052,1,331,91,9,4,2,1056,125,21408,2969,234825,256233,9/23/2020
8/22/2020,96,30602,5958,451237,481839,10,2484,12,2064,0,331,89,11,4,1,1057,84,21492,2626,237451,258943,9/23/2020
8/23/2020,70,30672,4365,455602,486274,11,2495,6,2070,0,331,94,11,2,1,1058,57,21549,2469,239920,261469,9/23/2020
8/24/2020,105,30777,5775,461377,492154,7,2502,10,2080,1,332,90,13,4,1,1059,75,21624,3156,243076,264700,9/23/2020
8/25/2020,108,30885,4776,466153,497038,10,2512,4,2084,1,333,95,11,4,1,1060,94,21718,2298,245374,267092,9/23/2020
8/26/2020,170,31055,9563,475716,506771,4,2516,8,2092,0,333,91,9,5,1,1061,128,21846,3077,248451,270297,9/23/2020
8/27/2020,93,31148,8800,484516,515664,6,2522,13,2105,1,334,83,6,5,2,1063,71,21917,3217,251668,273585,9/23/2020
8/28/2020,112,31260,8057,492573,523833,14,2536,4,2109,0,334,93,9,7,2,1065,88,22005,2432,254100,276105,9/23/2020
8/29/2020,65,31325,5414,497987,529312,6,2542,8,2117,1,335,90,10,6,1,1066,53,22058,1907,256007,278065,9/23/2020
8/30/2020,66,31391,4319,502306,533697,7,2549,4,2121,0,335,93,8,5,1,1067,48,22106,1994,258001,280107,9/23/2020
8/31/2020,105,31496,4867,507173,538669,10,2559,15,2136,0,335,88,8,4,0,1067,82,22188,2197,260198,282386,9/23/2020
9/1/2020,98,31594,7114,514287,545881,6,2565,9,2145,1,336,84,7,4,1,1068,67,22255,2376,262574,284829,9/23/2020
9/2/2020,124,31718,10554,524841,556559,9,2574,10,2155,1,337,82,8,4,2,1070,102,22357,2953,265527,287884,9/23/2020
9/3/2020,89,31807,11168,536009,567816,8,2582,8,2163,0,337,82,9,4,2,1072,76,22433,2579,268106,290539,9/23/2020
9/4/2020,102,31909,9027,545036,576945,11,2593,4,2167,0,337,89,9,4,1,1073,83,22516,2403,270509,293025,9/23/2020
9/5/2020,52,31961,6280,551316,583277,6,2599,9,2176,0,337,86,8,3,1,1074,42,22558,1588,272097,294655,9/23/2020
9/6/2020,87,32048,4310,555626,587674,4,2603,8,2184,1,338,81,6,3,1,1075,66,22624,1954,274051,296675,9/23/2020
9/7/2020,35,32083,2999,558625,590708,11,2614,3,2187,0,338,89,5,3,1,1076,26,22650,649,274700,297350,9/23/2020
9/8/2020,74,32157,6341,564966,597123,6,2620,12,2199,1,339,82,6,3,2,1078,67,22717,1592,276292,299009,9/23/2020
9/9/2020,118,32275,8794,573760,606035,9,2629,5,2204,1,340,85,9,3,1,1079,100,22817,2132,278424,301241,9/23/2020
9/10/2020,166,32441,11396,585156,617597,8,2637,8,2212,0,340,85,10,3,0,1079,115,22932,2269,280693,303625,9/23/2020
9/11/2020,119,32560,9418,594574,627134,11,2648,11,2223,0,340,85,10,5,0,1079,98,23030,1952,282645,305675,9/23/2020
9/12/2020,107,32667,6071,600645,633312,8,2656,5,2228,2,342,86,9,5,3,1082,101,23131,1449,284094,307225,9/23/2020
9/13/2020,58,32725,2614,603259,635984,4,2660,3,2231,0,342,87,9,5,0,1082,54,23185,804,284898,308083,9/23/2020
9/14/2020,101,32826,6238,609497,642323,5,2665,3,2234,2,344,87,9,5,1,1083,92,23277,1609,286507,309784,9/23/2020
9/15/2020,138,32964,8248,617745,650709,5,2670,2,2236,1,345,89,9,5,2,1085,118,23395,1960,288467,311862,9/23/2020
9/16/2020,151,33115,9532,627277,660392,7,2677,7,2243,2,347,87,7,6,5,1090,113,23508,1830,290297,313805,9/23/2020
9/17/2020,136,33251,9179,636456,669707,7,2684,14,2257,0,347,80,8,3,0,1090,156,23664,1881,292178,315842,9/23/2020
9/18/2020,200,33451,10046,646502,679953,6,2690,7,2264,1,348,78,11,5,2,1092,131,23795,2000,294178,317973,9/23/2020
9/19/2020,160,33611,8397,654899,688510,7,2697,3,2267,0,348,82,10,5,4,1096,110,23905,1776,295954,319859,9/23/2020
9/20/2020,81,33692,3769,658668,692360,6,2703,5,2272,2,350,81,10,7,4,1100,54,23959,1406,297360,321319,9/23/2020
9/21/2020,122,33814,5862,664530,698344,10,2713,3,2275,2,352,86,9,5,1,1101,97,24056,1849,299209,323265,9/23/2020
9/22/2020,138,33952,8096,672626,706578,,,,,,,,,,1,1102,121,24177,1734,300943,325120,9/23/2020
2/27/2020,0,0,0,0,0,1,1,0,0,0,0,1,0,0,0,0,0,0,0,0,0,9/24/2020
2/28/2020,0,0,0,0,0,0,1,0,0,0,0,1,1,0,0,0,0,0,0,0,0,9/24/2020
2/29/2020,0,0,0,0,0,0,1,0,0,0,0,1,1,0,0,0,0,0,0,0,0,9/24/2020
3/1/2020,2,2,2,2,4,0,1,0,0,0,0,1,1,1,0,0,2,2,2,2,4,9/24/2020
3/2/2020,0,2,1,3,5,1,2,0,0,0,0,2,2,2,0,0,0,2,1,3,5,9/24/2020
3/3/2020,0,2,2,5,7,0,2,0,0,0,0,2,2,2,0,0,0,2,2,5,7,9/24/2020
3/4/2020,0,2,12,17,19,1,3,0,0,0,0,3,2,2,0,0,0,2,10,15,17,9/24/2020
3/5/2020,0,2,4,21,23,0,3,0,0,0,0,3,2,2,0,0,1,3,4,19,22,9/24/2020
3/6/2020,1,3,12,33,36,0,3,0,0,0,0,3,2,2,0,0,0,3,11,30,33,9/24/2020
3/7/2020,0,3,19,52,55,0,3,0,0,0,0,3,2,1,0,0,0,3,19,49,52,9/24/2020
3/8/2020,0,3,18,70,73,0,3,0,0,0,0,3,2,1,0,0,0,3,18,67,70,9/24/2020
3/9/2020,1,4,15,85,89,0,3,0,0,0,0,3,2,1,0,0,1,4,15,82,86,9/24/2020
3/10/2020,2,6,25,110,116,0,3,0,0,0,0,3,2,1,0,0,1,5,23,105,110,9/24/2020
3/11/2020,0,6,34,144,150,1,4,0,0,0,0,4,1,1,0,0,0,5,34,139,144,9/24/2020
3/12/2020,9,15,41,185,200,1,5,0,0,0,0,5,1,1,0,0,8,13,38,177,190,9/24/2020
3/13/2020,6,21,50,235,256,4,9,1,1,0,0,8,1,1,0,0,6,19,48,225,244,9/24/2020
3/14/2020,0,21,90,325,346,0,9,0,1,0,0,8,1,1,0,0,0,19,86,311,330,9/24/2020
3/15/2020,1,22,54,379,401,1,10,0,1,0,0,9,2,1,0,0,1,20,54,365,385,9/24/2020
3/16/2020,2,24,95,474,498,2,12,0,1,0,0,11,2,0,0,0,2,22,92,457,479,9/24/2020
3/17/2020,12,36,162,636,672,6,18,0,1,0,0,17,2,0,0,0,11,33,151,608,641,9/24/2020
3/18/2020,9,45,116,752,797,3,21,0,1,0,0,20,2,0,0,0,11,44,110,718,762,9/24/2020
3/19/2020,15,60,262,1014,1074,2,23,1,2,0,0,21,3,0,1,1,17,61,251,969,1030,9/24/2020
3/20/2020,13,73,197,1211,1284,5,28,0,2,0,0,26,4,0,0,1,13,74,191,1160,1234,9/24/2020
3/21/2020,12,85,126,1337,1422,3,31,2,4,0,0,27,5,0,0,1,14,88,123,1283,1371,9/24/2020
3/22/2020,27,112,282,1619,1731,2,33,0,4,0,0,29,5,0,0,1,25,113,262,1545,1658,9/24/2020
3/23/2020,14,126,169,1788,1914,15,48,1,5,0,0,43,9,3,0,1,16,129,165,1710,1839,9/24/2020
3/24/2020,20,146,242,2030,2176,7,55,0,5,0,0,50,10,4,0,1,19,148,237,1947,2095,9/24/2020
3/25/2020,26,172,182,2212,2384,5,60,1,6,0,0,54,11,3,0,1,28,176,172,2119,2295,9/24/2020
3/26/2020,35,207,181,2393,2600,10,70,5,11,0,0,59,14,5,0,1,41,217,175,2294,2511,9/24/2020
3/27/2020,27,234,214,2607,2841,9,79,1,12,1,1,66,17,6,2,3,31,248,202,2496,2744,9/24/2020
3/28/2020,59,293,260,2867,3160,13,92,3,15,2,3,74,15,6,1,4,63,311,241,2737,3048,9/24/2020
3/29/2020,100,393,350,3217,3610,8,100,4,19,1,4,77,18,8,2,6,105,416,313,3050,3466,9/24/2020
3/30/2020,62,455,222,3439,3894,20,120,5,24,0,4,92,20,11,3,9,78,494,184,3234,3728,9/24/2020
3/31/2020,71,526,369,3808,4334,11,131,7,31,1,5,95,22,13,2,11,73,567,297,3531,4098,9/24/2020
4/1/2020,99,625,698,4506,5131,18,149,7,38,0,5,106,30,15,1,12,102,669,640,4171,4840,9/24/2020
4/2/2020,52,677,477,4983,5660,22,171,6,44,2,7,120,36,21,4,16,62,731,436,4607,5338,9/24/2020
4/3/2020,108,785,774,5757,6542,23,194,7,51,0,7,136,43,25,3,19,100,831,712,5319,6150,9/24/2020
4/4/2020,143,928,660,6417,7345,22,216,4,55,5,12,149,41,30,9,28,137,968,618,5937,6905,9/24/2020
4/5/2020,187,1115,1156,7573,8688,20,236,9,64,1,13,159,44,36,2,30,182,1150,1068,7005,8155,9/24/2020
4/6/2020,218,1333,1706,9279,10612,26,262,7,71,0,13,178,48,40,7,37,206,1356,1553,8558,9914,9/24/2020
4/7/2020,284,1617,1629,10908,12525,20,282,5,76,2,15,191,50,42,5,42,261,1617,1481,10039,11656,9/24/2020
4/8/2020,290,1907,1720,12628,14535,19,301,7,83,6,21,197,50,38,10,52,273,1890,1560,11599,13489,9/24/2020
4/9/2020,283,2190,1516,14144,16334,32,333,9,92,4,25,216,53,40,7,59,280,2170,1355,12954,15124,9/24/2020
4/10/2020,419,2609,2574,16718,19327,29,362,16,108,5,30,224,59,41,11,70,403,2573,2371,15325,17898,9/24/2020
4/11/2020,297,2906,1905,18623,21529,29,391,11,119,2,32,240,61,48,12,82,280,2853,1720,17045,19898,9/24/2020
4/12/2020,314,3220,1670,20293,23513,35,426,13,132,5,37,257,59,49,9,91,289,3142,1435,18480,21622,9/24/2020
4/13/2020,161,3381,935,21228,24609,35,461,13,145,3,40,276,64,54,9,100,187,3329,838,19318,22647,9/24/2020
4/14/2020,289,3670,1787,23015,26685,27,488,17,162,5,45,281,72,53,8,108,265,3594,1528,20846,24440,9/24/2020
4/15/2020,351,4021,1799,24814,28835,31,519,20,182,3,48,289,72,54,17,125,307,3901,1553,22399,26300,9/24/2020
4/16/2020,447,4468,2494,27308,31776,36,555,25,207,6,54,294,72,53,14,139,390,4291,2077,24476,28767,9/24/2020
4/17/2020,304,4772,1821,29129,33901,32,587,20,227,7,61,299,66,45,21,160,293,4584,1446,25922,30506,9/24/2020
4/18/2020,321,5093,1725,30854,35947,26,613,18,245,4,65,303,63,49,15,175,286,4870,1325,27247,32117,9/24/2020
4/19/2020,381,5474,2047,32901,38375,23,636,26,271,1,66,299,65,55,11,186,338,5208,1741,28988,34196,9/24/2020
4/20/2020,394,5868,1907,34808,40676,46,682,29,300,2,68,314,75,56,10,196,377,5585,1574,30562,36147,9/24/2020
4/21/2020,444,6312,2110,36918,43230,45,727,33,333,5,73,321,72,56,18,214,391,5976,1707,32269,38245,9/24/2020
4/22/2020,418,6730,2390,39308,46038,41,768,32,365,5,78,325,73,58,18,232,384,6360,1915,34184,40544,9/24/2020
4/23/2020,479,7209,2469,41777,48986,32,800,28,393,5,83,324,76,62,15,247,420,6780,1857,36041,42821,9/24/2020
4/24/2020,491,7700,3284,45061,52761,35,835,26,419,4,87,329,85,63,15,262,416,7196,2627,38668,45864,9/24/2020
4/25/2020,393,8093,2206,47267,55360,34,869,17,436,5,92,341,85,62,14,276,304,7500,1769,40437,47937,9/24/2020
4/26/2020,316,8409,2309,49576,57985,33,902,15,451,3,95,356,86,59,14,290,275,7775,1877,42314,50089,9/24/2020
4/27/2020,249,8658,1620,51196,59854,29,931,21,472,4,99,360,86,61,10,300,204,7979,1162,43476,51455,9/24/2020
4/28/2020,410,9068,2263,53459,62527,44,975,24,496,3,102,377,88,59,22,322,330,8309,1763,45239,53548,9/24/2020
4/29/2020,476,9544,3343,56802,66346,36,1011,38,534,11,113,364,78,53,18,340,373,8682,2425,47664,56346,9/24/2020
4/30/2020,432,9976,2769,59571,69547,33,1044,38,572,6,119,353,83,57,24,364,353,9035,1937,49601,58636,9/24/2020
5/1/2020,454,10430,3086,62657,73087,51,1095,39,611,3,122,362,84,58,14,378,320,9355,2194,51795,61150,9/24/2020
5/2/2020,257,10687,1926,64583,75270,36,1131,38,649,5,127,355,91,62,24,402,189,9544,1278,53073,62617,9/24/2020
5/3/2020,283,10970,2160,66743,77713,31,1162,26,675,8,135,352,90,61,21,423,182,9726,1592,54665,64391,9/24/2020
5/4/2020,387,11357,2098,68841,80198,30,1192,31,706,6,141,345,88,57,18,441,293,10019,1567,56232,66251,9/24/2020
5/5/2020,433,11790,2873,71714,83504,29,1221,32,738,6,147,336,82,54,16,457,308,10327,1966,58198,68525,9/24/2020
5/6/2020,488,12278,2830,74544,86822,28,1249,44,782,9,156,311,79,54,21,478,342,10669,1918,60116,70785,9/24/2020
5/7/2020,425,12703,2969,77513,90216,36,1285,41,823,5,161,301,71,52,21,499,274,10943,1969,62085,73028,9/24/2020
5/8/2020,359,13062,2598,80111,93173,30,1315,29,852,5,166,297,71,53,22,521,233,11176,1738,63823,74999,9/24/2020
5/9/2020,467,13529,3346,83457,96986,22,1337,21,873,4,170,294,69,51,15,536,291,11467,2259,66082,77549,9/24/2020
5/10/2020,285,13814,2117,85574,99388,20,1357,23,896,6,176,285,70,49,13,549,188,11655,1523,67605,79260,9/24/2020
5/11/2020,257,14071,1857,87431,101502,31,1388,16,912,6,182,294,71,49,15,564,178,11833,1301,68906,80739,9/24/2020
5/12/2020,387,14458,2611,90042,104500,23,1411,18,930,4,186,295,69,48,22,586,218,12051,1708,70614,82665,9/24/2020
5/13/2020,351,14809,3630,93672,108481,23,1434,25,955,1,187,292,69,49,13,599,199,12250,2006,72620,84870,9/24/2020
5/14/2020,329,15138,3408,97080,112218,19,1453,27,982,3,190,281,64,45,15,614,232,12482,2019,74639,87121,9/24/2020
5/15/2020,381,15519,3458,100538,116057,24,1477,41,1023,5,195,259,62,45,14,628,237,12719,1811,76450,89169,9/24/2020
5/16/2020,449,15968,4156,104694,120662,25,1502,13,1036,5,200,266,61,46,15,643,252,12971,1963,78413,91384,9/24/2020
5/17/2020,240,16208,2768,107462,123670,17,1519,8,1044,5,205,270,59,45,10,653,129,13100,1559,79972,93072,9/24/2020
5/18/2020,250,16458,2001,109463,125921,19,1538,15,1059,5,210,269,57,40,18,671,140,13240,1369,81341,94581,9/24/2020
5/19/2020,415,16873,3168,112631,129504,23,1561,32,1091,5,215,255,56,38,11,682,214,13454,1928,83269,96723,9/24/2020
5/20/2020,326,17199,2771,115402,132601,19,1580,23,1114,7,222,244,52,33,22,704,188,13642,1516,84785,98427,9/24/2020
5/21/2020,374,17573,3757,119159,136732,26,1606,15,1129,3,225,252,53,29,20,724,170,13812,1940,86725,100537,9/24/2020
5/22/2020,351,17924,3161,122320,140244,20,1626,29,1158,5,230,238,52,29,10,734,204,14016,1611,88336,102352,9/24/2020
5/23/2020,253,18177,2742,125062,143239,19,1645,11,1169,3,233,243,52,32,13,747,108,14124,1272,89608,103732,9/24/2020
5/24/2020,163,18340,1370,126432,144772,12,1657,14,1183,2,235,239,53,36,8,755,82,14206,773,90381,104587,9/24/2020
5/25/2020,147,18487,1385,127817,146304,13,1670,14,1197,0,235,238,53,34,10,765,72,14278,762,91143,105421,9/24/2020
5/26/2020,285,18772,2620,130437,149209,24,1694,22,1219,5,240,235,48,33,15,780,163,14441,1781,92924,107365,9/24/2020
5/27/2020,276,19048,2057,132494,151542,20,1714,18,1237,3,243,234,50,33,10,790,134,14575,1134,94058,108633,9/24/2020
5/28/2020,348,19396,3359,135853,155249,17,1731,29,1266,4,247,218,47,32,8,798,134,14709,1120,95178,109887,9/24/2020
5/29/2020,410,19806,3914,139767,159573,19,1750,27,1293,6,253,204,43,31,12,810,177,14886,1571,96749,111635,9/24/2020
5/30/2020,225,20031,3915,143682,163713,15,1765,19,1312,4,257,196,40,29,12,822,109,14995,1820,98569,113564,9/24/2020
5/31/2020,155,20186,1688,145370,165556,11,1776,10,1322,0,257,197,43,26,3,825,78,15073,857,99426,114499,9/24/2020
6/1/2020,212,20398,2792,148162,168560,8,1784,14,1336,1,258,190,44,29,5,830,99,15172,1384,100810,115982,9/24/2020
6/2/2020,273,20671,3022,151184,171855,8,1792,9,1345,3,261,186,37,25,10,840,107,15279,1449,102259,117538,9/24/2020
6/3/2020,254,20925,3486,154670,175595,14,1806,18,1363,6,267,176,34,25,11,851,105,15384,1662,103921,119305,9/24/2020
6/4/2020,276,21201,4471,159141,180342,7,1813,25,1388,3,270,155,31,24,11,862,111,15495,2039,105960,121455,9/24/2020
6/5/2020,215,21416,3513,162654,184070,15,1828,13,1401,6,276,151,27,21,11,873,106,15601,1577,107537,123138,9/24/2020
6/6/2020,201,21617,2616,165270,186887,10,1838,7,1408,2,278,152,29,19,6,879,69,15670,1136,108673,124343,9/24/2020
6/7/2020,83,21700,1625,166895,188595,11,1849,7,1415,1,279,155,25,17,4,883,50,15720,782,109455,125175,9/24/2020
6/8/2020,119,21819,1849,168744,190563,15,1864,12,1427,2,281,156,27,18,4,887,44,15764,962,110417,126181,9/24/2020
6/9/2020,223,22042,2673,171417,193459,10,1874,18,1445,0,281,148,28,21,1,888,67,15831,1258,111675,127506,9/24/2020
6/10/2020,209,22251,2987,174404,196655,13,1887,12,1457,2,283,147,24,17,4,892,105,15936,1467,113142,129078,9/24/2020
6/11/2020,195,22446,3513,177917,200363,7,1894,15,1472,1,284,138,25,16,6,898,88,16024,1535,114677,130701,9/24/2020
6/12/2020,209,22655,4601,182518,205173,9,1903,15,1487,1,285,131,24,16,2,900,82,16106,2185,116862,132968,9/24/2020
6/13/2020,113,22768,3036,185554,208322,6,1909,4,1491,0,285,133,20,15,3,903,50,16156,1373,118235,134391,9/24/2020
6/14/2020,81,22849,2046,187600,210449,7,1916,8,1499,1,286,131,20,14,3,906,33,16189,968,119203,135392,9/24/2020
6/15/2020,188,23037,3108,190708,213745,14,1930,14,1513,0,286,131,20,16,5,911,78,16267,1791,120994,137261,9/24/2020
6/16/2020,110,23147,3017,193725,216872,10,1940,9,1522,1,287,131,22,16,8,919,52,16319,1578,122572,138891,9/24/2020
6/17/2020,127,23274,2835,196560,219834,15,1955,20,1542,4,291,122,18,14,6,925,53,16372,1319,123891,140263,9/24/2020
6/18/2020,149,23423,3047,199607,223030,9,1964,13,1555,1,292,117,19,16,7,932,70,16442,1314,125205,141647,9/24/2020
6/19/2020,141,23564,3769,203376,226940,12,1976,11,1566,1,293,117,20,17,3,935,59,16501,1372,126577,143078,9/24/2020
6/20/2020,84,23648,1891,205267,228915,9,1985,12,1578,0,293,114,20,18,4,939,36,16537,813,127390,143927,9/24/2020
6/21/2020,37,23685,1064,206331,230016,8,1993,5,1583,0,293,117,20,18,2,941,28,16565,692,128082,144647,9/24/2020
6/22/2020,138,23823,3730,210061,233884,12,2005,16,1599,0,293,113,19,18,1,942,69,16634,1708,129790,146424,9/24/2020
6/23/2020,163,23986,3831,213892,237878,3,2008,13,1612,3,296,100,18,18,7,949,83,16717,1782,131572,148289,9/24/2020
6/24/2020,120,24106,3502,217394,241500,9,2017,10,1622,1,297,98,18,18,5,954,46,16763,1687,133259,150022,9/24/2020
6/25/2020,103,24209,2883,220277,244486,6,2023,14,1636,1,298,89,17,17,1,955,54,16817,1511,134770,151587,9/24/2020
6/26/2020,94,24303,2488,222765,247068,2,2025,10,1646,0,298,81,18,18,1,956,63,16880,1332,136102,152982,9/24/2020
6/27/2020,84,24387,3214,225979,250366,5,2030,3,1649,1,299,82,17,17,5,961,37,16917,1221,137323,154240,9/24/2020
6/28/2020,39,24426,1469,227448,251874,4,2034,4,1653,4,303,78,15,14,6,967,19,16936,596,137919,154855,9/24/2020
6/29/2020,85,24511,3697,231145,255656,4,2038,5,1658,0,303,77,14,14,1,968,39,16975,1354,139273,156248,9/24/2020
6/30/2020,57,24568,1956,233101,257669,1,2039,5,1663,1,304,72,12,11,4,972,33,17008,995,140268,157276,9/24/2020
7/1/2020,144,24712,4098,237199,261911,7,2046,9,1672,0,304,70,11,11,1,973,80,17088,1936,142204,159292,9/24/2020
7/2/2020,103,24815,2803,240002,264817,5,2051,5,1677,1,305,69,10,10,2,975,57,17145,1089,143293,160438,9/24/2020
7/3/2020,50,24865,2076,242078,266943,9,2060,6,1683,0,305,72,9,9,3,978,26,17171,778,144071,161242,9/24/2020
7/4/2020,57,24922,2345,244423,269345,2,2062,4,1687,1,306,69,10,9,2,980,34,17205,1010,145081,162286,9/24/2020
7/5/2020,49,24971,2932,247355,272326,1,2063,2,1689,1,307,67,8,8,2,982,26,17231,1446,146527,163758,9/24/2020
7/6/2020,101,25072,2811,250166,275238,6,2069,6,1695,0,307,67,9,9,4,986,58,17289,1552,148079,165368,9/24/2020
7/7/2020,81,25153,3457,253623,278776,5,2074,7,1702,0,307,65,8,8,2,988,48,17337,1535,149614,166951,9/24/2020
7/8/2020,105,25258,3403,257026,282284,4,2078,2,1704,0,307,67,9,8,0,988,65,17402,1425,151039,168441,9/24/2020
7/9/2020,94,25352,3712,260738,286090,9,2087,3,1707,0,307,73,9,8,0,988,51,17453,1630,152669,170122,9/24/2020
7/10/2020,131,25483,4431,265169,290652,6,2093,3,1710,2,309,74,7,7,3,991,80,17533,2079,154748,172281,9/24/2020
7/11/2020,63,25546,2932,268101,293647,6,2099,3,1713,1,310,76,6,6,3,994,34,17567,1317,156065,173632,9/24/2020
7/12/2020,47,25593,1836,269937,295530,1,2100,3,1716,1,311,73,6,5,3,997,34,17601,943,157008,174609,9/24/2020
7/13/2020,84,25677,3157,273094,298771,8,2108,10,1726,0,311,71,6,5,1,998,61,17662,1473,158481,176143,9/24/2020
7/14/2020,73,25750,3289,276383,302133,7,2115,4,1730,0,311,74,5,5,1,999,49,17711,1373,159854,177565,9/24/2020
7/15/2020,130,25880,4168,280551,306431,5,2120,7,1737,0,311,72,5,4,0,999,100,17811,1750,161604,179415,9/24/2020
7/16/2020,102,25982,3733,284284,310266,6,2126,9,1746,0,311,69,6,5,1,1000,78,17889,1618,163222,181111,9/24/2020
7/17/2020,156,26138,4235,288519,314657,14,2140,3,1749,1,312,79,5,5,2,1002,81,17970,1849,165071,183041,9/24/2020
7/18/2020,85,26223,3267,291786,318009,5,2145,9,1758,1,313,74,5,4,4,1006,69,18039,1401,166472,184511,9/24/2020
7/19/2020,82,26305,2693,294479,320784,7,2152,3,1761,0,313,78,6,4,2,1008,59,18098,1149,167621,185719,9/24/2020
7/20/2020,71,26376,2664,297143,323519,9,2161,7,1768,0,313,80,7,5,2,1010,69,18167,1466,169087,187254,9/24/2020
7/21/2020,130,26506,4298,301441,327947,9,2170,11,1779,0,313,78,9,6,1,1011,109,18276,1919,171006,189282,9/24/2020
7/22/2020,130,26636,3926,305367,332003,11,2181,11,1790,1,314,77,7,6,1,1012,87,18363,1683,172689,191052,9/24/2020
7/23/2020,141,26777,4376,309743,336520,8,2189,6,1796,0,314,79,8,7,0,1012,116,18479,1970,174659,193138,9/24/2020
7/24/2020,172,26949,5959,315702,342651,14,2203,14,1810,0,314,79,9,7,0,1012,123,18602,2322,176981,195583,9/24/2020
7/25/2020,134,27083,4398,320100,347183,7,2210,7,1817,0,314,79,10,8,2,1014,107,18709,2100,179081,197790,9/24/2020
7/26/2020,62,27145,3027,323127,350272,8,2218,9,1826,0,314,78,11,7,1,1015,54,18763,1340,180421,199184,9/24/2020
7/27/2020,186,27331,4163,327290,354621,12,2230,7,1833,0,314,83,13,8,1,1016,141,18904,2334,182755,201659,9/24/2020
7/28/2020,105,27436,3831,331121,358557,5,2235,5,1838,0,314,83,14,7,1,1017,94,18998,1632,184387,203385,9/24/2020
7/29/2020,191,27627,5123,336244,363871,11,2246,12,1850,0,314,82,15,7,0,1017,157,19155,2324,186711,205866,9/24/2020
7/30/2020,121,27748,4344,340588,368336,6,2252,2,1852,1,315,85,15,6,1,1018,96,19251,1651,188362,207613,9/24/2020
7/31/2020,131,27879,5508,346096,373975,8,2260,10,1862,0,315,83,15,7,1,1019,90,19341,1856,190218,209559,9/24/2020
8/1/2020,108,27987,4288,350384,378371,7,2267,2,1864,0,315,88,14,7,1,1020,88,19429,1558,191776,211205,9/24/2020
8/2/2020,84,28071,2802,353186,381257,12,2279,12,1876,2,317,86,14,8,2,1022,62,19491,1275,193051,212542,9/24/2020
8/3/2020,187,28258,5203,358389,386647,13,2292,12,1888,0,317,87,16,7,1,1023,154,19645,2186,195237,214882,9/24/2020
8/4/2020,126,28384,3687,362076,390460,8,2300,6,1894,1,318,88,12,5,2,1025,99,19744,1771,197008,216752,9/24/2020
8/5/2020,148,28532,5914,367990,396522,12,2312,10,1904,1,319,89,10,5,2,1027,118,19862,2469,199477,219339,9/24/2020
8/6/2020,169,28701,5533,373523,402224,7,2319,9,1913,0,319,87,9,4,0,1027,122,19984,2422,201899,221883,9/24/2020
8/7/2020,122,28823,4845,378368,407191,13,2332,10,1923,1,320,89,9,3,2,1029,90,20074,2155,204054,224128,9/24/2020
8/8/2020,122,28945,4105,382473,411418,19,2351,6,1929,1,321,101,8,3,1,1030,95,20169,1781,205835,226004,9/24/2020
8/9/2020,42,28987,1722,384195,413182,8,2359,10,1939,0,321,99,9,4,0,1030,36,20205,1076,206911,227116,9/24/2020
8/10/2020,149,29136,4577,388772,417908,11,2370,12,1951,0,321,98,9,4,1,1031,112,20317,2029,208940,229257,9/24/2020
8/11/2020,105,29241,4320,393092,422333,6,2376,14,1965,0,321,90,10,4,3,1034,93,20410,2269,211209,231619,9/24/2020
8/12/2020,121,29362,5184,398276,427638,8,2384,11,1976,0,321,87,9,3,1,1035,103,20513,2629,213838,234351,9/24/2020
8/13/2020,135,29497,4190,402466,431963,13,2397,12,1988,0,321,88,11,3,0,1035,97,20610,1910,215748,236358,9/24/2020
8/14/2020,145,29642,5462,407928,437570,13,2410,11,1999,0,321,90,11,4,3,1038,101,20711,1955,217703,238414,9/24/2020
8/15/2020,105,29747,4532,412460,442207,8,2418,11,2010,1,322,86,11,5,0,1038,90,20801,1703,219406,240207,9/24/2020
8/16/2020,83,29830,2784,415244,445074,7,2425,6,2016,4,326,83,8,4,6,1044,71,20872,985,220391,241263,9/24/2020
8/17/2020,106,29936,4547,419791,449727,10,2435,7,2023,0,326,86,8,5,2,1046,87,20959,2383,222774,243733,9/24/2020
8/18/2020,128,30064,5047,424838,454902,11,2446,9,2032,1,327,87,8,4,5,1051,97,21056,2780,225554,246610,9/24/2020
8/19/2020,114,30178,5407,430245,460423,8,2454,9,2041,1,328,85,9,5,0,1051,90,21146,2675,228229,249375,9/24/2020
8/20/2020,174,30352,8218,438463,468815,12,2466,6,2047,2,330,89,10,5,3,1054,137,21283,3568,231797,253080,9/24/2020
8/21/2020,154,30506,6811,445274,475780,8,2474,5,2052,1,331,91,9,4,2,1056,125,21408,2965,234762,256170,9/24/2020
8/22/2020,96,30602,5957,451231,481833,10,2484,12,2064,0,331,89,11,4,1,1057,84,21492,2625,237387,258879,9/24/2020
8/23/2020,70,30672,4365,455596,486268,11,2495,6,2070,0,331,94,11,2,1,1058,57,21549,2469,239856,261405,9/24/2020
8/24/2020,105,30777,5775,461371,492148,7,2502,10,2080,1,332,90,13,4,1,1059,75,21624,3153,243009,264633,9/24/2020
8/25/2020,108,30885,4745,466116,497001,10,2512,4,2084,1,333,95,11,4,1,1060,94,21718,2295,245304,267022,9/24/2020
8/26/2020,170,31055,9490,475606,506661,4,2516,8,2092,0,333,91,9,5,1,1061,128,21846,3069,248373,270219,9/24/2020
8/27/2020,93,31148,8798,484404,515552,6,2522,13,2105,1,334,83,6,5,2,1063,71,21917,3210,251583,273500,9/24/2020
8/28/2020,112,31260,8056,492460,523720,14,2536,4,2109,0,334,93,9,7,2,1065,88,22005,2428,254011,276016,9/24/2020
8/29/2020,65,31325,5412,497872,529197,6,2542,8,2117,1,335,90,10,6,2,1067,53,22058,1905,255916,277974,9/24/2020
8/30/2020,66,31391,4319,502191,533582,7,2549,4,2121,0,335,93,8,5,2,1069,48,22106,1993,257909,280015,9/24/2020
8/31/2020,105,31496,4867,507058,538554,10,2559,15,2136,0,335,88,8,4,0,1069,82,22188,2197,260106,282294,9/24/2020
9/1/2020,98,31594,7115,514173,545767,6,2565,9,2145,1,336,84,7,4,2,1071,67,22255,2377,262483,284738,9/24/2020
9/2/2020,125,31719,10653,524826,556545,9,2574,10,2155,1,337,82,8,4,2,1073,102,22357,3038,265521,287878,9/24/2020
9/3/2020,89,31808,11167,535993,567801,8,2582,8,2163,0,337,82,9,4,2,1075,76,22433,2577,268098,290531,9/24/2020
9/4/2020,102,31910,9024,545017,576927,11,2593,4,2167,0,337,89,9,4,1,1076,83,22516,2399,270497,293013,9/24/2020
9/5/2020,52,31962,6279,551296,583258,6,2599,9,2176,0,337,86,8,3,1,1077,42,22558,1588,272085,294643,9/24/2020
9/6/2020,87,32049,4310,555606,587655,4,2603,8,2184,1,338,81,6,3,1,1078,66,22624,1954,274039,296663,9/24/2020
9/7/2020,35,32084,2999,558605,590689,11,2614,3,2187,0,338,89,5,3,1,1079,26,22650,649,274688,297338,9/24/2020
9/8/2020,74,32158,6342,564947,597105,6,2620,12,2199,1,339,82,6,3,2,1081,67,22717,1592,276280,298997,9/24/2020
9/9/2020,118,32276,8799,573746,606022,9,2629,5,2204,1,340,85,9,3,1,1082,100,22817,2137,278417,301234,9/24/2020
9/10/2020,165,32441,11395,585141,617582,8,2637,8,2212,0,340,85,10,3,0,1082,115,22932,2269,280686,303618,9/24/2020
9/11/2020,119,32560,9418,594559,627119,11,2648,11,2223,0,340,85,10,5,0,1082,98,23030,1952,282638,305668,9/24/2020
9/12/2020,107,32667,6069,600628,633295,8,2656,5,2228,2,342,86,9,5,3,1085,102,23132,1447,284085,307217,9/24/2020
9/13/2020,58,32725,2613,603241,635966,4,2660,3,2231,0,342,87,9,5,0,1085,54,23186,804,284889,308075,9/24/2020
9/14/2020,101,32826,6238,609479,642305,5,2665,3,2234,2,344,87,9,5,1,1086,93,23279,1609,286498,309777,9/24/2020
9/15/2020,138,32964,8217,617696,650660,5,2670,2,2236,1,345,89,9,5,2,1088,118,23397,1948,288446,311843,9/24/2020
9/16/2020,151,33115,9490,627186,660301,7,2677,7,2243,2,347,87,7,6,5,1093,113,23510,1788,290234,313744,9/24/2020
9/17/2020,135,33250,9135,636321,669571,7,2684,14,2257,0,347,80,8,3,0,1093,155,23665,1843,292077,315742,9/24/2020
9/18/2020,200,33450,9951,646272,679722,6,2690,7,2264,1,348,78,11,5,2,1095,133,23798,1919,293996,317794,9/24/2020
9/19/2020,160,33610,8329,654601,688211,7,2697,3,2267,0,348,82,10,5,4,1099,110,23908,1725,295721,319629,9/24/2020
9/20/2020,81,33691,3769,658370,692061,6,2703,5,2272,2,350,81,10,7,4,1103,55,23963,1406,297127,321090,9/24/2020
9/21/2020,124,33815,6788,665158,698973,11,2714,3,2275,2,352,87,9,5,2,1105,99,24062,2219,299346,323408,9/24/2020
9/22/2020,152,33967,8195,673353,707320,11,2725,3,2278,1,353,94,8,4,1,1106,110,24172,1779,301125,325297,9/24/2020
9/23/2020,144,34111,9583,682936,717047,,,,,,,,,,0,1106,139,24311,2147,303272,327583,9/24/2020
2/27/2020,0,0,0,0,0,1,1,0,0,0,0,1,0,0,0,0,0,0,0,0,0,9/25/2020
2/28/2020,0,0,0,0,0,0,1,0,0,0,0,1,1,0,0,0,0,0,0,0,0,9/25/2020
2/29/2020,0,0,0,0,0,0,1,0,0,0,0,1,1,0,0,0,0,0,0,0,0,9/25/2020
3/1/2020,2,2,2,2,4,0,1,0,0,0,0,1,1,1,0,0,2,2,2,2,4,9/25/2020
3/2/2020,0,2,1,3,5,1,2,0,0,0,0,2,2,2,0,0,0,2,1,3,5,9/25/2020
3/3/2020,0,2,2,5,7,0,2,0,0,0,0,2,2,2,0,0,0,2,2,5,7,9/25/2020
3/4/2020,0,2,12,17,19,1,3,0,0,0,0,3,2,2,0,0,0,2,10,15,17,9/25/2020
3/5/2020,0,2,4,21,23,0,3,0,0,0,0,3,2,2,0,0,1,3,4,19,22,9/25/2020
3/6/2020,1,3,12,33,36,0,3,0,0,0,0,3,2,2,0,0,0,3,11,30,33,9/25/2020
3/7/2020,0,3,19,52,55,0,3,0,0,0,0,3,2,1,0,0,0,3,19,49,52,9/25/2020
3/8/2020,0,3,18,70,73,0,3,0,0,0,0,3,2,1,0,0,0,3,18,67,70,9/25/2020
3/9/2020,1,4,15,85,89,0,3,0,0,0,0,3,2,1,0,0,1,4,15,82,86,9/25/2020
3/10/2020,2,6,25,110,116,0,3,0,0,0,0,3,2,1,0,0,1,5,23,105,110,9/25/2020
3/11/2020,0,6,34,144,150,1,4,0,0,0,0,4,1,1,0,0,0,5,34,139,144,9/25/2020
3/12/2020,9,15,41,185,200,1,5,0,0,0,0,5,1,1,0,0,8,13,38,177,190,9/25/2020
3/13/2020,6,21,50,235,256,4,9,1,1,0,0,8,1,1,0,0,6,19,48,225,244,9/25/2020
3/14/2020,0,21,90,325,346,0,9,0,1,0,0,8,1,1,0,0,0,19,86,311,330,9/25/2020
3/15/2020,1,22,54,379,401,1,10,0,1,0,0,9,2,1,0,0,1,20,54,365,385,9/25/2020
3/16/2020,2,24,95,474,498,2,12,0,1,0,0,11,2,0,0,0,2,22,92,457,479,9/25/2020
3/17/2020,12,36,162,636,672,6,18,0,1,0,0,17,2,0,0,0,11,33,151,608,641,9/25/2020
3/18/2020,9,45,116,752,797,3,21,0,1,0,0,20,2,0,0,0,11,44,110,718,762,9/25/2020
3/19/2020,15,60,262,1014,1074,2,23,1,2,0,0,21,3,0,1,1,17,61,251,969,1030,9/25/2020
3/20/2020,13,73,197,1211,1284,5,28,0,2,0,0,26,4,0,0,1,13,74,191,1160,1234,9/25/2020
3/21/2020,12,85,126,1337,1422,3,31,2,4,0,0,27,5,0,0,1,14,88,123,1283,1371,9/25/2020
3/22/2020,27,112,282,1619,1731,2,33,0,4,0,0,29,5,0,0,1,25,113,262,1545,1658,9/25/2020
3/23/2020,14,126,169,1788,1914,15,48,1,5,0,0,43,9,3,0,1,16,129,165,1710,1839,9/25/2020
3/24/2020,20,146,242,2030,2176,7,55,0,5,0,0,50,10,4,0,1,19,148,237,1947,2095,9/25/2020
3/25/2020,26,172,182,2212,2384,5,60,1,6,0,0,54,11,3,0,1,28,176,172,2119,2295,9/25/2020
3/26/2020,35,207,181,2393,2600,10,70,5,11,0,0,59,14,5,0,1,41,217,175,2294,2511,9/25/2020
3/27/2020,27,234,214,2607,2841,9,79,1,12,1,1,66,17,6,2,3,31,248,202,2496,2744,9/25/2020
3/28/2020,59,293,260,2867,3160,13,92,3,15,2,3,74,15,6,1,4,64,312,241,2737,3049,9/25/2020
3/29/2020,100,393,350,3217,3610,8,100,4,19,1,4,77,18,8,2,6,105,417,312,3049,3466,9/25/2020
3/30/2020,62,455,222,3439,3894,20,120,5,24,0,4,92,20,11,3,9,78,495,184,3233,3728,9/25/2020
3/31/2020,71,526,369,3808,4334,11,131,7,31,1,5,95,22,13,2,11,73,568,297,3530,4098,9/25/2020
4/1/2020,99,625,698,4506,5131,18,149,7,38,0,5,106,30,15,1,12,100,668,640,4170,4838,9/25/2020
4/2/2020,52,677,477,4983,5660,22,171,6,44,2,7,120,36,21,4,16,62,730,436,4606,5336,9/25/2020
4/3/2020,108,785,774,5757,6542,23,194,7,51,0,7,136,43,25,3,19,100,830,712,5318,6148,9/25/2020
4/4/2020,143,928,660,6417,7345,22,216,4,55,5,12,149,41,30,9,28,138,968,618,5936,6904,9/25/2020
4/5/2020,187,1115,1156,7573,8688,20,236,9,64,1,13,159,44,36,2,30,182,1150,1067,7003,8153,9/25/2020
4/6/2020,218,1333,1706,9279,10612,26,262,7,71,0,13,178,48,40,7,37,208,1358,1552,8555,9913,9/25/2020
4/7/2020,284,1617,1629,10908,12525,20,282,5,76,2,15,191,50,42,5,42,261,1619,1481,10036,11655,9/25/2020
4/8/2020,290,1907,1720,12628,14535,19,301,7,83,6,21,197,50,38,10,52,271,1890,1559,11595,13485,9/25/2020
4/9/2020,283,2190,1516,14144,16334,32,333,9,92,4,25,216,53,40,7,59,277,2167,1355,12950,15117,9/25/2020
4/10/2020,419,2609,2574,16718,19327,29,362,16,108,5,30,224,59,41,11,70,401,2568,2371,15321,17889,9/25/2020
4/11/2020,297,2906,1905,18623,21529,29,391,11,119,2,32,240,61,48,12,82,279,2847,1720,17041,19888,9/25/2020
4/12/2020,314,3220,1670,20293,23513,35,426,13,132,5,37,257,59,49,9,91,284,3131,1435,18476,21607,9/25/2020
4/13/2020,161,3381,935,21228,24609,35,461,13,145,3,40,276,64,54,9,100,187,3318,838,19314,22632,9/25/2020
4/14/2020,289,3670,1787,23015,26685,27,488,17,162,5,45,281,72,53,8,108,262,3580,1528,20842,24422,9/25/2020
4/15/2020,351,4021,1799,24814,28835,31,519,20,182,3,48,289,72,54,17,125,306,3886,1553,22395,26281,9/25/2020
4/16/2020,447,4468,2494,27308,31776,36,555,25,207,6,54,294,72,53,14,139,386,4272,2077,24472,28744,9/25/2020
4/17/2020,304,4772,1821,29129,33901,32,587,20,227,7,61,299,66,45,21,160,290,4562,1446,25918,30480,9/25/2020
4/18/2020,321,5093,1725,30854,35947,26,613,18,245,4,65,303,63,49,15,175,284,4846,1325,27243,32089,9/25/2020
4/19/2020,381,5474,2047,32901,38375,23,636,26,271,1,66,299,65,55,11,186,336,5182,1741,28984,34166,9/25/2020
4/20/2020,394,5868,1907,34808,40676,46,682,29,300,2,68,314,75,56,10,196,378,5560,1573,30557,36117,9/25/2020
4/21/2020,444,6312,2110,36918,43230,45,727,33,333,5,73,321,72,56,18,214,384,5944,1705,32262,38206,9/25/2020
4/22/2020,418,6730,2390,39308,46038,41,768,32,365,5,78,325,73,58,18,232,379,6323,1915,34177,40500,9/25/2020
4/23/2020,479,7209,2469,41777,48986,32,800,28,393,5,83,324,76,62,15,247,412,6735,1857,36034,42769,9/25/2020
4/24/2020,491,7700,3284,45061,52761,35,835,26,419,4,87,329,85,63,15,262,408,7143,2627,38661,45804,9/25/2020
4/25/2020,393,8093,2206,47267,55360,34,869,17,436,5,92,341,85,62,14,276,300,7443,1769,40430,47873,9/25/2020
4/26/2020,316,8409,2309,49576,57985,33,902,15,451,3,95,356,86,59,14,290,274,7717,1877,42307,50024,9/25/2020
4/27/2020,249,8658,1620,51196,59854,29,931,21,472,4,99,360,86,61,10,300,206,7923,1162,43469,51392,9/25/2020
4/28/2020,410,9068,2263,53459,62527,44,975,24,496,3,102,377,88,59,22,322,331,8254,1763,45232,53486,9/25/2020
4/29/2020,476,9544,3343,56802,66346,36,1011,38,534,11,113,364,78,53,18,340,371,8625,2425,47657,56282,9/25/2020
4/30/2020,432,9976,2769,59571,69547,33,1044,38,572,6,119,353,83,57,24,364,350,8975,1937,49594,58569,9/25/2020
5/1/2020,454,10430,3086,62657,73087,51,1095,39,611,3,122,362,84,58,14,378,325,9300,2188,51782,61082,9/25/2020
5/2/2020,257,10687,1926,64583,75270,36,1131,38,649,5,127,355,91,62,24,402,192,9492,1278,53060,62552,9/25/2020
5/3/2020,283,10970,2160,66743,77713,31,1162,26,675,8,135,352,90,61,21,423,183,9675,1592,54652,64327,9/25/2020
5/4/2020,387,11357,2098,68841,80198,30,1192,31,706,6,141,345,88,57,18,441,290,9965,1567,56219,66184,9/25/2020
5/5/2020,433,11790,2873,71714,83504,29,1221,32,738,6,147,336,82,54,16,457,299,10264,1965,58184,68448,9/25/2020
5/6/2020,488,12278,2830,74544,86822,28,1249,44,782,9,156,311,79,54,21,478,340,10604,1916,60100,70704,9/25/2020
5/7/2020,425,12703,2969,77513,90216,36,1285,41,823,5,161,301,71,52,21,499,269,10873,1969,62069,72942,9/25/2020
5/8/2020,359,13062,2598,80111,93173,30,1315,29,852,5,166,297,71,53,22,521,230,11103,1738,63807,74910,9/25/2020
5/9/2020,467,13529,3346,83457,96986,22,1337,21,873,4,170,294,69,51,15,536,290,11393,2259,66066,77459,9/25/2020
5/10/2020,285,13814,2117,85574,99388,20,1357,23,896,6,176,285,70,49,13,549,189,11582,1523,67589,79171,9/25/2020
5/11/2020,257,14071,1857,87431,101502,31,1388,16,912,6,182,294,71,49,15,564,174,11756,1301,68890,80646,9/25/2020
5/12/2020,387,14458,2611,90042,104500,23,1411,18,930,4,186,295,69,48,22,586,224,11980,1708,70598,82578,9/25/2020
5/13/2020,351,14809,3630,93672,108481,23,1434,25,955,1,187,292,69,49,13,599,199,12179,2006,72604,84783,9/25/2020
5/14/2020,329,15138,3408,97080,112218,19,1453,27,982,3,190,281,64,45,15,614,230,12409,2019,74623,87032,9/25/2020
5/15/2020,381,15519,3458,100538,116057,24,1477,41,1023,5,195,259,62,45,14,628,233,12642,1811,76434,89076,9/25/2020
5/16/2020,449,15968,4156,104694,120662,25,1502,13,1036,5,200,266,61,46,15,643,249,12891,1963,78397,91288,9/25/2020
5/17/2020,240,16208,2768,107462,123670,17,1519,8,1044,5,205,270,59,45,10,653,126,13017,1558,79955,92972,9/25/2020
5/18/2020,250,16458,2001,109463,125921,19,1538,15,1059,5,210,269,57,40,18,671,136,13153,1369,81324,94477,9/25/2020
5/19/2020,415,16873,3168,112631,129504,23,1561,32,1091,5,215,255,56,38,11,682,215,13368,1928,83252,96620,9/25/2020
5/20/2020,326,17199,2771,115402,132601,19,1580,23,1114,7,222,244,52,33,22,704,185,13553,1516,84768,98321,9/25/2020
5/21/2020,374,17573,3757,119159,136732,26,1606,15,1129,3,225,252,53,29,20,724,167,13720,1940,86708,100428,9/25/2020
5/22/2020,351,17924,3161,122320,140244,20,1626,29,1158,5,230,238,52,29,10,734,206,13926,1610,88318,102244,9/25/2020
5/23/2020,253,18177,2742,125062,143239,19,1645,11,1169,3,233,243,52,32,13,747,108,14034,1272,89590,103624,9/25/2020
5/24/2020,163,18340,1370,126432,144772,12,1657,14,1183,2,235,239,53,36,8,755,82,14116,773,90363,104479,9/25/2020
5/25/2020,147,18487,1385,127817,146304,13,1670,14,1197,0,235,238,53,34,10,765,76,14192,762,91125,105317,9/25/2020
5/26/2020,285,18772,2620,130437,149209,24,1694,22,1219,5,240,235,48,33,15,780,157,14349,1781,92906,107255,9/25/2020
5/27/2020,276,19048,2057,132494,151542,20,1714,18,1237,3,243,234,50,33,10,790,132,14481,1134,94040,108521,9/25/2020
5/28/2020,348,19396,3359,135853,155249,17,1731,29,1266,4,247,218,47,32,8,798,130,14611,1119,95159,109770,9/25/2020
5/29/2020,410,19806,3914,139767,159573,19,1750,27,1293,6,253,204,43,31,12,810,173,14784,1571,96730,111514,9/25/2020
5/30/2020,225,20031,3915,143682,163713,15,1765,19,1312,4,257,196,40,29,12,822,109,14893,1820,98550,113443,9/25/2020
5/31/2020,155,20186,1688,145370,165556,11,1776,10,1322,0,257,197,43,26,3,825,78,14971,857,99407,114378,9/25/2020
6/1/2020,212,20398,2792,148162,168560,8,1784,14,1336,1,258,190,44,29,5,830,94,15065,1384,100791,115856,9/25/2020
6/2/2020,273,20671,3022,151184,171855,8,1792,9,1345,3,261,186,37,25,10,840,98,15163,1449,102240,117403,9/25/2020
6/3/2020,254,20925,3486,154670,175595,14,1806,18,1363,6,267,176,34,25,11,851,99,15262,1661,103901,119163,9/25/2020
6/4/2020,276,21201,4471,159141,180342,7,1813,25,1388,3,270,155,31,24,11,862,107,15369,2039,105940,121309,9/25/2020
6/5/2020,215,21416,3513,162654,184070,15,1828,13,1401,6,276,151,27,21,11,873,99,15468,1577,107517,122985,9/25/2020
6/6/2020,201,21617,2616,165270,186887,10,1838,7,1408,2,278,152,29,19,6,879,67,15535,1136,108653,124188,9/25/2020
6/7/2020,83,21700,1625,166895,188595,11,1849,7,1415,1,279,155,25,17,4,883,51,15586,782,109435,125021,9/25/2020
6/8/2020,119,21819,1849,168744,190563,15,1864,12,1427,2,281,156,27,18,4,887,45,15631,962,110397,126028,9/25/2020
6/9/2020,223,22042,2673,171417,193459,10,1874,18,1445,0,281,148,28,21,1,888,64,15695,1258,111655,127350,9/25/2020
6/10/2020,209,22251,2987,174404,196655,13,1887,12,1457,2,283,147,24,17,4,892,101,15796,1467,113122,128918,9/25/2020
6/11/2020,195,22446,3513,177917,200363,7,1894,15,1472,1,284,138,25,16,6,898,88,15884,1534,114656,130540,9/25/2020
6/12/2020,209,22655,4601,182518,205173,9,1903,15,1487,1,285,131,24,16,2,900,78,15962,2184,116840,132802,9/25/2020
6/13/2020,113,22768,3036,185554,208322,6,1909,4,1491,0,285,133,20,15,3,903,49,16011,1373,118213,134224,9/25/2020
6/14/2020,81,22849,2046,187600,210449,7,1916,8,1499,1,286,131,20,14,3,906,33,16044,968,119181,135225,9/25/2020
6/15/2020,188,23037,3108,190708,213745,14,1930,14,1513,0,286,131,20,16,5,911,75,16119,1791,120972,137091,9/25/2020
6/16/2020,110,23147,3017,193725,216872,10,1940,9,1522,1,287,131,22,16,8,919,50,16169,1578,122550,138719,9/25/2020
6/17/2020,127,23274,2835,196560,219834,15,1955,20,1542,4,291,122,18,14,6,925,50,16219,1319,123869,140088,9/25/2020
6/18/2020,149,23423,3047,199607,223030,9,1964,13,1555,1,292,117,19,16,7,932,70,16289,1314,125183,141472,9/25/2020
6/19/2020,141,23564,3769,203376,226940,12,1976,11,1566,1,293,117,20,17,3,935,59,16348,1372,126555,142903,9/25/2020
6/20/2020,84,23648,1891,205267,228915,9,1985,12,1578,0,293,114,20,18,4,939,36,16384,813,127368,143752,9/25/2020
6/21/2020,37,23685,1064,206331,230016,8,1993,5,1583,0,293,117,20,18,2,941,29,16413,692,128060,144473,9/25/2020
6/22/2020,138,23823,3730,210061,233884,12,2005,16,1599,0,293,113,19,18,1,942,65,16478,1708,129768,146246,9/25/2020
6/23/2020,163,23986,3831,213892,237878,3,2008,13,1612,3,296,100,18,18,7,949,81,16559,1781,131549,148108,9/25/2020
6/24/2020,120,24106,3502,217394,241500,9,2017,10,1622,1,297,98,18,18,5,954,44,16603,1687,133236,149839,9/25/2020
6/25/2020,103,24209,2883,220277,244486,6,2023,14,1636,1,298,89,17,17,1,955,50,16653,1511,134747,151400,9/25/2020
6/26/2020,94,24303,2488,222765,247068,2,2025,10,1646,0,298,81,18,18,1,956,61,16714,1332,136079,152793,9/25/2020
6/27/2020,84,24387,3214,225979,250366,5,2030,3,1649,1,299,82,17,17,5,961,37,16751,1221,137300,154051,9/25/2020
6/28/2020,39,24426,1469,227448,251874,4,2034,4,1653,4,303,78,15,14,6,967,17,16768,596,137896,154664,9/25/2020
6/29/2020,85,24511,3697,231145,255656,4,2038,5,1658,0,303,77,14,14,1,968,39,16807,1354,139250,156057,9/25/2020
6/30/2020,57,24568,1956,233101,257669,1,2039,5,1663,1,304,72,12,11,4,972,33,16840,995,140245,157085,9/25/2020
7/1/2020,144,24712,4098,237199,261911,7,2046,9,1672,0,304,70,11,11,1,973,78,16918,1936,142181,159099,9/25/2020
7/2/2020,103,24815,2803,240002,264817,5,2051,5,1677,1,305,69,10,10,2,975,59,16977,1089,143270,160247,9/25/2020
7/3/2020,50,24865,2076,242078,266943,9,2060,6,1683,0,305,72,9,9,3,978,25,17002,778,144048,161050,9/25/2020
7/4/2020,57,24922,2345,244423,269345,2,2062,4,1687,1,306,69,10,9,2,980,33,17035,1010,145058,162093,9/25/2020
7/5/2020,49,24971,2932,247355,272326,1,2063,2,1689,1,307,67,8,8,2,982,26,17061,1446,146504,163565,9/25/2020
7/6/2020,101,25072,2811,250166,275238,6,2069,6,1695,0,307,67,9,9,4,986,57,17118,1552,148056,165174,9/25/2020
7/7/2020,81,25153,3457,253623,278776,5,2074,7,1702,0,307,65,8,8,2,988,47,17165,1534,149590,166755,9/25/2020
7/8/2020,105,25258,3403,257026,282284,4,2078,2,1704,0,307,67,9,8,0,988,64,17229,1425,151015,168244,9/25/2020
7/9/2020,94,25352,3712,260738,286090,9,2087,3,1707,0,307,73,9,8,0,988,50,17279,1630,152645,169924,9/25/2020
7/10/2020,131,25483,4431,265169,290652,6,2093,3,1710,2,309,74,7,7,3,991,80,17359,2078,154723,172082,9/25/2020
7/11/2020,63,25546,2932,268101,293647,6,2099,3,1713,1,310,76,6,6,3,994,36,17395,1316,156039,173434,9/25/2020
7/12/2020,47,25593,1836,269937,295530,1,2100,3,1716,1,311,73,6,5,3,997,33,17428,943,156982,174410,9/25/2020
7/13/2020,84,25677,3157,273094,298771,8,2108,10,1726,0,311,71,6,5,1,998,61,17489,1473,158455,175944,9/25/2020
7/14/2020,73,25750,3289,276383,302133,7,2115,4,1730,0,311,74,5,5,1,999,43,17532,1373,159828,177360,9/25/2020
7/15/2020,130,25880,4168,280551,306431,5,2120,7,1737,0,311,72,5,4,0,999,99,17631,1749,161577,179208,9/25/2020
7/16/2020,102,25982,3733,284284,310266,6,2126,9,1746,0,311,69,6,5,1,1000,76,17707,1618,163195,180902,9/25/2020
7/17/2020,156,26138,4235,288519,314657,14,2140,3,1749,1,312,79,5,5,2,1002,79,17786,1849,165044,182830,9/25/2020
7/18/2020,85,26223,3267,291786,318009,5,2145,9,1758,1,313,74,5,4,4,1006,70,17856,1401,166445,184301,9/25/2020
7/19/2020,82,26305,2693,294479,320784,7,2152,3,1761,0,313,78,6,4,2,1008,57,17913,1149,167594,185507,9/25/2020
7/20/2020,71,26376,2664,297143,323519,9,2161,7,1768,0,313,80,7,5,2,1010,68,17981,1466,169060,187041,9/25/2020
7/21/2020,130,26506,4298,301441,327947,9,2170,11,1779,0,313,78,9,6,1,1011,109,18090,1918,170978,189068,9/25/2020
7/22/2020,130,26636,3926,305367,332003,11,2181,11,1790,1,314,77,7,6,1,1012,86,18176,1683,172661,190837,9/25/2020
7/23/2020,141,26777,4376,309743,336520,8,2189,6,1796,0,314,79,8,7,0,1012,116,18292,1969,174630,192922,9/25/2020
7/24/2020,172,26949,5959,315702,342651,14,2203,14,1810,0,314,79,9,7,0,1012,119,18411,2322,176952,195363,9/25/2020
7/25/2020,134,27083,4398,320100,347183,7,2210,7,1817,0,314,79,10,8,2,1014,108,18519,2100,179052,197571,9/25/2020
7/26/2020,62,27145,3027,323127,350272,8,2218,9,1826,0,314,78,11,7,1,1015,54,18573,1339,180391,198964,9/25/2020
7/27/2020,186,27331,4163,327290,354621,12,2230,7,1833,0,314,83,13,8,1,1016,138,18711,2333,182724,201435,9/25/2020
7/28/2020,105,27436,3831,331121,358557,5,2235,5,1838,0,314,83,14,7,1,1017,94,18805,1632,184356,203161,9/25/2020
7/29/2020,191,27627,5123,336244,363871,11,2246,12,1850,0,314,82,15,7,0,1017,154,18959,2324,186680,205639,9/25/2020
7/30/2020,121,27748,4344,340588,368336,6,2252,2,1852,1,315,85,15,6,1,1018,97,19056,1651,188331,207387,9/25/2020
7/31/2020,131,27879,5508,346096,373975,8,2260,10,1862,0,315,83,15,7,1,1019,89,19145,1856,190187,209332,9/25/2020
8/1/2020,108,27987,4288,350384,378371,7,2267,2,1864,0,315,88,14,7,1,1020,88,19233,1558,191745,210978,9/25/2020
8/2/2020,84,28071,2802,353186,381257,12,2279,12,1876,2,317,86,14,8,2,1022,62,19295,1275,193020,212315,9/25/2020
8/3/2020,187,28258,5203,358389,386647,13,2292,12,1888,0,317,87,16,7,1,1023,150,19445,2186,195206,214651,9/25/2020
8/4/2020,126,28384,3687,362076,390460,8,2300,6,1894,1,318,88,12,5,2,1025,99,19544,1770,196976,216520,9/25/2020
8/5/2020,148,28532,5914,367990,396522,12,2312,10,1904,1,319,89,10,5,2,1027,118,19662,2468,199444,219106,9/25/2020
8/6/2020,169,28701,5533,373523,402224,7,2319,9,1913,0,319,87,9,4,0,1027,121,19783,2422,201866,221649,9/25/2020
8/7/2020,122,28823,4845,378368,407191,13,2332,10,1923,1,320,89,9,3,2,1029,87,19870,2155,204021,223891,9/25/2020
8/8/2020,122,28945,4105,382473,411418,19,2351,6,1929,1,321,101,8,3,1,1030,91,19961,1781,205802,225763,9/25/2020
8/9/2020,42,28987,1722,384195,413182,8,2359,10,1939,0,321,99,9,4,0,1030,35,19996,1076,206878,226874,9/25/2020
8/10/2020,149,29136,4577,388772,417908,11,2370,12,1951,0,321,98,9,4,1,1031,113,20109,2028,208906,229015,9/25/2020
8/11/2020,105,29241,4320,393092,422333,6,2376,14,1965,0,321,90,10,4,3,1034,92,20201,2269,211175,231376,9/25/2020
8/12/2020,121,29362,5184,398276,427638,8,2384,11,1976,0,321,87,9,3,1,1035,101,20302,2629,213804,234106,9/25/2020
8/13/2020,135,29497,4190,402466,431963,13,2397,12,1988,0,321,88,11,3,0,1035,95,20397,1909,215713,236110,9/25/2020
8/14/2020,145,29642,5462,407928,437570,13,2410,11,1999,0,321,90,11,4,3,1038,99,20496,1954,217667,238163,9/25/2020
8/15/2020,105,29747,4532,412460,442207,8,2418,11,2010,1,322,86,11,5,0,1038,89,20585,1701,219368,239953,9/25/2020
8/16/2020,83,29830,2784,415244,445074,7,2425,6,2016,4,326,83,8,4,6,1044,71,20656,985,220353,241009,9/25/2020
8/17/2020,106,29936,4548,419792,449728,10,2435,7,2023,0,326,86,8,5,2,1046,88,20744,2383,222736,243480,9/25/2020
8/18/2020,128,30064,5047,424839,454903,11,2446,9,2032,1,327,87,8,4,5,1051,95,20839,2778,225514,246353,9/25/2020
8/19/2020,114,30178,5407,430246,460424,8,2454,9,2041,1,328,85,9,5,0,1051,89,20928,2672,228186,249114,9/25/2020
8/20/2020,174,30352,8218,438464,468816,12,2466,6,2047,2,330,89,10,5,3,1054,139,21067,3565,231751,252818,9/25/2020
8/21/2020,154,30506,6811,445275,475781,8,2474,5,2052,1,331,91,9,4,2,1056,125,21192,2965,234716,255908,9/25/2020
8/22/2020,96,30602,5957,451232,481834,10,2484,12,2064,0,331,89,11,4,1,1057,84,21276,2625,237341,258617,9/25/2020
8/23/2020,70,30672,4365,455597,486269,11,2495,6,2070,0,331,94,11,2,1,1058,56,21332,2468,239809,261141,9/25/2020
8/24/2020,105,30777,5775,461372,492149,7,2502,10,2080,1,332,90,13,4,1,1059,76,21408,3151,242960,264368,9/25/2020
8/25/2020,108,30885,4745,466117,497002,10,2512,4,2084,1,333,95,11,4,1,1060,92,21500,2295,245255,266755,9/25/2020
8/26/2020,170,31055,9490,475607,506662,4,2516,8,2092,0,333,91,9,5,1,1061,127,21627,3068,248323,269950,9/25/2020
8/27/2020,93,31148,8798,484405,515553,6,2522,13,2105,1,334,83,6,5,2,1063,71,21698,3210,251533,273231,9/25/2020
8/28/2020,112,31260,8056,492461,523721,14,2536,4,2109,0,334,93,9,7,2,1065,88,21786,2427,253960,275746,9/25/2020
8/29/2020,65,31325,5412,497873,529198,6,2542,8,2117,1,335,90,10,6,2,1067,51,21837,1904,255864,277701,9/25/2020
8/30/2020,66,31391,4319,502192,533583,7,2549,4,2121,0,335,93,8,5,2,1069,48,21885,1993,257857,279742,9/25/2020
8/31/2020,105,31496,4870,507062,538558,10,2559,15,2136,0,335,88,8,4,0,1069,80,21965,2197,260054,282019,9/25/2020
9/1/2020,98,31594,7121,514183,545777,6,2565,9,2145,1,336,84,7,4,2,1071,65,22030,2377,262431,284461,9/25/2020
9/2/2020,126,31720,10680,524863,556583,9,2574,10,2155,1,337,82,8,4,2,1073,103,22133,3047,265478,287611,9/25/2020
9/3/2020,89,31809,11205,536068,567877,8,2582,8,2163,0,337,82,9,4,2,1075,74,22207,2583,268061,290268,9/25/2020
9/4/2020,102,31911,9038,545106,577017,11,2593,4,2167,0,337,89,9,4,1,1076,82,22289,2399,270460,292749,9/25/2020
9/5/2020,52,31963,6307,551413,583376,6,2599,9,2176,0,337,86,8,3,1,1077,42,22331,1601,272061,294392,9/25/2020
9/6/2020,87,32050,4316,555729,587779,4,2603,8,2184,1,338,81,6,3,1,1078,64,22395,1959,274020,296415,9/25/2020
9/7/2020,35,32085,3002,558731,590816,11,2614,3,2187,0,338,89,5,3,1,1079,26,22421,649,274669,297090,9/25/2020
9/8/2020,75,32160,6377,565108,597268,6,2620,12,2199,1,339,82,6,3,2,1081,66,22487,1605,276274,298761,9/25/2020
9/9/2020,118,32278,8840,573948,606226,9,2629,5,2204,1,340,85,9,3,1,1082,101,22588,2157,278431,301019,9/25/2020
9/10/2020,166,32444,11425,585373,617817,8,2637,8,2212,0,340,85,10,3,0,1082,113,22701,2273,280704,303405,9/25/2020
9/11/2020,119,32563,9459,594832,627395,11,2648,11,2223,0,340,85,10,5,0,1082,99,22800,1971,282675,305475,9/25/2020
9/12/2020,108,32671,6112,600944,633615,8,2656,5,2228,2,342,86,9,5,3,1085,96,22896,1474,284149,307045,9/25/2020
9/13/2020,58,32729,2629,603573,636302,4,2660,3,2231,0,342,87,9,5,0,1085,53,22949,808,284957,307906,9/25/2020
9/14/2020,101,32830,6278,609851,642681,5,2665,3,2234,2,344,87,9,5,1,1086,93,23042,1637,286594,309636,9/25/2020
9/15/2020,142,32972,8374,618225,651197,5,2670,2,2236,1,345,89,9,5,2,1088,117,23159,2067,288661,311820,9/25/2020
9/16/2020,155,33127,9575,627800,660927,7,2677,7,2243,2,347,87,7,6,5,1093,117,23276,1843,290504,313780,9/25/2020
9/17/2020,136,33263,9258,637058,670321,7,2684,14,2257,0,347,80,8,3,0,1093,155,23431,1925,292429,315860,9/25/2020
9/18/2020,201,33464,10008,647066,680530,6,2690,7,2264,1,348,78,11,5,2,1095,129,23560,1960,294389,317949,9/25/2020
9/19/2020,163,33627,8389,655455,689082,7,2697,3,2267,0,348,82,10,5,4,1099,108,23668,1750,296139,319807,9/25/2020
9/20/2020,81,33708,3800,659255,692963,6,2703,5,2272,2,350,81,10,7,4,1103,54,23722,1417,297556,321278,9/25/2020
9/21/2020,125,33833,7058,666313,700146,11,2714,3,2275,2,352,87,9,5,2,1105,97,23819,2437,299993,323812,9/25/2020
9/22/2020,168,34001,9069,675382,709383,11,2725,3,2278,1,353,94,8,4,1,1106,110,23929,2065,302058,325987,9/25/2020
9/23/2020,164,34165,10226,685608,719773,,,,,,,,,,0,1106,133,24062,2128,304186,328248,9/25/2020
9/24/2020,134,34299,7562,693170,727469,,,,,,,,,,1,1107,119,24181,1667,305853,330034,9/25/2020
2/27/2020,0,0,0,0,0,1,1,0,0,0,0,1,0,0,0,0,0,0,0,0,0,9/28/2020
2/28/2020,0,0,0,0,0,0,1,0,0,0,0,1,1,0,0,0,0,0,0,0,0,9/28/2020
2/29/2020,0,0,0,0,0,0,1,0,0,0,0,1,1,0,0,0,0,0,0,0,0,9/28/2020
3/1/2020,2,2,2,2,4,0,1,0,0,0,0,1,1,1,0,0,2,2,2,2,4,9/28/2020
3/2/2020,0,2,1,3,5,1,2,0,0,0,0,2,2,2,0,0,0,2,1,3,5,9/28/2020
3/3/2020,0,2,2,5,7,0,2,0,0,0,0,2,2,2,0,0,0,2,2,5,7,9/28/2020
3/4/2020,0,2,12,17,19,1,3,0,0,0,0,3,2,2,0,0,0,2,10,15,17,9/28/2020
3/5/2020,0,2,4,21,23,0,3,0,0,0,0,3,2,2,0,0,1,3,4,19,22,9/28/2020
3/6/2020,1,3,12,33,36,0,3,0,0,0,0,3,2,2,0,0,0,3,11,30,33,9/28/2020
3/7/2020,0,3,19,52,55,0,3,0,0,0,0,3,2,1,0,0,0,3,19,49,52,9/28/2020
3/8/2020,0,3,18,70,73,0,3,0,0,0,0,3,2,1,0,0,0,3,18,67,70,9/28/2020
3/9/2020,1,4,15,85,89,0,3,0,0,0,0,3,2,1,0,0,1,4,15,82,86,9/28/2020
3/10/2020,2,6,25,110,116,0,3,0,0,0,0,3,2,1,0,0,1,5,23,105,110,9/28/2020
3/11/2020,0,6,34,144,150,1,4,0,0,0,0,4,1,1,0,0,0,5,34,139,144,9/28/2020
3/12/2020,9,15,41,185,200,1,5,0,0,0,0,5,1,1,0,0,8,13,38,177,190,9/28/2020
3/13/2020,6,21,50,235,256,4,9,1,1,0,0,8,1,1,0,0,6,19,48,225,244,9/28/2020
3/14/2020,0,21,90,325,346,0,9,0,1,0,0,8,1,1,0,0,0,19,86,311,330,9/28/2020
3/15/2020,1,22,54,379,401,1,10,0,1,0,0,9,2,1,0,0,1,20,54,365,385,9/28/2020
3/16/2020,2,24,95,474,498,2,12,0,1,0,0,11,2,0,0,0,2,22,92,457,479,9/28/2020
3/17/2020,12,36,162,636,672,6,18,0,1,0,0,17,2,0,0,0,11,33,151,608,641,9/28/2020
3/18/2020,9,45,116,752,797,3,21,0,1,0,0,20,2,0,0,0,11,44,110,718,762,9/28/2020
3/19/2020,15,60,262,1014,1074,2,23,1,2,0,0,21,3,0,1,1,17,61,251,969,1030,9/28/2020
3/20/2020,13,73,197,1211,1284,5,28,0,2,0,0,26,4,0,0,1,13,74,191,1160,1234,9/28/2020
3/21/2020,12,85,126,1337,1422,3,31,2,4,0,0,27,5,0,0,1,14,88,123,1283,1371,9/28/2020
3/22/2020,27,112,282,1619,1731,2,33,0,4,0,0,29,5,0,0,1,25,113,262,1545,1658,9/28/2020
3/23/2020,14,126,169,1788,1914,15,48,1,5,0,0,43,9,3,0,1,16,129,165,1710,1839,9/28/2020
3/24/2020,20,146,242,2030,2176,7,55,0,5,0,0,50,10,4,0,1,19,148,237,1947,2095,9/28/2020
3/25/2020,26,172,182,2212,2384,5,60,1,6,0,0,54,11,3,0,1,28,176,172,2119,2295,9/28/2020
3/26/2020,35,207,181,2393,2600,10,70,5,11,0,0,59,14,5,0,1,41,217,174,2293,2510,9/28/2020
3/27/2020,27,234,214,2607,2841,9,79,1,12,1,1,66,17,6,2,3,31,248,202,2495,2743,9/28/2020
3/28/2020,59,293,260,2867,3160,13,92,3,15,2,3,74,15,6,1,4,64,312,241,2736,3048,9/28/2020
3/29/2020,100,393,350,3217,3610,8,100,4,19,1,4,77,18,8,2,6,105,417,312,3048,3465,9/28/2020
3/30/2020,62,455,222,3439,3894,20,120,5,24,0,4,92,20,11,3,9,78,495,184,3232,3727,9/28/2020
3/31/2020,71,526,369,3808,4334,11,131,7,31,1,5,95,22,13,2,11,73,568,297,3529,4097,9/28/2020
4/1/2020,99,625,698,4506,5131,18,149,7,38,0,5,106,30,15,1,12,100,668,640,4169,4837,9/28/2020
4/2/2020,52,677,477,4983,5660,22,171,6,44,2,7,120,36,21,4,16,62,730,436,4605,5335,9/28/2020
4/3/2020,108,785,774,5757,6542,23,194,7,51,0,7,136,43,25,3,19,100,830,712,5317,6147,9/28/2020
4/4/2020,143,928,660,6417,7345,22,216,4,55,5,12,149,41,30,9,28,138,968,618,5935,6903,9/28/2020
4/5/2020,187,1115,1156,7573,8688,20,236,9,64,1,13,159,44,36,2,30,182,1150,1067,7002,8152,9/28/2020
4/6/2020,218,1333,1706,9279,10612,26,262,7,71,0,13,178,48,40,7,37,208,1358,1552,8554,9912,9/28/2020
4/7/2020,284,1617,1629,10908,12525,20,282,5,76,2,15,191,50,42,5,42,261,1619,1481,10035,11654,9/28/2020
4/8/2020,290,1907,1720,12628,14535,19,301,7,83,6,21,197,50,38,10,52,271,1890,1558,11593,13483,9/28/2020
4/9/2020,283,2190,1516,14144,16334,32,333,9,92,4,25,216,53,40,7,59,277,2167,1355,12948,15115,9/28/2020
4/10/2020,419,2609,2574,16718,19327,29,362,16,108,5,30,224,59,41,11,70,401,2568,2371,15319,17887,9/28/2020
4/11/2020,297,2906,1905,18623,21529,29,391,11,119,2,32,240,61,48,12,82,280,2848,1719,17038,19886,9/28/2020
4/12/2020,314,3220,1670,20293,23513,35,426,13,132,5,37,257,59,49,9,91,284,3132,1435,18473,21605,9/28/2020
4/13/2020,161,3381,935,21228,24609,35,461,13,145,3,40,276,64,54,9,100,187,3319,838,19311,22630,9/28/2020
4/14/2020,289,3670,1787,23015,26685,27,488,17,162,5,45,281,72,53,8,108,262,3581,1528,20839,24420,9/28/2020
4/15/2020,351,4021,1799,24814,28835,31,519,20,182,3,48,289,72,54,17,125,306,3887,1553,22392,26279,9/28/2020
4/16/2020,447,4468,2494,27308,31776,36,555,25,207,6,54,294,72,53,14,139,386,4273,2076,24468,28741,9/28/2020
4/17/2020,304,4772,1821,29129,33901,32,587,20,227,7,61,299,66,45,21,160,290,4563,1446,25914,30477,9/28/2020
4/18/2020,321,5093,1725,30854,35947,26,613,18,245,4,65,303,63,49,15,175,284,4847,1325,27239,32086,9/28/2020
4/19/2020,381,5474,2047,32901,38375,23,636,26,271,1,66,299,65,55,11,186,336,5183,1741,28980,34163,9/28/2020
4/20/2020,394,5868,1907,34808,40676,46,682,29,300,2,68,314,75,56,10,196,378,5561,1571,30551,36112,9/28/2020
4/21/2020,444,6312,2110,36918,43230,45,727,33,333,5,73,321,72,56,18,214,384,5945,1705,32256,38201,9/28/2020
4/22/2020,418,6730,2390,39308,46038,41,768,32,365,5,78,325,73,58,18,232,379,6324,1915,34171,40495,9/28/2020
4/23/2020,479,7209,2469,41777,48986,32,800,28,393,5,83,324,76,62,15,247,412,6736,1856,36027,42763,9/28/2020
4/24/2020,491,7700,3284,45061,52761,35,835,26,419,4,87,329,85,63,15,262,408,7144,2627,38654,45798,9/28/2020
4/25/2020,393,8093,2206,47267,55360,34,869,17,436,5,92,341,85,62,14,276,300,7444,1766,40420,47864,9/28/2020
4/26/2020,316,8409,2309,49576,57985,33,902,15,451,3,95,356,86,59,14,290,274,7718,1877,42297,50015,9/28/2020
4/27/2020,249,8658,1620,51196,59854,29,931,21,472,4,99,360,86,61,10,300,206,7924,1162,43459,51383,9/28/2020
4/28/2020,410,9068,2263,53459,62527,44,975,24,496,3,102,377,88,59,22,322,331,8255,1763,45222,53477,9/28/2020
4/29/2020,476,9544,3343,56802,66346,36,1011,38,534,11,113,364,78,53,18,340,371,8626,2424,47646,56272,9/28/2020
4/30/2020,432,9976,2769,59571,69547,33,1044,38,572,6,119,353,83,57,24,364,350,8976,1932,49578,58554,9/28/2020
5/1/2020,454,10430,3086,62657,73087,51,1095,39,611,3,122,362,84,58,14,378,325,9301,2182,51760,61061,9/28/2020
5/2/2020,257,10687,1926,64583,75270,36,1131,38,649,5,127,355,91,62,24,402,192,9493,1277,53037,62530,9/28/2020
5/3/2020,283,10970,2160,66743,77713,31,1162,26,675,8,135,352,90,61,21,423,183,9676,1590,54627,64303,9/28/2020
5/4/2020,387,11357,2098,68841,80198,30,1192,31,706,6,141,345,88,57,18,441,290,9966,1564,56191,66157,9/28/2020
5/5/2020,433,11790,2873,71714,83504,29,1221,32,738,6,147,336,82,54,16,457,299,10265,1964,58155,68420,9/28/2020
5/6/2020,488,12278,2830,74544,86822,28,1249,44,782,9,156,311,79,54,21,478,340,10605,1916,60071,70676,9/28/2020
5/7/2020,425,12703,2969,77513,90216,36,1285,41,823,5,161,301,71,52,21,499,269,10874,1968,62039,72913,9/28/2020
5/8/2020,359,13062,2598,80111,93173,30,1315,29,852,5,166,297,71,53,22,521,230,11104,1737,63776,74880,9/28/2020
5/9/2020,467,13529,3346,83457,96986,22,1337,21,873,4,170,294,69,51,15,536,290,11394,2259,66035,77429,9/28/2020
5/10/2020,285,13814,2117,85574,99388,20,1357,23,896,6,176,285,70,49,13,549,189,11583,1523,67558,79141,9/28/2020
5/11/2020,257,14071,1857,87431,101502,31,1388,16,912,6,182,294,71,49,15,564,174,11757,1301,68859,80616,9/28/2020
5/12/2020,387,14458,2611,90042,104500,23,1411,18,930,4,186,295,69,48,22,586,224,11981,1707,70566,82547,9/28/2020
5/13/2020,351,14809,3630,93672,108481,23,1434,25,955,1,187,292,69,49,13,599,199,12180,2005,72571,84751,9/28/2020
5/14/2020,329,15138,3408,97080,112218,19,1453,27,982,3,190,281,64,45,15,614,230,12410,2019,74590,87000,9/28/2020
5/15/2020,381,15519,3458,100538,116057,24,1477,41,1023,5,195,259,62,45,14,628,233,12643,1811,76401,89044,9/28/2020
5/16/2020,449,15968,4156,104694,120662,25,1502,13,1036,5,200,266,61,46,15,643,249,12892,1963,78364,91256,9/28/2020
5/17/2020,240,16208,2768,107462,123670,17,1519,8,1044,5,205,270,59,45,10,653,126,13018,1558,79922,92940,9/28/2020
5/18/2020,250,16458,2001,109463,125921,19,1538,15,1059,5,210,269,57,40,18,671,136,13154,1369,81291,94445,9/28/2020
5/19/2020,415,16873,3168,112631,129504,23,1561,32,1091,5,215,255,56,38,11,682,215,13369,1928,83219,96588,9/28/2020
5/20/2020,326,17199,2771,115402,132601,19,1580,23,1114,7,222,244,52,33,22,704,185,13554,1515,84734,98288,9/28/2020
5/21/2020,374,17573,3757,119159,136732,26,1606,15,1129,3,225,252,53,29,20,724,167,13721,1940,86674,100395,9/28/2020
5/22/2020,351,17924,3161,122320,140244,20,1626,29,1158,5,230,238,52,29,10,734,206,13927,1610,88284,102211,9/28/2020
5/23/2020,253,18177,2742,125062,143239,19,1645,11,1169,3,233,243,52,32,13,747,108,14035,1271,89555,103590,9/28/2020
5/24/2020,163,18340,1370,126432,144772,12,1657,14,1183,2,235,239,53,36,8,755,82,14117,773,90328,104445,9/28/2020
5/25/2020,147,18487,1385,127817,146304,13,1670,14,1197,0,235,238,53,34,10,765,76,14193,762,91090,105283,9/28/2020
5/26/2020,285,18772,2620,130437,149209,24,1694,22,1219,5,240,235,48,33,15,780,157,14350,1781,92871,107221,9/28/2020
5/27/2020,276,19048,2057,132494,151542,20,1714,18,1237,3,243,234,50,33,10,790,132,14482,1134,94005,108487,9/28/2020
5/28/2020,348,19396,3359,135853,155249,17,1731,29,1266,4,247,218,47,32,8,798,130,14612,1117,95122,109734,9/28/2020
5/29/2020,410,19806,3914,139767,159573,19,1750,27,1293,6,253,204,43,31,12,810,173,14785,1571,96693,111478,9/28/2020
5/30/2020,225,20031,3915,143682,163713,15,1765,19,1312,4,257,196,40,29,12,822,109,14894,1820,98513,113407,9/28/2020
5/31/2020,155,20186,1688,145370,165556,11,1776,10,1322,0,257,197,43,26,3,825,78,14972,857,99370,114342,9/28/2020
6/1/2020,212,20398,2792,148162,168560,8,1784,14,1336,1,258,190,44,29,5,830,94,15066,1384,100754,115820,9/28/2020
6/2/2020,273,20671,3022,151184,171855,8,1792,9,1345,3,261,186,37,25,10,840,98,15164,1448,102202,117366,9/28/2020
6/3/2020,254,20925,3486,154670,175595,14,1806,18,1363,6,267,176,34,25,11,851,99,15263,1661,103863,119126,9/28/2020
6/4/2020,276,21201,4471,159141,180342,7,1813,25,1388,3,270,155,31,24,11,862,107,15370,2038,105901,121271,9/28/2020
6/5/2020,215,21416,3513,162654,184070,15,1828,13,1401,6,276,151,27,21,11,873,99,15469,1577,107478,122947,9/28/2020
6/6/2020,201,21617,2616,165270,186887,10,1838,7,1408,2,278,152,29,19,6,879,67,15536,1136,108614,124150,9/28/2020
6/7/2020,83,21700,1625,166895,188595,11,1849,7,1415,1,279,155,25,17,4,883,51,15587,782,109396,124983,9/28/2020
6/8/2020,119,21819,1849,168744,190563,15,1864,12,1427,2,281,156,27,18,4,887,45,15632,962,110358,125990,9/28/2020
6/9/2020,223,22042,2673,171417,193459,10,1874,18,1445,0,281,148,28,21,1,888,64,15696,1258,111616,127312,9/28/2020
6/10/2020,209,22251,2987,174404,196655,13,1887,12,1457,2,283,147,24,17,4,892,101,15797,1467,113083,128880,9/28/2020
6/11/2020,195,22446,3513,177917,200363,7,1894,15,1472,1,284,138,25,16,6,898,88,15885,1534,114617,130502,9/28/2020
6/12/2020,209,22655,4601,182518,205173,9,1903,15,1487,1,285,131,24,16,2,900,78,15963,2183,116800,132763,9/28/2020
6/13/2020,113,22768,3036,185554,208322,6,1909,4,1491,0,285,133,20,15,3,903,49,16012,1373,118173,134185,9/28/2020
6/14/2020,81,22849,2046,187600,210449,7,1916,8,1499,1,286,131,20,14,3,906,33,16045,967,119140,135185,9/28/2020
6/15/2020,188,23037,3108,190708,213745,14,1930,14,1513,0,286,131,20,16,5,911,75,16120,1791,120931,137051,9/28/2020
6/16/2020,110,23147,3017,193725,216872,10,1940,9,1522,1,287,131,22,16,8,919,50,16170,1578,122509,138679,9/28/2020
6/17/2020,127,23274,2835,196560,219834,15,1955,20,1542,4,291,122,18,14,6,925,50,16220,1319,123828,140048,9/28/2020
6/18/2020,149,23423,3047,199607,223030,9,1964,13,1555,1,292,117,19,16,7,932,70,16290,1314,125142,141432,9/28/2020
6/19/2020,141,23564,3769,203376,226940,12,1976,11,1566,1,293,117,20,17,3,935,59,16349,1371,126513,142862,9/28/2020
6/20/2020,84,23648,1891,205267,228915,9,1985,12,1578,0,293,114,20,18,4,939,36,16385,813,127326,143711,9/28/2020
6/21/2020,37,23685,1064,206331,230016,8,1993,5,1583,0,293,117,20,18,2,941,29,16414,692,128018,144432,9/28/2020
6/22/2020,138,23823,3730,210061,233884,12,2005,16,1599,0,293,113,19,18,1,942,65,16479,1707,129725,146204,9/28/2020
6/23/2020,163,23986,3831,213892,237878,3,2008,13,1612,3,296,100,18,18,7,949,81,16560,1781,131506,148066,9/28/2020
6/24/2020,120,24106,3502,217394,241500,9,2017,10,1622,1,297,98,18,18,5,954,44,16604,1687,133193,149797,9/28/2020
6/25/2020,103,24209,2883,220277,244486,6,2023,14,1636,1,298,89,17,17,1,955,50,16654,1511,134704,151358,9/28/2020
6/26/2020,94,24303,2488,222765,247068,2,2025,10,1646,0,298,81,18,18,1,956,61,16715,1332,136036,152751,9/28/2020
6/27/2020,84,24387,3214,225979,250366,5,2030,3,1649,1,299,82,17,17,5,961,37,16752,1221,137257,154009,9/28/2020
6/28/2020,39,24426,1469,227448,251874,4,2034,4,1653,4,303,78,15,14,6,967,17,16769,595,137852,154621,9/28/2020
6/29/2020,85,24511,3697,231145,255656,4,2038,5,1658,0,303,77,14,14,1,968,39,16808,1354,139206,156014,9/28/2020
6/30/2020,57,24568,1956,233101,257669,1,2039,5,1663,1,304,72,12,11,4,972,33,16841,995,140201,157042,9/28/2020
7/1/2020,144,24712,4098,237199,261911,7,2046,9,1672,0,304,70,11,11,1,973,78,16919,1936,142137,159056,9/28/2020
7/2/2020,103,24815,2803,240002,264817,5,2051,5,1677,1,305,69,10,10,3,976,59,16978,1089,143226,160204,9/28/2020
7/3/2020,50,24865,2076,242078,266943,9,2060,6,1683,0,305,72,9,9,3,979,25,17003,778,144004,161007,9/28/2020
7/4/2020,57,24922,2345,244423,269345,2,2062,4,1687,1,306,69,10,9,2,981,33,17036,1010,145014,162050,9/28/2020
7/5/2020,49,24971,2932,247355,272326,1,2063,2,1689,1,307,67,8,8,2,983,26,17062,1445,146459,163521,9/28/2020
7/6/2020,101,25072,2811,250166,275238,6,2069,6,1695,0,307,67,9,9,4,987,57,17119,1552,148011,165130,9/28/2020
7/7/2020,81,25153,3457,253623,278776,5,2074,7,1702,0,307,65,8,8,2,989,47,17166,1534,149545,166711,9/28/2020
7/8/2020,105,25258,3403,257026,282284,4,2078,2,1704,0,307,67,9,8,0,989,64,17230,1424,150969,168199,9/28/2020
7/9/2020,94,25352,3712,260738,286090,9,2087,3,1707,0,307,73,9,8,0,989,50,17280,1628,152597,169877,9/28/2020
7/10/2020,131,25483,4431,265169,290652,6,2093,3,1710,2,309,74,7,7,3,992,80,17360,2077,154674,172034,9/28/2020
7/11/2020,63,25546,2932,268101,293647,6,2099,3,1713,1,310,76,6,6,3,995,36,17396,1316,155990,173386,9/28/2020
7/12/2020,47,25593,1836,269937,295530,1,2100,3,1716,1,311,73,6,5,3,998,33,17429,943,156933,174362,9/28/2020
7/13/2020,84,25677,3157,273094,298771,8,2108,10,1726,0,311,71,6,5,1,999,61,17490,1473,158406,175896,9/28/2020
7/14/2020,73,25750,3289,276383,302133,7,2115,4,1730,0,311,74,5,5,1,1000,43,17533,1373,159779,177312,9/28/2020
7/15/2020,130,25880,4168,280551,306431,5,2120,7,1737,0,311,72,5,4,0,1000,99,17632,1748,161527,179159,9/28/2020
7/16/2020,102,25982,3733,284284,310266,6,2126,9,1746,0,311,69,6,5,1,1001,75,17707,1618,163145,180852,9/28/2020
7/17/2020,156,26138,4235,288519,314657,14,2140,3,1749,1,312,79,5,5,2,1003,79,17786,1848,164993,182779,9/28/2020
7/18/2020,85,26223,3267,291786,318009,5,2145,9,1758,1,313,74,5,4,4,1007,70,17856,1401,166394,184250,9/28/2020
7/19/2020,82,26305,2693,294479,320784,7,2152,3,1761,0,313,78,6,4,2,1009,57,17913,1149,167543,185456,9/28/2020
7/20/2020,71,26376,2664,297143,323519,9,2161,7,1768,0,313,80,7,5,2,1011,68,17981,1466,169009,186990,9/28/2020
7/21/2020,130,26506,4298,301441,327947,9,2170,11,1779,0,313,78,9,6,1,1012,109,18090,1918,170927,189017,9/28/2020
7/22/2020,130,26636,3926,305367,332003,11,2181,11,1790,1,314,77,7,6,1,1013,86,18176,1683,172610,190786,9/28/2020
7/23/2020,141,26777,4376,309743,336520,8,2189,6,1796,0,314,79,8,7,0,1013,116,18292,1968,174578,192870,9/28/2020
7/24/2020,172,26949,5959,315702,342651,14,2203,14,1810,0,314,79,9,7,0,1013,119,18411,2322,176900,195311,9/28/2020
7/25/2020,134,27083,4398,320100,347183,7,2210,7,1817,0,314,79,10,8,2,1015,108,18519,2100,179000,197519,9/28/2020
7/26/2020,62,27145,3027,323127,350272,8,2218,9,1826,0,314,78,11,7,1,1016,54,18573,1339,180339,198912,9/28/2020
7/27/2020,186,27331,4163,327290,354621,12,2230,7,1833,0,314,83,13,8,1,1017,138,18711,2332,182671,201382,9/28/2020
7/28/2020,105,27436,3831,331121,358557,5,2235,5,1838,0,314,83,14,7,1,1018,94,18805,1631,184302,203107,9/28/2020
7/29/2020,191,27627,5123,336244,363871,11,2246,12,1850,0,314,82,15,7,0,1018,154,18959,2324,186626,205585,9/28/2020
7/30/2020,121,27748,4344,340588,368336,6,2252,2,1852,1,315,85,15,6,1,1019,97,19056,1651,188277,207333,9/28/2020
7/31/2020,131,27879,5508,346096,373975,8,2260,10,1862,0,315,83,15,7,1,1020,89,19145,1856,190133,209278,9/28/2020
8/1/2020,108,27987,4288,350384,378371,7,2267,2,1864,0,315,88,14,7,1,1021,88,19233,1558,191691,210924,9/28/2020
8/2/2020,84,28071,2802,353186,381257,12,2279,12,1876,2,317,86,14,8,2,1023,62,19295,1274,192965,212260,9/28/2020
8/3/2020,187,28258,5218,358404,386662,13,2292,12,1888,0,317,87,16,7,1,1024,150,19445,2200,195165,214610,9/28/2020
8/4/2020,126,28384,3689,362093,390477,8,2300,6,1894,1,318,88,12,5,2,1026,99,19544,1771,196936,216480,9/28/2020
8/5/2020,148,28532,5919,368012,396544,12,2312,10,1904,1,319,89,10,5,2,1028,118,19662,2471,199407,219069,9/28/2020
8/6/2020,169,28701,5533,373545,402246,7,2319,9,1913,0,319,87,9,4,0,1028,121,19783,2421,201828,221611,9/28/2020
8/7/2020,122,28823,4845,378390,407213,13,2332,10,1923,1,320,89,9,3,2,1030,87,19870,2153,203981,223851,9/28/2020
8/8/2020,123,28946,4106,382496,411442,19,2351,6,1929,1,321,101,8,3,1,1031,91,19961,1781,205762,225723,9/28/2020
8/9/2020,42,28988,1722,384218,413206,8,2359,10,1939,0,321,99,9,4,0,1031,35,19996,1076,206838,226834,9/28/2020
8/10/2020,149,29137,4580,388798,417935,11,2370,12,1951,0,321,98,9,4,1,1032,113,20109,2030,208868,228977,9/28/2020
8/11/2020,105,29242,4325,393123,422365,6,2376,14,1965,0,321,90,10,4,3,1035,92,20201,2270,211138,231339,9/28/2020
8/12/2020,121,29363,5184,398307,427670,8,2384,11,1976,0,321,87,9,3,1,1036,101,20302,2629,213767,234069,9/28/2020
8/13/2020,135,29498,4191,402498,431996,13,2397,12,1988,0,321,88,11,3,0,1036,95,20397,1909,215676,236073,9/28/2020
8/14/2020,145,29643,5492,407990,437633,13,2410,11,1999,0,321,90,11,4,3,1039,99,20496,1976,217652,238148,9/28/2020
8/15/2020,105,29748,4533,412523,442271,8,2418,11,2010,1,322,86,11,5,0,1039,89,20585,1701,219353,239938,9/28/2020
8/16/2020,83,29831,2785,415308,445139,7,2425,6,2016,4,326,83,8,4,6,1045,71,20656,984,220337,240993,9/28/2020
8/17/2020,106,29937,4570,419878,449815,10,2435,7,2023,0,326,86,8,5,2,1047,88,20744,2396,222733,243477,9/28/2020
8/18/2020,128,30065,5048,424926,454991,11,2446,9,2032,1,327,87,8,4,5,1052,95,20839,2777,225510,246349,9/28/2020
8/19/2020,114,30179,5407,430333,460512,8,2454,9,2041,1,328,85,9,5,0,1052,89,20928,2671,228181,249109,9/28/2020
8/20/2020,174,30353,8220,438553,468906,12,2466,6,2047,2,330,89,10,5,3,1055,139,21067,3564,231745,252812,9/28/2020
8/21/2020,154,30507,6816,445369,475876,8,2474,5,2052,1,331,91,9,4,2,1057,125,21192,2965,234710,255902,9/28/2020
8/22/2020,96,30603,5957,451326,481929,10,2484,12,2064,0,331,89,11,4,1,1058,84,21276,2624,237334,258610,9/28/2020
8/23/2020,70,30673,4365,455691,486364,11,2495,6,2070,0,331,94,11,2,1,1059,56,21332,2469,239803,261135,9/28/2020
8/24/2020,105,30778,5776,461467,492245,7,2502,10,2080,1,332,90,13,4,1,1060,76,21408,3152,242955,264363,9/28/2020
8/25/2020,108,30886,4745,466212,497098,10,2512,4,2084,1,333,95,11,4,1,1061,92,21500,2295,245250,266750,9/28/2020
8/26/2020,170,31056,9490,475702,506758,4,2516,8,2092,0,333,91,9,5,1,1062,127,21627,3067,248317,269944,9/28/2020
8/27/2020,93,31149,8798,484500,515649,6,2522,13,2105,1,334,83,6,5,2,1064,71,21698,3207,251524,273222,9/28/2020
8/28/2020,112,31261,8058,492558,523819,14,2536,4,2109,0,334,93,9,7,2,1066,88,21786,2422,253946,275732,9/28/2020
8/29/2020,65,31326,5413,497971,529297,6,2542,8,2117,1,335,90,10,6,2,1068,51,21837,1904,255850,277687,9/28/2020
8/30/2020,66,31392,4319,502290,533682,7,2549,4,2121,0,335,93,8,5,2,1070,48,21885,1993,257843,279728,9/28/2020
8/31/2020,105,31497,4871,507161,538658,10,2559,15,2136,0,335,88,8,4,1,1071,80,21965,2193,260036,282001,9/28/2020
9/1/2020,98,31595,7124,514285,545880,6,2565,9,2145,1,336,84,7,4,2,1073,65,22030,2375,262411,284441,9/28/2020
9/2/2020,126,31721,10680,524965,556686,9,2574,10,2155,1,337,82,8,4,2,1075,103,22133,3046,265457,287590,9/28/2020
9/3/2020,90,31811,11214,536179,567990,8,2582,8,2163,0,337,82,9,4,2,1077,74,22207,2589,268046,290253,9/28/2020
9/4/2020,102,31913,9039,545218,577131,11,2593,4,2167,0,337,89,9,4,1,1078,82,22289,2396,270442,292731,9/28/2020
9/5/2020,52,31965,6307,551525,583490,6,2599,9,2176,0,337,86,8,3,1,1079,42,22331,1600,272042,294373,9/28/2020
9/6/2020,87,32052,4317,555842,587894,4,2603,8,2184,1,338,81,6,3,1,1080,64,22395,1959,274001,296396,9/28/2020
9/7/2020,35,32087,3002,558844,590931,11,2614,3,2187,0,338,89,5,3,1,1081,26,22421,649,274650,297071,9/28/2020
9/8/2020,75,32162,6381,565225,597387,6,2620,12,2199,1,339,82,6,3,2,1083,66,22487,1608,276258,298745,9/28/2020
9/9/2020,118,32280,8840,574065,606345,9,2629,5,2204,1,340,85,9,3,1,1084,101,22588,2155,278413,301001,9/28/2020
9/10/2020,166,32446,11425,585490,617936,8,2637,8,2212,0,340,85,10,3,0,1084,113,22701,2269,280682,303383,9/28/2020
9/11/2020,119,32565,9463,594953,627518,11,2648,11,2223,0,340,85,10,5,0,1084,99,22800,1972,282654,305454,9/28/2020
9/12/2020,108,32673,6140,601093,633766,8,2656,5,2228,2,342,86,9,5,3,1087,96,22896,1490,284144,307040,9/28/2020
9/13/2020,58,32731,2699,603792,636523,4,2660,3,2231,0,342,87,9,5,0,1087,53,22949,853,284997,307946,9/28/2020
9/14/2020,101,32832,6223,610015,642847,5,2665,3,2234,2,344,87,9,5,1,1088,93,23042,1601,286598,309640,9/28/2020
9/15/2020,142,32974,8376,618391,651365,5,2670,2,2236,1,345,89,9,5,2,1090,121,23163,2071,288669,311832,9/28/2020
9/16/2020,155,33129,9586,627977,661106,7,2677,7,2243,2,347,87,7,6,5,1095,116,23279,1848,290517,313796,9/28/2020
9/17/2020,136,33265,9272,637249,670514,7,2684,14,2257,0,347,80,8,3,0,1095,152,23431,1928,292445,315876,9/28/2020
9/18/2020,201,33466,10026,647275,680741,6,2690,7,2264,1,348,78,11,5,2,1097,127,23558,1962,294407,317965,9/28/2020
9/19/2020,163,33629,8395,655670,689299,7,2697,3,2267,0,348,82,10,5,4,1101,110,23668,1749,296156,319824,9/28/2020
9/20/2020,81,33710,3804,659474,693184,6,2703,5,2272,2,350,81,10,7,4,1105,53,23721,1418,297574,321295,9/28/2020
9/21/2020,125,33835,7076,666550,700385,11,2714,3,2275,2,352,87,9,5,2,1107,95,23816,2439,300013,323829,9/28/2020
9/22/2020,168,34003,9111,675661,709664,11,2725,3,2278,1,353,94,8,4,1,1108,107,23923,2078,302091,326014,9/28/2020
9/23/2020,165,34168,10586,686247,720415,,,,,,,,,,0,1108,131,24054,2198,304289,328343,9/28/2020
9/24/2020,149,34317,11638,697885,732202,,,,,,,,,,1,1109,117,24171,2291,306580,330751,9/28/2020
9/25/2020,134,34451,9627,707512,741963,,,,,,,,,,1,1110,113,24284,2284,308864,333148,9/28/2020
9/26/2020,113,34564,9072,716584,751148,,,,,,,,,,0,1110,114,24398,1858,310722,335120,9/28/2020
9/27/2020,37,34601,1971,718555,753156,,,,,,,,,,0,1110,26,24424,538,311260,335684,9/28/2020
2/27/2020,0,0,0,0,0,1,1,0,0,0,0,1,0,0,0,0,0,0,0,0,0,9/29/2020
2/28/2020,0,0,0,0,0,0,1,0,0,0,0,1,1,0,0,0,0,0,0,0,0,9/29/2020
2/29/2020,0,0,0,0,0,0,1,0,0,0,0,1,1,0,0,0,0,0,0,0,0,9/29/2020
3/1/2020,2,2,2,2,4,0,1,0,0,0,0,1,1,1,0,0,2,2,2,2,4,9/29/2020
3/2/2020,0,2,1,3,5,1,2,0,0,0,0,2,2,2,0,0,0,2,1,3,5,9/29/2020
3/3/2020,0,2,2,5,7,0,2,0,0,0,0,2,2,2,0,0,0,2,2,5,7,9/29/2020
3/4/2020,0,2,12,17,19,1,3,0,0,0,0,3,2,2,0,0,0,2,10,15,17,9/29/2020
3/5/2020,0,2,4,21,23,0,3,0,0,0,0,3,2,2,0,0,1,3,4,19,22,9/29/2020
3/6/2020,1,3,12,33,36,0,3,0,0,0,0,3,2,2,0,0,0,3,11,30,33,9/29/2020
3/7/2020,0,3,19,52,55,0,3,0,0,0,0,3,2,1,0,0,0,3,19,49,52,9/29/2020
3/8/2020,0,3,18,70,73,0,3,0,0,0,0,3,2,1,0,0,0,3,18,67,70,9/29/2020
3/9/2020,1,4,15,85,89,0,3,0,0,0,0,3,2,1,0,0,1,4,15,82,86,9/29/2020
3/10/2020,2,6,25,110,116,0,3,0,0,0,0,3,2,1,0,0,1,5,23,105,110,9/29/2020
3/11/2020,0,6,34,144,150,1,4,0,0,0,0,4,1,1,0,0,0,5,34,139,144,9/29/2020
3/12/2020,9,15,41,185,200,1,5,0,0,0,0,5,1,1,0,0,8,13,38,177,190,9/29/2020
3/13/2020,6,21,50,235,256,4,9,1,1,0,0,8,1,1,0,0,6,19,48,225,244,9/29/2020
3/14/2020,0,21,90,325,346,0,9,0,1,0,0,8,1,1,0,0,0,19,86,311,330,9/29/2020
3/15/2020,1,22,54,379,401,1,10,0,1,0,0,9,2,1,0,0,1,20,54,365,385,9/29/2020
3/16/2020,2,24,95,474,498,2,12,0,1,0,0,11,2,0,0,0,2,22,92,457,479,9/29/2020
3/17/2020,12,36,162,636,672,6,18,0,1,0,0,17,2,0,0,0,11,33,151,608,641,9/29/2020
3/18/2020,9,45,116,752,797,3,21,0,1,0,0,20,2,0,0,0,11,44,110,718,762,9/29/2020
3/19/2020,15,60,262,1014,1074,2,23,1,2,0,0,21,3,0,1,1,17,61,251,969,1030,9/29/2020
3/20/2020,13,73,197,1211,1284,5,28,0,2,0,0,26,4,0,0,1,13,74,191,1160,1234,9/29/2020
3/21/2020,12,85,126,1337,1422,3,31,2,4,0,0,27,5,0,0,1,14,88,123,1283,1371,9/29/2020
3/22/2020,27,112,282,1619,1731,2,33,0,4,0,0,29,5,0,0,1,25,113,262,1545,1658,9/29/2020
3/23/2020,14,126,169,1788,1914,15,48,1,5,0,0,43,9,3,0,1,16,129,165,1710,1839,9/29/2020
3/24/2020,20,146,242,2030,2176,7,55,0,5,0,0,50,10,4,0,1,19,148,237,1947,2095,9/29/2020
3/25/2020,26,172,182,2212,2384,5,60,1,6,0,0,54,11,3,0,1,28,176,172,2119,2295,9/29/2020
3/26/2020,35,207,181,2393,2600,10,70,5,11,0,0,59,14,5,0,1,41,217,174,2293,2510,9/29/2020
3/27/2020,27,234,214,2607,2841,9,79,1,12,1,1,66,17,6,2,3,31,248,202,2495,2743,9/29/2020
3/28/2020,59,293,260,2867,3160,13,92,3,15,2,3,74,15,6,1,4,64,312,241,2736,3048,9/29/2020
3/29/2020,100,393,350,3217,3610,8,100,4,19,1,4,77,18,8,2,6,105,417,312,3048,3465,9/29/2020
3/30/2020,62,455,222,3439,3894,20,120,5,24,0,4,92,20,11,3,9,78,495,184,3232,3727,9/29/2020
3/31/2020,71,526,369,3808,4334,11,131,7,31,1,5,95,22,13,2,11,73,568,297,3529,4097,9/29/2020
4/1/2020,99,625,698,4506,5131,18,149,7,38,0,5,106,30,15,1,12,100,668,640,4169,4837,9/29/2020
4/2/2020,52,677,477,4983,5660,22,171,6,44,2,7,120,36,21,4,16,62,730,436,4605,5335,9/29/2020
4/3/2020,108,785,774,5757,6542,23,194,7,51,0,7,136,43,25,3,19,100,830,712,5317,6147,9/29/2020
4/4/2020,143,928,660,6417,7345,22,216,4,55,5,12,149,41,30,9,28,138,968,618,5935,6903,9/29/2020
4/5/2020,187,1115,1156,7573,8688,20,236,9,64,1,13,159,44,36,2,30,181,1149,1067,7002,8151,9/29/2020
4/6/2020,218,1333,1706,9279,10612,26,262,7,71,0,13,178,48,40,7,37,208,1357,1552,8554,9911,9/29/2020
4/7/2020,284,1617,1629,10908,12525,20,282,4,75,2,15,192,50,42,5,42,261,1618,1480,10034,11652,9/29/2020
4/8/2020,290,1907,1720,12628,14535,19,301,7,82,6,21,198,50,38,10,52,271,1889,1558,11592,13481,9/29/2020
4/9/2020,283,2190,1516,14144,16334,32,333,9,91,4,25,217,53,40,7,59,277,2166,1355,12947,15113,9/29/2020
4/10/2020,419,2609,2574,16718,19327,29,362,17,108,5,30,224,59,41,11,70,401,2567,2370,15317,17884,9/29/2020
4/11/2020,297,2906,1905,18623,21529,29,391,11,119,2,32,240,61,48,12,82,280,2847,1718,17035,19882,9/29/2020
4/12/2020,314,3220,1670,20293,23513,34,425,13,132,5,37,256,59,49,9,91,284,3131,1435,18470,21601,9/29/2020
4/13/2020,161,3381,935,21228,24609,35,460,13,145,3,40,275,64,54,9,100,187,3318,837,19307,22625,9/29/2020
4/14/2020,289,3670,1787,23015,26685,27,487,17,162,5,45,280,72,53,8,108,262,3580,1528,20835,24415,9/29/2020
4/15/2020,351,4021,1799,24814,28835,31,518,19,181,3,48,289,72,54,17,125,306,3886,1553,22388,26274,9/29/2020
4/16/2020,447,4468,2494,27308,31776,36,554,25,206,6,54,294,72,53,14,139,386,4272,2076,24464,28736,9/29/2020
4/17/2020,304,4772,1821,29129,33901,32,586,20,226,7,61,299,66,45,21,160,290,4562,1446,25910,30472,9/29/2020
4/18/2020,321,5093,1725,30854,35947,26,612,18,244,4,65,303,63,49,15,175,284,4846,1325,27235,32081,9/29/2020
4/19/2020,381,5474,2047,32901,38375,23,635,26,270,1,66,299,65,55,11,186,336,5182,1739,28974,34156,9/29/2020
4/20/2020,394,5868,1907,34808,40676,46,681,29,299,2,68,314,75,56,10,196,376,5558,1570,30544,36102,9/29/2020
4/21/2020,444,6312,2110,36918,43230,45,726,33,332,5,73,321,72,56,18,214,384,5942,1703,32247,38189,9/29/2020
4/22/2020,418,6730,2390,39308,46038,41,767,32,364,5,78,325,73,58,18,232,379,6321,1914,34161,40482,9/29/2020
4/23/2020,479,7209,2469,41777,48986,32,799,28,392,5,83,324,76,62,15,247,412,6733,1856,36017,42750,9/29/2020
4/24/2020,491,7700,3284,45061,52761,35,834,26,418,4,87,329,85,63,15,262,408,7141,2626,38643,45784,9/29/2020
4/25/2020,393,8093,2206,47267,55360,34,868,17,435,5,92,341,85,62,14,276,300,7441,1766,40409,47850,9/29/2020
4/26/2020,316,8409,2309,49576,57985,33,901,15,450,3,95,356,86,59,14,290,274,7715,1876,42285,50000,9/29/2020
4/27/2020,249,8658,1620,51196,59854,29,930,21,471,4,99,360,86,61,10,300,206,7921,1162,43447,51368,9/29/2020
4/28/2020,410,9068,2263,53459,62527,44,974,24,495,3,102,377,88,59,22,322,331,8252,1763,45210,53462,9/29/2020
4/29/2020,476,9544,3343,56802,66346,36,1010,38,533,11,113,364,78,53,18,340,371,8623,2423,47633,56256,9/29/2020
4/30/2020,432,9976,2769,59571,69547,33,1043,38,571,6,119,353,83,57,24,364,350,8973,1932,49565,58538,9/29/2020
5/1/2020,454,10430,3086,62657,73087,51,1094,39,610,3,122,362,84,58,14,378,325,9298,2181,51746,61044,9/29/2020
5/2/2020,257,10687,1926,64583,75270,36,1130,38,648,5,127,355,91,62,24,402,192,9490,1275,53021,62511,9/29/2020
5/3/2020,283,10970,2160,66743,77713,31,1161,26,674,8,135,352,90,61,21,423,183,9673,1584,54605,64278,9/29/2020
5/4/2020,387,11357,2098,68841,80198,30,1191,31,705,6,141,345,88,57,18,441,290,9963,1564,56169,66132,9/29/2020
5/5/2020,433,11790,2873,71714,83504,29,1220,32,737,6,147,336,82,54,16,457,299,10262,1963,58132,68394,9/29/2020
5/6/2020,488,12278,2830,74544,86822,28,1248,44,781,9,156,311,79,54,21,478,340,10602,1915,60047,70649,9/29/2020
5/7/2020,425,12703,2969,77513,90216,36,1284,41,822,5,161,301,71,52,21,499,269,10871,1966,62013,72884,9/29/2020
5/8/2020,359,13062,2598,80111,93173,30,1314,29,851,5,166,297,71,53,22,521,230,11101,1737,63750,74851,9/29/2020
5/9/2020,467,13529,3346,83457,96986,22,1336,21,872,4,170,294,69,51,15,536,290,11391,2257,66007,77398,9/29/2020
5/10/2020,285,13814,2117,85574,99388,20,1356,23,895,6,176,285,70,49,13,549,189,11580,1523,67530,79110,9/29/2020
5/11/2020,257,14071,1857,87431,101502,31,1387,16,911,6,182,294,71,49,15,564,174,11754,1301,68831,80585,9/29/2020
5/12/2020,387,14458,2611,90042,104500,23,1410,18,929,4,186,295,69,48,22,586,224,11978,1707,70538,82516,9/29/2020
5/13/2020,351,14809,3630,93672,108481,23,1433,25,954,1,187,292,69,49,13,599,199,12177,2005,72543,84720,9/29/2020
5/14/2020,329,15138,3408,97080,112218,19,1452,27,981,3,190,281,64,45,15,614,230,12407,2019,74562,86969,9/29/2020
5/15/2020,381,15519,3458,100538,116057,24,1476,41,1022,5,195,259,62,45,14,628,232,12639,1811,76373,89012,9/29/2020
5/16/2020,449,15968,4156,104694,120662,25,1501,13,1035,5,200,266,61,46,15,643,248,12887,1963,78336,91223,9/29/2020
5/17/2020,240,16208,2768,107462,123670,17,1518,8,1043,5,205,270,59,45,10,653,126,13013,1557,79893,92906,9/29/2020
5/18/2020,250,16458,2001,109463,125921,19,1537,15,1058,5,210,269,57,40,18,671,136,13149,1369,81262,94411,9/29/2020
5/19/2020,415,16873,3168,112631,129504,23,1560,32,1090,5,215,255,56,38,11,682,215,13364,1928,83190,96554,9/29/2020
5/20/2020,326,17199,2771,115402,132601,19,1579,23,1113,7,222,244,52,33,22,704,183,13547,1514,84704,98251,9/29/2020
5/21/2020,374,17573,3757,119159,136732,25,1604,15,1128,3,225,251,53,29,20,724,167,13714,1940,86644,100358,9/29/2020
5/22/2020,351,17924,3161,122320,140244,20,1624,29,1157,5,230,237,52,29,10,734,206,13920,1610,88254,102174,9/29/2020
5/23/2020,253,18177,2742,125062,143239,19,1643,11,1168,3,233,242,52,32,13,747,108,14028,1271,89525,103553,9/29/2020
5/24/2020,163,18340,1370,126432,144772,12,1655,14,1182,2,235,238,53,36,8,755,82,14110,773,90298,104408,9/29/2020
5/25/2020,147,18487,1385,127817,146304,14,1669,14,1196,0,235,238,53,34,10,765,76,14186,762,91060,105246,9/29/2020
5/26/2020,285,18772,2620,130437,149209,24,1693,21,1217,5,240,236,48,33,15,780,157,14343,1781,92841,107184,9/29/2020
5/27/2020,276,19048,2057,132494,151542,20,1713,18,1235,3,243,235,50,33,10,790,132,14475,1133,93974,108449,9/29/2020
5/28/2020,348,19396,3359,135853,155249,17,1730,29,1264,4,247,219,47,32,8,798,130,14605,1117,95091,109696,9/29/2020
5/29/2020,410,19806,3914,139767,159573,19,1749,27,1291,6,253,205,43,31,12,810,173,14778,1570,96661,111439,9/29/2020
5/30/2020,225,20031,3915,143682,163713,15,1764,19,1310,4,257,197,40,29,12,822,109,14887,1820,98481,113368,9/29/2020
5/31/2020,155,20186,1688,145370,165556,10,1774,10,1320,1,258,196,42,26,3,825,78,14965,857,99338,114303,9/29/2020
6/1/2020,212,20398,2792,148162,168560,8,1782,14,1334,1,259,189,43,29,5,830,93,15058,1384,100722,115780,9/29/2020
6/2/2020,273,20671,3022,151184,171855,8,1790,9,1343,3,262,185,36,25,10,840,98,15156,1448,102170,117326,9/29/2020
6/3/2020,254,20925,3486,154670,175595,14,1804,18,1361,6,268,175,33,25,11,851,99,15255,1661,103831,119086,9/29/2020
6/4/2020,276,21201,4471,159141,180342,7,1811,25,1386,3,271,154,30,24,11,862,107,15362,2038,105869,121231,9/29/2020
6/5/2020,215,21416,3513,162654,184070,15,1826,12,1398,6,277,151,27,21,11,873,99,15461,1577,107446,122907,9/29/2020
6/6/2020,201,21617,2616,165270,186887,10,1836,7,1405,2,279,152,29,19,6,879,67,15528,1136,108582,124110,9/29/2020
6/7/2020,83,21700,1625,166895,188595,11,1847,7,1412,1,280,155,25,17,4,883,51,15579,782,109364,124943,9/29/2020
6/8/2020,119,21819,1849,168744,190563,15,1862,12,1424,2,282,156,27,18,4,887,45,15624,961,110325,125949,9/29/2020
6/9/2020,223,22042,2673,171417,193459,10,1872,18,1442,0,282,148,28,21,1,888,64,15688,1258,111583,127271,9/29/2020
6/10/2020,209,22251,2987,174404,196655,13,1885,12,1454,2,284,147,24,17,4,892,101,15789,1467,113050,128839,9/29/2020
6/11/2020,195,22446,3513,177917,200363,7,1892,15,1469,1,285,138,25,16,6,898,88,15877,1534,114584,130461,9/29/2020
6/12/2020,209,22655,4601,182518,205173,9,1901,15,1484,1,286,131,24,16,2,900,78,15955,2180,116764,132719,9/29/2020
6/13/2020,113,22768,3036,185554,208322,6,1907,4,1488,0,286,133,20,15,3,903,49,16004,1373,118137,134141,9/29/2020
6/14/2020,81,22849,2046,187600,210449,7,1914,8,1496,1,287,131,20,14,3,906,33,16037,967,119104,135141,9/29/2020
6/15/2020,188,23037,3108,190708,213745,14,1928,14,1510,0,287,131,20,16,5,911,75,16112,1791,120895,137007,9/29/2020
6/16/2020,110,23147,3017,193725,216872,11,1939,9,1519,1,288,132,22,16,8,919,50,16162,1578,122473,138635,9/29/2020
6/17/2020,127,23274,2835,196560,219834,15,1954,20,1539,4,292,123,18,14,6,925,50,16212,1319,123792,140004,9/29/2020
6/18/2020,149,23423,3047,199607,223030,9,1963,13,1552,1,293,118,19,16,7,932,70,16282,1314,125106,141388,9/29/2020
6/19/2020,141,23564,3769,203376,226940,12,1975,11,1563,1,294,118,20,17,3,935,59,16341,1371,126477,142818,9/29/2020
6/20/2020,84,23648,1891,205267,228915,9,1984,12,1575,0,294,115,20,18,4,939,36,16377,813,127290,143667,9/29/2020
6/21/2020,37,23685,1064,206331,230016,8,1992,5,1580,0,294,118,20,18,2,941,29,16406,692,127982,144388,9/29/2020
6/22/2020,138,23823,3730,210061,233884,12,2004,16,1596,0,294,114,19,18,2,943,65,16471,1706,129688,146159,9/29/2020
6/23/2020,163,23986,3831,213892,237878,3,2007,13,1609,3,297,101,18,18,7,950,81,16552,1780,131468,148020,9/29/2020
6/24/2020,120,24106,3502,217394,241500,9,2016,10,1619,1,298,99,18,18,5,955,44,16596,1687,133155,149751,9/29/2020
6/25/2020,103,24209,2883,220277,244486,6,2022,14,1633,1,299,90,17,17,1,956,50,16646,1511,134666,151312,9/29/2020
6/26/2020,94,24303,2488,222765,247068,2,2024,10,1643,0,299,82,18,18,1,957,60,16706,1332,135998,152704,9/29/2020
6/27/2020,84,24387,3214,225979,250366,5,2029,3,1646,1,300,83,17,17,5,962,37,16743,1221,137219,153962,9/29/2020
6/28/2020,39,24426,1469,227448,251874,4,2033,4,1650,4,304,79,15,14,6,968,17,16760,595,137814,154574,9/29/2020
6/29/2020,85,24511,3697,231145,255656,4,2037,5,1655,0,304,78,14,14,1,969,39,16799,1354,139168,155967,9/29/2020
6/30/2020,57,24568,1956,233101,257669,1,2038,5,1660,1,305,73,12,11,4,973,33,16832,995,140163,156995,9/29/2020
7/1/2020,144,24712,4098,237199,261911,7,2045,9,1669,0,305,71,11,11,1,974,78,16910,1935,142098,159008,9/29/2020
7/2/2020,103,24815,2803,240002,264817,5,2050,5,1674,1,306,70,10,10,3,977,59,16969,1088,143186,160155,9/29/2020
7/3/2020,50,24865,2076,242078,266943,9,2059,6,1680,0,306,73,9,9,3,980,25,16994,777,143963,160957,9/29/2020
7/4/2020,57,24922,2345,244423,269345,2,2061,4,1684,1,307,70,10,9,2,982,33,17027,1010,144973,162000,9/29/2020
7/5/2020,49,24971,2932,247355,272326,1,2062,2,1686,1,308,68,8,8,2,984,26,17053,1445,146418,163471,9/29/2020
7/6/2020,101,25072,2811,250166,275238,6,2068,6,1692,0,308,68,9,9,4,988,57,17110,1552,147970,165080,9/29/2020
7/7/2020,81,25153,3457,253623,278776,5,2073,7,1699,0,308,66,8,8,2,990,47,17157,1534,149504,166661,9/29/2020
7/8/2020,105,25258,3403,257026,282284,4,2077,2,1701,0,308,68,9,8,0,990,64,17221,1424,150928,168149,9/29/2020
7/9/2020,94,25352,3712,260738,286090,9,2086,3,1704,0,308,74,9,8,0,990,50,17271,1628,152556,169827,9/29/2020
7/10/2020,131,25483,4431,265169,290652,6,2092,3,1707,2,310,75,7,7,3,993,80,17351,2077,154633,171984,9/29/2020
7/11/2020,63,25546,2932,268101,293647,6,2098,3,1710,1,311,77,6,6,3,996,36,17387,1316,155949,173336,9/29/2020
7/12/2020,47,25593,1836,269937,295530,1,2099,3,1713,1,312,74,6,5,3,999,33,17420,943,156892,174312,9/29/2020
7/13/2020,84,25677,3157,273094,298771,8,2107,10,1723,0,312,72,6,5,1,1000,61,17481,1473,158365,175846,9/29/2020
7/14/2020,73,25750,3289,276383,302133,7,2114,4,1727,0,312,75,5,5,1,1001,43,17524,1373,159738,177262,9/29/2020
7/15/2020,130,25880,4168,280551,306431,5,2119,7,1734,0,312,73,5,4,0,1001,99,17623,1747,161485,179108,9/29/2020
7/16/2020,102,25982,3733,284284,310266,6,2125,9,1743,0,312,70,6,5,1,1002,75,17698,1618,163103,180801,9/29/2020
7/17/2020,156,26138,4235,288519,314657,14,2139,3,1746,1,313,80,5,5,2,1004,79,17777,1848,164951,182728,9/29/2020
7/18/2020,85,26223,3267,291786,318009,5,2144,9,1755,1,314,75,5,4,4,1008,70,17847,1400,166351,184198,9/29/2020
7/19/2020,82,26305,2693,294479,320784,7,2151,3,1758,0,314,79,6,4,2,1010,57,17904,1149,167500,185404,9/29/2020
7/20/2020,71,26376,2664,297143,323519,9,2160,7,1765,0,314,81,7,5,2,1012,68,17972,1466,168966,186938,9/29/2020
7/21/2020,130,26506,4298,301441,327947,9,2169,11,1776,0,314,79,9,6,1,1013,109,18081,1917,170883,188964,9/29/2020
7/22/2020,130,26636,3926,305367,332003,11,2180,11,1787,1,315,78,7,6,1,1014,86,18167,1683,172566,190733,9/29/2020
7/23/2020,141,26777,4376,309743,336520,8,2188,6,1793,0,315,80,8,7,0,1014,115,18282,1968,174534,192816,9/29/2020
7/24/2020,172,26949,5959,315702,342651,14,2202,14,1807,0,315,80,9,7,0,1014,119,18401,2321,176855,195256,9/29/2020
7/25/2020,134,27083,4398,320100,347183,7,2209,7,1814,0,315,80,10,8,2,1016,108,18509,2100,178955,197464,9/29/2020
7/26/2020,62,27145,3027,323127,350272,8,2217,9,1823,0,315,79,11,7,1,1017,54,18563,1339,180294,198857,9/29/2020
7/27/2020,186,27331,4163,327290,354621,12,2229,7,1830,0,315,84,13,8,1,1018,138,18701,2332,182626,201327,9/29/2020
7/28/2020,105,27436,3831,331121,358557,5,2234,5,1835,0,315,84,14,7,1,1019,94,18795,1631,184257,203052,9/29/2020
7/29/2020,191,27627,5123,336244,363871,11,2245,12,1847,0,315,83,15,7,0,1019,154,18949,2324,186581,205530,9/29/2020
7/30/2020,121,27748,4344,340588,368336,6,2251,2,1849,1,316,86,15,6,1,1020,97,19046,1650,188231,207277,9/29/2020
7/31/2020,131,27879,5508,346096,373975,8,2259,10,1859,0,316,84,15,7,1,1021,89,19135,1856,190087,209222,9/29/2020
8/1/2020,108,27987,4288,350384,378371,7,2266,2,1861,0,316,89,14,7,1,1022,88,19223,1558,191645,210868,9/29/2020
8/2/2020,84,28071,2802,353186,381257,12,2278,12,1873,2,318,87,14,8,2,1024,62,19285,1274,192919,212204,9/29/2020
8/3/2020,187,28258,5218,358404,386662,13,2291,12,1885,0,318,88,16,7,1,1025,150,19435,2200,195119,214554,9/29/2020
8/4/2020,126,28384,3689,362093,390477,8,2299,6,1891,1,319,89,12,5,2,1027,99,19534,1771,196890,216424,9/29/2020
8/5/2020,148,28532,5919,368012,396544,12,2311,10,1901,1,320,90,10,5,2,1029,118,19652,2471,199361,219013,9/29/2020
8/6/2020,169,28701,5533,373545,402246,7,2318,9,1910,0,320,88,9,4,0,1029,121,19773,2421,201782,221555,9/29/2020
8/7/2020,122,28823,4845,378390,407213,13,2331,10,1920,1,321,90,9,3,2,1031,87,19860,2152,203934,223794,9/29/2020
8/8/2020,123,28946,4106,382496,411442,19,2350,6,1926,1,322,102,8,3,1,1032,92,19952,1780,205714,225666,9/29/2020
8/9/2020,42,28988,1722,384218,413206,8,2358,10,1936,0,322,100,9,4,0,1032,35,19987,1076,206790,226777,9/29/2020
8/10/2020,149,29137,4580,388798,417935,11,2369,12,1948,0,322,99,9,4,1,1033,113,20100,2029,208819,228919,9/29/2020
8/11/2020,105,29242,4325,393123,422365,6,2375,14,1962,0,322,91,10,4,3,1036,92,20192,2270,211089,231281,9/29/2020
8/12/2020,121,29363,5184,398307,427670,8,2383,11,1973,0,322,88,9,3,1,1037,101,20293,2628,213717,234010,9/29/2020
8/13/2020,135,29498,4191,402498,431996,13,2396,12,1985,0,322,89,11,3,0,1037,95,20388,1909,215626,236014,9/29/2020
8/14/2020,145,29643,5492,407990,437633,13,2409,11,1996,0,322,91,11,4,3,1040,99,20487,1976,217602,238089,9/29/2020
8/15/2020,105,29748,4533,412523,442271,8,2417,11,2007,1,323,87,11,5,0,1040,89,20576,1699,219301,239877,9/29/2020
8/16/2020,83,29831,2785,415308,445139,7,2424,6,2013,4,327,84,8,4,6,1046,70,20646,984,220285,240931,9/29/2020
8/17/2020,106,29937,4570,419878,449815,10,2434,7,2020,0,327,87,8,5,2,1048,88,20734,2394,222679,243413,9/29/2020
8/18/2020,128,30065,5048,424926,454991,11,2445,9,2029,1,328,88,8,4,5,1053,95,20829,2777,225456,246285,9/29/2020
8/19/2020,114,30179,5407,430333,460512,8,2453,9,2038,1,329,86,9,5,0,1053,89,20918,2671,228127,249045,9/29/2020
8/20/2020,174,30353,8220,438553,468906,12,2465,6,2044,2,331,90,10,5,3,1056,139,21057,3563,231690,252747,9/29/2020
8/21/2020,154,30507,6816,445369,475876,8,2473,5,2049,1,332,92,9,4,2,1058,125,21182,2964,234654,255836,9/29/2020
8/22/2020,96,30603,5956,451325,481928,10,2483,12,2061,0,332,90,11,4,1,1059,84,21266,2624,237278,258544,9/29/2020
8/23/2020,70,30673,4365,455690,486363,11,2494,6,2067,0,332,95,11,2,1,1060,56,21322,2469,239747,261069,9/29/2020
8/24/2020,105,30778,5776,461466,492244,7,2501,10,2077,1,333,91,13,4,1,1061,76,21398,3151,242898,264296,9/29/2020
8/25/2020,108,30886,4745,466211,497097,10,2511,4,2081,1,334,96,11,4,1,1062,92,21490,2295,245193,266683,9/29/2020
8/26/2020,170,31056,9490,475701,506757,4,2515,8,2089,0,334,92,9,5,1,1063,127,21617,3066,248259,269876,9/29/2020
8/27/2020,93,31149,8798,484499,515648,6,2521,13,2102,1,335,84,6,5,2,1065,71,21688,3207,251466,273154,9/29/2020
8/28/2020,112,31261,8058,492557,523818,14,2535,4,2106,0,335,94,9,7,2,1067,88,21776,2421,253887,275663,9/29/2020
8/29/2020,65,31326,5413,497970,529296,6,2541,8,2114,1,336,91,10,6,2,1069,51,21827,1903,255790,277617,9/29/2020
8/30/2020,66,31392,4319,502289,533681,7,2548,4,2118,0,336,94,8,5,2,1071,48,21875,1993,257783,279658,9/29/2020
8/31/2020,105,31497,4871,507160,538657,12,2560,15,2133,0,336,91,8,4,1,1072,80,21955,2193,259976,281931,9/29/2020
9/1/2020,98,31595,7124,514284,545879,6,2566,9,2142,1,337,87,7,4,2,1074,65,22020,2375,262351,284371,9/29/2020
9/2/2020,126,31721,10680,524964,556685,9,2575,10,2152,1,338,85,8,4,2,1076,103,22123,3045,265396,287519,9/29/2020
9/3/2020,90,31811,11214,536178,567989,8,2583,8,2160,0,338,85,9,4,2,1078,73,22196,2587,267983,290179,9/29/2020
9/4/2020,102,31913,9039,545217,577130,11,2594,4,2164,0,338,92,9,4,1,1079,82,22278,2396,270379,292657,9/29/2020
9/5/2020,52,31965,6307,551524,583489,6,2600,9,2173,0,338,89,8,3,1,1080,42,22320,1600,271979,294299,9/29/2020
9/6/2020,87,32052,4317,555841,587893,4,2604,8,2181,1,339,84,6,3,1,1081,64,22384,1959,273938,296322,9/29/2020
9/7/2020,35,32087,3002,558843,590930,11,2615,3,2184,0,339,92,5,3,1,1082,26,22410,649,274587,296997,9/29/2020
9/8/2020,75,32162,6381,565224,597386,6,2621,12,2196,1,340,85,6,3,2,1084,66,22476,1608,276195,298671,9/29/2020
9/9/2020,118,32280,8840,574064,606344,9,2630,5,2201,1,341,88,9,3,1,1085,101,22577,2155,278350,300927,9/29/2020
9/10/2020,166,32446,11425,585489,617935,9,2639,8,2209,0,341,89,10,3,0,1085,113,22690,2269,280619,303309,9/29/2020
9/11/2020,119,32565,9463,594952,627517,11,2650,11,2220,0,341,89,10,5,0,1085,99,22789,1972,282591,305380,9/29/2020
9/12/2020,108,32673,6140,601092,633765,8,2658,5,2225,2,343,90,9,5,3,1088,96,22885,1490,284081,306966,9/29/2020
9/13/2020,58,32731,2699,603791,636522,4,2662,3,2228,0,343,91,10,5,0,1088,53,22938,853,284934,307872,9/29/2020
9/14/2020,101,32832,6223,610014,642846,5,2667,3,2231,2,345,91,10,5,1,1089,93,23031,1601,286535,309566,9/29/2020
9/15/2020,142,32974,8376,618390,651364,6,2673,2,2233,1,346,94,10,5,2,1091,121,23152,2070,288605,311757,9/29/2020
9/16/2020,155,33129,9586,627976,661105,7,2680,7,2240,2,348,92,8,6,5,1096,116,23268,1848,290453,313721,9/29/2020
9/17/2020,136,33265,9272,637248,670513,7,2687,14,2254,0,348,85,8,4,0,1096,152,23420,1926,292379,315799,9/29/2020
9/18/2020,201,33466,10026,647274,680740,7,2694,7,2261,1,349,84,11,6,2,1098,127,23547,1960,294339,317886,9/29/2020
9/19/2020,163,33629,8395,655669,689298,7,2701,3,2264,0,349,88,10,6,4,1102,110,23657,1748,296087,319744,9/29/2020
9/20/2020,81,33710,3804,659473,693183,7,2708,6,2270,2,351,87,10,8,4,1106,53,23710,1418,297505,321215,9/29/2020
9/21/2020,125,33835,7076,666549,700384,12,2720,3,2273,2,353,94,9,6,2,1108,96,23806,2436,299941,323747,9/29/2020
9/22/2020,168,34003,9114,675663,709666,12,2732,3,2276,1,354,102,8,5,1,1109,107,23913,2079,302020,325933,9/29/2020
9/23/2020,165,34168,10586,686249,720417,9,2741,7,2283,0,354,104,6,5,0,1109,131,24044,2195,304215,328259,9/29/2020
9/24/2020,154,34322,11777,698026,732348,7,2748,9,2292,1,355,101,6,5,1,1110,116,24160,2389,306604,330764,9/29/2020
9/25/2020,137,34459,9774,707800,742259,9,2757,10,2302,0,355,100,5,5,1,1111,125,24285,2355,308959,333244,9/29/2020
9/26/2020,142,34601,9819,717619,752220,10,2767,9,2311,0,355,101,5,5,1,1112,112,24397,1975,310934,335331,9/29/2020
9/27/2020,41,34642,2108,719727,754369,7,2774,5,2316,0,355,103,8,5,0,1112,28,24425,604,311538,335963,9/29/2020
9/28/2020,137,34779,5722,725449,760228,,,,,,,,,,1,1113,131,24556,1804,313342,337898,9/29/2020
2/27/2020,0,0,0,0,0,1,1,0,0,0,0,1,0,0,0,0,0,0,0,0,0,9/30/2020
2/28/2020,0,0,0,0,0,0,1,0,0,0,0,1,1,0,0,0,0,0,0,0,0,9/30/2020
2/29/2020,0,0,0,0,0,0,1,0,0,0,0,1,1,0,0,0,0,0,0,0,0,9/30/2020
3/1/2020,2,2,2,2,4,0,1,0,0,0,0,1,1,1,0,0,2,2,2,2,4,9/30/2020
3/2/2020,0,2,1,3,5,1,2,0,0,0,0,2,2,2,0,0,0,2,1,3,5,9/30/2020
3/3/2020,0,2,2,5,7,0,2,0,0,0,0,2,2,2,0,0,0,2,2,5,7,9/30/2020
3/4/2020,0,2,12,17,19,1,3,0,0,0,0,3,2,2,0,0,0,2,10,15,17,9/30/2020
3/5/2020,0,2,4,21,23,0,3,0,0,0,0,3,2,2,0,0,1,3,4,19,22,9/30/2020
3/6/2020,1,3,12,33,36,0,3,0,0,0,0,3,2,2,0,0,0,3,11,30,33,9/30/2020
3/7/2020,0,3,19,52,55,0,3,0,0,0,0,3,2,1,0,0,0,3,19,49,52,9/30/2020
3/8/2020,0,3,18,70,73,0,3,0,0,0,0,3,2,1,0,0,0,3,18,67,70,9/30/2020
3/9/2020,1,4,15,85,89,0,3,0,0,0,0,3,2,1,0,0,1,4,15,82,86,9/30/2020
3/10/2020,2,6,25,110,116,0,3,0,0,0,0,3,2,1,0,0,1,5,23,105,110,9/30/2020
3/11/2020,0,6,34,144,150,1,4,0,0,0,0,4,1,1,0,0,0,5,34,139,144,9/30/2020
3/12/2020,9,15,41,185,200,1,5,0,0,0,0,5,1,1,0,0,8,13,38,177,190,9/30/2020
3/13/2020,6,21,50,235,256,4,9,1,1,0,0,8,1,1,0,0,6,19,48,225,244,9/30/2020
3/14/2020,0,21,90,325,346,0,9,0,1,0,0,8,1,1,0,0,0,19,86,311,330,9/30/2020
3/15/2020,1,22,54,379,401,1,10,0,1,0,0,9,2,1,0,0,1,20,54,365,385,9/30/2020
3/16/2020,2,24,95,474,498,2,12,0,1,0,0,11,2,0,0,0,2,22,92,457,479,9/30/2020
3/17/2020,12,36,162,636,672,6,18,0,1,0,0,17,2,0,0,0,11,33,151,608,641,9/30/2020
3/18/2020,9,45,116,752,797,3,21,0,1,0,0,20,2,0,0,0,11,44,110,718,762,9/30/2020
3/19/2020,15,60,262,1014,1074,2,23,1,2,0,0,21,3,0,1,1,17,61,251,969,1030,9/30/2020
3/20/2020,13,73,197,1211,1284,5,28,0,2,0,0,26,4,0,0,1,13,74,190,1159,1233,9/30/2020
3/21/2020,12,85,126,1337,1422,3,31,2,4,0,0,27,5,0,0,1,14,88,123,1282,1370,9/30/2020
3/22/2020,27,112,282,1619,1731,2,33,0,4,0,0,29,5,0,0,1,25,113,262,1544,1657,9/30/2020
3/23/2020,14,126,169,1788,1914,15,48,1,5,0,0,43,9,3,0,1,16,129,165,1709,1838,9/30/2020
3/24/2020,20,146,242,2030,2176,7,55,0,5,0,0,50,10,4,0,1,19,148,237,1946,2094,9/30/2020
3/25/2020,26,172,182,2212,2384,5,60,1,6,0,0,54,11,3,0,1,28,176,171,2117,2293,9/30/2020
3/26/2020,35,207,181,2393,2600,10,70,5,11,0,0,59,14,5,0,1,41,217,174,2291,2508,9/30/2020
3/27/2020,27,234,214,2607,2841,9,79,1,12,1,1,66,17,6,2,3,31,248,202,2493,2741,9/30/2020
3/28/2020,59,293,260,2867,3160,13,92,3,15,2,3,74,15,6,1,4,64,312,241,2734,3046,9/30/2020
3/29/2020,100,393,350,3217,3610,8,100,4,19,1,4,77,18,8,2,6,105,417,313,3047,3464,9/30/2020
3/30/2020,62,455,222,3439,3894,20,120,5,24,0,4,92,20,11,3,9,78,495,184,3231,3726,9/30/2020
3/31/2020,71,526,369,3808,4334,11,131,7,31,1,5,95,22,13,2,11,73,568,296,3527,4095,9/30/2020
4/1/2020,99,625,698,4506,5131,18,149,7,38,0,5,106,30,15,1,12,100,668,640,4167,4835,9/30/2020
4/2/2020,52,677,477,4983,5660,22,171,6,44,2,7,120,36,21,4,16,62,730,436,4603,5333,9/30/2020
4/3/2020,108,785,774,5757,6542,23,194,7,51,0,7,136,43,25,3,19,100,830,712,5315,6145,9/30/2020
4/4/2020,143,928,660,6417,7345,22,216,4,55,5,12,149,41,30,9,28,138,968,618,5933,6901,9/30/2020
4/5/2020,187,1115,1156,7573,8688,20,236,9,64,1,13,159,44,36,2,30,181,1149,1066,6999,8148,9/30/2020
4/6/2020,218,1333,1706,9279,10612,26,262,7,71,0,13,178,48,40,7,37,208,1357,1552,8551,9908,9/30/2020
4/7/2020,284,1617,1629,10908,12525,20,282,4,75,2,15,192,50,42,5,42,261,1618,1480,10031,11649,9/30/2020
4/8/2020,290,1907,1720,12628,14535,19,301,7,82,6,21,198,50,38,10,52,271,1889,1560,11591,13480,9/30/2020
4/9/2020,283,2190,1516,14144,16334,32,333,9,91,4,25,217,53,40,7,59,277,2166,1355,12946,15112,9/30/2020
4/10/2020,419,2609,2574,16718,19327,29,362,17,108,5,30,224,59,41,11,70,401,2567,2370,15316,17883,9/30/2020
4/11/2020,297,2906,1905,18623,21529,29,391,11,119,2,32,240,61,48,12,82,280,2847,1716,17032,19879,9/30/2020
4/12/2020,314,3220,1670,20293,23513,34,425,13,132,5,37,256,59,49,9,91,284,3131,1435,18467,21598,9/30/2020
4/13/2020,161,3381,935,21228,24609,35,460,13,145,3,40,275,64,54,9,100,187,3318,837,19304,22622,9/30/2020
4/14/2020,289,3670,1787,23015,26685,27,487,17,162,5,45,280,72,53,8,108,262,3580,1528,20832,24412,9/30/2020
4/15/2020,351,4021,1799,24814,28835,31,518,19,181,3,48,289,72,54,17,125,306,3886,1553,22385,26271,9/30/2020
4/16/2020,447,4468,2494,27308,31776,36,554,25,206,6,54,294,72,53,14,139,386,4272,2074,24459,28731,9/30/2020
4/17/2020,304,4772,1821,29129,33901,32,586,20,226,7,61,299,66,45,21,160,290,4562,1446,25905,30467,9/30/2020
4/18/2020,321,5093,1725,30854,35947,26,612,18,244,4,65,303,63,49,15,175,284,4846,1325,27230,32076,9/30/2020
4/19/2020,381,5474,2047,32901,38375,23,635,26,270,1,66,299,65,55,11,186,336,5182,1740,28970,34152,9/30/2020
4/20/2020,394,5868,1907,34808,40676,46,681,29,299,2,68,314,75,56,10,196,376,5558,1570,30540,36098,9/30/2020
4/21/2020,444,6312,2110,36918,43230,45,726,33,332,5,73,321,72,56,18,214,384,5942,1703,32243,38185,9/30/2020
4/22/2020,418,6730,2390,39308,46038,41,767,32,364,5,78,325,73,58,18,232,379,6321,1914,34157,40478,9/30/2020
4/23/2020,479,7209,2469,41777,48986,32,799,28,392,5,83,324,76,62,15,247,412,6733,1855,36012,42745,9/30/2020
4/24/2020,491,7700,3284,45061,52761,35,834,26,418,4,87,329,85,63,15,262,408,7141,2626,38638,45779,9/30/2020
4/25/2020,393,8093,2206,47267,55360,34,868,17,435,5,92,341,85,62,14,276,300,7441,1765,40403,47844,9/30/2020
4/26/2020,316,8409,2309,49576,57985,33,901,15,450,3,95,356,86,59,14,290,274,7715,1875,42278,49993,9/30/2020
4/27/2020,249,8658,1620,51196,59854,29,930,21,471,4,99,360,86,61,10,300,206,7921,1162,43440,51361,9/30/2020
4/28/2020,410,9068,2263,53459,62527,44,974,24,495,3,102,377,88,59,22,322,331,8252,1762,45202,53454,9/30/2020
4/29/2020,476,9544,3343,56802,66346,36,1010,38,533,11,113,364,78,53,18,340,371,8623,2423,47625,56248,9/30/2020
4/30/2020,432,9976,2769,59571,69547,33,1043,38,571,6,119,353,83,57,24,364,350,8973,1930,49555,58528,9/30/2020
5/1/2020,454,10430,3086,62657,73087,51,1094,39,610,3,122,362,84,58,14,378,325,9298,2179,51734,61032,9/30/2020
5/2/2020,257,10687,1926,64583,75270,36,1130,38,648,5,127,355,91,62,24,402,192,9490,1275,53009,62499,9/30/2020
5/3/2020,283,10970,2160,66743,77713,31,1161,26,674,8,135,352,90,61,21,423,183,9673,1579,54588,64261,9/30/2020
5/4/2020,387,11357,2098,68841,80198,30,1191,31,705,6,141,345,88,57,18,441,290,9963,1564,56152,66115,9/30/2020
5/5/2020,433,11790,2873,71714,83504,29,1220,32,737,6,147,336,82,54,16,457,299,10262,1961,58113,68375,9/30/2020
5/6/2020,488,12278,2830,74544,86822,28,1248,44,781,9,156,311,79,54,21,478,340,10602,1918,60031,70633,9/30/2020
5/7/2020,425,12703,2969,77513,90216,36,1284,41,822,5,161,301,71,52,21,499,269,10871,1965,61996,72867,9/30/2020
5/8/2020,359,13062,2598,80111,93173,30,1314,29,851,5,166,297,71,53,22,521,230,11101,1737,63733,74834,9/30/2020
5/9/2020,467,13529,3346,83457,96986,22,1336,21,872,4,170,294,69,51,15,536,290,11391,2257,65990,77381,9/30/2020
5/10/2020,285,13814,2117,85574,99388,20,1356,23,895,6,176,285,70,49,13,549,189,11580,1523,67513,79093,9/30/2020
5/11/2020,257,14071,1857,87431,101502,31,1387,16,911,6,182,294,71,49,15,564,174,11754,1302,68815,80569,9/30/2020
5/12/2020,387,14458,2611,90042,104500,23,1410,18,929,4,186,295,69,48,22,586,224,11978,1707,70522,82500,9/30/2020
5/13/2020,351,14809,3630,93672,108481,23,1433,25,954,1,187,292,69,49,13,599,199,12177,2005,72527,84704,9/30/2020
5/14/2020,329,15138,3408,97080,112218,19,1452,27,981,3,190,281,64,45,15,614,230,12407,2019,74546,86953,9/30/2020
5/15/2020,381,15519,3458,100538,116057,24,1476,41,1022,5,195,259,62,45,14,628,232,12639,1809,76355,88994,9/30/2020
5/16/2020,449,15968,4156,104694,120662,25,1501,13,1035,5,200,266,61,46,15,643,247,12886,1964,78319,91205,9/30/2020
5/17/2020,240,16208,2768,107462,123670,17,1518,8,1043,5,205,270,59,45,10,653,126,13012,1557,79876,92888,9/30/2020
5/18/2020,250,16458,2001,109463,125921,19,1537,15,1058,5,210,269,57,40,18,671,136,13148,1369,81245,94393,9/30/2020
5/19/2020,415,16873,3168,112631,129504,23,1560,32,1090,5,215,255,56,38,11,682,215,13363,1928,83173,96536,9/30/2020
5/20/2020,326,17199,2771,115402,132601,19,1579,23,1113,7,222,244,52,33,22,704,183,13546,1515,84688,98234,9/30/2020
5/21/2020,374,17573,3757,119159,136732,25,1604,15,1128,3,225,251,53,29,20,724,167,13713,1940,86628,100341,9/30/2020
5/22/2020,351,17924,3161,122320,140244,20,1624,29,1157,5,230,237,52,29,10,734,206,13919,1609,88237,102156,9/30/2020
5/23/2020,253,18177,2742,125062,143239,19,1643,11,1168,3,233,242,52,32,13,747,109,14028,1271,89508,103536,9/30/2020
5/24/2020,163,18340,1370,126432,144772,12,1655,14,1182,2,235,238,53,36,8,755,82,14110,773,90281,104391,9/30/2020
5/25/2020,147,18487,1385,127817,146304,14,1669,14,1196,0,235,238,53,34,10,765,76,14186,762,91043,105229,9/30/2020
5/26/2020,285,18772,2620,130437,149209,24,1693,21,1217,5,240,236,48,33,15,780,157,14343,1781,92824,107167,9/30/2020
5/27/2020,276,19048,2057,132494,151542,20,1713,18,1235,3,243,235,50,33,10,790,132,14475,1133,93957,108432,9/30/2020
5/28/2020,348,19396,3359,135853,155249,17,1730,29,1264,4,247,219,47,32,8,798,130,14605,1117,95074,109679,9/30/2020
5/29/2020,410,19806,3914,139767,159573,19,1749,27,1291,6,253,205,43,31,12,810,173,14778,1571,96645,111423,9/30/2020
5/30/2020,225,20031,3915,143682,163713,15,1764,19,1310,4,257,197,40,29,12,822,109,14887,1820,98465,113352,9/30/2020
5/31/2020,155,20186,1688,145370,165556,10,1774,10,1320,1,258,196,42,26,3,825,78,14965,857,99322,114287,9/30/2020
6/1/2020,212,20398,2792,148162,168560,8,1782,14,1334,1,259,189,43,29,5,830,93,15058,1384,100706,115764,9/30/2020
6/2/2020,273,20671,3022,151184,171855,8,1790,9,1343,3,262,185,36,25,10,840,98,15156,1448,102154,117310,9/30/2020
6/3/2020,254,20925,3486,154670,175595,14,1804,18,1361,6,268,175,33,25,11,851,99,15255,1661,103815,119070,9/30/2020
6/4/2020,276,21201,4471,159141,180342,7,1811,25,1386,3,271,154,30,24,11,862,107,15362,2038,105853,121215,9/30/2020
6/5/2020,215,21416,3513,162654,184070,15,1826,12,1398,6,277,151,27,21,11,873,99,15461,1576,107429,122890,9/30/2020
6/6/2020,201,21617,2616,165270,186887,10,1836,7,1405,2,279,152,29,19,6,879,67,15528,1136,108565,124093,9/30/2020
6/7/2020,83,21700,1625,166895,188595,11,1847,7,1412,1,280,155,25,17,4,883,51,15579,782,109347,124926,9/30/2020
6/8/2020,119,21819,1849,168744,190563,15,1862,12,1424,2,282,156,27,18,4,887,45,15624,961,110308,125932,9/30/2020
6/9/2020,223,22042,2673,171417,193459,10,1872,18,1442,0,282,148,28,21,1,888,64,15688,1257,111565,127253,9/30/2020
6/10/2020,209,22251,2987,174404,196655,13,1885,12,1454,2,284,147,24,17,4,892,101,15789,1466,113031,128820,9/30/2020
6/11/2020,195,22446,3513,177917,200363,7,1892,15,1469,1,285,138,25,16,6,898,88,15877,1534,114565,130442,9/30/2020
6/12/2020,209,22655,4601,182518,205173,9,1901,15,1484,1,286,131,24,16,2,900,78,15955,2183,116748,132703,9/30/2020
6/13/2020,113,22768,3036,185554,208322,6,1907,4,1488,0,286,133,20,15,3,903,49,16004,1373,118121,134125,9/30/2020
6/14/2020,81,22849,2046,187600,210449,7,1914,8,1496,1,287,131,20,14,3,906,33,16037,968,119089,135126,9/30/2020
6/15/2020,188,23037,3108,190708,213745,14,1928,14,1510,0,287,131,20,16,5,911,75,16112,1791,120880,136992,9/30/2020
6/16/2020,110,23147,3017,193725,216872,11,1939,9,1519,1,288,132,22,16,8,919,50,16162,1578,122458,138620,9/30/2020
6/17/2020,127,23274,2835,196560,219834,15,1954,20,1539,4,292,123,18,14,6,925,50,16212,1319,123777,139989,9/30/2020
6/18/2020,149,23423,3047,199607,223030,9,1963,13,1552,1,293,118,19,16,7,932,70,16282,1313,125090,141372,9/30/2020
6/19/2020,141,23564,3769,203376,226940,12,1975,11,1563,1,294,118,20,17,3,935,59,16341,1371,126461,142802,9/30/2020
6/20/2020,84,23648,1891,205267,228915,9,1984,12,1575,0,294,115,20,18,4,939,36,16377,813,127274,143651,9/30/2020
6/21/2020,37,23685,1064,206331,230016,8,1992,5,1580,0,294,118,20,18,2,941,29,16406,692,127966,144372,9/30/2020
6/22/2020,138,23823,3730,210061,233884,12,2004,16,1596,0,294,114,19,18,2,943,65,16471,1706,129672,146143,9/30/2020
6/23/2020,163,23986,3831,213892,237878,3,2007,13,1609,3,297,101,18,18,7,950,81,16552,1780,131452,148004,9/30/2020
6/24/2020,120,24106,3502,217394,241500,9,2016,10,1619,1,298,99,18,18,5,955,44,16596,1687,133139,149735,9/30/2020
6/25/2020,103,24209,2883,220277,244486,6,2022,14,1633,1,299,90,17,17,1,956,50,16646,1512,134651,151297,9/30/2020
6/26/2020,94,24303,2488,222765,247068,2,2024,10,1643,0,299,82,18,18,1,957,60,16706,1331,135982,152688,9/30/2020
6/27/2020,84,24387,3214,225979,250366,5,2029,3,1646,1,300,83,17,17,5,962,37,16743,1220,137202,153945,9/30/2020
6/28/2020,39,24426,1469,227448,251874,4,2033,4,1650,4,304,79,15,14,6,968,17,16760,595,137797,154557,9/30/2020
6/29/2020,85,24511,3697,231145,255656,4,2037,5,1655,0,304,78,14,14,1,969,39,16799,1354,139151,155950,9/30/2020
6/30/2020,57,24568,1956,233101,257669,1,2038,5,1660,1,305,73,12,11,4,973,33,16832,995,140146,156978,9/30/2020
7/1/2020,144,24712,4098,237199,261911,7,2045,9,1669,0,305,71,11,11,1,974,78,16910,1934,142080,158990,9/30/2020
7/2/2020,103,24815,2803,240002,264817,5,2050,5,1674,1,306,70,10,10,3,977,59,16969,1089,143169,160138,9/30/2020
7/3/2020,50,24865,2076,242078,266943,9,2059,6,1680,0,306,73,9,9,3,980,25,16994,778,143947,160941,9/30/2020
7/4/2020,57,24922,2345,244423,269345,2,2061,4,1684,1,307,70,10,9,2,982,33,17027,1011,144958,161985,9/30/2020
7/5/2020,49,24971,2932,247355,272326,1,2062,2,1686,1,308,68,8,8,2,984,26,17053,1445,146403,163456,9/30/2020
7/6/2020,101,25072,2811,250166,275238,6,2068,6,1692,0,308,68,9,9,4,988,57,17110,1552,147955,165065,9/30/2020
7/7/2020,81,25153,3457,253623,278776,5,2073,7,1699,0,308,66,8,8,2,990,47,17157,1535,149490,166647,9/30/2020
7/8/2020,105,25258,3403,257026,282284,4,2077,2,1701,0,308,68,9,8,0,990,64,17221,1425,150915,168136,9/30/2020
7/9/2020,94,25352,3712,260738,286090,9,2086,3,1704,0,308,74,9,8,0,990,50,17271,1628,152543,169814,9/30/2020
7/10/2020,131,25483,4431,265169,290652,6,2092,3,1707,2,310,75,7,7,3,993,80,17351,2080,154623,171974,9/30/2020
7/11/2020,63,25546,2932,268101,293647,6,2098,3,1710,1,311,77,6,6,3,996,36,17387,1316,155939,173326,9/30/2020
7/12/2020,47,25593,1836,269937,295530,1,2099,3,1713,1,312,74,6,5,3,999,33,17420,943,156882,174302,9/30/2020
7/13/2020,84,25677,3157,273094,298771,8,2107,10,1723,0,312,72,6,5,1,1000,61,17481,1474,158356,175837,9/30/2020
7/14/2020,73,25750,3289,276383,302133,7,2114,4,1727,0,312,75,5,5,1,1001,43,17524,1374,159730,177254,9/30/2020
7/15/2020,130,25880,4168,280551,306431,5,2119,7,1734,0,312,73,5,4,0,1001,99,17623,1750,161480,179103,9/30/2020
7/16/2020,102,25982,3733,284284,310266,6,2125,9,1743,0,312,70,6,5,1,1002,75,17698,1619,163099,180797,9/30/2020
7/17/2020,156,26138,4235,288519,314657,14,2139,3,1746,1,313,80,5,5,2,1004,79,17777,1847,164946,182723,9/30/2020
7/18/2020,85,26223,3267,291786,318009,5,2144,9,1755,1,314,75,5,4,4,1008,70,17847,1399,166345,184192,9/30/2020
7/19/2020,82,26305,2693,294479,320784,7,2151,3,1758,0,314,79,6,4,2,1010,57,17904,1149,167494,185398,9/30/2020
7/20/2020,71,26376,2664,297143,323519,9,2160,7,1765,0,314,81,7,5,2,1012,68,17972,1466,168960,186932,9/30/2020
7/21/2020,130,26506,4298,301441,327947,9,2169,11,1776,0,314,79,9,6,1,1013,109,18081,1920,170880,188961,9/30/2020
7/22/2020,130,26636,3926,305367,332003,11,2180,11,1787,1,315,78,7,6,1,1014,86,18167,1683,172563,190730,9/30/2020
7/23/2020,141,26777,4376,309743,336520,8,2188,6,1793,0,315,80,8,7,0,1014,115,18282,1968,174531,192813,9/30/2020
7/24/2020,172,26949,5959,315702,342651,14,2202,14,1807,0,315,80,9,7,0,1014,119,18401,2323,176854,195255,9/30/2020
7/25/2020,134,27083,4398,320100,347183,7,2209,7,1814,0,315,80,10,8,2,1016,108,18509,2100,178954,197463,9/30/2020
7/26/2020,62,27145,3027,323127,350272,8,2217,9,1823,0,315,79,11,7,1,1017,54,18563,1339,180293,198856,9/30/2020
7/27/2020,186,27331,4163,327290,354621,12,2229,7,1830,0,315,84,13,8,1,1018,138,18701,2333,182626,201327,9/30/2020
7/28/2020,105,27436,3831,331121,358557,5,2234,5,1835,0,315,84,14,7,1,1019,94,18795,1632,184258,203053,9/30/2020
7/29/2020,191,27627,5123,336244,363871,11,2245,12,1847,0,315,83,15,7,0,1019,154,18949,2324,186582,205531,9/30/2020
7/30/2020,121,27748,4344,340588,368336,6,2251,2,1849,1,316,86,15,6,1,1020,97,19046,1650,188232,207278,9/30/2020
7/31/2020,131,27879,5508,346096,373975,8,2259,10,1859,0,316,84,15,7,1,1021,89,19135,1856,190088,209223,9/30/2020
8/1/2020,108,27987,4288,350384,378371,7,2266,2,1861,0,316,89,14,7,1,1022,88,19223,1559,191647,210870,9/30/2020
8/2/2020,84,28071,2802,353186,381257,12,2278,12,1873,2,318,87,14,8,2,1024,62,19285,1274,192921,212206,9/30/2020
8/3/2020,187,28258,5218,358404,386662,13,2291,12,1885,0,318,88,16,7,1,1025,150,19435,2200,195121,214556,9/30/2020
8/4/2020,126,28384,3689,362093,390477,8,2299,6,1891,1,319,89,12,5,2,1027,99,19534,1773,196894,216428,9/30/2020
8/5/2020,148,28532,5919,368012,396544,12,2311,10,1901,1,320,90,10,5,2,1029,118,19652,2475,199369,219021,9/30/2020
8/6/2020,169,28701,5533,373545,402246,7,2318,9,1910,0,320,88,9,4,0,1029,121,19773,2425,201794,221567,9/30/2020
8/7/2020,122,28823,4845,378390,407213,13,2331,10,1920,1,321,90,9,3,2,1031,87,19860,2151,203945,223805,9/30/2020
8/8/2020,123,28946,4106,382496,411442,19,2350,6,1926,1,322,102,8,3,1,1032,92,19952,1780,205725,225677,9/30/2020
8/9/2020,42,28988,1722,384218,413206,8,2358,10,1936,0,322,100,9,4,0,1032,35,19987,1075,206800,226787,9/30/2020
8/10/2020,149,29137,4580,388798,417935,11,2369,12,1948,0,322,99,9,4,1,1033,113,20100,2029,208829,228929,9/30/2020
8/11/2020,105,29242,4325,393123,422365,6,2375,14,1962,0,322,91,10,4,3,1036,92,20192,2270,211099,231291,9/30/2020
8/12/2020,121,29363,5184,398307,427670,8,2383,11,1973,0,322,88,9,3,1,1037,101,20293,2630,213729,234022,9/30/2020
8/13/2020,135,29498,4191,402498,431996,13,2396,12,1985,0,322,89,11,3,0,1037,95,20388,1909,215638,236026,9/30/2020
8/14/2020,145,29643,5492,407990,437633,13,2409,11,1996,0,322,91,11,4,3,1040,99,20487,1977,217615,238102,9/30/2020
8/15/2020,105,29748,4533,412523,442271,8,2417,11,2007,1,323,87,11,5,0,1040,89,20576,1699,219314,239890,9/30/2020
8/16/2020,83,29831,2785,415308,445139,7,2424,6,2013,4,327,84,8,4,6,1046,70,20646,984,220298,240944,9/30/2020
8/17/2020,106,29937,4570,419878,449815,10,2434,7,2020,0,327,87,8,5,2,1048,88,20734,2400,222698,243432,9/30/2020
8/18/2020,128,30065,5048,424926,454991,11,2445,9,2029,1,328,88,8,4,5,1053,95,20829,2780,225478,246307,9/30/2020
8/19/2020,114,30179,5407,430333,460512,8,2453,9,2038,1,329,86,9,5,0,1053,89,20918,2677,228155,249073,9/30/2020
8/20/2020,174,30353,8220,438553,468906,12,2465,6,2044,2,331,90,10,5,3,1056,139,21057,3569,231724,252781,9/30/2020
8/21/2020,154,30507,6816,445369,475876,8,2473,5,2049,1,332,92,9,4,2,1058,125,21182,2969,234693,255875,9/30/2020
8/22/2020,96,30603,5957,451326,481929,10,2483,12,2061,0,332,90,11,4,1,1059,84,21266,2627,237320,258586,9/30/2020
8/23/2020,70,30673,4365,455691,486364,11,2494,6,2067,0,332,95,11,2,1,1060,56,21322,2476,239796,261118,9/30/2020
8/24/2020,105,30778,5776,461467,492245,7,2501,10,2077,1,333,91,13,4,1,1061,76,21398,3161,242957,264355,9/30/2020
8/25/2020,108,30886,4745,466212,497098,10,2511,4,2081,1,334,96,11,4,1,1062,92,21490,2295,245252,266742,9/30/2020
8/26/2020,170,31056,9490,475702,506758,4,2515,8,2089,0,334,92,9,5,1,1063,127,21617,3073,248325,269942,9/30/2020
8/27/2020,93,31149,8798,484500,515649,6,2521,13,2102,1,335,84,6,5,2,1065,71,21688,3210,251535,273223,9/30/2020
8/28/2020,112,31261,8058,492558,523819,14,2535,4,2106,0,335,94,9,7,2,1067,88,21776,2430,253965,275741,9/30/2020
8/29/2020,65,31326,5413,497971,529297,6,2541,8,2114,1,336,91,10,6,2,1069,51,21827,1905,255870,277697,9/30/2020
8/30/2020,66,31392,4319,502290,533682,7,2548,4,2118,0,336,94,8,5,2,1071,48,21875,1998,257868,279743,9/30/2020
8/31/2020,105,31497,4871,507161,538658,12,2560,15,2133,0,336,91,8,4,1,1072,80,21955,2193,260061,282016,9/30/2020
9/1/2020,98,31595,7118,514279,545874,6,2566,9,2142,1,337,87,7,4,2,1074,65,22020,2381,262442,284462,9/30/2020
9/2/2020,125,31720,10669,524948,556668,9,2575,10,2152,1,338,85,8,4,2,1076,103,22123,3047,265489,287612,9/30/2020
9/3/2020,90,31810,11195,536143,567953,8,2583,8,2160,0,338,85,9,4,2,1078,73,22196,2594,268083,290279,9/30/2020
9/4/2020,102,31912,9029,545172,577084,11,2594,4,2164,0,338,92,9,4,1,1079,82,22278,2396,270479,292757,9/30/2020
9/5/2020,52,31964,6303,551475,583439,6,2600,9,2173,0,338,89,8,3,1,1080,42,22320,1604,272083,294403,9/30/2020
9/6/2020,87,32051,4317,555792,587843,4,2604,8,2181,1,339,84,6,3,1,1081,64,22384,1960,274043,296427,9/30/2020
9/7/2020,35,32086,3000,558792,590878,11,2615,3,2184,0,339,92,5,3,1,1082,26,22410,648,274691,297101,9/30/2020
9/8/2020,74,32160,6376,565168,597328,6,2621,12,2196,1,340,85,6,3,2,1084,66,22476,1607,276298,298774,9/30/2020
9/9/2020,118,32278,8832,574000,606278,9,2630,5,2201,1,341,88,9,3,1,1085,101,22577,2164,278462,301039,9/30/2020
9/10/2020,166,32444,11417,585417,617861,9,2639,8,2209,0,341,89,10,3,0,1085,112,22689,2273,280735,303424,9/30/2020
9/11/2020,121,32565,9471,594888,627453,11,2650,11,2220,0,341,89,10,5,0,1085,99,22788,1984,282719,305507,9/30/2020
9/12/2020,109,32674,6152,601040,633714,8,2658,5,2225,2,343,90,9,5,3,1088,96,22884,1501,284220,307104,9/30/2020
9/13/2020,58,32732,2706,603746,636478,4,2662,3,2228,0,343,91,10,5,0,1088,53,22937,858,285078,308015,9/30/2020
9/14/2020,104,32836,6421,610167,643003,5,2667,3,2231,2,345,91,10,5,1,1089,93,23030,1710,286788,309818,9/30/2020
9/15/2020,122,32958,8546,618713,651671,6,2673,2,2233,1,346,94,10,5,2,1091,121,23151,2200,288988,312139,9/30/2020
9/16/2020,137,33095,9802,628515,661610,7,2680,7,2240,2,348,92,8,6,5,1096,116,23267,1971,290959,314226,9/30/2020
9/17/2020,124,33219,9267,637782,671001,7,2687,14,2254,0,348,85,8,4,0,1096,152,23419,1937,292896,316315,9/30/2020
9/18/2020,132,33351,10044,647826,681177,7,2694,7,2261,1,349,84,11,6,2,1098,127,23546,1945,294841,318387,9/30/2020
9/19/2020,116,33467,8327,656153,689620,7,2701,3,2264,0,349,88,10,6,4,1102,112,23658,1694,296535,320193,9/30/2020
9/20/2020,60,33527,3667,659820,693347,7,2708,6,2270,2,351,87,10,8,4,1106,54,23712,1349,297884,321596,9/30/2020
9/21/2020,103,33630,6975,666795,700425,12,2720,3,2273,2,353,94,9,6,2,1108,96,23808,2396,300280,324088,9/30/2020
9/22/2020,154,33784,9372,676167,709951,12,2732,3,2276,1,354,102,8,5,1,1109,108,23916,2230,302510,326426,9/30/2020
9/23/2020,136,33920,10760,686927,720847,10,2742,7,2283,0,354,105,7,5,0,1109,132,24048,2251,304761,328809,9/30/2020
9/24/2020,103,34023,11141,698068,732091,7,2749,9,2292,1,355,102,8,6,1,1110,121,24169,2056,306817,330986,9/30/2020
9/25/2020,134,34157,9776,707844,742001,9,2758,10,2302,0,355,101,7,6,1,1111,129,24298,2353,309170,333468,9/30/2020
9/26/2020,145,34302,9859,717703,752005,11,2769,9,2311,0,355,103,7,6,1,1112,115,24413,1994,311164,335577,9/30/2020
9/27/2020,42,34344,2575,720278,754622,7,2776,5,2316,0,355,105,9,6,0,1112,30,24443,809,311973,336416,9/30/2020
9/28/2020,146,34490,6028,726306,760796,6,2782,6,2322,2,357,103,7,6,2,1114,132,24575,1949,313922,338497,9/30/2020
9/29/2020,196,34686,8830,735136,769822,,,,,,,,,,0,1114,173,24748,1931,315853,340601,9/30/2020
2/27/2020,0,0,0,0,0,1,1,0,0,0,0,1,0,0,0,0,0,0,0,0,0,10/1/2020
2/28/2020,0,0,0,0,0,0,1,0,0,0,0,1,1,0,0,0,0,0,0,0,0,10/1/2020
2/29/2020,0,0,0,0,0,0,1,0,0,0,0,1,1,0,0,0,0,0,0,0,0,10/1/2020
3/1/2020,2,2,2,2,4,0,1,0,0,0,0,1,1,1,0,0,2,2,2,2,4,10/1/2020
3/2/2020,0,2,1,3,5,1,2,0,0,0,0,2,2,2,0,0,0,2,1,3,5,10/1/2020
3/3/2020,0,2,2,5,7,0,2,0,0,0,0,2,2,2,0,0,0,2,2,5,7,10/1/2020
3/4/2020,0,2,12,17,19,1,3,0,0,0,0,3,2,2,0,0,0,2,10,15,17,10/1/2020
3/5/2020,0,2,4,21,23,0,3,0,0,0,0,3,2,2,0,0,1,3,4,19,22,10/1/2020
3/6/2020,1,3,12,33,36,0,3,0,0,0,0,3,2,2,0,0,0,3,11,30,33,10/1/2020
3/7/2020,0,3,19,52,55,0,3,0,0,0,0,3,2,1,0,0,0,3,19,49,52,10/1/2020
3/8/2020,0,3,18,70,73,0,3,0,0,0,0,3,2,1,0,0,0,3,18,67,70,10/1/2020
3/9/2020,1,4,15,85,89,0,3,0,0,0,0,3,2,1,0,0,1,4,15,82,86,10/1/2020
3/10/2020,2,6,25,110,116,0,3,0,0,0,0,3,2,1,0,0,1,5,23,105,110,10/1/2020
3/11/2020,0,6,34,144,150,1,4,0,0,0,0,4,1,1,0,0,0,5,34,139,144,10/1/2020
3/12/2020,9,15,41,185,200,1,5,0,0,0,0,5,1,1,0,0,8,13,38,177,190,10/1/2020
3/13/2020,6,21,50,235,256,4,9,1,1,0,0,8,1,1,0,0,6,19,48,225,244,10/1/2020
3/14/2020,0,21,90,325,346,0,9,0,1,0,0,8,1,1,0,0,0,19,86,311,330,10/1/2020
3/15/2020,1,22,54,379,401,1,10,0,1,0,0,9,2,1,0,0,1,20,54,365,385,10/1/2020
3/16/2020,2,24,95,474,498,2,12,0,1,0,0,11,2,0,0,0,2,22,92,457,479,10/1/2020
3/17/2020,12,36,162,636,672,6,18,0,1,0,0,17,2,0,0,0,11,33,151,608,641,10/1/2020
3/18/2020,9,45,116,752,797,3,21,0,1,0,0,20,2,0,0,0,11,44,110,718,762,10/1/2020
3/19/2020,15,60,262,1014,1074,2,23,1,2,0,0,21,3,0,1,1,17,61,251,969,1030,10/1/2020
3/20/2020,13,73,197,1211,1284,5,28,0,2,0,0,26,4,0,0,1,13,74,190,1159,1233,10/1/2020
3/21/2020,12,85,126,1337,1422,3,31,2,4,0,0,27,5,0,0,1,14,88,123,1282,1370,10/1/2020
3/22/2020,27,112,282,1619,1731,2,33,0,4,0,0,29,5,0,0,1,25,113,262,1544,1657,10/1/2020
3/23/2020,14,126,169,1788,1914,15,48,1,5,0,0,43,9,3,0,1,16,129,165,1709,1838,10/1/2020
3/24/2020,20,146,242,2030,2176,7,55,0,5,0,0,50,10,4,0,1,19,148,237,1946,2094,10/1/2020
3/25/2020,26,172,182,2212,2384,5,60,1,6,0,0,54,11,3,0,1,28,176,171,2117,2293,10/1/2020
3/26/2020,35,207,181,2393,2600,10,70,5,11,0,0,59,14,5,0,1,41,217,174,2291,2508,10/1/2020
3/27/2020,27,234,214,2607,2841,9,79,1,12,1,1,66,17,6,2,3,31,248,202,2493,2741,10/1/2020
3/28/2020,59,293,260,2867,3160,13,92,3,15,2,3,74,15,6,1,4,64,312,241,2734,3046,10/1/2020
3/29/2020,100,393,350,3217,3610,8,100,4,19,1,4,77,18,8,2,6,105,417,313,3047,3464,10/1/2020
3/30/2020,62,455,222,3439,3894,20,120,5,24,0,4,92,20,11,3,9,78,495,184,3231,3726,10/1/2020
3/31/2020,71,526,369,3808,4334,11,131,7,31,1,5,95,22,13,2,11,73,568,296,3527,4095,10/1/2020
4/1/2020,99,625,698,4506,5131,18,149,7,38,0,5,106,30,15,1,12,100,668,640,4167,4835,10/1/2020
4/2/2020,52,677,477,4983,5660,22,171,6,44,2,7,120,36,21,4,16,62,730,436,4603,5333,10/1/2020
4/3/2020,108,785,774,5757,6542,23,194,7,51,0,7,136,43,25,3,19,100,830,711,5314,6144,10/1/2020
4/4/2020,143,928,660,6417,7345,22,216,4,55,5,12,149,41,30,9,28,138,968,618,5932,6900,10/1/2020
4/5/2020,187,1115,1156,7573,8688,20,236,9,64,1,13,159,44,36,2,30,181,1149,1065,6997,8146,10/1/2020
4/6/2020,218,1333,1706,9279,10612,26,262,7,71,0,13,178,48,40,7,37,208,1357,1551,8548,9905,10/1/2020
4/7/2020,284,1617,1629,10908,12525,20,282,4,75,2,15,192,50,42,5,42,261,1618,1480,10028,11646,10/1/2020
4/8/2020,290,1907,1720,12628,14535,19,301,7,82,6,21,198,50,38,10,52,271,1889,1560,11588,13477,10/1/2020
4/9/2020,283,2190,1516,14144,16334,32,333,9,91,4,25,217,53,40,7,59,277,2166,1354,12942,15108,10/1/2020
4/10/2020,419,2609,2574,16718,19327,29,362,17,108,5,30,224,59,41,11,70,401,2567,2370,15312,17879,10/1/2020
4/11/2020,297,2906,1905,18623,21529,29,391,11,119,2,32,240,61,48,12,82,280,2847,1716,17028,19875,10/1/2020
4/12/2020,314,3220,1670,20293,23513,34,425,13,132,5,37,256,59,49,9,91,284,3131,1435,18463,21594,10/1/2020
4/13/2020,161,3381,935,21228,24609,35,460,13,145,3,40,275,64,54,9,100,187,3318,837,19300,22618,10/1/2020
4/14/2020,289,3670,1787,23015,26685,27,487,17,162,5,45,280,72,53,8,108,262,3580,1528,20828,24408,10/1/2020
4/15/2020,351,4021,1799,24814,28835,31,518,19,181,3,48,289,72,54,17,125,306,3886,1553,22381,26267,10/1/2020
4/16/2020,447,4468,2494,27308,31776,36,554,25,206,6,54,294,72,53,14,139,386,4272,2074,24455,28727,10/1/2020
4/17/2020,304,4772,1821,29129,33901,32,586,20,226,7,61,299,66,45,21,160,290,4562,1446,25901,30463,10/1/2020
4/18/2020,321,5093,1725,30854,35947,26,612,18,244,4,65,303,63,49,15,175,284,4846,1324,27225,32071,10/1/2020
4/19/2020,381,5474,2047,32901,38375,23,635,26,270,1,66,299,65,55,11,186,336,5182,1740,28965,34147,10/1/2020
4/20/2020,394,5868,1907,34808,40676,46,681,29,299,2,68,314,75,56,10,196,376,5558,1568,30533,36091,10/1/2020
4/21/2020,444,6312,2110,36918,43230,45,726,33,332,5,73,321,72,56,18,214,384,5942,1700,32233,38175,10/1/2020
4/22/2020,418,6730,2390,39308,46038,41,767,32,364,5,78,325,73,58,18,232,379,6321,1913,34146,40467,10/1/2020
4/23/2020,479,7209,2469,41777,48986,32,799,28,392,5,83,324,76,62,15,247,412,6733,1854,36000,42733,10/1/2020
4/24/2020,491,7700,3284,45061,52761,35,834,26,418,4,87,329,85,63,15,262,407,7140,2624,38624,45764,10/1/2020
4/25/2020,393,8093,2206,47267,55360,34,868,17,435,5,92,341,85,62,14,276,300,7440,1765,40389,47829,10/1/2020
4/26/2020,316,8409,2309,49576,57985,33,901,15,450,3,95,356,86,59,14,290,274,7714,1875,42264,49978,10/1/2020
4/27/2020,249,8658,1620,51196,59854,29,930,21,471,4,99,360,86,61,10,300,206,7920,1162,43426,51346,10/1/2020
4/28/2020,410,9068,2263,53459,62527,44,974,24,495,3,102,377,88,59,22,322,331,8251,1762,45188,53439,10/1/2020
4/29/2020,476,9544,3343,56802,66346,36,1010,38,533,11,113,364,78,53,18,340,371,8622,2422,47610,56232,10/1/2020
4/30/2020,432,9976,2769,59571,69547,33,1043,38,571,6,119,353,83,57,24,364,350,8972,1923,49533,58505,10/1/2020
5/1/2020,454,10430,3086,62657,73087,51,1094,39,610,3,122,362,84,58,14,378,325,9297,2176,51709,61006,10/1/2020
5/2/2020,257,10687,1926,64583,75270,36,1130,38,648,5,127,355,91,62,24,402,192,9489,1274,52983,62472,10/1/2020
5/3/2020,283,10970,2160,66743,77713,31,1161,27,675,8,135,351,90,61,21,423,183,9672,1577,54560,64232,10/1/2020
5/4/2020,387,11357,2098,68841,80198,30,1191,31,706,5,140,345,88,57,18,441,290,9962,1562,56122,66084,10/1/2020
5/5/2020,433,11790,2873,71714,83504,29,1220,32,738,6,146,336,82,54,16,457,299,10261,1961,58083,68344,10/1/2020
5/6/2020,488,12278,2830,74544,86822,28,1248,44,782,9,155,311,79,54,21,478,340,10601,1917,60000,70601,10/1/2020
5/7/2020,425,12703,2969,77513,90216,36,1284,41,823,5,160,301,71,52,21,499,269,10870,1963,61963,72833,10/1/2020
5/8/2020,359,13062,2598,80111,93173,30,1314,29,852,5,165,297,71,53,22,521,230,11100,1737,63700,74800,10/1/2020
5/9/2020,467,13529,3346,83457,96986,22,1336,21,873,4,169,294,69,51,15,536,290,11390,2256,65956,77346,10/1/2020
5/10/2020,285,13814,2117,85574,99388,20,1356,23,896,6,175,285,70,49,13,549,189,11579,1523,67479,79058,10/1/2020
5/11/2020,257,14071,1857,87431,101502,31,1387,16,912,6,181,294,71,49,15,564,174,11753,1301,68780,80533,10/1/2020
5/12/2020,387,14458,2611,90042,104500,23,1410,18,930,4,185,295,69,48,22,586,224,11977,1706,70486,82463,10/1/2020
5/13/2020,351,14809,3630,93672,108481,23,1433,25,955,1,186,292,69,49,13,599,199,12176,2003,72489,84665,10/1/2020
5/14/2020,329,15138,3408,97080,112218,19,1452,27,982,3,189,281,64,45,15,614,230,12406,2018,74507,86913,10/1/2020
5/15/2020,381,15519,3458,100538,116057,24,1476,41,1023,5,194,259,62,45,14,628,232,12638,1808,76315,88953,10/1/2020
5/16/2020,449,15968,4156,104694,120662,25,1501,13,1036,5,199,266,61,46,15,643,247,12885,1964,78279,91164,10/1/2020
5/17/2020,240,16208,2768,107462,123670,17,1518,8,1044,5,204,270,59,45,10,653,126,13011,1556,79835,92846,10/1/2020
5/18/2020,250,16458,2001,109463,125921,19,1537,15,1059,5,209,269,57,40,18,671,136,13147,1369,81204,94351,10/1/2020
5/19/2020,415,16873,3168,112631,129504,23,1560,32,1091,5,214,255,56,38,11,682,215,13362,1927,83131,96493,10/1/2020
5/20/2020,326,17199,2771,115402,132601,19,1579,23,1114,7,221,244,52,33,22,704,183,13545,1515,84646,98191,10/1/2020
5/21/2020,374,17573,3757,119159,136732,26,1605,15,1129,3,224,252,53,29,20,724,168,13713,1940,86586,100299,10/1/2020
5/22/2020,351,17924,3161,122320,140244,20,1625,29,1158,5,229,238,52,29,10,734,206,13919,1608,88194,102113,10/1/2020
5/23/2020,253,18177,2742,125062,143239,19,1644,11,1169,3,232,243,52,32,13,747,109,14028,1271,89465,103493,10/1/2020
5/24/2020,163,18340,1370,126432,144772,12,1656,14,1183,2,234,239,53,36,8,755,82,14110,773,90238,104348,10/1/2020
5/25/2020,147,18487,1385,127817,146304,14,1670,14,1197,0,234,239,53,34,10,765,76,14186,762,91000,105186,10/1/2020
5/26/2020,285,18772,2620,130437,149209,24,1694,22,1219,5,239,236,48,33,15,780,157,14343,1780,92780,107123,10/1/2020
5/27/2020,276,19048,2057,132494,151542,20,1714,18,1237,3,242,235,50,33,10,790,132,14475,1133,93913,108388,10/1/2020
5/28/2020,348,19396,3359,135853,155249,17,1731,29,1266,4,246,219,47,32,8,798,130,14605,1117,95030,109635,10/1/2020
5/29/2020,410,19806,3914,139767,159573,19,1750,27,1293,6,252,205,43,31,12,810,173,14778,1571,96601,111379,10/1/2020
5/30/2020,225,20031,3915,143682,163713,15,1765,19,1312,4,256,197,40,29,12,822,109,14887,1820,98421,113308,10/1/2020
5/31/2020,155,20186,1688,145370,165556,10,1775,10,1322,1,257,196,42,26,3,825,78,14965,857,99278,114243,10/1/2020
6/1/2020,212,20398,2792,148162,168560,8,1783,14,1336,1,258,189,43,29,5,830,93,15058,1384,100662,115720,10/1/2020
6/2/2020,273,20671,3022,151184,171855,8,1791,9,1345,3,261,185,36,25,10,840,98,15156,1448,102110,117266,10/1/2020
6/3/2020,254,20925,3486,154670,175595,14,1805,18,1363,6,267,175,33,25,11,851,99,15255,1661,103771,119026,10/1/2020
6/4/2020,276,21201,4471,159141,180342,7,1812,25,1388,3,270,154,30,24,11,862,107,15362,2037,105808,121170,10/1/2020
6/5/2020,215,21416,3513,162654,184070,15,1827,12,1400,6,276,151,27,21,11,873,99,15461,1575,107383,122844,10/1/2020
6/6/2020,201,21617,2616,165270,186887,10,1837,7,1407,2,278,152,29,19,6,879,67,15528,1136,108519,124047,10/1/2020
6/7/2020,83,21700,1625,166895,188595,11,1848,7,1414,1,279,155,25,17,4,883,51,15579,782,109301,124880,10/1/2020
6/8/2020,119,21819,1849,168744,190563,15,1863,12,1426,2,281,156,27,18,4,887,45,15624,960,110261,125885,10/1/2020
6/9/2020,223,22042,2673,171417,193459,10,1873,18,1444,0,281,148,28,21,1,888,64,15688,1257,111518,127206,10/1/2020
6/10/2020,209,22251,2987,174404,196655,13,1886,12,1456,2,283,147,24,17,4,892,101,15789,1465,112983,128772,10/1/2020
6/11/2020,195,22446,3513,177917,200363,7,1893,15,1471,1,284,138,25,16,6,898,88,15877,1534,114517,130394,10/1/2020
6/12/2020,209,22655,4601,182518,205173,9,1902,15,1486,1,285,131,24,16,2,900,78,15955,2181,116698,132653,10/1/2020
6/13/2020,113,22768,3036,185554,208322,6,1908,4,1490,0,285,133,20,15,3,903,49,16004,1373,118071,134075,10/1/2020
6/14/2020,81,22849,2046,187600,210449,7,1915,8,1498,1,286,131,20,14,3,906,33,16037,968,119039,135076,10/1/2020
6/15/2020,188,23037,3108,190708,213745,14,1929,14,1512,0,286,131,20,16,5,911,75,16112,1791,120830,136942,10/1/2020
6/16/2020,110,23147,3017,193725,216872,11,1940,9,1521,1,287,132,22,16,8,919,50,16162,1578,122408,138570,10/1/2020
6/17/2020,127,23274,2835,196560,219834,15,1955,20,1541,4,291,123,18,14,6,925,50,16212,1319,123727,139939,10/1/2020
6/18/2020,149,23423,3047,199607,223030,9,1964,13,1554,1,292,118,19,16,7,932,70,16282,1313,125040,141322,10/1/2020
6/19/2020,141,23564,3769,203376,226940,12,1976,11,1565,1,293,118,20,17,3,935,59,16341,1371,126411,142752,10/1/2020
6/20/2020,84,23648,1891,205267,228915,9,1985,12,1577,0,293,115,20,18,4,939,36,16377,813,127224,143601,10/1/2020
6/21/2020,37,23685,1064,206331,230016,8,1993,5,1582,0,293,118,20,18,2,941,29,16406,692,127916,144322,10/1/2020
6/22/2020,138,23823,3730,210061,233884,12,2005,16,1598,0,293,114,19,18,2,943,65,16471,1706,129622,146093,10/1/2020
6/23/2020,163,23986,3831,213892,237878,3,2008,13,1611,3,296,101,18,18,7,950,81,16552,1780,131402,147954,10/1/2020
6/24/2020,120,24106,3502,217394,241500,9,2017,10,1621,1,297,99,18,18,5,955,44,16596,1686,133088,149684,10/1/2020
6/25/2020,103,24209,2883,220277,244486,6,2023,14,1635,1,298,90,17,17,1,956,50,16646,1512,134600,151246,10/1/2020
6/26/2020,94,24303,2488,222765,247068,2,2025,10,1645,0,298,82,18,18,1,957,60,16706,1331,135931,152637,10/1/2020
6/27/2020,84,24387,3214,225979,250366,5,2030,3,1648,1,299,83,17,17,5,962,37,16743,1220,137151,153894,10/1/2020
6/28/2020,39,24426,1469,227448,251874,4,2034,4,1652,4,303,79,15,14,6,968,17,16760,595,137746,154506,10/1/2020
6/29/2020,85,24511,3697,231145,255656,4,2038,5,1657,0,303,78,14,14,1,969,39,16799,1354,139100,155899,10/1/2020
6/30/2020,57,24568,1957,233102,257670,1,2039,5,1662,1,304,73,12,11,4,973,33,16832,996,140096,156928,10/1/2020
7/1/2020,144,24712,4098,237200,261912,7,2046,9,1671,0,304,71,11,11,1,974,78,16910,1934,142030,158940,10/1/2020
7/2/2020,103,24815,2803,240003,264818,5,2051,5,1676,1,305,70,10,10,3,977,59,16969,1089,143119,160088,10/1/2020
7/3/2020,50,24865,2076,242079,266944,9,2060,6,1682,0,305,73,9,9,3,980,25,16994,778,143897,160891,10/1/2020
7/4/2020,57,24922,2345,244424,269346,2,2062,4,1686,1,306,70,10,9,2,982,33,17027,1011,144908,161935,10/1/2020
7/5/2020,49,24971,2932,247356,272327,1,2063,2,1688,1,307,68,8,8,2,984,26,17053,1445,146353,163406,10/1/2020
7/6/2020,101,25072,2811,250167,275239,6,2069,6,1694,0,307,68,9,9,4,988,57,17110,1552,147905,165015,10/1/2020
7/7/2020,81,25153,3457,253624,278777,5,2074,7,1701,0,307,66,8,8,2,990,47,17157,1535,149440,166597,10/1/2020
7/8/2020,105,25258,3403,257027,282285,4,2078,2,1703,0,307,68,9,8,0,990,64,17221,1425,150865,168086,10/1/2020
7/9/2020,94,25352,3712,260739,286091,9,2087,3,1706,0,307,74,9,8,0,990,50,17271,1628,152493,169764,10/1/2020
7/10/2020,131,25483,4431,265170,290653,6,2093,3,1709,2,309,75,7,7,3,993,80,17351,2080,154573,171924,10/1/2020
7/11/2020,63,25546,2932,268102,293648,6,2099,3,1712,1,310,77,6,6,3,996,36,17387,1316,155889,173276,10/1/2020
7/12/2020,47,25593,1836,269938,295531,1,2100,3,1715,1,311,74,6,5,3,999,33,17420,943,156832,174252,10/1/2020
7/13/2020,84,25677,3201,273139,298816,8,2108,10,1725,0,311,72,6,5,1,1000,61,17481,1505,158337,175818,10/1/2020
7/14/2020,73,25750,3291,276430,302180,7,2115,4,1729,0,311,75,5,5,1,1001,43,17524,1375,159712,177236,10/1/2020
7/15/2020,130,25880,4172,280602,306482,5,2120,7,1736,0,311,73,5,4,0,1001,99,17623,1752,161464,179087,10/1/2020
7/16/2020,102,25982,3733,284335,310317,6,2126,9,1745,0,311,70,6,5,1,1002,75,17698,1619,163083,180781,10/1/2020
7/17/2020,156,26138,4236,288571,314709,14,2140,3,1748,1,312,80,5,5,2,1004,79,17777,1847,164930,182707,10/1/2020
7/18/2020,85,26223,3267,291838,318061,5,2145,9,1757,1,313,75,5,4,4,1008,70,17847,1399,166329,184176,10/1/2020
7/19/2020,82,26305,2693,294531,320836,7,2152,3,1760,0,313,79,6,4,2,1010,57,17904,1149,167478,185382,10/1/2020
7/20/2020,71,26376,2664,297195,323571,9,2161,7,1767,0,313,81,7,5,2,1012,68,17972,1465,168943,186915,10/1/2020
7/21/2020,130,26506,4298,301493,327999,9,2170,11,1778,0,313,79,9,6,1,1013,109,18081,1920,170863,188944,10/1/2020
7/22/2020,130,26636,3926,305419,332055,11,2181,11,1789,1,314,78,7,6,1,1014,86,18167,1683,172546,190713,10/1/2020
7/23/2020,141,26777,4412,309831,336608,8,2189,6,1795,0,314,80,8,7,0,1014,115,18282,1990,174536,192818,10/1/2020
7/24/2020,172,26949,5959,315790,342739,14,2203,14,1809,0,314,80,9,7,0,1014,119,18401,2322,176858,195259,10/1/2020
7/25/2020,134,27083,4398,320188,347271,7,2210,7,1816,0,314,80,10,8,2,1016,108,18509,2100,178958,197467,10/1/2020
7/26/2020,62,27145,3027,323215,350360,8,2218,9,1825,0,314,79,11,7,1,1017,54,18563,1338,180296,198859,10/1/2020
7/27/2020,188,27333,4190,327405,354738,12,2230,7,1832,0,314,84,13,8,1,1018,138,18701,2350,182646,201347,10/1/2020
7/28/2020,105,27438,3834,331239,358677,5,2235,5,1837,0,314,84,14,7,1,1019,94,18795,1635,184281,203076,10/1/2020
7/29/2020,191,27629,5137,336376,364005,11,2246,12,1849,0,314,83,15,7,0,1019,154,18949,2325,186606,205555,10/1/2020
7/30/2020,121,27750,4344,340720,368470,6,2252,2,1851,1,315,86,15,6,1,1020,97,19046,1650,188256,207302,10/1/2020
7/31/2020,131,27881,5508,346228,374109,8,2260,10,1861,0,315,84,15,7,1,1021,89,19135,1854,190110,209245,10/1/2020
8/1/2020,108,27989,4288,350516,378505,7,2267,2,1863,0,315,89,14,7,1,1022,88,19223,1559,191669,210892,10/1/2020
8/2/2020,84,28073,2802,353318,381391,12,2279,12,1875,2,317,87,14,8,2,1024,62,19285,1274,192943,212228,10/1/2020
8/3/2020,187,28260,5238,358556,386816,13,2292,12,1887,0,317,88,16,7,1,1025,150,19435,2203,195146,214581,10/1/2020
8/4/2020,126,28386,3691,362247,390633,8,2300,6,1893,1,318,89,12,5,2,1027,99,19534,1773,196919,216453,10/1/2020
8/5/2020,148,28534,5932,368179,396713,12,2312,10,1903,1,319,90,10,5,2,1029,118,19652,2474,199393,219045,10/1/2020
8/6/2020,169,28703,5533,373712,402415,7,2319,9,1912,0,319,88,9,4,0,1029,121,19773,2408,201801,221574,10/1/2020
8/7/2020,122,28825,4845,378557,407382,13,2332,10,1922,1,320,90,9,3,2,1031,87,19860,2149,203950,223810,10/1/2020
8/8/2020,123,28948,4106,382663,411611,19,2351,6,1928,1,321,102,8,3,1,1032,92,19952,1780,205730,225682,10/1/2020
8/9/2020,42,28990,1722,384385,413375,8,2359,10,1938,0,321,100,9,4,0,1032,35,19987,1075,206805,226792,10/1/2020
8/10/2020,149,29139,4580,388965,418104,11,2370,12,1950,0,321,99,9,4,1,1033,113,20100,2029,208834,228934,10/1/2020
8/11/2020,105,29244,4325,393290,422534,6,2376,14,1964,0,321,91,10,4,3,1036,92,20192,2269,211103,231295,10/1/2020
8/12/2020,121,29365,5184,398474,427839,8,2384,11,1975,0,321,88,9,3,1,1037,101,20293,2630,213733,234026,10/1/2020
8/13/2020,135,29500,4191,402665,432165,13,2397,12,1987,0,321,89,11,3,0,1037,95,20388,1909,215642,236030,10/1/2020
8/14/2020,145,29645,5492,408157,437802,13,2410,11,1998,0,321,91,11,4,3,1040,99,20487,1977,217619,238106,10/1/2020
8/15/2020,105,29750,4533,412690,442440,8,2418,11,2009,1,322,87,11,5,0,1040,89,20576,1697,219316,239892,10/1/2020
8/16/2020,83,29833,2785,415475,445308,7,2425,6,2015,4,326,84,8,4,6,1046,70,20646,982,220298,240944,10/1/2020
8/17/2020,106,29939,4570,420045,449984,10,2435,7,2022,0,326,87,8,5,2,1048,88,20734,2400,222698,243432,10/1/2020
8/18/2020,128,30067,5049,425094,455161,11,2446,9,2031,1,327,88,8,4,5,1053,95,20829,2773,225471,246300,10/1/2020
8/19/2020,114,30181,5407,430501,460682,8,2454,9,2040,1,328,86,9,5,0,1053,89,20918,2664,228135,249053,10/1/2020
8/20/2020,174,30355,8220,438721,469076,12,2466,6,2046,2,330,90,10,5,3,1056,139,21057,3559,231694,252751,10/1/2020
8/21/2020,154,30509,6816,445537,476046,8,2474,5,2051,1,331,92,9,4,2,1058,125,21182,2968,234662,255844,10/1/2020
8/22/2020,96,30605,5957,451494,482099,10,2484,12,2063,0,331,90,11,4,1,1059,84,21266,2627,237289,258555,10/1/2020
8/23/2020,70,30675,4365,455859,486534,11,2495,6,2069,0,331,95,11,2,1,1060,56,21322,2476,239765,261087,10/1/2020
8/24/2020,105,30780,5776,461635,492415,7,2502,10,2079,1,332,91,13,4,1,1061,76,21398,3161,242926,264324,10/1/2020
8/25/2020,108,30888,4796,466431,497319,10,2512,4,2083,1,333,96,11,4,1,1062,92,21490,2302,245228,266718,10/1/2020
8/26/2020,170,31058,9604,476035,507093,4,2516,8,2091,0,333,92,9,5,1,1063,127,21617,3087,248315,269932,10/1/2020
8/27/2020,94,31152,8848,484883,516035,6,2522,13,2104,1,334,84,6,5,2,1065,71,21688,3223,251538,273226,10/1/2020
8/28/2020,112,31264,8106,492989,524253,14,2536,4,2108,0,334,94,9,7,2,1067,88,21776,2442,253980,275756,10/1/2020
8/29/2020,65,31329,5516,498505,529834,6,2542,8,2116,1,335,91,10,6,2,1069,51,21827,1911,255891,277718,10/1/2020
8/30/2020,66,31395,4319,502824,534219,7,2549,4,2120,0,335,94,8,5,2,1071,48,21875,1997,257888,279763,10/1/2020
8/31/2020,105,31500,4864,507688,539188,12,2561,15,2135,0,335,91,8,4,1,1072,80,21955,2190,260078,282033,10/1/2020
9/1/2020,98,31598,7199,514887,546485,6,2567,9,2144,1,336,87,7,4,2,1074,65,22020,2381,262459,284479,10/1/2020
9/2/2020,125,31723,10750,525637,557360,9,2576,10,2154,1,337,85,8,4,2,1076,103,22123,3074,265533,287656,10/1/2020
9/3/2020,90,31813,11373,537010,568823,8,2584,8,2162,0,337,85,9,4,3,1079,73,22196,2598,268131,290327,10/1/2020
9/4/2020,102,31915,9187,546197,578112,11,2595,4,2166,0,337,92,9,4,1,1080,82,22278,2399,270530,292808,10/1/2020
9/5/2020,52,31967,6356,552553,584520,6,2601,9,2175,0,337,89,8,3,1,1081,42,22320,1606,272136,294456,10/1/2020
9/6/2020,87,32054,4317,556870,588924,4,2605,8,2183,1,338,84,6,3,1,1082,64,22384,1960,274096,296480,10/1/2020
9/7/2020,35,32089,3000,559870,591959,11,2616,3,2186,0,338,92,5,3,1,1083,26,22410,647,274743,297153,10/1/2020
9/8/2020,74,32163,6407,566277,598440,6,2622,12,2198,1,339,85,6,3,2,1085,66,22476,1607,276350,298826,10/1/2020
9/9/2020,118,32281,8866,575143,607424,9,2631,5,2203,1,340,88,9,3,1,1086,101,22577,2168,278518,301095,10/1/2020
9/10/2020,167,32448,11791,586934,619382,9,2640,8,2211,0,340,89,10,3,0,1086,112,22689,2283,280801,303490,10/1/2020
9/11/2020,124,32572,9500,596434,629006,11,2651,11,2222,0,340,89,10,5,0,1086,101,22790,1986,282787,305577,10/1/2020
9/12/2020,109,32681,6187,602621,635302,8,2659,5,2227,2,342,90,9,5,3,1089,97,22887,1503,284290,307177,10/1/2020
9/13/2020,58,32739,2707,605328,638067,4,2663,3,2230,0,342,91,10,5,0,1089,53,22940,859,285149,308089,10/1/2020
9/14/2020,104,32843,6424,611752,644595,5,2668,3,2233,2,344,91,10,5,1,1090,95,23035,1710,286859,309894,10/1/2020
9/15/2020,122,32965,8554,620306,653271,6,2674,2,2235,1,345,94,10,5,2,1092,125,23160,2201,289060,312220,10/1/2020
9/16/2020,137,33102,9879,630185,663287,7,2681,7,2242,2,347,92,8,6,5,1097,118,23278,1975,291035,314313,10/1/2020
9/17/2020,124,33226,9581,639766,672992,7,2688,14,2256,0,347,85,8,4,0,1097,155,23433,1962,292997,316430,10/1/2020
9/18/2020,132,33358,10263,650029,683387,7,2695,7,2263,1,348,84,11,6,2,1099,131,23564,1955,294952,318516,10/1/2020
9/19/2020,116,33474,8393,658422,691896,7,2702,3,2266,0,348,88,10,6,4,1103,111,23675,1710,296662,320337,10/1/2020
9/20/2020,60,33534,3668,662090,695624,7,2709,6,2272,2,350,87,10,8,4,1107,46,23721,1345,298007,321728,10/1/2020
9/21/2020,103,33637,7005,669095,702732,12,2721,3,2275,2,352,94,9,6,2,1109,92,23813,2419,300426,324239,10/1/2020
9/22/2020,154,33791,9402,678497,712288,12,2733,3,2278,1,353,102,8,5,1,1110,125,23938,2232,302658,326596,10/1/2020
9/23/2020,136,33927,10944,689441,723368,10,2743,7,2285,0,353,105,7,5,0,1110,126,24064,2230,304888,328952,10/1/2020
9/24/2020,105,34032,11508,700949,734981,7,2750,9,2294,1,354,102,8,6,1,1111,106,24170,2085,306973,331143,10/1/2020
9/25/2020,136,34168,10183,711132,745300,9,2759,10,2304,0,354,101,7,6,1,1112,129,24299,2398,309371,333670,10/1/2020
9/26/2020,148,34316,10124,721256,755572,11,2770,9,2313,0,354,103,7,6,1,1113,115,24414,2005,311376,335790,10/1/2020
9/27/2020,42,34358,2575,723831,758189,7,2777,5,2318,0,354,105,9,6,0,1113,31,24445,809,312185,336630,10/1/2020
9/28/2020,149,34507,6854,730685,765192,6,2783,6,2324,2,356,103,7,6,2,1115,126,24571,2091,314276,338847,10/1/2020
9/29/2020,202,34709,9973,740658,775367,10,2793,18,2342,1,357,94,6,7,1,1116,173,24744,2263,316539,341283,10/1/2020
9/30/2020,197,34906,10636,751294,786200,,,,,,,,,,1,1117,170,24914,2046,318585,343499,10/1/2020
2/27/2020,0,0,0,0,0,1,1,0,0,0,0,1,0,0,0,0,0,0,0,0,0,10/2/2020
2/28/2020,0,0,0,0,0,0,1,0,0,0,0,1,1,0,0,0,0,0,0,0,0,10/2/2020
2/29/2020,0,0,0,0,0,0,1,0,0,0,0,1,1,0,0,0,0,0,0,0,0,10/2/2020
3/1/2020,2,2,2,2,4,0,1,0,0,0,0,1,1,1,0,0,2,2,2,2,4,10/2/2020
3/2/2020,0,2,1,3,5,1,2,0,0,0,0,2,2,2,0,0,0,2,1,3,5,10/2/2020
3/3/2020,0,2,2,5,7,0,2,0,0,0,0,2,2,2,0,0,0,2,2,5,7,10/2/2020
3/4/2020,0,2,12,17,19,1,3,0,0,0,0,3,2,2,0,0,0,2,10,15,17,10/2/2020
3/5/2020,0,2,4,21,23,0,3,0,0,0,0,3,2,2,0,0,1,3,4,19,22,10/2/2020
3/6/2020,1,3,12,33,36,0,3,0,0,0,0,3,2,2,0,0,0,3,11,30,33,10/2/2020
3/7/2020,0,3,19,52,55,0,3,0,0,0,0,3,2,1,0,0,0,3,19,49,52,10/2/2020
3/8/2020,0,3,18,70,73,0,3,0,0,0,0,3,2,1,0,0,0,3,18,67,70,10/2/2020
3/9/2020,1,4,15,85,89,0,3,0,0,0,0,3,2,1,0,0,1,4,15,82,86,10/2/2020
3/10/2020,2,6,25,110,116,0,3,0,0,0,0,3,2,1,0,0,1,5,23,105,110,10/2/2020
3/11/2020,0,6,34,144,150,1,4,0,0,0,0,4,1,1,0,0,0,5,34,139,144,10/2/2020
3/12/2020,9,15,41,185,200,1,5,0,0,0,0,5,1,1,0,0,8,13,38,177,190,10/2/2020
3/13/2020,6,21,50,235,256,4,9,1,1,0,0,8,1,1,0,0,6,19,48,225,244,10/2/2020
3/14/2020,0,21,90,325,346,0,9,0,1,0,0,8,1,1,0,0,0,19,86,311,330,10/2/2020
3/15/2020,1,22,54,379,401,1,10,0,1,0,0,9,2,1,0,0,1,20,54,365,385,10/2/2020
3/16/2020,2,24,95,474,498,2,12,0,1,0,0,11,2,0,0,0,2,22,92,457,479,10/2/2020
3/17/2020,12,36,162,636,672,6,18,0,1,0,0,17,2,0,0,0,11,33,151,608,641,10/2/2020
3/18/2020,9,45,116,752,797,3,21,0,1,0,0,20,2,0,0,0,11,44,110,718,762,10/2/2020
3/19/2020,15,60,262,1014,1074,2,23,1,2,0,0,21,3,0,1,1,17,61,251,969,1030,10/2/2020
3/20/2020,13,73,197,1211,1284,5,28,0,2,0,0,26,4,0,0,1,13,74,190,1159,1233,10/2/2020
3/21/2020,12,85,126,1337,1422,3,31,2,4,0,0,27,5,0,0,1,14,88,123,1282,1370,10/2/2020
3/22/2020,27,112,282,1619,1731,2,33,0,4,0,0,29,5,0,0,1,25,113,262,1544,1657,10/2/2020
3/23/2020,14,126,169,1788,1914,15,48,1,5,0,0,43,9,3,0,1,16,129,165,1709,1838,10/2/2020
3/24/2020,20,146,242,2030,2176,7,55,0,5,0,0,50,10,4,0,1,19,148,237,1946,2094,10/2/2020
3/25/2020,26,172,182,2212,2384,5,60,1,6,0,0,54,11,3,0,1,28,176,171,2117,2293,10/2/2020
3/26/2020,35,207,181,2393,2600,10,70,5,11,0,0,59,14,5,0,1,41,217,174,2291,2508,10/2/2020
3/27/2020,27,234,214,2607,2841,9,79,1,12,1,1,66,17,6,2,3,31,248,202,2493,2741,10/2/2020
3/28/2020,59,293,260,2867,3160,13,92,3,15,2,3,74,15,6,1,4,64,312,241,2734,3046,10/2/2020
3/29/2020,100,393,350,3217,3610,8,100,4,19,1,4,77,18,8,2,6,105,417,313,3047,3464,10/2/2020
3/30/2020,62,455,222,3439,3894,20,120,5,24,0,4,92,20,11,3,9,78,495,184,3231,3726,10/2/2020
3/31/2020,71,526,369,3808,4334,11,131,7,31,1,5,95,22,13,2,11,73,568,296,3527,4095,10/2/2020
4/1/2020,99,625,698,4506,5131,18,149,7,38,0,5,106,30,15,1,12,100,668,640,4167,4835,10/2/2020
4/2/2020,52,677,477,4983,5660,22,171,6,44,2,7,120,36,21,4,16,62,730,436,4603,5333,10/2/2020
4/3/2020,108,785,774,5757,6542,23,194,7,51,0,7,136,43,25,3,19,100,830,711,5314,6144,10/2/2020
4/4/2020,143,928,660,6417,7345,22,216,4,55,5,12,149,41,30,9,28,138,968,618,5932,6900,10/2/2020
4/5/2020,187,1115,1156,7573,8688,20,236,9,64,1,13,159,44,36,2,30,181,1149,1064,6996,8145,10/2/2020
4/6/2020,218,1333,1706,9279,10612,26,262,7,71,0,13,178,48,40,7,37,208,1357,1551,8547,9904,10/2/2020
4/7/2020,284,1617,1629,10908,12525,20,282,4,75,2,15,192,50,42,5,42,261,1618,1479,10026,11644,10/2/2020
4/8/2020,290,1907,1720,12628,14535,19,301,7,82,6,21,198,50,38,10,52,271,1889,1559,11585,13474,10/2/2020
4/9/2020,283,2190,1516,14144,16334,32,333,9,91,4,25,217,53,40,7,59,277,2166,1354,12939,15105,10/2/2020
4/10/2020,419,2609,2574,16718,19327,29,362,17,108,5,30,224,59,41,11,70,401,2567,2369,15308,17875,10/2/2020
4/11/2020,297,2906,1905,18623,21529,29,391,11,119,2,32,240,61,48,12,82,280,2847,1716,17024,19871,10/2/2020
4/12/2020,314,3220,1670,20293,23513,35,426,13,132,5,37,257,59,49,9,91,284,3131,1435,18459,21590,10/2/2020
4/13/2020,161,3381,935,21228,24609,35,461,13,145,3,40,276,64,54,9,100,187,3318,837,19296,22614,10/2/2020
4/14/2020,289,3670,1787,23015,26685,27,488,17,162,5,45,281,72,53,8,108,262,3580,1528,20824,24404,10/2/2020
4/15/2020,351,4021,1799,24814,28835,31,519,20,182,3,48,289,72,54,17,125,306,3886,1553,22377,26263,10/2/2020
4/16/2020,447,4468,2494,27308,31776,36,555,25,207,6,54,294,72,53,14,139,387,4273,2073,24450,28723,10/2/2020
4/17/2020,304,4772,1821,29129,33901,32,587,20,227,7,61,299,66,45,21,160,290,4563,1446,25896,30459,10/2/2020
4/18/2020,321,5093,1725,30854,35947,26,613,18,245,4,65,303,63,49,15,175,284,4847,1324,27220,32067,10/2/2020
4/19/2020,381,5474,2047,32901,38375,23,636,26,271,1,66,299,65,55,11,186,336,5183,1740,28960,34143,10/2/2020
4/20/2020,394,5868,1907,34808,40676,46,682,29,300,2,68,314,75,56,10,196,376,5559,1568,30528,36087,10/2/2020
4/21/2020,444,6312,2110,36918,43230,45,727,33,333,5,73,321,72,56,18,214,384,5943,1700,32228,38171,10/2/2020
4/22/2020,418,6730,2390,39308,46038,41,768,32,365,5,78,325,73,58,18,232,379,6322,1913,34141,40463,10/2/2020
4/23/2020,479,7209,2469,41777,48986,32,800,28,393,5,83,324,76,62,15,247,413,6735,1854,35995,42730,10/2/2020
4/24/2020,491,7700,3284,45061,52761,35,835,26,419,4,87,329,85,63,15,262,407,7142,2624,38619,45761,10/2/2020
4/25/2020,393,8093,2206,47267,55360,34,869,17,436,5,92,341,85,62,14,276,300,7442,1764,40383,47825,10/2/2020
4/26/2020,316,8409,2309,49576,57985,33,902,15,451,3,95,356,86,59,14,290,274,7716,1875,42258,49974,10/2/2020
4/27/2020,249,8658,1620,51196,59854,29,931,21,472,4,99,360,86,61,10,300,206,7922,1162,43420,51342,10/2/2020
4/28/2020,410,9068,2263,53459,62527,44,975,24,496,3,102,377,88,59,22,322,331,8253,1761,45181,53434,10/2/2020
4/29/2020,476,9544,3343,56802,66346,36,1011,38,534,11,113,364,78,53,18,340,371,8624,2422,47603,56227,10/2/2020
4/30/2020,432,9976,2769,59571,69547,33,1044,38,572,6,119,353,83,57,24,364,350,8974,1922,49525,58499,10/2/2020
5/1/2020,454,10430,3086,62657,73087,51,1095,40,612,3,122,361,84,58,14,378,325,9299,2175,51700,60999,10/2/2020
5/2/2020,257,10687,1926,64583,75270,36,1131,37,649,5,127,355,91,62,24,402,193,9492,1274,52974,62466,10/2/2020
5/3/2020,283,10970,2160,66743,77713,31,1162,26,675,8,135,352,90,61,21,423,183,9675,1577,54551,64226,10/2/2020
5/4/2020,387,11357,2098,68841,80198,30,1192,31,706,6,141,345,88,57,18,441,290,9965,1561,56112,66077,10/2/2020
5/5/2020,433,11790,2873,71714,83504,29,1221,32,738,6,147,336,82,54,16,457,300,10265,1960,58072,68337,10/2/2020
5/6/2020,488,12278,2830,74544,86822,28,1249,44,782,9,156,311,79,54,21,478,340,10605,1917,59989,70594,10/2/2020
5/7/2020,425,12703,2969,77513,90216,36,1285,41,823,5,161,301,71,52,21,499,269,10874,1961,61950,72824,10/2/2020
5/8/2020,359,13062,2598,80111,93173,30,1315,29,852,5,166,297,71,53,22,521,230,11104,1737,63687,74791,10/2/2020
5/9/2020,467,13529,3346,83457,96986,22,1337,21,873,4,170,294,69,51,15,536,290,11394,2256,65943,77337,10/2/2020
5/10/2020,285,13814,2117,85574,99388,20,1357,23,896,6,176,285,70,49,13,549,189,11583,1523,67466,79049,10/2/2020
5/11/2020,257,14071,1857,87431,101502,31,1388,16,912,6,182,294,71,49,15,564,174,11757,1301,68767,80524,10/2/2020
5/12/2020,387,14458,2611,90042,104500,23,1411,18,930,4,186,295,69,48,22,586,224,11981,1706,70473,82454,10/2/2020
5/13/2020,351,14809,3630,93672,108481,23,1434,25,955,1,187,292,69,49,13,599,199,12180,2003,72476,84656,10/2/2020
5/14/2020,329,15138,3408,97080,112218,19,1453,27,982,3,190,281,64,45,15,614,230,12410,2017,74493,86903,10/2/2020
5/15/2020,381,15519,3458,100538,116057,24,1477,41,1023,5,195,259,62,45,14,628,232,12642,1807,76300,88942,10/2/2020
5/16/2020,449,15968,4156,104694,120662,25,1502,13,1036,5,200,266,61,46,15,643,247,12889,1963,78263,91152,10/2/2020
5/17/2020,240,16208,2768,107462,123670,17,1519,8,1044,5,205,270,59,45,10,653,126,13015,1556,79819,92834,10/2/2020
5/18/2020,250,16458,2001,109463,125921,19,1538,15,1059,5,210,269,57,40,18,671,135,13150,1369,81188,94338,10/2/2020
5/19/2020,415,16873,3168,112631,129504,23,1561,32,1091,5,215,255,56,38,11,682,215,13365,1927,83115,96480,10/2/2020
5/20/2020,326,17199,2771,115402,132601,18,1579,23,1114,7,222,243,52,33,22,704,183,13548,1514,84629,98177,10/2/2020
5/21/2020,374,17573,3757,119159,136732,26,1605,15,1129,3,225,251,53,29,20,724,168,13716,1939,86568,100284,10/2/2020
5/22/2020,351,17924,3161,122320,140244,20,1625,28,1157,5,230,238,52,29,10,734,206,13922,1608,88176,102098,10/2/2020
5/23/2020,253,18177,2742,125062,143239,19,1644,11,1168,3,233,243,52,32,13,747,109,14031,1271,89447,103478,10/2/2020
5/24/2020,163,18340,1370,126432,144772,12,1656,14,1182,2,235,239,53,36,8,755,82,14113,773,90220,104333,10/2/2020
5/25/2020,147,18487,1385,127817,146304,14,1670,14,1196,0,235,239,53,34,10,765,76,14189,762,90982,105171,10/2/2020
5/26/2020,285,18772,2620,130437,149209,24,1694,22,1218,5,240,236,48,33,15,780,157,14346,1780,92762,107108,10/2/2020
5/27/2020,276,19048,2057,132494,151542,20,1714,18,1236,3,243,235,50,33,10,790,132,14478,1133,93895,108373,10/2/2020
5/28/2020,348,19396,3359,135853,155249,16,1730,29,1265,4,247,218,47,32,8,798,130,14608,1117,95012,109620,10/2/2020
5/29/2020,410,19806,3914,139767,159573,19,1749,27,1292,6,253,204,43,31,12,810,173,14781,1571,96583,111364,10/2/2020
5/30/2020,225,20031,3915,143682,163713,15,1764,19,1311,4,257,196,40,29,12,822,109,14890,1820,98403,113293,10/2/2020
5/31/2020,155,20186,1688,145370,165556,11,1775,10,1321,1,258,196,43,26,3,825,78,14968,857,99260,114228,10/2/2020
6/1/2020,212,20398,2792,148162,168560,8,1783,14,1335,1,259,189,44,29,5,830,93,15061,1384,100644,115705,10/2/2020
6/2/2020,273,20671,3022,151184,171855,8,1791,9,1344,3,262,185,37,25,10,840,98,15159,1448,102092,117251,10/2/2020
6/3/2020,254,20925,3486,154670,175595,14,1805,17,1361,6,268,176,34,25,11,851,99,15258,1660,103752,119010,10/2/2020
6/4/2020,276,21201,4471,159141,180342,7,1812,25,1386,3,271,155,31,24,11,862,107,15365,2036,105788,121153,10/2/2020
6/5/2020,215,21416,3513,162654,184070,15,1827,13,1399,6,277,151,27,21,11,873,99,15464,1575,107363,122827,10/2/2020
6/6/2020,201,21617,2616,165270,186887,10,1837,7,1406,2,279,152,29,19,6,879,67,15531,1136,108499,124030,10/2/2020
6/7/2020,83,21700,1625,166895,188595,11,1848,7,1413,1,280,155,25,17,4,883,51,15582,782,109281,124863,10/2/2020
6/8/2020,119,21819,1849,168744,190563,15,1863,12,1425,2,282,156,27,18,4,887,45,15627,960,110241,125868,10/2/2020
6/9/2020,223,22042,2673,171417,193459,10,1873,18,1443,0,282,148,28,21,1,888,64,15691,1257,111498,127189,10/2/2020
6/10/2020,209,22251,2987,174404,196655,13,1886,12,1455,2,284,147,24,17,4,892,101,15792,1464,112962,128754,10/2/2020
6/11/2020,195,22446,3513,177917,200363,7,1893,15,1470,1,285,138,25,16,6,898,88,15880,1534,114496,130376,10/2/2020
6/12/2020,209,22655,4601,182518,205173,9,1902,15,1485,1,286,131,24,16,2,900,78,15958,2179,116675,132633,10/2/2020
6/13/2020,113,22768,3036,185554,208322,6,1908,4,1489,0,286,133,20,15,3,903,49,16007,1373,118048,134055,10/2/2020
6/14/2020,81,22849,2046,187600,210449,7,1915,8,1497,1,287,131,20,14,3,906,33,16040,968,119016,135056,10/2/2020
6/15/2020,188,23037,3108,190708,213745,14,1929,14,1511,0,287,131,20,16,5,911,75,16115,1791,120807,136922,10/2/2020
6/16/2020,110,23147,3017,193725,216872,11,1940,9,1520,1,288,132,22,16,8,919,50,16165,1578,122385,138550,10/2/2020
6/17/2020,127,23274,2835,196560,219834,15,1955,20,1540,4,292,123,18,14,6,925,50,16215,1318,123703,139918,10/2/2020
6/18/2020,149,23423,3047,199607,223030,9,1964,13,1553,1,293,118,19,16,7,932,70,16285,1313,125016,141301,10/2/2020
6/19/2020,141,23564,3769,203376,226940,12,1976,11,1564,1,294,118,20,17,3,935,59,16344,1370,126386,142730,10/2/2020
6/20/2020,84,23648,1891,205267,228915,9,1985,12,1576,0,294,115,20,18,4,939,36,16380,812,127198,143578,10/2/2020
6/21/2020,37,23685,1064,206331,230016,8,1993,5,1581,0,294,118,20,18,2,941,29,16409,692,127890,144299,10/2/2020
6/22/2020,138,23823,3730,210061,233884,12,2005,16,1597,0,294,114,19,18,2,943,65,16474,1706,129596,146070,10/2/2020
6/23/2020,163,23986,3831,213892,237878,3,2008,13,1610,3,297,101,18,18,7,950,81,16555,1780,131376,147931,10/2/2020
6/24/2020,120,24106,3502,217394,241500,9,2017,10,1620,1,298,99,18,18,5,955,44,16599,1686,133062,149661,10/2/2020
6/25/2020,103,24209,2883,220277,244486,6,2023,14,1634,1,299,90,17,17,1,956,50,16649,1512,134574,151223,10/2/2020
6/26/2020,94,24303,2488,222765,247068,2,2025,10,1644,0,299,82,18,18,1,957,60,16709,1331,135905,152614,10/2/2020
6/27/2020,84,24387,3214,225979,250366,5,2030,3,1647,1,300,83,17,17,5,962,37,16746,1218,137123,153869,10/2/2020
6/28/2020,39,24426,1469,227448,251874,4,2034,4,1651,4,304,79,15,14,6,968,17,16763,595,137718,154481,10/2/2020
6/29/2020,85,24511,3697,231145,255656,4,2038,5,1656,0,304,78,14,14,1,969,39,16802,1354,139072,155874,10/2/2020
6/30/2020,57,24568,1957,233102,257670,1,2039,5,1661,1,305,73,12,11,4,973,33,16835,995,140067,156902,10/2/2020
7/1/2020,144,24712,4098,237200,261912,7,2046,9,1670,0,305,71,11,11,1,974,78,16913,1934,142001,158914,10/2/2020
7/2/2020,103,24815,2803,240003,264818,5,2051,5,1675,1,306,70,10,10,3,977,59,16972,1089,143090,160062,10/2/2020
7/3/2020,50,24865,2076,242079,266944,9,2060,6,1681,0,306,73,9,9,3,980,25,16997,778,143868,160865,10/2/2020
7/4/2020,57,24922,2345,244424,269346,2,2062,4,1685,1,307,70,10,9,2,982,33,17030,1011,144879,161909,10/2/2020
7/5/2020,49,24971,2932,247356,272327,1,2063,2,1687,1,308,68,8,8,2,984,26,17056,1445,146324,163380,10/2/2020
7/6/2020,101,25072,2811,250167,275239,6,2069,6,1693,0,308,68,9,9,4,988,57,17113,1552,147876,164989,10/2/2020
7/7/2020,81,25153,3457,253624,278777,5,2074,7,1700,0,308,66,8,8,2,990,47,17160,1535,149411,166571,10/2/2020
7/8/2020,105,25258,3403,257027,282285,4,2078,2,1702,0,308,68,9,8,0,990,64,17224,1425,150836,168060,10/2/2020
7/9/2020,94,25352,3712,260739,286091,9,2087,3,1705,0,308,74,9,8,0,990,50,17274,1628,152464,169738,10/2/2020
7/10/2020,131,25483,4431,265170,290653,6,2093,3,1708,2,310,75,7,7,3,993,80,17354,2080,154544,171898,10/2/2020
7/11/2020,63,25546,2932,268102,293648,6,2099,3,1711,1,311,77,6,6,3,996,36,17390,1316,155860,173250,10/2/2020
7/12/2020,47,25593,1836,269938,295531,1,2100,3,1714,1,312,74,6,5,3,999,33,17423,943,156803,174226,10/2/2020
7/13/2020,84,25677,3201,273139,298816,8,2108,10,1724,0,312,72,6,5,1,1000,61,17484,1505,158308,175792,10/2/2020
7/14/2020,73,25750,3291,276430,302180,7,2115,4,1728,0,312,75,5,5,1,1001,43,17527,1375,159683,177210,10/2/2020
7/15/2020,130,25880,4172,280602,306482,5,2120,7,1735,0,312,73,5,4,0,1001,99,17626,1751,161434,179060,10/2/2020
7/16/2020,102,25982,3733,284335,310317,6,2126,9,1744,0,312,70,6,5,1,1002,75,17701,1619,163053,180754,10/2/2020
7/17/2020,156,26138,4236,288571,314709,14,2140,3,1747,1,313,80,5,5,2,1004,79,17780,1847,164900,182680,10/2/2020
7/18/2020,85,26223,3267,291838,318061,5,2145,9,1756,1,314,75,5,4,4,1008,70,17850,1399,166299,184149,10/2/2020
7/19/2020,82,26305,2693,294531,320836,7,2152,3,1759,0,314,79,6,4,2,1010,57,17907,1149,167448,185355,10/2/2020
7/20/2020,71,26376,2664,297195,323571,9,2161,7,1766,0,314,81,7,5,2,1012,68,17975,1465,168913,186888,10/2/2020
7/21/2020,130,26506,4298,301493,327999,9,2170,11,1777,0,314,79,9,6,1,1013,109,18084,1919,170832,188916,10/2/2020
7/22/2020,130,26636,3926,305419,332055,11,2181,11,1788,1,315,78,7,6,1,1014,86,18170,1683,172515,190685,10/2/2020
7/23/2020,141,26777,4412,309831,336608,8,2189,6,1794,0,315,80,8,7,0,1014,115,18285,1990,174505,192790,10/2/2020
7/24/2020,172,26949,5959,315790,342739,14,2203,14,1808,0,315,80,9,7,0,1014,119,18404,2322,176827,195231,10/2/2020
7/25/2020,134,27083,4398,320188,347271,7,2210,7,1815,0,315,80,10,8,2,1016,108,18512,2100,178927,197439,10/2/2020
7/26/2020,62,27145,3027,323215,350360,8,2218,9,1824,0,315,79,11,7,1,1017,54,18566,1338,180265,198831,10/2/2020
7/27/2020,188,27333,4190,327405,354738,12,2230,7,1831,0,315,84,13,8,1,1018,138,18704,2350,182615,201319,10/2/2020
7/28/2020,105,27438,3834,331239,358677,5,2235,5,1836,0,315,84,14,7,1,1019,94,18798,1635,184250,203048,10/2/2020
7/29/2020,191,27629,5137,336376,364005,11,2246,12,1848,0,315,83,15,7,0,1019,154,18952,2324,186574,205526,10/2/2020
7/30/2020,121,27750,4344,340720,368470,6,2252,2,1850,1,316,86,15,6,1,1020,97,19049,1650,188224,207273,10/2/2020
7/31/2020,131,27881,5508,346228,374109,8,2260,10,1860,0,316,84,15,7,1,1021,89,19138,1854,190078,209216,10/2/2020
8/1/2020,108,27989,4288,350516,378505,7,2267,2,1862,0,316,89,14,7,1,1022,88,19226,1559,191637,210863,10/2/2020
8/2/2020,84,28073,2802,353318,381391,12,2279,12,1874,2,318,87,14,8,2,1024,62,19288,1274,192911,212199,10/2/2020
8/3/2020,187,28260,5238,358556,386816,13,2292,12,1886,0,318,88,16,7,1,1025,150,19438,2202,195113,214551,10/2/2020
8/4/2020,126,28386,3691,362247,390633,8,2300,6,1892,1,319,89,12,5,2,1027,99,19537,1773,196886,216423,10/2/2020
8/5/2020,148,28534,5932,368179,396713,12,2312,10,1902,1,320,90,10,5,2,1029,118,19655,2474,199360,219015,10/2/2020
8/6/2020,169,28703,5533,373712,402415,7,2319,9,1911,0,320,88,9,4,0,1029,121,19776,2408,201768,221544,10/2/2020
8/7/2020,122,28825,4845,378557,407382,13,2332,10,1921,1,321,90,9,3,2,1031,87,19863,2149,203917,223780,10/2/2020
8/8/2020,123,28948,4106,382663,411611,19,2351,6,1927,1,322,102,8,3,1,1032,92,19955,1780,205697,225652,10/2/2020
8/9/2020,42,28990,1722,384385,413375,8,2359,10,1937,0,322,100,9,4,0,1032,35,19990,1075,206772,226762,10/2/2020
8/10/2020,149,29139,4580,388965,418104,11,2370,12,1949,0,322,99,9,4,1,1033,113,20103,2029,208801,228904,10/2/2020
8/11/2020,105,29244,4325,393290,422534,6,2376,14,1963,0,322,91,10,4,3,1036,92,20195,2268,211069,231264,10/2/2020
8/12/2020,121,29365,5184,398474,427839,8,2384,11,1974,0,322,88,9,3,1,1037,101,20296,2630,213699,233995,10/2/2020
8/13/2020,135,29500,4191,402665,432165,13,2397,12,1986,0,322,89,11,3,0,1037,95,20391,1909,215608,235999,10/2/2020
8/14/2020,145,29645,5492,408157,437802,13,2410,11,1997,0,322,91,11,4,3,1040,99,20490,1977,217585,238075,10/2/2020
8/15/2020,105,29750,4533,412690,442440,8,2418,11,2008,1,323,87,11,5,0,1040,89,20579,1696,219281,239860,10/2/2020
8/16/2020,83,29833,2785,415475,445308,7,2425,6,2014,4,327,84,8,4,6,1046,70,20649,981,220262,240911,10/2/2020
8/17/2020,106,29939,4570,420045,449984,10,2435,7,2021,0,327,87,8,5,2,1048,88,20737,2400,222662,243399,10/2/2020
8/18/2020,128,30067,5049,425094,455161,11,2446,9,2030,1,328,88,8,4,5,1053,95,20832,2772,225434,246266,10/2/2020
8/19/2020,114,30181,5407,430501,460682,8,2454,9,2039,1,329,86,9,5,0,1053,89,20921,2663,228097,249018,10/2/2020
8/20/2020,174,30355,8220,438721,469076,12,2466,6,2045,2,331,90,10,5,3,1056,139,21060,3559,231656,252716,10/2/2020
8/21/2020,154,30509,6816,445537,476046,8,2474,5,2050,1,332,92,9,4,2,1058,125,21185,2967,234623,255808,10/2/2020
8/22/2020,96,30605,5957,451494,482099,10,2484,12,2062,0,332,90,11,4,1,1059,84,21269,2627,237250,258519,10/2/2020
8/23/2020,70,30675,4365,455859,486534,11,2495,6,2068,0,332,95,11,2,1,1060,56,21325,2476,239726,261051,10/2/2020
8/24/2020,105,30780,5776,461635,492415,7,2502,10,2078,1,333,91,13,4,1,1061,76,21401,3161,242887,264288,10/2/2020
8/25/2020,108,30888,4796,466431,497319,10,2512,4,2082,1,334,96,11,4,1,1062,92,21493,2302,245189,266682,10/2/2020
8/26/2020,170,31058,9604,476035,507093,4,2516,8,2090,0,334,92,9,5,1,1063,127,21620,3087,248276,269896,10/2/2020
8/27/2020,94,31152,8848,484883,516035,6,2522,13,2103,1,335,84,6,5,2,1065,71,21691,3220,251496,273187,10/2/2020
8/28/2020,112,31264,8106,492989,524253,14,2536,4,2107,0,335,94,9,7,2,1067,88,21779,2442,253938,275717,10/2/2020
8/29/2020,65,31329,5516,498505,529834,6,2542,8,2115,1,336,91,10,6,2,1069,51,21830,1911,255849,277679,10/2/2020
8/30/2020,66,31395,4319,502824,534219,7,2549,4,2119,0,336,94,8,5,2,1071,48,21878,1997,257846,279724,10/2/2020
8/31/2020,105,31500,4864,507688,539188,12,2561,15,2134,0,336,91,8,4,1,1072,80,21958,2189,260035,281993,10/2/2020
9/1/2020,98,31598,7199,514887,546485,6,2567,9,2143,1,337,87,7,4,2,1074,65,22023,2381,262416,284439,10/2/2020
9/2/2020,125,31723,10750,525637,557360,9,2576,10,2153,1,338,85,8,4,2,1076,103,22126,3074,265490,287616,10/2/2020
9/3/2020,90,31813,11373,537010,568823,8,2584,8,2161,0,338,85,9,4,3,1079,73,22199,2598,268088,290287,10/2/2020
9/4/2020,102,31915,9187,546197,578112,11,2595,4,2165,0,338,92,9,4,1,1080,82,22281,2399,270487,292768,10/2/2020
9/5/2020,52,31967,6356,552553,584520,6,2601,9,2174,0,338,89,8,3,1,1081,42,22323,1604,272091,294414,10/2/2020
9/6/2020,87,32054,4317,556870,588924,4,2605,8,2182,1,339,84,6,3,1,1082,64,22387,1960,274051,296438,10/2/2020
9/7/2020,35,32089,3000,559870,591959,11,2616,3,2185,0,339,92,5,3,1,1083,26,22413,647,274698,297111,10/2/2020
9/8/2020,74,32163,6407,566277,598440,6,2622,12,2197,1,340,85,6,3,2,1085,66,22479,1607,276305,298784,10/2/2020
9/9/2020,118,32281,8866,575143,607424,9,2631,5,2202,1,341,88,9,3,1,1086,101,22580,2167,278472,301052,10/2/2020
9/10/2020,167,32448,11791,586934,619382,9,2640,8,2210,0,341,89,10,3,0,1086,113,22693,2282,280754,303447,10/2/2020
9/11/2020,124,32572,9500,596434,629006,11,2651,11,2221,0,341,89,10,5,0,1086,101,22794,1986,282740,305534,10/2/2020
9/12/2020,109,32681,6188,602622,635303,8,2659,5,2226,2,343,90,9,5,3,1089,97,22891,1504,284244,307135,10/2/2020
9/13/2020,58,32739,2707,605329,638068,4,2663,3,2229,0,343,91,10,5,0,1089,53,22944,859,285103,308047,10/2/2020
9/14/2020,104,32843,6424,611753,644596,5,2668,3,2232,2,345,91,10,5,1,1090,95,23039,1710,286813,309852,10/2/2020
9/15/2020,122,32965,8554,620307,653272,6,2674,2,2234,1,346,94,10,5,2,1092,125,23164,2201,289014,312178,10/2/2020
9/16/2020,137,33102,9879,630186,663288,7,2681,7,2241,2,348,92,8,6,5,1097,118,23282,1975,290989,314271,10/2/2020
9/17/2020,124,33226,9581,639767,672993,7,2688,14,2255,0,348,85,8,4,0,1097,154,23436,1962,292951,316387,10/2/2020
9/18/2020,132,33358,10263,650030,683388,7,2695,7,2262,1,349,84,11,6,2,1099,133,23569,1955,294906,318475,10/2/2020
9/19/2020,116,33474,8393,658423,691897,7,2702,3,2265,0,349,88,10,6,4,1103,112,23681,1710,296616,320297,10/2/2020
9/20/2020,60,33534,3668,662091,695625,7,2709,6,2271,2,351,87,10,8,4,1107,48,23729,1345,297961,321690,10/2/2020
9/21/2020,103,33637,7005,669096,702733,12,2721,3,2274,2,353,94,9,6,2,1109,93,23822,2417,300378,324200,10/2/2020
9/22/2020,154,33791,9404,678500,712291,12,2733,3,2277,1,354,102,8,5,1,1110,125,23947,2231,302609,326556,10/2/2020
9/23/2020,136,33927,10944,689444,723371,10,2743,7,2284,0,354,105,7,5,0,1110,127,24074,2230,304839,328913,10/2/2020
9/24/2020,105,34032,11509,700953,734985,7,2750,9,2293,1,355,102,8,6,1,1111,110,24184,2086,306925,331109,10/2/2020
9/25/2020,136,34168,10183,711136,745304,9,2759,10,2303,0,355,101,7,6,1,1112,129,24313,2396,309321,333634,10/2/2020
9/26/2020,148,34316,10126,721262,755578,12,2771,9,2312,0,355,104,7,6,1,1113,115,24428,2005,311326,335754,10/2/2020
9/27/2020,42,34358,2575,723837,758195,6,2777,5,2317,0,355,105,10,6,0,1113,30,24458,808,312134,336592,10/2/2020
9/28/2020,152,34510,6937,730774,765284,6,2783,6,2323,2,357,103,8,6,2,1115,127,24585,2141,314275,338860,10/2/2020
9/29/2020,204,34714,10128,740902,775616,11,2794,17,2340,1,358,96,7,7,1,1116,184,24769,2352,316627,341396,10/2/2020
9/30/2020,210,34924,11348,752250,787174,6,2800,6,2346,0,358,96,7,7,1,1117,174,24943,2324,318951,343894,10/2/2020
10/1/2020,153,35077,9687,761937,797014,,,,,,,,,,1,1118,133,25076,1882,320833,345909,10/2/2020
2/27/2020,0,0,0,0,0,1,1,0,0,0,0,1,0,0,0,0,0,0,0,0,0,10/6/2020
2/28/2020,0,0,0,0,0,0,1,0,0,0,0,1,1,0,0,0,0,0,0,0,0,10/6/2020
2/29/2020,0,0,0,0,0,0,1,0,0,0,0,1,1,0,0,0,0,0,0,0,0,10/6/2020
3/1/2020,2,2,2,2,4,0,1,0,0,0,0,1,1,1,0,0,2,2,2,2,4,10/6/2020
3/2/2020,0,2,1,3,5,1,2,0,0,0,0,2,2,2,0,0,0,2,1,3,5,10/6/2020
3/3/2020,0,2,2,5,7,0,2,0,0,0,0,2,2,2,0,0,0,2,2,5,7,10/6/2020
3/4/2020,0,2,12,17,19,1,3,0,0,0,0,3,2,2,0,0,0,2,10,15,17,10/6/2020
3/5/2020,0,2,4,21,23,0,3,0,0,0,0,3,2,2,0,0,1,3,4,19,22,10/6/2020
3/6/2020,1,3,12,33,36,0,3,0,0,0,0,3,2,2,0,0,0,3,11,30,33,10/6/2020
3/7/2020,0,3,19,52,55,0,3,0,0,0,0,3,2,1,0,0,0,3,19,49,52,10/6/2020
3/8/2020,0,3,18,70,73,0,3,0,0,0,0,3,2,1,0,0,0,3,18,67,70,10/6/2020
3/9/2020,1,4,15,85,89,0,3,0,0,0,0,3,2,1,0,0,1,4,15,82,86,10/6/2020
3/10/2020,2,6,25,110,116,0,3,0,0,0,0,3,2,1,0,0,1,5,23,105,110,10/6/2020
3/11/2020,0,6,34,144,150,1,4,0,0,0,0,4,1,1,0,0,0,5,34,139,144,10/6/2020
3/12/2020,9,15,41,185,200,1,5,0,0,0,0,5,1,1,0,0,8,13,38,177,190,10/6/2020
3/13/2020,6,21,50,235,256,4,9,1,1,0,0,8,1,1,0,0,6,19,48,225,244,10/6/2020
3/14/2020,0,21,90,325,346,0,9,0,1,0,0,8,1,1,0,0,0,19,86,311,330,10/6/2020
3/15/2020,1,22,54,379,401,1,10,0,1,0,0,9,2,1,0,0,1,20,54,365,385,10/6/2020
3/16/2020,2,24,95,474,498,2,12,0,1,0,0,11,2,0,0,0,2,22,92,457,479,10/6/2020
3/17/2020,12,36,162,636,672,6,18,0,1,0,0,17,2,0,0,0,11,33,151,608,641,10/6/2020
3/18/2020,9,45,116,752,797,3,21,0,1,0,0,20,2,0,0,0,11,44,110,718,762,10/6/2020
3/19/2020,15,60,262,1014,1074,2,23,1,2,0,0,21,3,0,1,1,17,61,251,969,1030,10/6/2020
3/20/2020,13,73,197,1211,1284,5,28,0,2,0,0,26,4,0,0,1,13,74,190,1159,1233,10/6/2020
3/21/2020,12,85,126,1337,1422,3,31,2,4,0,0,27,5,0,0,1,14,88,123,1282,1370,10/6/2020
3/22/2020,27,112,282,1619,1731,2,33,0,4,0,0,29,5,0,0,1,25,113,261,1543,1656,10/6/2020
3/23/2020,14,126,169,1788,1914,15,48,1,5,0,0,43,9,3,0,1,16,129,165,1708,1837,10/6/2020
3/24/2020,20,146,242,2030,2176,7,55,0,5,0,0,50,10,4,0,1,19,148,237,1945,2093,10/6/2020
3/25/2020,26,172,182,2212,2384,5,60,1,6,0,0,54,11,3,0,1,28,176,171,2116,2292,10/6/2020
3/26/2020,35,207,181,2393,2600,10,70,5,11,0,0,59,14,5,0,1,41,217,174,2290,2507,10/6/2020
3/27/2020,27,234,214,2607,2841,9,79,1,12,1,1,66,17,6,2,3,31,248,201,2491,2739,10/6/2020
3/28/2020,59,293,260,2867,3160,13,92,3,15,2,3,74,15,6,1,4,64,312,241,2732,3044,10/6/2020
3/29/2020,100,393,350,3217,3610,8,100,4,19,1,4,77,18,8,2,6,105,417,313,3045,3462,10/6/2020
3/30/2020,62,455,222,3439,3894,20,120,5,24,0,4,92,20,11,3,9,78,495,184,3229,3724,10/6/2020
3/31/2020,71,526,369,3808,4334,11,131,7,31,1,5,95,22,13,2,11,73,568,296,3525,4093,10/6/2020
4/1/2020,99,625,698,4506,5131,18,149,7,38,0,5,106,30,15,1,12,100,668,640,4165,4833,10/6/2020
4/2/2020,52,677,477,4983,5660,22,171,6,44,2,7,120,36,21,4,16,62,730,436,4601,5331,10/6/2020
4/3/2020,108,785,774,5757,6542,23,194,7,51,0,7,136,43,25,3,19,100,830,711,5312,6142,10/6/2020
4/4/2020,143,928,660,6417,7345,22,216,4,55,5,12,149,41,30,9,28,138,968,617,5929,6897,10/6/2020
4/5/2020,187,1115,1156,7573,8688,20,236,9,64,1,13,159,44,36,2,30,181,1149,1064,6993,8142,10/6/2020
4/6/2020,218,1333,1706,9279,10612,26,262,7,71,0,13,178,48,40,7,37,208,1357,1548,8541,9898,10/6/2020
4/7/2020,284,1617,1629,10908,12525,20,282,4,75,2,15,192,50,42,5,42,261,1618,1478,10019,11637,10/6/2020
4/8/2020,290,1907,1720,12628,14535,19,301,7,82,6,21,198,50,38,10,52,271,1889,1558,11577,13466,10/6/2020
4/9/2020,283,2190,1516,14144,16334,32,333,9,91,4,25,217,53,40,7,59,277,2166,1354,12931,15097,10/6/2020
4/10/2020,419,2609,2574,16718,19327,29,362,17,108,5,30,224,59,41,11,70,401,2567,2368,15299,17866,10/6/2020
4/11/2020,297,2906,1905,18623,21529,29,391,11,119,2,32,240,61,48,12,82,280,2847,1714,17013,19860,10/6/2020
4/12/2020,314,3220,1670,20293,23513,35,426,13,132,5,37,257,59,49,9,91,284,3131,1433,18446,21577,10/6/2020
4/13/2020,161,3381,935,21228,24609,35,461,13,145,3,40,276,64,54,9,100,187,3318,837,19283,22601,10/6/2020
4/14/2020,289,3670,1787,23015,26685,27,488,17,162,5,45,281,72,53,8,108,262,3580,1528,20811,24391,10/6/2020
4/15/2020,351,4021,1799,24814,28835,31,519,20,182,3,48,289,72,54,17,125,306,3886,1549,22360,26246,10/6/2020
4/16/2020,447,4468,2494,27308,31776,36,555,25,207,6,54,294,72,53,14,139,387,4273,2070,24430,28703,10/6/2020
4/17/2020,304,4772,1821,29129,33901,32,587,20,227,7,61,299,66,45,21,160,290,4563,1444,25874,30437,10/6/2020
4/18/2020,321,5093,1725,30854,35947,26,613,18,245,4,65,303,63,49,15,175,284,4847,1324,27198,32045,10/6/2020
4/19/2020,381,5474,2047,32901,38375,23,636,26,271,1,66,299,65,55,11,186,336,5183,1739,28937,34120,10/6/2020
4/20/2020,394,5868,1907,34808,40676,46,682,29,300,2,68,314,75,56,10,196,376,5559,1567,30504,36063,10/6/2020
4/21/2020,444,6312,2110,36918,43230,45,727,33,333,5,73,321,72,56,18,214,384,5943,1700,32204,38147,10/6/2020
4/22/2020,418,6730,2390,39308,46038,41,768,32,365,5,78,325,73,58,18,232,379,6322,1913,34117,40439,10/6/2020
4/23/2020,479,7209,2469,41777,48986,32,800,28,393,5,83,324,76,62,15,247,412,6734,1853,35970,42704,10/6/2020
4/24/2020,491,7700,3284,45061,52761,35,835,26,419,4,87,329,85,63,15,262,407,7141,2622,38592,45733,10/6/2020
4/25/2020,393,8093,2206,47267,55360,34,869,17,436,5,92,341,85,62,14,276,300,7441,1762,40354,47795,10/6/2020
4/26/2020,316,8409,2309,49576,57985,33,902,15,451,3,95,356,86,59,14,290,274,7715,1875,42229,49944,10/6/2020
4/27/2020,249,8658,1620,51196,59854,29,931,21,472,4,99,360,86,61,10,300,206,7921,1161,43390,51311,10/6/2020
4/28/2020,410,9068,2263,53459,62527,44,975,24,496,3,102,377,88,59,22,322,331,8252,1761,45151,53403,10/6/2020
4/29/2020,476,9544,3343,56802,66346,36,1011,38,534,11,113,364,78,53,18,340,371,8623,2420,47571,56194,10/6/2020
4/30/2020,432,9976,2769,59571,69547,33,1044,38,572,6,119,353,83,57,24,364,350,8973,1915,49486,58459,10/6/2020
5/1/2020,454,10430,3086,62657,73087,51,1095,39,611,3,122,362,84,58,14,378,325,9298,2168,51654,60952,10/6/2020
5/2/2020,257,10687,1926,64583,75270,36,1131,38,649,5,127,355,91,62,24,402,192,9490,1274,52928,62418,10/6/2020
5/3/2020,283,10970,2160,66743,77713,31,1162,26,675,8,135,352,90,61,21,423,183,9673,1576,54504,64177,10/6/2020
5/4/2020,387,11357,2098,68841,80198,30,1192,31,706,6,141,345,88,57,18,441,290,9963,1560,56064,66027,10/6/2020
5/5/2020,433,11790,2873,71714,83504,29,1221,32,738,6,147,336,82,54,16,457,299,10262,1958,58022,68284,10/6/2020
5/6/2020,488,12278,2830,74544,86822,28,1249,44,782,9,156,311,79,54,21,478,340,10602,1917,59939,70541,10/6/2020
5/7/2020,425,12703,2969,77513,90216,36,1285,41,823,5,161,301,71,52,21,499,270,10872,1960,61899,72771,10/6/2020
5/8/2020,359,13062,2598,80111,93173,30,1315,29,852,5,166,297,71,53,22,521,230,11102,1737,63636,74738,10/6/2020
5/9/2020,467,13529,3346,83457,96986,22,1337,21,873,4,170,294,69,51,15,536,290,11392,2256,65892,77284,10/6/2020
5/10/2020,285,13814,2117,85574,99388,20,1357,23,896,6,176,285,70,49,13,549,189,11581,1523,67415,78996,10/6/2020
5/11/2020,257,14071,1857,87431,101502,31,1388,16,912,6,182,294,71,49,15,564,174,11755,1301,68716,80471,10/6/2020
5/12/2020,387,14458,2611,90042,104500,23,1411,18,930,4,186,295,69,48,22,586,224,11979,1702,70418,82397,10/6/2020
5/13/2020,351,14809,3630,93672,108481,23,1434,25,955,1,187,292,69,49,13,599,199,12178,2001,72419,84597,10/6/2020
5/14/2020,329,15138,3408,97080,112218,19,1453,27,982,3,190,281,64,45,15,614,230,12408,2015,74434,86842,10/6/2020
5/15/2020,381,15519,3458,100538,116057,24,1477,41,1023,5,195,259,62,45,14,628,232,12640,1805,76239,88879,10/6/2020
5/16/2020,449,15968,4156,104694,120662,25,1502,13,1036,5,200,266,61,46,15,643,247,12887,1962,78201,91088,10/6/2020
5/17/2020,240,16208,2768,107462,123670,17,1519,8,1044,5,205,270,59,45,10,653,126,13013,1555,79756,92769,10/6/2020
5/18/2020,250,16458,2001,109463,125921,19,1538,15,1059,5,210,269,57,40,18,671,135,13148,1368,81124,94272,10/6/2020
5/19/2020,415,16873,3168,112631,129504,23,1561,32,1091,5,215,255,56,38,11,682,215,13363,1926,83050,96413,10/6/2020
5/20/2020,326,17199,2771,115402,132601,19,1580,23,1114,7,222,244,52,33,22,704,183,13546,1514,84564,98110,10/6/2020
5/21/2020,374,17573,3757,119159,136732,26,1606,15,1129,3,225,252,53,29,20,724,168,13714,1937,86501,100215,10/6/2020
5/22/2020,351,17924,3161,122320,140244,20,1626,29,1158,5,230,238,52,29,10,734,206,13920,1608,88109,102029,10/6/2020
5/23/2020,253,18177,2742,125062,143239,19,1645,11,1169,3,233,243,52,32,13,747,109,14029,1271,89380,103409,10/6/2020
5/24/2020,163,18340,1370,126432,144772,12,1657,14,1183,2,235,239,53,36,8,755,82,14111,773,90153,104264,10/6/2020
5/25/2020,147,18487,1385,127817,146304,14,1671,14,1197,0,235,239,53,34,10,765,76,14187,762,90915,105102,10/6/2020
5/26/2020,285,18772,2620,130437,149209,24,1695,22,1219,5,240,236,48,33,15,780,157,14344,1780,92695,107039,10/6/2020
5/27/2020,276,19048,2057,132494,151542,20,1715,18,1237,3,243,235,50,33,10,790,132,14476,1133,93828,108304,10/6/2020
5/28/2020,348,19396,3359,135853,155249,17,1732,29,1266,4,247,219,47,32,8,798,130,14606,1117,94945,109551,10/6/2020
5/29/2020,410,19806,3914,139767,159573,19,1751,27,1293,6,253,205,43,31,12,810,173,14779,1570,96515,111294,10/6/2020
5/30/2020,225,20031,3915,143682,163713,15,1766,19,1312,4,257,197,40,29,12,822,109,14888,1819,98334,113222,10/6/2020
5/31/2020,155,20186,1688,145370,165556,11,1777,10,1322,1,258,197,43,26,3,825,78,14966,855,99189,114155,10/6/2020
6/1/2020,212,20398,2792,148162,168560,8,1785,14,1336,1,259,190,44,29,5,830,93,15059,1383,100572,115631,10/6/2020
6/2/2020,273,20671,3022,151184,171855,8,1793,9,1345,3,262,186,37,25,10,840,98,15157,1448,102020,117177,10/6/2020
6/3/2020,254,20925,3486,154670,175595,14,1807,18,1363,6,268,176,34,25,11,851,99,15256,1659,103679,118935,10/6/2020
6/4/2020,276,21201,4471,159141,180342,7,1814,25,1388,3,271,155,31,24,11,862,107,15363,2035,105714,121077,10/6/2020
6/5/2020,215,21416,3513,162654,184070,15,1829,13,1401,6,277,151,27,21,11,873,99,15462,1574,107288,122750,10/6/2020
6/6/2020,201,21617,2616,165270,186887,10,1839,7,1408,2,279,152,29,19,6,879,67,15529,1136,108424,123953,10/6/2020
6/7/2020,83,21700,1625,166895,188595,11,1850,7,1415,1,280,155,25,17,4,883,51,15580,782,109206,124786,10/6/2020
6/8/2020,119,21819,1849,168744,190563,15,1865,12,1427,2,282,156,27,18,4,887,45,15625,959,110165,125790,10/6/2020
6/9/2020,223,22042,2673,171417,193459,10,1875,18,1445,0,282,148,28,21,1,888,64,15689,1257,111422,127111,10/6/2020
6/10/2020,209,22251,2987,174404,196655,13,1888,12,1457,2,284,147,24,17,4,892,101,15790,1464,112886,128676,10/6/2020
6/11/2020,195,22446,3513,177917,200363,7,1895,15,1472,1,285,138,25,16,6,898,88,15878,1534,114420,130298,10/6/2020
6/12/2020,209,22655,4601,182518,205173,9,1904,15,1487,1,286,131,24,16,2,900,78,15956,2178,116598,132554,10/6/2020
6/13/2020,113,22768,3036,185554,208322,6,1910,4,1491,0,286,133,20,15,3,903,49,16005,1373,117971,133976,10/6/2020
6/14/2020,81,22849,2046,187600,210449,7,1917,8,1499,1,287,131,20,14,3,906,33,16038,968,118939,134977,10/6/2020
6/15/2020,188,23037,3108,190708,213745,14,1931,14,1513,0,287,131,20,16,5,911,75,16113,1790,120729,136842,10/6/2020
6/16/2020,110,23147,3017,193725,216872,11,1942,9,1522,1,288,132,22,16,8,919,50,16163,1577,122306,138469,10/6/2020
6/17/2020,127,23274,2835,196560,219834,15,1957,20,1542,4,292,123,18,14,6,925,50,16213,1318,123624,139837,10/6/2020
6/18/2020,149,23423,3047,199607,223030,9,1966,13,1555,1,293,118,19,16,7,932,70,16283,1312,124936,141219,10/6/2020
6/19/2020,141,23564,3769,203376,226940,12,1978,11,1566,1,294,118,20,17,3,935,59,16342,1370,126306,142648,10/6/2020
6/20/2020,84,23648,1891,205267,228915,9,1987,12,1578,0,294,115,20,18,4,939,36,16378,812,127118,143496,10/6/2020
6/21/2020,37,23685,1064,206331,230016,8,1995,5,1583,0,294,118,20,18,2,941,29,16407,692,127810,144217,10/6/2020
6/22/2020,138,23823,3730,210061,233884,12,2007,16,1599,0,294,114,19,18,2,943,65,16472,1705,129515,145987,10/6/2020
6/23/2020,163,23986,3831,213892,237878,3,2010,13,1612,3,297,101,18,18,7,950,81,16553,1780,131295,147848,10/6/2020
6/24/2020,120,24106,3502,217394,241500,9,2019,10,1622,1,298,99,18,18,5,955,44,16597,1685,132980,149577,10/6/2020
6/25/2020,103,24209,2883,220277,244486,6,2025,14,1636,1,299,90,17,17,1,956,50,16647,1512,134492,151139,10/6/2020
6/26/2020,94,24303,2488,222765,247068,2,2027,10,1646,0,299,82,18,18,1,957,60,16707,1331,135823,152530,10/6/2020
6/27/2020,84,24387,3214,225979,250366,5,2032,3,1649,1,300,83,17,17,5,962,37,16744,1218,137041,153785,10/6/2020
6/28/2020,39,24426,1469,227448,251874,4,2036,4,1653,4,304,79,15,14,6,968,17,16761,595,137636,154397,10/6/2020
6/29/2020,85,24511,3697,231145,255656,4,2040,5,1658,0,304,78,14,14,1,969,39,16800,1352,138988,155788,10/6/2020
6/30/2020,57,24568,1957,233102,257670,1,2041,5,1663,1,305,73,12,11,4,973,33,16833,995,139983,156816,10/6/2020
7/1/2020,144,24712,4098,237200,261912,7,2048,9,1672,0,305,71,11,11,1,974,78,16911,1934,141917,158828,10/6/2020
7/2/2020,103,24815,2803,240003,264818,5,2053,5,1677,1,306,70,10,10,3,977,59,16970,1088,143005,159975,10/6/2020
7/3/2020,50,24865,2076,242079,266944,9,2062,6,1683,0,306,73,9,9,3,980,25,16995,778,143783,160778,10/6/2020
7/4/2020,57,24922,2345,244424,269346,2,2064,4,1687,1,307,70,10,9,2,982,33,17028,1011,144794,161822,10/6/2020
7/5/2020,49,24971,2932,247356,272327,1,2065,2,1689,1,308,68,8,8,2,984,26,17054,1443,146237,163291,10/6/2020
7/6/2020,101,25072,2811,250167,275239,6,2071,6,1695,0,308,68,9,9,4,988,57,17111,1551,147788,164899,10/6/2020
7/7/2020,81,25153,3457,253624,278777,5,2076,7,1702,0,308,66,8,8,2,990,47,17158,1535,149323,166481,10/6/2020
7/8/2020,105,25258,3403,257027,282285,4,2080,2,1704,0,308,68,9,8,0,990,64,17222,1423,150746,167968,10/6/2020
7/9/2020,94,25352,3712,260739,286091,9,2089,3,1707,0,308,74,9,8,0,990,50,17272,1626,152372,169644,10/6/2020
7/10/2020,131,25483,4431,265170,290653,6,2095,3,1710,2,310,75,7,7,3,993,80,17352,2079,154451,171803,10/6/2020
7/11/2020,63,25546,2932,268102,293648,6,2101,3,1713,1,311,77,6,6,3,996,36,17388,1316,155767,173155,10/6/2020
7/12/2020,47,25593,1836,269938,295531,1,2102,3,1716,1,312,74,6,5,3,999,34,17422,943,156710,174132,10/6/2020
7/13/2020,84,25677,3201,273139,298816,8,2110,10,1726,0,312,72,6,5,1,1000,61,17483,1505,158215,175698,10/6/2020
7/14/2020,73,25750,3291,276430,302180,7,2117,4,1730,0,312,75,5,5,1,1001,43,17526,1375,159590,177116,10/6/2020
7/15/2020,130,25880,4172,280602,306482,5,2122,7,1737,0,312,73,5,4,0,1001,99,17625,1751,161341,178966,10/6/2020
7/16/2020,102,25982,3733,284335,310317,6,2128,9,1746,0,312,70,6,5,1,1002,75,17700,1619,162960,180660,10/6/2020
7/17/2020,156,26138,4236,288571,314709,14,2142,3,1749,1,313,80,5,5,2,1004,79,17779,1846,164806,182585,10/6/2020
7/18/2020,85,26223,3267,291838,318061,5,2147,9,1758,1,314,75,5,4,4,1008,70,17849,1399,166205,184054,10/6/2020
7/19/2020,82,26305,2693,294531,320836,7,2154,3,1761,0,314,79,6,4,2,1010,57,17906,1149,167354,185260,10/6/2020
7/20/2020,71,26376,2664,297195,323571,9,2163,7,1768,0,314,81,7,5,2,1012,68,17974,1464,168818,186792,10/6/2020
7/21/2020,130,26506,4298,301493,327999,9,2172,11,1779,0,314,79,9,6,1,1013,109,18083,1919,170737,188820,10/6/2020
7/22/2020,130,26636,3926,305419,332055,11,2183,11,1790,1,315,78,7,6,1,1014,86,18169,1683,172420,190589,10/6/2020
7/23/2020,141,26777,4412,309831,336608,8,2191,6,1796,0,315,80,8,7,0,1014,115,18284,1989,174409,192693,10/6/2020
7/24/2020,172,26949,5959,315790,342739,14,2205,14,1810,0,315,80,9,7,0,1014,119,18403,2322,176731,195134,10/6/2020
7/25/2020,134,27083,4398,320188,347271,7,2212,7,1817,0,315,80,10,8,2,1016,108,18511,2100,178831,197342,10/6/2020
7/26/2020,62,27145,3027,323215,350360,8,2220,9,1826,0,315,79,11,7,1,1017,54,18565,1336,180167,198732,10/6/2020
7/27/2020,188,27333,4190,327405,354738,12,2232,7,1833,0,315,84,13,8,1,1018,138,18703,2350,182517,201220,10/6/2020
7/28/2020,105,27438,3834,331239,358677,5,2237,5,1838,0,315,84,14,7,1,1019,94,18797,1635,184152,202949,10/6/2020
7/29/2020,191,27629,5137,336376,364005,11,2248,12,1850,0,315,83,15,7,0,1019,154,18951,2324,186476,205427,10/6/2020
7/30/2020,121,27750,4344,340720,368470,6,2254,2,1852,1,316,86,15,6,1,1020,97,19048,1650,188126,207174,10/6/2020
7/31/2020,131,27881,5508,346228,374109,8,2262,10,1862,0,316,84,15,7,1,1021,89,19137,1854,189980,209117,10/6/2020
8/1/2020,108,27989,4288,350516,378505,7,2269,2,1864,0,316,89,14,7,1,1022,88,19225,1559,191539,210764,10/6/2020
8/2/2020,84,28073,2802,353318,381391,12,2281,12,1876,2,318,87,14,8,2,1024,62,19287,1274,192813,212100,10/6/2020
8/3/2020,187,28260,5238,358556,386816,13,2294,12,1888,0,318,88,16,7,1,1025,150,19437,2202,195015,214452,10/6/2020
8/4/2020,126,28386,3691,362247,390633,8,2302,6,1894,1,319,89,12,5,2,1027,99,19536,1772,196787,216323,10/6/2020
8/5/2020,148,28534,5932,368179,396713,12,2314,10,1904,1,320,90,10,5,2,1029,118,19654,2472,199259,218913,10/6/2020
8/6/2020,169,28703,5533,373712,402415,7,2321,9,1913,0,320,88,9,4,0,1029,121,19775,2408,201667,221442,10/6/2020
8/7/2020,122,28825,4845,378557,407382,13,2334,10,1923,1,321,90,9,3,2,1031,87,19862,2146,203813,223675,10/6/2020
8/8/2020,123,28948,4106,382663,411611,19,2353,6,1929,1,322,102,8,3,1,1032,92,19954,1780,205593,225547,10/6/2020
8/9/2020,42,28990,1722,384385,413375,8,2361,10,1939,0,322,100,9,4,0,1032,35,19989,1075,206668,226657,10/6/2020
8/10/2020,149,29139,4580,388965,418104,11,2372,12,1951,0,322,99,9,4,1,1033,113,20102,2029,208697,228799,10/6/2020
8/11/2020,105,29244,4325,393290,422534,6,2378,14,1965,0,322,91,10,4,3,1036,92,20194,2266,210963,231157,10/6/2020
8/12/2020,121,29365,5184,398474,427839,8,2386,11,1976,0,322,88,9,3,1,1037,101,20295,2630,213593,233888,10/6/2020
8/13/2020,135,29500,4191,402665,432165,13,2399,12,1988,0,322,89,11,3,0,1037,95,20390,1907,215500,235890,10/6/2020
8/14/2020,145,29645,5492,408157,437802,13,2412,11,1999,0,322,91,11,4,3,1040,99,20489,1976,217476,237965,10/6/2020
8/15/2020,105,29750,4533,412690,442440,8,2420,11,2010,1,323,87,11,5,0,1040,89,20578,1694,219170,239748,10/6/2020
8/16/2020,83,29833,2785,415475,445308,7,2427,6,2016,4,327,84,8,4,6,1046,70,20648,980,220150,240798,10/6/2020
8/17/2020,106,29939,4570,420045,449984,10,2437,7,2023,0,327,87,8,5,2,1048,88,20736,2399,222549,243285,10/6/2020
8/18/2020,128,30067,5049,425094,455161,11,2448,9,2032,1,328,88,8,4,5,1053,95,20831,2770,225319,246150,10/6/2020
8/19/2020,114,30181,5407,430501,460682,8,2456,9,2041,1,329,86,9,5,0,1053,89,20920,2662,227981,248901,10/6/2020
8/20/2020,174,30355,8220,438721,469076,12,2468,6,2047,2,331,90,10,5,3,1056,139,21059,3558,231539,252598,10/6/2020
8/21/2020,154,30509,6816,445537,476046,8,2476,5,2052,1,332,92,9,4,2,1058,126,21185,2965,234504,255689,10/6/2020
8/22/2020,96,30605,5957,451494,482099,10,2486,12,2064,0,332,90,11,4,1,1059,84,21269,2627,237131,258400,10/6/2020
8/23/2020,70,30675,4365,455859,486534,11,2497,6,2070,0,332,95,11,2,1,1060,56,21325,2476,239607,260932,10/6/2020
8/24/2020,105,30780,5776,461635,492415,7,2504,10,2080,1,333,91,13,4,1,1061,77,21402,3161,242768,264170,10/6/2020
8/25/2020,108,30888,4796,466431,497319,10,2514,4,2084,1,334,96,11,4,1,1062,92,21494,2302,245070,266564,10/6/2020
8/26/2020,170,31058,9604,476035,507093,4,2518,8,2092,0,334,92,9,5,1,1063,127,21621,3086,248156,269777,10/6/2020
8/27/2020,94,31152,8848,484883,516035,6,2524,13,2105,1,335,84,6,5,2,1065,71,21692,3218,251374,273066,10/6/2020
8/28/2020,112,31264,8106,492989,524253,14,2538,4,2109,0,335,94,9,7,2,1067,88,21780,2440,253814,275594,10/6/2020
8/29/2020,65,31329,5516,498505,529834,6,2544,8,2117,1,336,91,10,6,2,1069,51,21831,1910,255724,277555,10/6/2020
8/30/2020,66,31395,4319,502824,534219,7,2551,4,2121,0,336,94,8,5,2,1071,48,21879,1997,257721,279600,10/6/2020
8/31/2020,105,31500,4864,507688,539188,12,2563,15,2136,0,336,91,8,4,1,1072,80,21959,2189,259910,281869,10/6/2020
9/1/2020,98,31598,7199,514887,546485,6,2569,9,2145,1,337,87,7,4,2,1074,65,22024,2381,262291,284315,10/6/2020
9/2/2020,125,31723,10750,525637,557360,9,2578,10,2155,1,338,85,8,4,2,1076,104,22128,3068,265359,287487,10/6/2020
9/3/2020,90,31813,11373,537010,568823,8,2586,8,2163,0,338,85,9,4,3,1079,73,22201,2598,267957,290158,10/6/2020
9/4/2020,102,31915,9187,546197,578112,11,2597,4,2167,0,338,92,9,4,1,1080,82,22283,2399,270356,292639,10/6/2020
9/5/2020,52,31967,6356,552553,584520,6,2603,9,2176,0,338,89,8,3,1,1081,42,22325,1603,271959,294284,10/6/2020
9/6/2020,87,32054,4317,556870,588924,4,2607,8,2184,1,339,84,6,3,1,1082,64,22389,1959,273918,296307,10/6/2020
9/7/2020,35,32089,3000,559870,591959,11,2618,3,2187,0,339,92,5,3,1,1083,26,22415,647,274565,296980,10/6/2020
9/8/2020,74,32163,6407,566277,598440,6,2624,12,2199,1,340,85,6,3,2,1085,66,22481,1607,276172,298653,10/6/2020
9/9/2020,118,32281,8866,575143,607424,9,2633,5,2204,1,341,88,9,3,1,1086,101,22582,2166,278338,300920,10/6/2020
9/10/2020,167,32448,11791,586934,619382,9,2642,8,2212,0,341,89,10,3,0,1086,112,22694,2282,280620,303314,10/6/2020
9/11/2020,124,32572,9501,596435,629007,11,2653,11,2223,0,341,89,10,5,0,1086,98,22792,1984,282604,305396,10/6/2020
9/12/2020,109,32681,6188,602623,635304,8,2661,5,2228,2,343,90,9,5,3,1089,97,22889,1503,284107,306996,10/6/2020
9/13/2020,58,32739,2707,605330,638069,4,2665,3,2231,0,343,91,10,5,0,1089,53,22942,859,284966,307908,10/6/2020
9/14/2020,104,32843,6426,611756,644599,5,2670,3,2234,2,345,91,10,5,1,1090,95,23037,1710,286676,309713,10/6/2020
9/15/2020,122,32965,8554,620310,653275,6,2676,2,2236,1,346,94,10,5,2,1092,124,23161,2198,288874,312035,10/6/2020
9/16/2020,137,33102,9880,630190,663292,7,2683,7,2243,2,348,92,8,6,5,1097,118,23279,1975,290849,314128,10/6/2020
9/17/2020,124,33226,9581,639771,672997,7,2690,14,2257,0,348,85,8,4,0,1097,154,23433,1962,292811,316244,10/6/2020
9/18/2020,132,33358,10263,650034,683392,7,2697,7,2264,1,349,84,11,6,2,1099,132,23565,1954,294765,318330,10/6/2020
9/19/2020,116,33474,8393,658427,691901,7,2704,3,2267,0,349,88,10,6,4,1103,113,23678,1710,296475,320153,10/6/2020
9/20/2020,60,33534,3668,662095,695629,7,2711,6,2273,2,351,87,10,8,4,1107,48,23726,1343,297818,321544,10/6/2020
9/21/2020,103,33637,7006,669101,702738,12,2723,3,2276,2,353,94,9,6,2,1109,93,23819,2416,300234,324053,10/6/2020
9/22/2020,154,33791,9405,678506,712297,12,2735,3,2279,1,354,102,8,5,1,1110,125,23944,2229,302463,326407,10/6/2020
9/23/2020,136,33927,10946,689452,723379,11,2746,7,2286,0,354,106,7,5,0,1110,127,24071,2229,304692,328763,10/6/2020
9/24/2020,106,34033,11510,700962,734995,7,2753,9,2295,1,355,103,8,6,1,1111,108,24179,2086,306778,330957,10/6/2020
9/25/2020,136,34169,10192,711154,745323,9,2762,10,2305,0,355,102,7,6,1,1112,129,24308,2398,309176,333484,10/6/2020
9/26/2020,148,34317,10126,721280,755597,12,2774,9,2314,0,355,105,7,6,1,1113,115,24423,2004,311180,335603,10/6/2020
9/27/2020,42,34359,2575,723855,758214,7,2781,5,2319,0,355,107,10,6,0,1113,31,24454,806,311986,336440,10/6/2020
9/28/2020,152,34511,6939,730794,765305,6,2787,6,2325,2,357,105,8,6,2,1115,130,24584,2139,314125,338709,10/6/2020
9/29/2020,204,34715,10137,740931,775646,11,2798,18,2343,1,358,97,7,7,1,1116,184,24768,2355,316480,341248,10/6/2020
9/30/2020,213,34928,11399,752330,787258,6,2804,6,2349,0,358,97,7,7,1,1117,177,24945,2359,318839,343784,10/6/2020
10/1/2020,175,35103,11358,763688,798791,16,2820,13,2362,1,359,99,6,5,1,1118,149,25094,2245,321084,346178,10/6/2020
10/2/2020,199,35302,11051,774739,810041,11,2831,13,2375,1,360,96,7,4,1,1119,170,25264,2292,323376,348640,10/6/2020
10/3/2020,148,35450,8695,783434,818884,9,2840,9,2384,2,362,94,8,4,2,1121,134,25398,1849,325225,350623,10/6/2020
10/4/2020,66,35516,1896,785330,820846,9,2849,9,2393,1,363,93,8,4,2,1123,53,25451,816,326041,351492,10/6/2020
10/5/2020,149,35665,7019,792349,828014,,,,,,,,,,2,1125,145,25596,2444,328485,354081,10/6/2020
2/27/2020,0,0,0,0,0,1,1,0,0,0,0,1,0,0,0,0,0,0,0,0,0,10/7/2020
2/28/2020,0,0,0,0,0,0,1,0,0,0,0,1,1,0,0,0,0,0,0,0,0,10/7/2020
2/29/2020,0,0,0,0,0,0,1,0,0,0,0,1,1,0,0,0,0,0,0,0,0,10/7/2020
3/1/2020,2,2,2,2,4,0,1,0,0,0,0,1,1,1,0,0,2,2,2,2,4,10/7/2020
3/2/2020,0,2,1,3,5,1,2,0,0,0,0,2,2,2,0,0,0,2,1,3,5,10/7/2020
3/3/2020,0,2,2,5,7,0,2,0,0,0,0,2,2,2,0,0,0,2,2,5,7,10/7/2020
3/4/2020,0,2,12,17,19,1,3,0,0,0,0,3,2,2,0,0,0,2,10,15,17,10/7/2020
3/5/2020,0,2,4,21,23,0,3,0,0,0,0,3,2,2,0,0,1,3,4,19,22,10/7/2020
3/6/2020,1,3,12,33,36,0,3,0,0,0,0,3,2,2,0,0,0,3,11,30,33,10/7/2020
3/7/2020,0,3,19,52,55,0,3,0,0,0,0,3,2,1,0,0,0,3,19,49,52,10/7/2020
3/8/2020,0,3,18,70,73,0,3,0,0,0,0,3,2,1,0,0,0,3,18,67,70,10/7/2020
3/9/2020,1,4,15,85,89,0,3,0,0,0,0,3,2,1,0,0,1,4,15,82,86,10/7/2020
3/10/2020,2,6,25,110,116,0,3,0,0,0,0,3,2,1,0,0,1,5,23,105,110,10/7/2020
3/11/2020,0,6,34,144,150,1,4,0,0,0,0,4,1,1,0,0,0,5,34,139,144,10/7/2020
3/12/2020,9,15,41,185,200,1,5,0,0,0,0,5,1,1,0,0,8,13,38,177,190,10/7/2020
3/13/2020,6,21,50,235,256,4,9,1,1,0,0,8,1,1,0,0,6,19,48,225,244,10/7/2020
3/14/2020,0,21,90,325,346,0,9,0,1,0,0,8,1,1,0,0,0,19,86,311,330,10/7/2020
3/15/2020,1,22,54,379,401,1,10,0,1,0,0,9,2,1,0,0,1,20,54,365,385,10/7/2020
3/16/2020,2,24,95,474,498,2,12,0,1,0,0,11,2,0,0,0,2,22,92,457,479,10/7/2020
3/17/2020,12,36,162,636,672,6,18,0,1,0,0,17,2,0,0,0,11,33,151,608,641,10/7/2020
3/18/2020,9,45,116,752,797,3,21,0,1,0,0,20,2,0,0,0,11,44,110,718,762,10/7/2020
3/19/2020,15,60,262,1014,1074,2,23,1,2,0,0,21,3,0,1,1,17,61,251,969,1030,10/7/2020
3/20/2020,13,73,197,1211,1284,5,28,0,2,0,0,26,4,0,0,1,13,74,190,1159,1233,10/7/2020
3/21/2020,12,85,126,1337,1422,3,31,2,4,0,0,27,5,0,0,1,14,88,123,1282,1370,10/7/2020
3/22/2020,27,112,282,1619,1731,2,33,0,4,0,0,29,5,0,0,1,25,113,261,1543,1656,10/7/2020
3/23/2020,14,126,169,1788,1914,15,48,1,5,0,0,43,9,3,0,1,16,129,165,1708,1837,10/7/2020
3/24/2020,20,146,242,2030,2176,7,55,0,5,0,0,50,10,4,0,1,19,148,237,1945,2093,10/7/2020
3/25/2020,26,172,182,2212,2384,5,60,1,6,0,0,54,11,3,0,1,28,176,171,2116,2292,10/7/2020
3/26/2020,35,207,181,2393,2600,10,70,5,11,0,0,59,14,5,0,1,41,217,174,2290,2507,10/7/2020
3/27/2020,27,234,214,2607,2841,9,79,1,12,1,1,66,17,6,2,3,31,248,200,2490,2738,10/7/2020
3/28/2020,59,293,260,2867,3160,13,92,3,15,2,3,74,15,6,1,4,64,312,241,2731,3043,10/7/2020
3/29/2020,100,393,350,3217,3610,8,100,4,19,1,4,77,18,8,2,6,105,417,313,3044,3461,10/7/2020
3/30/2020,62,455,222,3439,3894,20,120,5,24,0,4,92,20,11,3,9,78,495,184,3228,3723,10/7/2020
3/31/2020,71,526,369,3808,4334,11,131,7,31,1,5,95,22,13,2,11,73,568,296,3524,4092,10/7/2020
4/1/2020,99,625,698,4506,5131,18,149,7,38,0,5,106,30,15,1,12,100,668,640,4164,4832,10/7/2020
4/2/2020,52,677,477,4983,5660,22,171,6,44,2,7,120,36,21,4,16,62,730,436,4600,5330,10/7/2020
4/3/2020,108,785,774,5757,6542,23,194,7,51,0,7,136,43,25,3,19,100,830,710,5310,6140,10/7/2020
4/4/2020,143,928,660,6417,7345,22,216,4,55,5,12,149,41,30,9,28,138,968,617,5927,6895,10/7/2020
4/5/2020,187,1115,1156,7573,8688,20,236,9,64,1,13,159,44,36,2,30,181,1149,1064,6991,8140,10/7/2020
4/6/2020,218,1333,1706,9279,10612,26,262,7,71,0,13,178,48,40,7,37,208,1357,1547,8538,9895,10/7/2020
4/7/2020,284,1617,1629,10908,12525,20,282,4,75,2,15,192,50,42,5,42,261,1618,1477,10015,11633,10/7/2020
4/8/2020,290,1907,1720,12628,14535,19,301,7,82,6,21,198,50,38,10,52,271,1889,1558,11573,13462,10/7/2020
4/9/2020,283,2190,1516,14144,16334,32,333,9,91,4,25,217,53,40,7,59,277,2166,1354,12927,15093,10/7/2020
4/10/2020,419,2609,2574,16718,19327,29,362,17,108,5,30,224,59,41,11,70,401,2567,2368,15295,17862,10/7/2020
4/11/2020,297,2906,1905,18623,21529,29,391,11,119,2,32,240,61,48,12,82,280,2847,1714,17009,19856,10/7/2020
4/12/2020,314,3220,1670,20293,23513,35,426,13,132,5,37,257,59,49,9,91,284,3131,1432,18441,21572,10/7/2020
4/13/2020,161,3381,935,21228,24609,35,461,13,145,3,40,276,64,54,9,100,187,3318,837,19278,22596,10/7/2020
4/14/2020,289,3670,1787,23015,26685,27,488,17,162,5,45,281,72,53,8,108,262,3580,1528,20806,24386,10/7/2020
4/15/2020,351,4021,1799,24814,28835,31,519,20,182,3,48,289,72,54,17,125,306,3886,1549,22355,26241,10/7/2020
4/16/2020,447,4468,2494,27308,31776,36,555,25,207,6,54,294,72,53,14,139,387,4273,2070,24425,28698,10/7/2020
4/17/2020,304,4772,1821,29129,33901,32,587,20,227,7,61,299,66,45,21,160,290,4563,1444,25869,30432,10/7/2020
4/18/2020,321,5093,1725,30854,35947,26,613,18,245,4,65,303,63,49,15,175,284,4847,1323,27192,32039,10/7/2020
4/19/2020,381,5474,2047,32901,38375,23,636,26,271,1,66,299,65,55,11,186,336,5183,1738,28930,34113,10/7/2020
4/20/2020,394,5868,1907,34808,40676,46,682,29,300,2,68,314,75,56,10,196,376,5559,1566,30496,36055,10/7/2020
4/21/2020,444,6312,2110,36918,43230,45,727,33,333,5,73,321,72,56,18,214,384,5943,1700,32196,38139,10/7/2020
4/22/2020,418,6730,2390,39308,46038,41,768,32,365,5,78,325,73,58,18,232,379,6322,1913,34109,40431,10/7/2020
4/23/2020,479,7209,2469,41777,48986,32,800,28,393,5,83,324,76,62,15,247,412,6734,1852,35961,42695,10/7/2020
4/24/2020,491,7700,3284,45061,52761,35,835,26,419,4,87,329,85,63,15,262,407,7141,2622,38583,45724,10/7/2020
4/25/2020,393,8093,2206,47267,55360,34,869,17,436,5,92,341,85,62,14,276,300,7441,1762,40345,47786,10/7/2020
4/26/2020,316,8409,2309,49576,57985,33,902,15,451,3,95,356,86,59,14,290,274,7715,1875,42220,49935,10/7/2020
4/27/2020,249,8658,1620,51196,59854,29,931,21,472,4,99,360,86,61,10,300,206,7921,1161,43381,51302,10/7/2020
4/28/2020,410,9068,2263,53459,62527,44,975,24,496,3,102,377,88,59,22,322,331,8252,1760,45141,53393,10/7/2020
4/29/2020,476,9544,3343,56802,66346,36,1011,38,534,11,113,364,78,53,18,340,371,8623,2420,47561,56184,10/7/2020
4/30/2020,432,9976,2769,59571,69547,33,1044,38,572,6,119,353,83,57,24,364,350,8973,1915,49476,58449,10/7/2020
5/1/2020,454,10430,3086,62657,73087,51,1095,39,611,3,122,362,84,58,14,378,325,9298,2167,51643,60941,10/7/2020
5/2/2020,257,10687,1926,64583,75270,36,1131,38,649,5,127,355,91,62,24,402,192,9490,1274,52917,62407,10/7/2020
5/3/2020,283,10970,2160,66743,77713,31,1162,27,676,8,135,351,90,61,21,423,183,9673,1576,54493,64166,10/7/2020
5/4/2020,387,11357,2098,68841,80198,30,1192,31,707,5,140,345,88,57,18,441,290,9963,1560,56053,66016,10/7/2020
5/5/2020,433,11790,2873,71714,83504,29,1221,32,739,6,146,336,82,54,16,457,300,10263,1956,58009,68272,10/7/2020
5/6/2020,488,12278,2830,74544,86822,28,1249,44,783,9,155,311,79,54,21,478,340,10603,1916,59925,70528,10/7/2020
5/7/2020,425,12703,2969,77513,90216,36,1285,41,824,5,160,301,71,52,21,499,270,10873,1960,61885,72758,10/7/2020
5/8/2020,359,13062,2598,80111,93173,30,1315,29,853,5,165,297,71,53,22,521,230,11103,1737,63622,74725,10/7/2020
5/9/2020,467,13529,3346,83457,96986,22,1337,21,874,4,169,294,69,51,15,536,290,11393,2256,65878,77271,10/7/2020
5/10/2020,285,13814,2117,85574,99388,20,1357,23,897,6,175,285,70,49,13,549,189,11582,1522,67400,78982,10/7/2020
5/11/2020,257,14071,1857,87431,101502,31,1388,16,913,6,181,294,71,49,15,564,174,11756,1301,68701,80457,10/7/2020
5/12/2020,387,14458,2611,90042,104500,23,1411,18,931,4,185,295,69,48,22,586,224,11980,1701,70402,82382,10/7/2020
5/13/2020,351,14809,3630,93672,108481,23,1434,25,956,1,186,292,69,49,13,599,199,12179,2001,72403,84582,10/7/2020
5/14/2020,329,15138,3408,97080,112218,19,1453,27,983,3,189,281,64,45,15,614,230,12409,2013,74416,86825,10/7/2020
5/15/2020,381,15519,3458,100538,116057,24,1477,41,1024,5,194,259,62,45,14,628,232,12641,1804,76220,88861,10/7/2020
5/16/2020,449,15968,4156,104694,120662,25,1502,13,1037,5,199,266,61,46,15,643,247,12888,1961,78181,91069,10/7/2020
5/17/2020,240,16208,2768,107462,123670,17,1519,8,1045,5,204,270,59,45,10,653,126,13014,1555,79736,92750,10/7/2020
5/18/2020,250,16458,2001,109463,125921,19,1538,15,1060,5,209,269,57,40,18,671,135,13149,1368,81104,94253,10/7/2020
5/19/2020,415,16873,3168,112631,129504,23,1561,32,1092,5,214,255,56,38,11,682,215,13364,1926,83030,96394,10/7/2020
5/20/2020,326,17199,2771,115402,132601,19,1580,23,1115,7,221,244,52,33,22,704,183,13547,1514,84544,98091,10/7/2020
5/21/2020,374,17573,3757,119159,136732,26,1606,15,1130,3,224,252,53,29,20,724,168,13715,1936,86480,100195,10/7/2020
5/22/2020,351,17924,3161,122320,140244,20,1626,29,1159,5,229,238,52,29,10,734,206,13921,1608,88088,102009,10/7/2020
5/23/2020,253,18177,2742,125062,143239,19,1645,11,1170,3,232,243,52,32,13,747,109,14030,1271,89359,103389,10/7/2020
5/24/2020,163,18340,1370,126432,144772,12,1657,14,1184,2,234,239,53,36,8,755,82,14112,773,90132,104244,10/7/2020
5/25/2020,147,18487,1385,127817,146304,14,1671,14,1198,0,234,239,53,34,10,765,76,14188,762,90894,105082,10/7/2020
5/26/2020,285,18772,2620,130437,149209,24,1695,22,1220,5,239,236,48,33,15,780,157,14345,1780,92674,107019,10/7/2020
5/27/2020,276,19048,2057,132494,151542,20,1715,18,1238,3,242,235,50,33,10,790,132,14477,1133,93807,108284,10/7/2020
5/28/2020,348,19396,3359,135853,155249,17,1732,29,1267,4,246,219,47,32,8,798,130,14607,1117,94924,109531,10/7/2020
5/29/2020,410,19806,3914,139767,159573,19,1751,27,1294,6,252,205,43,31,12,810,173,14780,1570,96494,111274,10/7/2020
5/30/2020,225,20031,3915,143682,163713,15,1766,19,1313,4,256,197,40,29,12,822,109,14889,1818,98312,113201,10/7/2020
5/31/2020,155,20186,1688,145370,165556,11,1777,10,1323,1,257,197,43,26,3,825,78,14967,855,99167,114134,10/7/2020
6/1/2020,212,20398,2792,148162,168560,8,1785,14,1337,1,258,190,44,29,5,830,93,15060,1383,100550,115610,10/7/2020
6/2/2020,273,20671,3022,151184,171855,8,1793,9,1346,3,261,186,37,25,10,840,98,15158,1448,101998,117156,10/7/2020
6/3/2020,254,20925,3486,154670,175595,14,1807,18,1364,6,267,176,34,25,11,851,99,15257,1658,103656,118913,10/7/2020
6/4/2020,276,21201,4471,159141,180342,7,1814,25,1389,3,270,155,31,24,11,862,107,15364,2035,105691,121055,10/7/2020
6/5/2020,215,21416,3513,162654,184070,15,1829,13,1402,6,276,151,27,21,11,873,99,15463,1574,107265,122728,10/7/2020
6/6/2020,201,21617,2616,165270,186887,10,1839,7,1409,2,278,152,29,19,6,879,67,15530,1136,108401,123931,10/7/2020
6/7/2020,83,21700,1625,166895,188595,11,1850,7,1416,1,279,155,25,17,4,883,51,15581,782,109183,124764,10/7/2020
6/8/2020,119,21819,1849,168744,190563,15,1865,12,1428,2,281,156,27,18,4,887,45,15626,959,110142,125768,10/7/2020
6/9/2020,223,22042,2673,171417,193459,10,1875,18,1446,0,281,148,28,21,1,888,64,15690,1257,111399,127089,10/7/2020
6/10/2020,209,22251,2987,174404,196655,13,1888,12,1458,2,283,147,24,17,4,892,101,15791,1464,112863,128654,10/7/2020
6/11/2020,195,22446,3513,177917,200363,7,1895,15,1473,1,284,138,25,16,6,898,88,15879,1534,114397,130276,10/7/2020
6/12/2020,209,22655,4601,182518,205173,9,1904,15,1488,1,285,131,24,16,2,900,78,15957,2178,116575,132532,10/7/2020
6/13/2020,113,22768,3036,185554,208322,6,1910,4,1492,0,285,133,20,15,3,903,49,16006,1373,117948,133954,10/7/2020
6/14/2020,81,22849,2046,187600,210449,7,1917,8,1500,1,286,131,20,14,3,906,33,16039,968,118916,134955,10/7/2020
6/15/2020,188,23037,3108,190708,213745,14,1931,14,1514,0,286,131,20,16,5,911,75,16114,1790,120706,136820,10/7/2020
6/16/2020,110,23147,3017,193725,216872,11,1942,9,1523,1,287,132,22,16,8,919,50,16164,1576,122282,138446,10/7/2020
6/17/2020,127,23274,2835,196560,219834,15,1957,20,1543,4,291,123,18,14,6,925,50,16214,1318,123600,139814,10/7/2020
6/18/2020,149,23423,3047,199607,223030,9,1966,13,1556,1,292,118,19,16,7,932,70,16284,1312,124912,141196,10/7/2020
6/19/2020,141,23564,3769,203376,226940,12,1978,11,1567,1,293,118,20,17,3,935,59,16343,1370,126282,142625,10/7/2020
6/20/2020,84,23648,1891,205267,228915,9,1987,12,1579,0,293,115,20,18,4,939,36,16379,812,127094,143473,10/7/2020
6/21/2020,37,23685,1064,206331,230016,8,1995,5,1584,0,293,118,20,18,2,941,29,16408,692,127786,144194,10/7/2020
6/22/2020,138,23823,3730,210061,233884,12,2007,16,1600,0,293,114,19,18,2,943,65,16473,1705,129491,145964,10/7/2020
6/23/2020,163,23986,3831,213892,237878,3,2010,13,1613,3,296,101,18,18,7,950,81,16554,1780,131271,147825,10/7/2020
6/24/2020,120,24106,3502,217394,241500,9,2019,10,1623,1,297,99,18,18,5,955,44,16598,1685,132956,149554,10/7/2020
6/25/2020,103,24209,2883,220277,244486,6,2025,14,1637,1,298,90,17,17,1,956,50,16648,1512,134468,151116,10/7/2020
6/26/2020,94,24303,2488,222765,247068,2,2027,10,1647,0,298,82,18,18,1,957,60,16708,1331,135799,152507,10/7/2020
6/27/2020,84,24387,3214,225979,250366,5,2032,3,1650,1,299,83,17,17,5,962,37,16745,1218,137017,153762,10/7/2020
6/28/2020,39,24426,1469,227448,251874,4,2036,4,1654,4,303,79,15,14,6,968,17,16762,595,137612,154374,10/7/2020
6/29/2020,85,24511,3697,231145,255656,4,2040,5,1659,0,303,78,14,14,1,969,39,16801,1352,138964,155765,10/7/2020
6/30/2020,57,24568,1957,233102,257670,1,2041,5,1664,1,304,73,12,11,4,973,33,16834,995,139959,156793,10/7/2020
7/1/2020,144,24712,4098,237200,261912,7,2048,9,1673,0,304,71,11,11,1,974,78,16912,1933,141892,158804,10/7/2020
7/2/2020,103,24815,2803,240003,264818,5,2053,5,1678,1,305,70,10,10,3,977,59,16971,1088,142980,159951,10/7/2020
7/3/2020,50,24865,2076,242079,266944,9,2062,6,1684,0,305,73,9,9,3,980,25,16996,778,143758,160754,10/7/2020
7/4/2020,57,24922,2345,244424,269346,2,2064,4,1688,1,306,70,10,9,2,982,33,17029,1011,144769,161798,10/7/2020
7/5/2020,49,24971,2932,247356,272327,1,2065,2,1690,1,307,68,8,8,2,984,26,17055,1443,146212,163267,10/7/2020
7/6/2020,101,25072,2811,250167,275239,6,2071,6,1696,0,307,68,9,9,4,988,57,17112,1551,147763,164875,10/7/2020
7/7/2020,81,25153,3457,253624,278777,5,2076,7,1703,0,307,66,8,8,2,990,47,17159,1535,149298,166457,10/7/2020
7/8/2020,105,25258,3403,257027,282285,4,2080,2,1705,0,307,68,9,8,0,990,64,17223,1423,150721,167944,10/7/2020
7/9/2020,94,25352,3712,260739,286091,9,2089,3,1708,0,307,74,9,8,0,990,50,17273,1626,152347,169620,10/7/2020
7/10/2020,131,25483,4431,265170,290653,6,2095,3,1711,2,309,75,7,7,3,993,80,17353,2076,154423,171776,10/7/2020
7/11/2020,63,25546,2932,268102,293648,6,2101,3,1714,1,310,77,6,6,3,996,36,17389,1316,155739,173128,10/7/2020
7/12/2020,47,25593,1836,269938,295531,1,2102,3,1717,1,311,74,6,5,3,999,34,17423,943,156682,174105,10/7/2020
7/13/2020,84,25677,3201,273139,298816,8,2110,10,1727,0,311,72,6,5,1,1000,61,17484,1504,158186,175670,10/7/2020
7/14/2020,73,25750,3291,276430,302180,7,2117,4,1731,0,311,75,5,5,1,1001,43,17527,1375,159561,177088,10/7/2020
7/15/2020,130,25880,4172,280602,306482,5,2122,7,1738,0,311,73,5,4,0,1001,99,17626,1751,161312,178938,10/7/2020
7/16/2020,102,25982,3733,284335,310317,6,2128,9,1747,0,311,70,6,5,1,1002,75,17701,1619,162931,180632,10/7/2020
7/17/2020,156,26138,4236,288571,314709,14,2142,3,1750,1,312,80,5,5,2,1004,79,17780,1845,164776,182556,10/7/2020
7/18/2020,85,26223,3267,291838,318061,5,2147,9,1759,1,313,75,5,4,4,1008,70,17850,1399,166175,184025,10/7/2020
7/19/2020,82,26305,2693,294531,320836,7,2154,3,1762,0,313,79,6,4,2,1010,57,17907,1149,167324,185231,10/7/2020
7/20/2020,71,26376,2664,297195,323571,9,2163,7,1769,0,313,81,7,5,2,1012,68,17975,1463,168787,186762,10/7/2020
7/21/2020,130,26506,4298,301493,327999,9,2172,11,1780,0,313,79,9,6,1,1013,109,18084,1918,170705,188789,10/7/2020
7/22/2020,130,26636,3926,305419,332055,11,2183,11,1791,1,314,78,7,6,1,1014,86,18170,1683,172388,190558,10/7/2020
7/23/2020,141,26777,4412,309831,336608,8,2191,6,1797,0,314,80,8,7,0,1014,115,18285,1989,174377,192662,10/7/2020
7/24/2020,172,26949,5959,315790,342739,14,2205,14,1811,0,314,80,9,7,0,1014,119,18404,2321,176698,195102,10/7/2020
7/25/2020,134,27083,4398,320188,347271,7,2212,7,1818,0,314,80,10,8,2,1016,108,18512,2099,178797,197309,10/7/2020
7/26/2020,62,27145,3027,323215,350360,8,2220,9,1827,0,314,79,11,7,1,1017,54,18566,1335,180132,198698,10/7/2020
7/27/2020,188,27333,4190,327405,354738,12,2232,7,1834,0,314,84,13,8,1,1018,138,18704,2350,182482,201186,10/7/2020
7/28/2020,105,27438,3834,331239,358677,5,2237,5,1839,0,314,84,14,7,1,1019,94,18798,1635,184117,202915,10/7/2020
7/29/2020,191,27629,5137,336376,364005,11,2248,12,1851,0,314,83,15,7,0,1019,154,18952,2324,186441,205393,10/7/2020
7/30/2020,121,27750,4344,340720,368470,6,2254,2,1853,1,315,86,15,6,1,1020,97,19049,1650,188091,207140,10/7/2020
7/31/2020,131,27881,5508,346228,374109,8,2262,10,1863,0,315,84,15,7,1,1021,89,19138,1854,189945,209083,10/7/2020
8/1/2020,108,27989,4288,350516,378505,7,2269,2,1865,0,315,89,14,7,1,1022,88,19226,1559,191504,210730,10/7/2020
8/2/2020,84,28073,2802,353318,381391,12,2281,12,1877,2,317,87,14,8,2,1024,62,19288,1274,192778,212066,10/7/2020
8/3/2020,187,28260,5238,358556,386816,13,2294,12,1889,0,317,88,16,7,1,1025,150,19438,2202,194980,214418,10/7/2020
8/4/2020,126,28386,3691,362247,390633,8,2302,6,1895,1,318,89,12,5,2,1027,99,19537,1771,196751,216288,10/7/2020
8/5/2020,148,28534,5932,368179,396713,12,2314,10,1905,1,319,90,10,5,2,1029,118,19655,2471,199222,218877,10/7/2020
8/6/2020,169,28703,5533,373712,402415,7,2321,9,1914,0,319,88,9,4,0,1029,121,19776,2408,201630,221406,10/7/2020
8/7/2020,122,28825,4845,378557,407382,13,2334,10,1924,1,320,90,9,3,2,1031,87,19863,2146,203776,223639,10/7/2020
8/8/2020,123,28948,4106,382663,411611,19,2353,6,1930,1,321,102,8,3,1,1032,92,19955,1779,205555,225510,10/7/2020
8/9/2020,42,28990,1722,384385,413375,8,2361,10,1940,0,321,100,9,4,0,1032,35,19990,1075,206630,226620,10/7/2020
8/10/2020,149,29139,4580,388965,418104,11,2372,12,1952,0,321,99,9,4,1,1033,113,20103,2028,208658,228761,10/7/2020
8/11/2020,105,29244,4325,393290,422534,6,2378,14,1966,0,321,91,10,4,3,1036,92,20195,2266,210924,231119,10/7/2020
8/12/2020,121,29365,5184,398474,427839,8,2386,11,1977,0,321,88,9,3,1,1037,101,20296,2630,213554,233850,10/7/2020
8/13/2020,135,29500,4191,402665,432165,13,2399,12,1989,0,321,89,11,3,0,1037,95,20391,1905,215459,235850,10/7/2020
8/14/2020,145,29645,5492,408157,437802,13,2412,11,2000,0,321,91,11,4,3,1040,99,20490,1976,217435,237925,10/7/2020
8/15/2020,105,29750,4533,412690,442440,8,2420,11,2011,1,322,87,11,5,0,1040,89,20579,1693,219128,239707,10/7/2020
8/16/2020,83,29833,2785,415475,445308,7,2427,6,2017,4,326,84,8,4,6,1046,70,20649,980,220108,240757,10/7/2020
8/17/2020,106,29939,4570,420045,449984,10,2437,7,2024,0,326,87,8,5,2,1048,88,20737,2399,222507,243244,10/7/2020
8/18/2020,128,30067,5049,425094,455161,11,2448,9,2033,1,327,88,8,4,5,1053,95,20832,2770,225277,246109,10/7/2020
8/19/2020,114,30181,5407,430501,460682,8,2456,9,2042,1,328,86,9,5,0,1053,89,20921,2662,227939,248860,10/7/2020
8/20/2020,174,30355,8220,438721,469076,12,2468,6,2048,2,330,90,10,5,3,1056,139,21060,3557,231496,252556,10/7/2020
8/21/2020,154,30509,6816,445537,476046,8,2476,5,2053,1,331,92,9,4,2,1058,126,21186,2965,234461,255647,10/7/2020
8/22/2020,96,30605,5957,451494,482099,10,2486,12,2065,0,331,90,11,4,1,1059,84,21270,2626,237087,258357,10/7/2020
8/23/2020,70,30675,4365,455859,486534,11,2497,6,2071,0,331,95,11,2,1,1060,56,21326,2475,239562,260888,10/7/2020
8/24/2020,105,30780,5776,461635,492415,7,2504,10,2081,1,332,91,13,4,1,1061,77,21403,3161,242723,264126,10/7/2020
8/25/2020,108,30888,4796,466431,497319,10,2514,4,2085,1,333,96,11,4,1,1062,92,21495,2301,245024,266519,10/7/2020
8/26/2020,170,31058,9604,476035,507093,4,2518,8,2093,0,333,92,9,5,1,1063,127,21622,3086,248110,269732,10/7/2020
8/27/2020,94,31152,8848,484883,516035,6,2524,13,2106,1,334,84,6,5,2,1065,71,21693,3218,251328,273021,10/7/2020
8/28/2020,112,31264,8106,492989,524253,14,2538,4,2110,0,334,94,9,7,2,1067,88,21781,2440,253768,275549,10/7/2020
8/29/2020,65,31329,5516,498505,529834,6,2544,8,2118,1,335,91,10,6,2,1069,51,21832,1910,255678,277510,10/7/2020
8/30/2020,66,31395,4319,502824,534219,7,2551,4,2122,0,335,94,8,5,2,1071,48,21880,1997,257675,279555,10/7/2020
8/31/2020,105,31500,4864,507688,539188,12,2563,15,2137,0,335,91,8,4,1,1072,80,21960,2189,259864,281824,10/7/2020
9/1/2020,98,31598,7199,514887,546485,6,2569,9,2146,1,336,87,7,4,2,1074,65,22025,2380,262244,284269,10/7/2020
9/2/2020,125,31723,10750,525637,557360,9,2578,10,2156,1,337,85,8,4,2,1076,104,22129,3068,265312,287441,10/7/2020
9/3/2020,90,31813,11373,537010,568823,8,2586,8,2164,0,337,85,9,4,3,1079,73,22202,2598,267910,290112,10/7/2020
9/4/2020,102,31915,9187,546197,578112,11,2597,4,2168,0,337,92,9,4,1,1080,82,22284,2399,270309,292593,10/7/2020
9/5/2020,52,31967,6356,552553,584520,6,2603,9,2177,0,337,89,8,3,1,1081,42,22326,1603,271912,294238,10/7/2020
9/6/2020,87,32054,4317,556870,588924,4,2607,8,2185,1,338,84,6,3,1,1082,64,22390,1959,273871,296261,10/7/2020
9/7/2020,35,32089,3000,559870,591959,11,2618,3,2188,0,338,92,5,3,1,1083,26,22416,647,274518,296934,10/7/2020
9/8/2020,74,32163,6407,566277,598440,6,2624,12,2200,1,339,85,6,3,2,1085,66,22482,1607,276125,298607,10/7/2020
9/9/2020,118,32281,8866,575143,607424,9,2633,5,2205,1,340,88,9,3,1,1086,101,22583,2165,278290,300873,10/7/2020
9/10/2020,167,32448,11791,586934,619382,9,2642,8,2213,0,340,89,10,3,0,1086,112,22695,2282,280572,303267,10/7/2020
9/11/2020,124,32572,9501,596435,629007,11,2653,11,2224,0,340,89,10,5,0,1086,98,22793,1982,282554,305347,10/7/2020
9/12/2020,109,32681,6188,602623,635304,8,2661,5,2229,2,342,90,9,5,3,1089,97,22890,1503,284057,306947,10/7/2020
9/13/2020,58,32739,2707,605330,638069,4,2665,3,2232,0,342,91,10,5,0,1089,53,22943,859,284916,307859,10/7/2020
9/14/2020,104,32843,6426,611756,644599,5,2670,3,2235,2,344,91,10,5,1,1090,95,23038,1710,286626,309664,10/7/2020
9/15/2020,122,32965,8554,620310,653275,6,2676,2,2237,1,345,94,10,5,2,1092,124,23162,2198,288824,311986,10/7/2020
9/16/2020,137,33102,9880,630190,663292,7,2683,7,2244,2,347,92,8,6,5,1097,118,23280,1973,290797,314077,10/7/2020
9/17/2020,124,33226,9581,639771,672997,7,2690,14,2258,0,347,85,8,4,0,1097,154,23434,1960,292757,316191,10/7/2020
9/18/2020,132,33358,10263,650034,683392,6,2696,7,2265,1,348,83,11,6,2,1099,132,23566,1954,294711,318277,10/7/2020
9/19/2020,116,33474,8393,658427,691901,7,2703,3,2268,0,348,87,10,6,4,1103,112,23678,1707,296418,320096,10/7/2020
9/20/2020,60,33534,3668,662095,695629,7,2710,6,2274,2,350,86,10,8,4,1107,48,23726,1343,297761,321487,10/7/2020
9/21/2020,103,33637,7006,669101,702738,12,2722,2,2276,2,352,94,9,6,2,1109,93,23819,2416,300177,323996,10/7/2020
9/22/2020,154,33791,9405,678506,712297,12,2734,3,2279,1,353,102,8,5,1,1110,125,23944,2228,302405,326349,10/7/2020
9/23/2020,136,33927,10946,689452,723379,11,2745,7,2286,0,353,106,7,5,0,1110,127,24071,2227,304632,328703,10/7/2020
9/24/2020,106,34033,11510,700962,734995,7,2752,9,2295,1,354,103,8,6,1,1111,120,24191,2084,306716,330907,10/7/2020
9/25/2020,136,34169,10192,711154,745323,9,2761,10,2305,0,354,102,7,6,1,1112,129,24320,2398,309114,333434,10/7/2020
9/26/2020,149,34318,10126,721280,755598,12,2773,9,2314,0,354,105,7,6,1,1113,116,24436,2004,311118,335554,10/7/2020
9/27/2020,42,34360,2575,723855,758215,7,2780,5,2319,0,354,107,10,6,0,1113,32,24468,806,311924,336392,10/7/2020
9/28/2020,152,34512,6939,730794,765306,6,2786,6,2325,2,356,105,8,6,2,1115,130,24598,2137,314061,338659,10/7/2020
9/29/2020,204,34716,10137,740931,775647,10,2796,18,2343,1,357,96,7,7,1,1116,185,24783,2354,316415,341198,10/7/2020
9/30/2020,213,34929,11399,752330,787259,6,2802,6,2349,0,357,96,7,7,1,1117,181,24964,2358,318773,343737,10/7/2020
10/1/2020,177,35106,11458,763788,798894,16,2818,13,2362,1,358,98,6,5,1,1118,156,25120,2311,321084,346204,10/7/2020
10/2/2020,206,35312,11201,774989,810301,11,2829,12,2374,1,359,96,7,4,1,1119,166,25286,2379,323463,348749,10/7/2020
10/3/2020,152,35464,8841,783830,819294,9,2838,9,2383,2,361,94,8,4,2,1121,135,25421,1933,325396,350817,10/7/2020
10/4/2020,80,35544,2005,785835,821379,11,2849,9,2392,1,362,95,8,4,2,1123,68,25489,878,326274,351763,10/7/2020
10/5/2020,168,35712,7411,793246,828958,24,2873,10,2402,2,364,107,10,5,3,1126,142,25631,2634,328908,354539,10/7/2020
10/6/2020,155,35867,9369,802615,838482,,,,,,,,,,0,1126,145,25776,2666,331574,357350,10/7/2020
2/27/2020,0,0,0,0,0,1,1,0,0,0,0,1,0,0,0,0,0,0,0,0,0,10/8/2020
2/28/2020,0,0,0,0,0,0,1,0,0,0,0,1,1,0,0,0,0,0,0,0,0,10/8/2020
2/29/2020,0,0,0,0,0,0,1,0,0,0,0,1,1,0,0,0,0,0,0,0,0,10/8/2020
3/1/2020,2,2,2,2,4,0,1,0,0,0,0,1,1,1,0,0,2,2,2,2,4,10/8/2020
3/2/2020,0,2,1,3,5,1,2,0,0,0,0,2,2,2,0,0,0,2,1,3,5,10/8/2020
3/3/2020,0,2,2,5,7,0,2,0,0,0,0,2,2,2,0,0,0,2,2,5,7,10/8/2020
3/4/2020,0,2,12,17,19,1,3,0,0,0,0,3,2,2,0,0,0,2,10,15,17,10/8/2020
3/5/2020,0,2,4,21,23,0,3,0,0,0,0,3,2,2,0,0,1,3,4,19,22,10/8/2020
3/6/2020,1,3,12,33,36,0,3,0,0,0,0,3,2,2,0,0,0,3,11,30,33,10/8/2020
3/7/2020,0,3,19,52,55,0,3,0,0,0,0,3,2,1,0,0,0,3,19,49,52,10/8/2020
3/8/2020,0,3,18,70,73,0,3,0,0,0,0,3,2,1,0,0,0,3,18,67,70,10/8/2020
3/9/2020,1,4,15,85,89,0,3,0,0,0,0,3,2,1,0,0,1,4,15,82,86,10/8/2020
3/10/2020,2,6,25,110,116,0,3,0,0,0,0,3,2,1,0,0,1,5,23,105,110,10/8/2020
3/11/2020,0,6,34,144,150,1,4,0,0,0,0,4,1,1,0,0,0,5,34,139,144,10/8/2020
3/12/2020,9,15,41,185,200,1,5,0,0,0,0,5,1,1,0,0,8,13,38,177,190,10/8/2020
3/13/2020,6,21,50,235,256,4,9,1,1,0,0,8,1,1,0,0,6,19,48,225,244,10/8/2020
3/14/2020,0,21,90,325,346,0,9,0,1,0,0,8,1,1,0,0,0,19,86,311,330,10/8/2020
3/15/2020,1,22,54,379,401,1,10,0,1,0,0,9,2,1,0,0,1,20,54,365,385,10/8/2020
3/16/2020,2,24,95,474,498,2,12,0,1,0,0,11,2,0,0,0,2,22,92,457,479,10/8/2020
3/17/2020,12,36,162,636,672,6,18,0,1,0,0,17,2,0,0,0,11,33,151,608,641,10/8/2020
3/18/2020,9,45,116,752,797,3,21,0,1,0,0,20,2,0,0,0,11,44,110,718,762,10/8/2020
3/19/2020,15,60,262,1014,1074,2,23,1,2,0,0,21,3,0,1,1,17,61,251,969,1030,10/8/2020
3/20/2020,13,73,197,1211,1284,5,28,0,2,0,0,26,4,0,0,1,13,74,190,1159,1233,10/8/2020
3/21/2020,12,85,126,1337,1422,3,31,2,4,0,0,27,5,0,0,1,14,88,123,1282,1370,10/8/2020
3/22/2020,27,112,282,1619,1731,2,33,0,4,0,0,29,5,0,0,1,25,113,261,1543,1656,10/8/2020
3/23/2020,14,126,169,1788,1914,15,48,1,5,0,0,43,9,3,0,1,16,129,165,1708,1837,10/8/2020
3/24/2020,20,146,242,2030,2176,7,55,0,5,0,0,50,10,4,0,1,19,148,237,1945,2093,10/8/2020
3/25/2020,26,172,182,2212,2384,5,60,1,6,0,0,54,11,3,0,1,28,176,171,2116,2292,10/8/2020
3/26/2020,35,207,181,2393,2600,10,70,5,11,0,0,59,14,5,0,1,41,217,174,2290,2507,10/8/2020
3/27/2020,27,234,214,2607,2841,9,79,1,12,1,1,66,17,6,2,3,31,248,200,2490,2738,10/8/2020
3/28/2020,59,293,260,2867,3160,13,92,3,15,2,3,74,15,6,1,4,64,312,241,2731,3043,10/8/2020
3/29/2020,100,393,350,3217,3610,8,100,4,19,1,4,77,18,8,2,6,105,417,313,3044,3461,10/8/2020
3/30/2020,62,455,222,3439,3894,20,120,5,24,0,4,92,20,11,3,9,78,495,184,3228,3723,10/8/2020
3/31/2020,71,526,369,3808,4334,11,131,7,31,1,5,95,22,13,2,11,73,568,296,3524,4092,10/8/2020
4/1/2020,99,625,698,4506,5131,18,149,7,38,0,5,106,30,15,1,12,100,668,640,4164,4832,10/8/2020
4/2/2020,52,677,477,4983,5660,22,171,6,44,2,7,120,36,21,4,16,62,730,436,4600,5330,10/8/2020
4/3/2020,108,785,774,5757,6542,23,194,7,51,0,7,136,43,25,3,19,100,830,710,5310,6140,10/8/2020
4/4/2020,143,928,660,6417,7345,22,216,4,55,5,12,149,41,30,9,28,138,968,617,5927,6895,10/8/2020
4/5/2020,187,1115,1156,7573,8688,20,236,9,64,1,13,159,44,36,2,30,181,1149,1064,6991,8140,10/8/2020
4/6/2020,218,1333,1706,9279,10612,26,262,7,71,0,13,178,48,40,7,37,207,1356,1547,8538,9894,10/8/2020
4/7/2020,284,1617,1629,10908,12525,20,282,4,75,2,15,192,50,42,5,42,261,1617,1477,10015,11632,10/8/2020
4/8/2020,290,1907,1720,12628,14535,19,301,7,82,6,21,198,50,38,10,52,271,1888,1558,11573,13461,10/8/2020
4/9/2020,283,2190,1516,14144,16334,32,333,9,91,4,25,217,53,40,7,59,277,2165,1353,12926,15091,10/8/2020
4/10/2020,419,2609,2574,16718,19327,29,362,17,108,5,30,224,59,41,11,70,402,2567,2368,15294,17861,10/8/2020
4/11/2020,297,2906,1905,18623,21529,29,391,11,119,2,32,240,61,48,12,82,280,2847,1714,17008,19855,10/8/2020
4/12/2020,314,3220,1670,20293,23513,35,426,13,132,5,37,257,59,49,9,91,284,3131,1432,18440,21571,10/8/2020
4/13/2020,161,3381,935,21228,24609,35,461,13,145,3,40,276,64,54,9,100,187,3318,837,19277,22595,10/8/2020
4/14/2020,289,3670,1787,23015,26685,27,488,17,162,5,45,281,72,53,8,108,262,3580,1527,20804,24384,10/8/2020
4/15/2020,351,4021,1799,24814,28835,31,519,20,182,3,48,289,72,54,17,125,306,3886,1548,22352,26238,10/8/2020
4/16/2020,447,4468,2494,27308,31776,36,555,25,207,6,54,294,72,53,14,139,387,4273,2070,24422,28695,10/8/2020
4/17/2020,304,4772,1821,29129,33901,32,587,20,227,7,61,299,66,45,21,160,290,4563,1444,25866,30429,10/8/2020
4/18/2020,321,5093,1725,30854,35947,26,613,18,245,4,65,303,63,49,15,175,284,4847,1323,27189,32036,10/8/2020
4/19/2020,381,5474,2047,32901,38375,23,636,26,271,1,66,299,65,55,11,186,336,5183,1738,28927,34110,10/8/2020
4/20/2020,394,5868,1907,34808,40676,46,682,29,300,2,68,314,75,56,10,196,376,5559,1566,30493,36052,10/8/2020
4/21/2020,444,6312,2110,36918,43230,45,727,33,333,5,73,321,72,56,18,214,384,5943,1700,32193,38136,10/8/2020
4/22/2020,418,6730,2390,39308,46038,41,768,32,365,5,78,325,73,58,18,232,379,6322,1913,34106,40428,10/8/2020
4/23/2020,479,7209,2469,41777,48986,32,800,28,393,5,83,324,76,62,15,247,412,6734,1852,35958,42692,10/8/2020
4/24/2020,491,7700,3284,45061,52761,35,835,26,419,4,87,329,85,63,15,262,407,7141,2622,38580,45721,10/8/2020
4/25/2020,393,8093,2206,47267,55360,34,869,17,436,5,92,341,85,62,14,276,300,7441,1761,40341,47782,10/8/2020
4/26/2020,316,8409,2309,49576,57985,33,902,15,451,3,95,356,86,59,14,290,274,7715,1875,42216,49931,10/8/2020
4/27/2020,249,8658,1620,51196,59854,29,931,21,472,4,99,360,86,61,10,300,206,7921,1161,43377,51298,10/8/2020
4/28/2020,410,9068,2263,53459,62527,44,975,24,496,3,102,377,88,59,22,322,331,8252,1760,45137,53389,10/8/2020
4/29/2020,476,9544,3343,56802,66346,36,1011,38,534,11,113,364,78,53,18,340,371,8623,2418,47555,56178,10/8/2020
4/30/2020,432,9976,2769,59571,69547,33,1044,38,572,6,119,353,83,57,24,364,350,8973,1913,49468,58441,10/8/2020
5/1/2020,454,10430,3086,62657,73087,51,1095,39,611,3,122,362,84,58,14,378,325,9298,2164,51632,60930,10/8/2020
5/2/2020,257,10687,1926,64583,75270,36,1131,38,649,5,127,355,91,62,24,402,192,9490,1272,52904,62394,10/8/2020
5/3/2020,283,10970,2160,66743,77713,31,1162,27,676,8,135,351,90,61,21,423,183,9673,1574,54478,64151,10/8/2020
5/4/2020,387,11357,2098,68841,80198,30,1192,31,707,5,140,345,88,57,18,441,290,9963,1559,56037,66000,10/8/2020
5/5/2020,433,11790,2873,71714,83504,29,1221,32,739,6,146,336,82,54,16,457,300,10263,1956,57993,68256,10/8/2020
5/6/2020,488,12278,2830,74544,86822,28,1249,44,783,9,155,311,79,54,21,478,340,10603,1916,59909,70512,10/8/2020
5/7/2020,425,12703,2969,77513,90216,36,1285,41,824,5,160,301,71,52,21,499,270,10873,1960,61869,72742,10/8/2020
5/8/2020,359,13062,2598,80111,93173,30,1315,29,853,5,165,297,71,53,22,521,230,11103,1736,63605,74708,10/8/2020
5/9/2020,467,13529,3346,83457,96986,22,1337,21,874,4,169,294,69,51,15,536,290,11393,2256,65861,77254,10/8/2020
5/10/2020,285,13814,2117,85574,99388,20,1357,23,897,6,175,285,70,49,13,549,189,11582,1522,67383,78965,10/8/2020
5/11/2020,257,14071,1857,87431,101502,31,1388,16,913,6,181,294,71,49,15,564,174,11756,1300,68683,80439,10/8/2020
5/12/2020,387,14458,2611,90042,104500,23,1411,18,931,4,185,295,69,48,22,586,224,11980,1701,70384,82364,10/8/2020
5/13/2020,351,14809,3630,93672,108481,23,1434,25,956,1,186,292,69,49,13,599,199,12179,2001,72385,84564,10/8/2020
5/14/2020,329,15138,3408,97080,112218,19,1453,27,983,3,189,281,64,45,15,614,230,12409,2013,74398,86807,10/8/2020
5/15/2020,381,15519,3458,100538,116057,24,1477,41,1024,5,194,259,62,45,14,628,232,12641,1804,76202,88843,10/8/2020
5/16/2020,449,15968,4156,104694,120662,25,1502,13,1037,5,199,266,61,46,15,643,247,12888,1960,78162,91050,10/8/2020
5/17/2020,240,16208,2768,107462,123670,17,1519,8,1045,5,204,270,59,45,10,653,126,13014,1555,79717,92731,10/8/2020
5/18/2020,250,16458,2001,109463,125921,19,1538,15,1060,5,209,269,57,40,18,671,135,13149,1366,81083,94232,10/8/2020
5/19/2020,415,16873,3168,112631,129504,23,1561,32,1092,5,214,255,56,38,11,682,215,13364,1926,83009,96373,10/8/2020
5/20/2020,326,17199,2771,115402,132601,19,1580,23,1115,7,221,244,52,33,22,704,183,13547,1514,84523,98070,10/8/2020
5/21/2020,374,17573,3757,119159,136732,26,1606,15,1130,3,224,252,53,29,20,724,168,13715,1936,86459,100174,10/8/2020
5/22/2020,351,17924,3161,122320,140244,20,1626,29,1159,5,229,238,52,29,10,734,206,13921,1606,88065,101986,10/8/2020
5/23/2020,253,18177,2742,125062,143239,19,1645,11,1170,3,232,243,52,32,13,747,109,14030,1271,89336,103366,10/8/2020
5/24/2020,163,18340,1370,126432,144772,12,1657,14,1184,2,234,239,53,36,8,755,82,14112,772,90108,104220,10/8/2020
5/25/2020,147,18487,1385,127817,146304,14,1671,14,1198,0,234,239,53,34,10,765,76,14188,762,90870,105058,10/8/2020
5/26/2020,285,18772,2620,130437,149209,24,1695,22,1220,5,239,236,48,33,15,780,157,14345,1779,92649,106994,10/8/2020
5/27/2020,276,19048,2057,132494,151542,20,1715,18,1238,3,242,235,50,33,10,790,132,14477,1133,93782,108259,10/8/2020
5/28/2020,348,19396,3359,135853,155249,17,1732,29,1267,4,246,219,47,32,8,798,130,14607,1117,94899,109506,10/8/2020
5/29/2020,410,19806,3914,139767,159573,19,1751,27,1294,6,252,205,43,31,12,810,173,14780,1570,96469,111249,10/8/2020
5/30/2020,225,20031,3915,143682,163713,15,1766,19,1313,4,256,197,40,29,12,822,109,14889,1818,98287,113176,10/8/2020
5/31/2020,155,20186,1688,145370,165556,11,1777,10,1323,1,257,197,43,26,3,825,78,14967,855,99142,114109,10/8/2020
6/1/2020,212,20398,2792,148162,168560,8,1785,14,1337,1,258,190,44,29,5,830,93,15060,1383,100525,115585,10/8/2020
6/2/2020,273,20671,3022,151184,171855,8,1793,9,1346,3,261,186,37,25,10,840,98,15158,1448,101973,117131,10/8/2020
6/3/2020,254,20925,3486,154670,175595,14,1807,18,1364,6,267,176,34,25,11,851,99,15257,1658,103631,118888,10/8/2020
6/4/2020,276,21201,4471,159141,180342,7,1814,25,1389,3,270,155,31,24,11,862,107,15364,2034,105665,121029,10/8/2020
6/5/2020,215,21416,3513,162654,184070,15,1829,13,1402,6,276,151,27,21,11,873,99,15463,1573,107238,122701,10/8/2020
6/6/2020,201,21617,2616,165270,186887,10,1839,7,1409,2,278,152,29,19,6,879,67,15530,1136,108374,123904,10/8/2020
6/7/2020,83,21700,1625,166895,188595,11,1850,7,1416,1,279,155,25,17,4,883,51,15581,782,109156,124737,10/8/2020
6/8/2020,119,21819,1849,168744,190563,15,1865,12,1428,2,281,156,27,18,4,887,45,15626,958,110114,125740,10/8/2020
6/9/2020,223,22042,2673,171417,193459,10,1875,18,1446,0,281,148,28,21,1,888,64,15690,1257,111371,127061,10/8/2020
6/10/2020,209,22251,2987,174404,196655,13,1888,12,1458,2,283,147,24,17,4,892,101,15791,1464,112835,128626,10/8/2020
6/11/2020,195,22446,3513,177917,200363,7,1895,15,1473,1,284,138,25,16,6,898,88,15879,1534,114369,130248,10/8/2020
6/12/2020,209,22655,4601,182518,205173,9,1904,15,1488,1,285,131,24,16,2,900,78,15957,2178,116547,132504,10/8/2020
6/13/2020,113,22768,3036,185554,208322,6,1910,4,1492,0,285,133,20,15,3,903,49,16006,1372,117919,133925,10/8/2020
6/14/2020,81,22849,2046,187600,210449,7,1917,8,1500,1,286,131,20,14,3,906,33,16039,968,118887,134926,10/8/2020
6/15/2020,188,23037,3108,190708,213745,14,1931,14,1514,0,286,131,20,16,5,911,75,16114,1789,120676,136790,10/8/2020
6/16/2020,110,23147,3017,193725,216872,11,1942,9,1523,1,287,132,22,16,8,919,50,16164,1576,122252,138416,10/8/2020
6/17/2020,127,23274,2835,196560,219834,15,1957,20,1543,4,291,123,18,14,6,925,50,16214,1318,123570,139784,10/8/2020
6/18/2020,149,23423,3047,199607,223030,9,1966,13,1556,1,292,118,19,16,7,932,70,16284,1312,124882,141166,10/8/2020
6/19/2020,141,23564,3769,203376,226940,12,1978,11,1567,1,293,118,20,17,3,935,59,16343,1370,126252,142595,10/8/2020
6/20/2020,84,23648,1891,205267,228915,9,1987,12,1579,0,293,115,20,18,4,939,36,16379,812,127064,143443,10/8/2020
6/21/2020,37,23685,1064,206331,230016,8,1995,5,1584,0,293,118,20,18,2,941,29,16408,692,127756,144164,10/8/2020
6/22/2020,138,23823,3730,210061,233884,12,2007,16,1600,0,293,114,19,18,2,943,65,16473,1705,129461,145934,10/8/2020
6/23/2020,163,23986,3831,213892,237878,3,2010,13,1613,3,296,101,18,18,7,950,81,16554,1780,131241,147795,10/8/2020
6/24/2020,120,24106,3502,217394,241500,9,2019,10,1623,1,297,99,18,18,5,955,44,16598,1683,132924,149522,10/8/2020
6/25/2020,103,24209,2883,220277,244486,6,2025,14,1637,1,298,90,17,17,1,956,50,16648,1511,134435,151083,10/8/2020
6/26/2020,94,24303,2488,222765,247068,2,2027,10,1647,0,298,82,18,18,1,957,60,16708,1331,135766,152474,10/8/2020
6/27/2020,84,24387,3214,225979,250366,5,2032,3,1650,1,299,83,17,17,5,962,37,16745,1217,136983,153728,10/8/2020
6/28/2020,39,24426,1469,227448,251874,4,2036,4,1654,4,303,79,15,14,6,968,17,16762,595,137578,154340,10/8/2020
6/29/2020,85,24511,3697,231145,255656,4,2040,5,1659,0,303,78,14,14,1,969,39,16801,1352,138930,155731,10/8/2020
6/30/2020,57,24568,1957,233102,257670,1,2041,5,1664,1,304,73,12,11,4,973,33,16834,994,139924,156758,10/8/2020
7/1/2020,144,24712,4098,237200,261912,7,2048,9,1673,0,304,71,11,11,1,974,78,16912,1933,141857,158769,10/8/2020
7/2/2020,103,24815,2803,240003,264818,5,2053,5,1678,1,305,70,10,10,3,977,59,16971,1088,142945,159916,10/8/2020
7/3/2020,50,24865,2076,242079,266944,9,2062,6,1684,0,305,73,9,9,3,980,25,16996,778,143723,160719,10/8/2020
7/4/2020,57,24922,2345,244424,269346,2,2064,4,1688,1,306,70,10,9,2,982,33,17029,1011,144734,161763,10/8/2020
7/5/2020,49,24971,2932,247356,272327,1,2065,2,1690,1,307,68,8,8,2,984,26,17055,1443,146177,163232,10/8/2020
7/6/2020,101,25072,2811,250167,275239,6,2071,6,1696,0,307,68,9,9,4,988,57,17112,1550,147727,164839,10/8/2020
7/7/2020,81,25153,3457,253624,278777,5,2076,7,1703,0,307,66,8,8,2,990,47,17159,1534,149261,166420,10/8/2020
7/8/2020,105,25258,3403,257027,282285,4,2080,2,1705,0,307,68,9,8,0,990,64,17223,1423,150684,167907,10/8/2020
7/9/2020,94,25352,3712,260739,286091,9,2089,3,1708,0,307,74,9,8,0,990,50,17273,1626,152310,169583,10/8/2020
7/10/2020,131,25483,4431,265170,290653,6,2095,3,1711,2,309,75,7,7,3,993,80,17353,2075,154385,171738,10/8/2020
7/11/2020,63,25546,2932,268102,293648,6,2101,3,1714,1,310,77,6,6,3,996,36,17389,1316,155701,173090,10/8/2020
7/12/2020,47,25593,1836,269938,295531,1,2102,3,1717,1,311,74,6,5,3,999,34,17423,943,156644,174067,10/8/2020
7/13/2020,84,25677,3201,273139,298816,8,2110,10,1727,0,311,72,6,5,1,1000,61,17484,1504,158148,175632,10/8/2020
7/14/2020,73,25750,3291,276430,302180,7,2117,4,1731,0,311,75,5,5,1,1001,43,17527,1375,159523,177050,10/8/2020
7/15/2020,130,25880,4172,280602,306482,5,2122,7,1738,0,311,73,5,4,0,1001,99,17626,1751,161274,178900,10/8/2020
7/16/2020,102,25982,3733,284335,310317,6,2128,9,1747,0,311,70,6,5,1,1002,75,17701,1619,162893,180594,10/8/2020
7/17/2020,156,26138,4236,288571,314709,14,2142,3,1750,1,312,80,5,5,2,1004,79,17780,1845,164738,182518,10/8/2020
7/18/2020,85,26223,3267,291838,318061,5,2147,9,1759,1,313,75,5,4,4,1008,70,17850,1399,166137,183987,10/8/2020
7/19/2020,82,26305,2693,294531,320836,7,2154,3,1762,0,313,79,6,4,2,1010,57,17907,1149,167286,185193,10/8/2020
7/20/2020,71,26376,2664,297195,323571,9,2163,7,1769,0,313,81,7,5,2,1012,68,17975,1463,168749,186724,10/8/2020
7/21/2020,130,26506,4298,301493,327999,9,2172,11,1780,0,313,79,9,6,1,1013,109,18084,1918,170667,188751,10/8/2020
7/22/2020,130,26636,3927,305420,332056,11,2183,11,1791,1,314,78,7,6,1,1014,86,18170,1684,172351,190521,10/8/2020
7/23/2020,141,26777,4412,309832,336609,8,2191,6,1797,0,314,80,8,7,0,1014,115,18285,1989,174340,192625,10/8/2020
7/24/2020,172,26949,5959,315791,342740,14,2205,14,1811,0,314,80,9,7,0,1014,119,18404,2321,176661,195065,10/8/2020
7/25/2020,134,27083,4398,320189,347272,7,2212,7,1818,0,314,80,10,8,2,1016,108,18512,2099,178760,197272,10/8/2020
7/26/2020,62,27145,3027,323216,350361,8,2220,9,1827,0,314,79,11,7,1,1017,54,18566,1335,180095,198661,10/8/2020
7/27/2020,188,27333,4190,327406,354739,12,2232,7,1834,0,314,84,13,8,1,1018,138,18704,2349,182444,201148,10/8/2020
7/28/2020,105,27438,3834,331240,358678,5,2237,5,1839,0,314,84,14,7,1,1019,94,18798,1634,184078,202876,10/8/2020
7/29/2020,191,27629,5137,336377,364006,11,2248,12,1851,0,314,83,15,7,0,1019,154,18952,2323,186401,205353,10/8/2020
7/30/2020,121,27750,4344,340721,368471,6,2254,2,1853,1,315,86,15,6,1,1020,97,19049,1649,188050,207099,10/8/2020
7/31/2020,131,27881,5508,346229,374110,8,2262,10,1863,0,315,84,15,7,1,1021,89,19138,1854,189904,209042,10/8/2020
8/1/2020,108,27989,4288,350517,378506,7,2269,2,1865,0,315,89,14,7,1,1022,88,19226,1558,191462,210688,10/8/2020
8/2/2020,84,28073,2802,353319,381392,12,2281,12,1877,2,317,87,14,8,2,1024,62,19288,1273,192735,212023,10/8/2020
8/3/2020,187,28260,5238,358557,386817,13,2294,12,1889,0,317,88,16,7,1,1025,150,19438,2202,194937,214375,10/8/2020
8/4/2020,126,28386,3691,362248,390634,8,2302,6,1895,1,318,89,12,5,2,1027,99,19537,1771,196708,216245,10/8/2020
8/5/2020,148,28534,5932,368180,396714,12,2314,10,1905,1,319,90,10,5,2,1029,118,19655,2471,199179,218834,10/8/2020
8/6/2020,169,28703,5533,373713,402416,7,2321,9,1914,0,319,88,9,4,0,1029,121,19776,2408,201587,221363,10/8/2020
8/7/2020,122,28825,4845,378558,407383,13,2334,10,1924,1,320,90,9,3,2,1031,87,19863,2146,203733,223596,10/8/2020
8/8/2020,123,28948,4106,382664,411612,19,2353,6,1930,1,321,102,8,3,1,1032,92,19955,1779,205512,225467,10/8/2020
8/9/2020,42,28990,1722,384386,413376,8,2361,10,1940,0,321,100,9,4,0,1032,35,19990,1074,206586,226576,10/8/2020
8/10/2020,149,29139,4580,388966,418105,11,2372,12,1952,0,321,99,9,4,1,1033,113,20103,2028,208614,228717,10/8/2020
8/11/2020,105,29244,4325,393291,422535,6,2378,14,1966,0,321,91,10,4,3,1036,92,20195,2266,210880,231075,10/8/2020
8/12/2020,121,29365,5184,398475,427840,8,2386,11,1977,0,321,88,9,3,1,1037,101,20296,2630,213510,233806,10/8/2020
8/13/2020,135,29500,4191,402666,432166,13,2399,12,1989,0,321,89,11,3,0,1037,95,20391,1905,215415,235806,10/8/2020
8/14/2020,145,29645,5492,408158,437803,13,2412,11,2000,0,321,91,11,4,3,1040,99,20490,1975,217390,237880,10/8/2020
8/15/2020,105,29750,4533,412691,442441,8,2420,11,2011,1,322,87,11,5,0,1040,89,20579,1693,219083,239662,10/8/2020
8/16/2020,83,29833,2785,415476,445309,7,2427,6,2017,4,326,84,8,4,6,1046,70,20649,980,220063,240712,10/8/2020
8/17/2020,106,29939,4570,420046,449985,10,2437,7,2024,0,326,87,8,5,2,1048,88,20737,2398,222461,243198,10/8/2020
8/18/2020,128,30067,5049,425095,455162,11,2448,9,2033,1,327,88,8,4,5,1053,95,20832,2770,225231,246063,10/8/2020
8/19/2020,114,30181,5407,430502,460683,8,2456,9,2042,1,328,86,9,5,0,1053,89,20921,2661,227892,248813,10/8/2020
8/20/2020,174,30355,8220,438722,469077,12,2468,6,2048,2,330,90,10,5,3,1056,139,21060,3556,231448,252508,10/8/2020
8/21/2020,154,30509,6816,445538,476047,8,2476,5,2053,1,331,92,9,4,2,1058,126,21186,2965,234413,255599,10/8/2020
8/22/2020,96,30605,5957,451495,482100,10,2486,12,2065,0,331,90,11,4,1,1059,84,21270,2626,237039,258309,10/8/2020
8/23/2020,70,30675,4365,455860,486535,11,2497,6,2071,0,331,95,11,2,1,1060,56,21326,2474,239513,260839,10/8/2020
8/24/2020,105,30780,5776,461636,492416,7,2504,10,2081,1,332,91,13,4,1,1061,77,21403,3160,242673,264076,10/8/2020
8/25/2020,108,30888,4796,466432,497320,10,2514,4,2085,1,333,96,11,4,1,1062,92,21495,2300,244973,266468,10/8/2020
8/26/2020,170,31058,9604,476036,507094,4,2518,8,2093,0,333,92,9,5,1,1063,127,21622,3086,248059,269681,10/8/2020
8/27/2020,94,31152,8848,484884,516036,6,2524,13,2106,1,334,84,6,5,2,1065,71,21693,3217,251276,272969,10/8/2020
8/28/2020,112,31264,8106,492990,524254,14,2538,4,2110,0,334,94,9,7,2,1067,87,21780,2439,253715,275495,10/8/2020
8/29/2020,65,31329,5516,498506,529835,6,2544,8,2118,1,335,91,10,6,2,1069,51,21831,1910,255625,277456,10/8/2020
8/30/2020,66,31395,4319,502825,534220,7,2551,4,2122,0,335,94,8,5,2,1071,48,21879,1996,257621,279500,10/8/2020
8/31/2020,105,31500,4864,507689,539189,12,2563,15,2137,0,335,91,8,4,1,1072,80,21959,2189,259810,281769,10/8/2020
9/1/2020,98,31598,7199,514888,546486,6,2569,9,2146,1,336,87,7,4,2,1074,65,22024,2380,262190,284214,10/8/2020
9/2/2020,125,31723,10750,525638,557361,9,2578,10,2156,1,337,85,8,4,2,1076,104,22128,3067,265257,287385,10/8/2020
9/3/2020,90,31813,11373,537011,568824,8,2586,8,2164,0,337,85,9,4,3,1079,73,22201,2598,267855,290056,10/8/2020
9/4/2020,102,31915,9187,546198,578113,11,2597,4,2168,0,337,92,9,4,1,1080,82,22283,2399,270254,292537,10/8/2020
9/5/2020,52,31967,6356,552554,584521,6,2603,9,2177,0,337,89,8,3,1,1081,42,22325,1603,271857,294182,10/8/2020
9/6/2020,87,32054,4317,556871,588925,4,2607,8,2185,1,338,84,6,3,1,1082,64,22389,1959,273816,296205,10/8/2020
9/7/2020,35,32089,3000,559871,591960,11,2618,3,2188,0,338,92,5,3,1,1083,26,22415,647,274463,296878,10/8/2020
9/8/2020,74,32163,6407,566278,598441,6,2624,12,2200,1,339,85,6,3,2,1085,66,22481,1606,276069,298550,10/8/2020
9/9/2020,118,32281,8866,575144,607425,9,2633,5,2205,1,340,88,9,3,1,1086,101,22582,2165,278234,300816,10/8/2020
9/10/2020,167,32448,11791,586935,619383,9,2642,8,2213,0,340,89,10,3,0,1086,112,22694,2282,280516,303210,10/8/2020
9/11/2020,124,32572,9501,596436,629008,11,2653,11,2224,0,340,89,10,5,0,1086,98,22792,1981,282497,305289,10/8/2020
9/12/2020,109,32681,6188,602624,635305,8,2661,5,2229,2,342,90,9,5,3,1089,97,22889,1502,283999,306888,10/8/2020
9/13/2020,58,32739,2707,605331,638070,4,2665,3,2232,0,342,91,10,5,0,1089,53,22942,858,284857,307799,10/8/2020
9/14/2020,104,32843,6426,611757,644600,5,2670,3,2235,2,344,91,10,5,1,1090,95,23037,1710,286567,309604,10/8/2020
9/15/2020,122,32965,8554,620311,653276,6,2676,2,2237,1,345,94,10,5,2,1092,124,23161,2197,288764,311925,10/8/2020
9/16/2020,137,33102,9880,630191,663293,7,2683,7,2244,2,347,92,8,6,5,1097,118,23279,1973,290737,314016,10/8/2020
9/17/2020,124,33226,9582,639773,672999,7,2690,14,2258,0,347,85,8,4,0,1097,154,23433,1960,292697,316130,10/8/2020
9/18/2020,132,33358,10263,650036,683394,7,2697,7,2265,1,348,84,11,6,2,1099,132,23565,1950,294647,318212,10/8/2020
9/19/2020,116,33474,8393,658429,691903,7,2704,3,2268,0,348,88,10,6,4,1103,112,23677,1707,296354,320031,10/8/2020
9/20/2020,60,33534,3668,662097,695631,7,2711,6,2274,2,350,87,10,8,4,1107,48,23725,1327,297681,321406,10/8/2020
9/21/2020,103,33637,7006,669103,702740,12,2723,3,2277,2,352,94,9,6,2,1109,93,23818,2416,300097,323915,10/8/2020
9/22/2020,154,33791,9405,678508,712299,12,2735,3,2280,1,353,102,8,5,1,1110,125,23943,2228,302325,326268,10/8/2020
9/23/2020,136,33927,10946,689454,723381,11,2746,7,2287,0,353,106,7,5,0,1110,127,24070,2226,304551,328621,10/8/2020
9/24/2020,120,34047,12824,702278,736325,7,2753,9,2296,1,354,103,8,6,1,1111,116,24186,3176,307727,331913,10/8/2020
9/25/2020,151,34198,11069,713347,747545,9,2762,10,2306,0,354,102,7,6,1,1112,144,24330,3040,310767,335097,10/8/2020
9/26/2020,149,34347,10817,724164,758511,12,2774,9,2315,0,354,105,7,6,1,1113,116,24446,2447,313214,337660,10/8/2020
9/27/2020,42,34389,2761,726925,761314,7,2781,5,2320,0,354,107,10,6,0,1113,33,24479,851,314065,338544,10/8/2020
9/28/2020,152,34541,7304,734229,768770,6,2787,6,2326,2,356,105,8,6,2,1115,130,24609,2269,316334,340943,10/8/2020
9/29/2020,209,34750,11023,745252,780002,11,2798,18,2344,1,357,97,7,7,1,1116,189,24798,2831,319165,343963,10/8/2020
9/30/2020,221,34971,12269,757521,792492,6,2804,6,2350,0,357,97,7,7,1,1117,185,24983,2597,321762,346745,10/8/2020
10/1/2020,184,35155,12476,769997,805152,16,2820,13,2363,1,358,99,6,5,1,1118,158,25141,2436,324198,349339,10/8/2020
10/2/2020,209,35364,12123,782120,817484,12,2832,13,2376,1,359,97,7,4,1,1119,179,25320,2512,326710,352030,10/8/2020
10/3/2020,157,35521,9280,791400,826921,9,2841,9,2385,2,361,95,8,4,2,1121,128,25448,2018,328728,354176,10/8/2020
10/4/2020,81,35602,2354,793754,829356,11,2852,9,2394,1,362,96,8,4,2,1123,71,25519,964,329692,355211,10/8/2020
10/5/2020,173,35775,8926,802680,838455,26,2878,10,2404,2,364,110,10,5,3,1126,161,25680,3061,332753,358433,10/8/2020
10/6/2020,171,35946,10673,813353,849299,11,2889,4,2408,0,364,117,12,6,0,1126,183,25863,2824,335577,361440,10/8/2020
10/7/2020,199,36145,9931,823284,859429,,,,,,,,,,1,1127,182,26045,2692,338269,364314,10/8/2020
2/27/2020,0,0,0,0,0,1,1,0,0,0,0,1,0,0,0,0,0,0,0,0,0,10/9/2020
2/28/2020,0,0,0,0,0,0,1,0,0,0,0,1,1,0,0,0,0,0,0,0,0,10/9/2020
2/29/2020,0,0,0,0,0,0,1,0,0,0,0,1,1,0,0,0,0,0,0,0,0,10/9/2020
3/1/2020,2,2,2,2,4,0,1,0,0,0,0,1,1,1,0,0,2,2,2,2,4,10/9/2020
3/2/2020,0,2,1,3,5,1,2,0,0,0,0,2,2,2,0,0,0,2,1,3,5,10/9/2020
3/3/2020,0,2,2,5,7,0,2,0,0,0,0,2,2,2,0,0,0,2,2,5,7,10/9/2020
3/4/2020,0,2,12,17,19,1,3,0,0,0,0,3,2,2,0,0,0,2,10,15,17,10/9/2020
3/5/2020,0,2,4,21,23,0,3,0,0,0,0,3,2,2,0,0,1,3,4,19,22,10/9/2020
3/6/2020,1,3,12,33,36,0,3,0,0,0,0,3,2,2,0,0,0,3,11,30,33,10/9/2020
3/7/2020,0,3,19,52,55,0,3,0,0,0,0,3,2,1,0,0,0,3,19,49,52,10/9/2020
3/8/2020,0,3,18,70,73,0,3,0,0,0,0,3,2,1,0,0,0,3,18,67,70,10/9/2020
3/9/2020,1,4,15,85,89,0,3,0,0,0,0,3,2,1,0,0,1,4,15,82,86,10/9/2020
3/10/2020,2,6,25,110,116,0,3,0,0,0,0,3,2,1,0,0,1,5,23,105,110,10/9/2020
3/11/2020,0,6,34,144,150,1,4,0,0,0,0,4,1,1,0,0,0,5,34,139,144,10/9/2020
3/12/2020,9,15,41,185,200,1,5,0,0,0,0,5,1,1,0,0,8,13,38,177,190,10/9/2020
3/13/2020,6,21,50,235,256,4,9,1,1,0,0,8,1,1,0,0,6,19,48,225,244,10/9/2020
3/14/2020,0,21,90,325,346,0,9,0,1,0,0,8,1,1,0,0,0,19,86,311,330,10/9/2020
3/15/2020,1,22,54,379,401,1,10,0,1,0,0,9,2,1,0,0,1,20,54,365,385,10/9/2020
3/16/2020,2,24,95,474,498,2,12,0,1,0,0,11,2,0,0,0,2,22,92,457,479,10/9/2020
3/17/2020,12,36,162,636,672,6,18,0,1,0,0,17,2,0,0,0,11,33,151,608,641,10/9/2020
3/18/2020,9,45,116,752,797,3,21,0,1,0,0,20,2,0,0,0,11,44,110,718,762,10/9/2020
3/19/2020,15,60,262,1014,1074,2,23,1,2,0,0,21,3,0,1,1,17,61,251,969,1030,10/9/2020
3/20/2020,13,73,197,1211,1284,5,28,0,2,0,0,26,4,0,0,1,13,74,190,1159,1233,10/9/2020
3/21/2020,12,85,126,1337,1422,3,31,2,4,0,0,27,5,0,0,1,14,88,123,1282,1370,10/9/2020
3/22/2020,27,112,282,1619,1731,2,33,0,4,0,0,29,5,0,0,1,25,113,261,1543,1656,10/9/2020
3/23/2020,14,126,169,1788,1914,15,48,1,5,0,0,43,9,3,0,1,16,129,165,1708,1837,10/9/2020
3/24/2020,20,146,242,2030,2176,7,55,0,5,0,0,50,10,4,0,1,19,148,237,1945,2093,10/9/2020
3/25/2020,26,172,182,2212,2384,5,60,1,6,0,0,54,11,3,0,1,28,176,171,2116,2292,10/9/2020
3/26/2020,35,207,181,2393,2600,10,70,5,11,0,0,59,14,5,0,1,41,217,174,2290,2507,10/9/2020
3/27/2020,27,234,214,2607,2841,9,79,1,12,1,1,66,17,6,2,3,31,248,200,2490,2738,10/9/2020
3/28/2020,59,293,260,2867,3160,13,92,3,15,2,3,74,15,6,1,4,64,312,240,2730,3042,10/9/2020
3/29/2020,100,393,350,3217,3610,8,100,4,19,1,4,77,18,8,2,6,105,417,313,3043,3460,10/9/2020
3/30/2020,62,455,222,3439,3894,20,120,5,24,0,4,92,20,11,3,9,78,495,184,3227,3722,10/9/2020
3/31/2020,71,526,369,3808,4334,11,131,7,31,1,5,95,22,13,2,11,73,568,296,3523,4091,10/9/2020
4/1/2020,99,625,698,4506,5131,18,149,7,38,0,5,106,30,15,1,12,100,668,640,4163,4831,10/9/2020
4/2/2020,52,677,477,4983,5660,22,171,6,44,2,7,120,36,21,4,16,62,730,436,4599,5329,10/9/2020
4/3/2020,108,785,774,5757,6542,23,194,7,51,0,7,136,43,25,3,19,100,830,710,5309,6139,10/9/2020
4/4/2020,143,928,660,6417,7345,22,216,4,55,5,12,149,41,30,9,28,138,968,617,5926,6894,10/9/2020
4/5/2020,187,1115,1156,7573,8688,20,236,9,64,1,13,159,44,36,2,30,181,1149,1062,6988,8137,10/9/2020
4/6/2020,218,1333,1706,9279,10612,26,262,7,71,0,13,178,48,40,7,37,207,1356,1547,8535,9891,10/9/2020
4/7/2020,284,1617,1629,10908,12525,20,282,4,75,2,15,192,50,42,5,42,261,1617,1476,10011,11628,10/9/2020
4/8/2020,290,1907,1720,12628,14535,19,301,7,82,6,21,198,50,38,10,52,271,1888,1557,11568,13456,10/9/2020
4/9/2020,283,2190,1516,14144,16334,32,333,9,91,4,25,217,53,40,7,59,277,2165,1352,12920,15085,10/9/2020
4/10/2020,419,2609,2574,16718,19327,29,362,17,108,5,30,224,59,41,11,70,402,2567,2366,15286,17853,10/9/2020
4/11/2020,297,2906,1905,18623,21529,29,391,11,119,2,32,240,61,48,12,82,280,2847,1713,16999,19846,10/9/2020
4/12/2020,314,3220,1670,20293,23513,35,426,13,132,5,37,257,59,49,9,91,284,3131,1431,18430,21561,10/9/2020
4/13/2020,161,3381,935,21228,24609,35,461,13,145,3,40,276,64,54,9,100,187,3318,837,19267,22585,10/9/2020
4/14/2020,289,3670,1787,23015,26685,27,488,17,162,5,45,281,72,53,8,108,262,3580,1527,20794,24374,10/9/2020
4/15/2020,351,4021,1799,24814,28835,31,519,20,182,3,48,289,72,54,17,125,306,3886,1548,22342,26228,10/9/2020
4/16/2020,447,4468,2494,27308,31776,36,555,25,207,6,54,294,72,53,14,139,387,4273,2070,24412,28685,10/9/2020
4/17/2020,304,4772,1821,29129,33901,32,587,20,227,7,61,299,66,45,21,160,290,4563,1444,25856,30419,10/9/2020
4/18/2020,321,5093,1725,30854,35947,26,613,18,245,4,65,303,63,49,15,175,284,4847,1321,27177,32024,10/9/2020
4/19/2020,381,5474,2047,32901,38375,23,636,26,271,1,66,299,65,55,11,186,336,5183,1738,28915,34098,10/9/2020
4/20/2020,394,5868,1907,34808,40676,46,682,29,300,2,68,314,75,56,10,196,376,5559,1565,30480,36039,10/9/2020
4/21/2020,444,6312,2110,36918,43230,45,727,33,333,5,73,321,72,56,18,214,384,5943,1700,32180,38123,10/9/2020
4/22/2020,418,6730,2390,39308,46038,41,768,32,365,5,78,325,73,58,18,232,379,6322,1913,34093,40415,10/9/2020
4/23/2020,479,7209,2469,41777,48986,32,800,28,393,5,83,324,76,62,15,247,412,6734,1852,35945,42679,10/9/2020
4/24/2020,491,7700,3284,45061,52761,35,835,26,419,4,87,329,85,63,15,262,407,7141,2620,38565,45706,10/9/2020
4/25/2020,393,8093,2206,47267,55360,34,869,17,436,5,92,341,85,62,14,276,300,7441,1761,40326,47767,10/9/2020
4/26/2020,316,8409,2309,49576,57985,33,902,15,451,3,95,356,86,59,14,290,274,7715,1873,42199,49914,10/9/2020
4/27/2020,249,8658,1620,51196,59854,29,931,21,472,4,99,360,86,61,10,300,206,7921,1161,43360,51281,10/9/2020
4/28/2020,410,9068,2263,53459,62527,44,975,24,496,3,102,377,88,59,22,322,331,8252,1759,45119,53371,10/9/2020
4/29/2020,476,9544,3343,56802,66346,36,1011,38,534,11,113,364,78,53,18,340,371,8623,2417,47536,56159,10/9/2020
4/30/2020,432,9976,2769,59571,69547,33,1044,38,572,6,119,353,83,57,24,364,350,8973,1913,49449,58422,10/9/2020
5/1/2020,454,10430,3086,62657,73087,51,1095,39,611,3,122,362,84,58,14,378,325,9298,2161,51610,60908,10/9/2020
5/2/2020,257,10687,1926,64583,75270,36,1131,38,649,5,127,355,91,62,24,402,192,9490,1272,52882,62372,10/9/2020
5/3/2020,283,10970,2160,66743,77713,31,1162,26,675,8,135,352,90,61,21,423,183,9673,1574,54456,64129,10/9/2020
5/4/2020,387,11357,2098,68841,80198,30,1192,31,706,6,141,345,88,57,18,441,290,9963,1559,56015,65978,10/9/2020
5/5/2020,433,11790,2873,71714,83504,29,1221,32,738,6,147,336,82,54,16,457,300,10263,1956,57971,68234,10/9/2020
5/6/2020,488,12278,2830,74544,86822,28,1249,44,782,9,156,311,79,54,21,478,340,10603,1916,59887,70490,10/9/2020
5/7/2020,425,12703,2969,77513,90216,36,1285,41,823,5,161,301,71,52,21,499,270,10873,1960,61847,72720,10/9/2020
5/8/2020,359,13062,2598,80111,93173,30,1315,29,852,5,166,297,71,53,22,521,230,11103,1736,63583,74686,10/9/2020
5/9/2020,467,13529,3346,83457,96986,22,1337,21,873,4,170,294,69,51,15,536,290,11393,2256,65839,77232,10/9/2020
5/10/2020,285,13814,2117,85574,99388,20,1357,23,896,6,176,285,70,49,13,549,189,11582,1522,67361,78943,10/9/2020
5/11/2020,257,14071,1857,87431,101502,31,1388,16,912,6,182,294,71,49,15,564,174,11756,1300,68661,80417,10/9/2020
5/12/2020,387,14458,2611,90042,104500,23,1411,18,930,4,186,295,69,48,22,586,224,11980,1701,70362,82342,10/9/2020
5/13/2020,351,14809,3630,93672,108481,23,1434,25,955,1,187,292,69,49,13,599,199,12179,2001,72363,84542,10/9/2020
5/14/2020,329,15138,3408,97080,112218,19,1453,27,982,3,190,281,64,45,15,614,230,12409,2013,74376,86785,10/9/2020
5/15/2020,381,15519,3458,100538,116057,24,1477,41,1023,5,195,259,62,45,14,628,232,12641,1803,76179,88820,10/9/2020
5/16/2020,449,15968,4156,104694,120662,25,1502,13,1036,5,200,266,61,46,15,643,247,12888,1960,78139,91027,10/9/2020
5/17/2020,240,16208,2768,107462,123670,17,1519,8,1044,5,205,270,59,45,10,653,126,13014,1555,79694,92708,10/9/2020
5/18/2020,250,16458,2001,109463,125921,19,1538,15,1059,5,210,269,57,40,18,671,135,13149,1366,81060,94209,10/9/2020
5/19/2020,415,16873,3168,112631,129504,23,1561,32,1091,5,215,255,56,38,11,682,215,13364,1926,82986,96350,10/9/2020
5/20/2020,326,17199,2771,115402,132601,19,1580,23,1114,7,222,244,52,33,22,704,183,13547,1513,84499,98046,10/9/2020
5/21/2020,374,17573,3757,119159,136732,26,1606,15,1129,3,225,252,53,29,20,724,168,13715,1936,86435,100150,10/9/2020
5/22/2020,351,17924,3161,122320,140244,20,1626,29,1158,5,230,238,52,29,10,734,206,13921,1605,88040,101961,10/9/2020
5/23/2020,253,18177,2742,125062,143239,19,1645,11,1169,3,233,243,52,32,13,747,109,14030,1270,89310,103340,10/9/2020
5/24/2020,163,18340,1370,126432,144772,13,1658,14,1183,2,235,240,53,36,8,755,83,14113,772,90082,104195,10/9/2020
5/25/2020,147,18487,1385,127817,146304,14,1672,14,1197,0,235,240,53,34,10,765,76,14189,762,90844,105033,10/9/2020
5/26/2020,285,18772,2620,130437,149209,24,1696,22,1219,5,240,237,48,33,15,780,157,14346,1779,92623,106969,10/9/2020
5/27/2020,276,19048,2057,132494,151542,20,1716,18,1237,3,243,236,50,33,10,790,132,14478,1133,93756,108234,10/9/2020
5/28/2020,348,19396,3359,135853,155249,17,1733,29,1266,4,247,220,47,32,8,798,130,14608,1116,94872,109480,10/9/2020
5/29/2020,410,19806,3914,139767,159573,19,1752,27,1293,6,253,206,43,31,12,810,174,14782,1570,96442,111224,10/9/2020
5/30/2020,225,20031,3915,143682,163713,16,1768,19,1312,4,257,199,41,29,12,822,109,14891,1818,98260,113151,10/9/2020
5/31/2020,155,20186,1688,145370,165556,11,1779,10,1322,1,258,199,44,26,3,825,78,14969,855,99115,114084,10/9/2020
6/1/2020,212,20398,2792,148162,168560,8,1787,14,1336,1,259,192,45,29,5,830,93,15062,1383,100498,115560,10/9/2020
6/2/2020,273,20671,3022,151184,171855,8,1795,9,1345,3,262,188,38,25,10,840,98,15160,1448,101946,117106,10/9/2020
6/3/2020,254,20925,3486,154670,175595,14,1809,18,1363,6,268,178,34,25,11,851,99,15259,1658,103604,118863,10/9/2020
6/4/2020,276,21201,4471,159141,180342,7,1816,25,1388,4,272,156,31,24,11,862,107,15366,2034,105638,121004,10/9/2020
6/5/2020,215,21416,3513,162654,184070,15,1831,13,1401,6,278,152,27,21,11,873,99,15465,1573,107211,122676,10/9/2020
6/6/2020,201,21617,2616,165270,186887,10,1841,7,1408,2,280,153,29,19,6,879,67,15532,1136,108347,123879,10/9/2020
6/7/2020,83,21700,1625,166895,188595,11,1852,7,1415,1,281,156,25,17,4,883,51,15583,782,109129,124712,10/9/2020
6/8/2020,119,21819,1849,168744,190563,15,1867,12,1427,2,283,157,27,18,4,887,45,15628,958,110087,125715,10/9/2020
6/9/2020,223,22042,2673,171417,193459,10,1877,18,1445,0,283,149,28,21,1,888,64,15692,1256,111343,127035,10/9/2020
6/10/2020,209,22251,2987,174404,196655,13,1890,12,1457,2,285,148,24,17,4,892,101,15793,1464,112807,128600,10/9/2020
6/11/2020,195,22446,3513,177917,200363,7,1897,15,1472,1,286,139,25,16,6,898,88,15881,1534,114341,130222,10/9/2020
6/12/2020,209,22655,4601,182518,205173,9,1906,15,1487,1,287,132,24,16,2,900,78,15959,2178,116519,132478,10/9/2020
6/13/2020,113,22768,3036,185554,208322,6,1912,5,1492,0,287,133,20,15,3,903,49,16008,1372,117891,133899,10/9/2020
6/14/2020,81,22849,2046,187600,210449,7,1919,8,1500,1,288,131,20,14,3,906,33,16041,968,118859,134900,10/9/2020
6/15/2020,188,23037,3108,190708,213745,14,1933,14,1514,0,288,131,20,16,5,911,75,16116,1789,120648,136764,10/9/2020
6/16/2020,110,23147,3017,193725,216872,11,1944,9,1523,1,289,132,22,16,8,919,50,16166,1576,122224,138390,10/9/2020
6/17/2020,127,23274,2835,196560,219834,15,1959,20,1543,4,293,123,18,14,6,925,50,16216,1318,123542,139758,10/9/2020
6/18/2020,149,23423,3047,199607,223030,9,1968,13,1556,1,294,118,19,16,7,932,70,16286,1312,124854,141140,10/9/2020
6/19/2020,141,23564,3769,203376,226940,12,1980,11,1567,1,295,118,20,17,3,935,59,16345,1370,126224,142569,10/9/2020
6/20/2020,84,23648,1891,205267,228915,9,1989,12,1579,0,295,115,20,18,4,939,36,16381,812,127036,143417,10/9/2020
6/21/2020,37,23685,1064,206331,230016,8,1997,5,1584,0,295,118,20,18,2,941,29,16410,692,127728,144138,10/9/2020
6/22/2020,138,23823,3730,210061,233884,12,2009,16,1600,0,295,114,19,18,2,943,65,16475,1705,129433,145908,10/9/2020
6/23/2020,163,23986,3831,213892,237878,3,2012,13,1613,3,298,101,18,18,7,950,81,16556,1780,131213,147769,10/9/2020
6/24/2020,120,24106,3502,217394,241500,9,2021,10,1623,1,299,99,18,18,5,955,44,16600,1682,132895,149495,10/9/2020
6/25/2020,103,24209,2883,220277,244486,6,2027,14,1637,1,300,90,17,17,1,956,50,16650,1510,134405,151055,10/9/2020
6/26/2020,94,24303,2488,222765,247068,2,2029,10,1647,0,300,82,18,18,1,957,60,16710,1331,135736,152446,10/9/2020
6/27/2020,84,24387,3214,225979,250366,5,2034,3,1650,1,301,83,17,17,5,962,37,16747,1217,136953,153700,10/9/2020
6/28/2020,39,24426,1469,227448,251874,4,2038,4,1654,4,305,79,15,14,6,968,17,16764,595,137548,154312,10/9/2020
6/29/2020,85,24511,3697,231145,255656,4,2042,5,1659,0,305,78,14,14,1,969,39,16803,1352,138900,155703,10/9/2020
6/30/2020,57,24568,1957,233102,257670,1,2043,5,1664,1,306,73,12,11,4,973,33,16836,993,139893,156729,10/9/2020
7/1/2020,144,24712,4098,237200,261912,7,2050,9,1673,0,306,71,11,11,1,974,79,16915,1933,141826,158741,10/9/2020
7/2/2020,103,24815,2803,240003,264818,5,2055,5,1678,1,307,70,10,10,3,977,59,16974,1088,142914,159888,10/9/2020
7/3/2020,50,24865,2076,242079,266944,9,2064,6,1684,0,307,73,9,9,3,980,25,16999,778,143692,160691,10/9/2020
7/4/2020,57,24922,2345,244424,269346,2,2066,4,1688,1,308,70,10,9,2,982,33,17032,1011,144703,161735,10/9/2020
7/5/2020,49,24971,2932,247356,272327,1,2067,2,1690,1,309,68,8,8,2,984,26,17058,1442,146145,163203,10/9/2020
7/6/2020,101,25072,2811,250167,275239,6,2073,6,1696,0,309,68,9,9,4,988,57,17115,1550,147695,164810,10/9/2020
7/7/2020,81,25153,3457,253624,278777,5,2078,7,1703,0,309,66,8,8,2,990,47,17162,1534,149229,166391,10/9/2020
7/8/2020,105,25258,3403,257027,282285,4,2082,2,1705,0,309,68,9,8,0,990,64,17226,1423,150652,167878,10/9/2020
7/9/2020,94,25352,3712,260739,286091,9,2091,3,1708,0,309,74,9,8,0,990,50,17276,1625,152277,169553,10/9/2020
7/10/2020,131,25483,4431,265170,290653,6,2097,3,1711,2,311,75,7,7,3,993,80,17356,2074,154351,171707,10/9/2020
7/11/2020,63,25546,2932,268102,293648,6,2103,3,1714,1,312,77,6,6,3,996,36,17392,1316,155667,173059,10/9/2020
7/12/2020,47,25593,1836,269938,295531,1,2104,3,1717,1,313,74,6,5,3,999,34,17426,943,156610,174036,10/9/2020
7/13/2020,84,25677,3201,273139,298816,8,2112,10,1727,0,313,72,6,5,1,1000,61,17487,1504,158114,175601,10/9/2020
7/14/2020,73,25750,3291,276430,302180,7,2119,4,1731,0,313,75,5,5,1,1001,43,17530,1374,159488,177018,10/9/2020
7/15/2020,130,25880,4172,280602,306482,5,2124,7,1738,0,313,73,5,4,0,1001,99,17629,1751,161239,178868,10/9/2020
7/16/2020,102,25982,3733,284335,310317,6,2130,9,1747,0,313,70,6,5,1,1002,75,17704,1619,162858,180562,10/9/2020
7/17/2020,156,26138,4236,288571,314709,14,2144,3,1750,1,314,80,5,5,2,1004,79,17783,1845,164703,182486,10/9/2020
7/18/2020,85,26223,3267,291838,318061,5,2149,9,1759,1,315,75,5,4,4,1008,70,17853,1399,166102,183955,10/9/2020
7/19/2020,82,26305,2693,294531,320836,7,2156,3,1762,0,315,79,6,4,2,1010,57,17910,1149,167251,185161,10/9/2020
7/20/2020,71,26376,2664,297195,323571,9,2165,7,1769,0,315,81,7,5,2,1012,68,17978,1462,168713,186691,10/9/2020
7/21/2020,130,26506,4298,301493,327999,9,2174,11,1780,0,315,79,9,6,1,1013,109,18087,1918,170631,188718,10/9/2020
7/22/2020,130,26636,3927,305420,332056,11,2185,11,1791,1,316,78,7,6,1,1014,86,18173,1684,172315,190488,10/9/2020
7/23/2020,141,26777,4412,309832,336609,8,2193,6,1797,0,316,80,8,7,0,1014,115,18288,1987,174302,192590,10/9/2020
7/24/2020,172,26949,5959,315791,342740,14,2207,14,1811,0,316,80,9,7,0,1014,119,18407,2321,176623,195030,10/9/2020
7/25/2020,134,27083,4398,320189,347272,7,2214,7,1818,0,316,80,10,8,2,1016,108,18515,2099,178722,197237,10/9/2020
7/26/2020,62,27145,3027,323216,350361,8,2222,9,1827,0,316,79,11,7,1,1017,54,18569,1335,180057,198626,10/9/2020
7/27/2020,188,27333,4190,327406,354739,12,2234,7,1834,0,316,84,13,8,1,1018,138,18707,2349,182406,201113,10/9/2020
7/28/2020,105,27438,3834,331240,358678,5,2239,5,1839,0,316,84,14,7,1,1019,94,18801,1634,184040,202841,10/9/2020
7/29/2020,191,27629,5137,336377,364006,11,2250,12,1851,0,316,83,15,7,0,1019,154,18955,2323,186363,205318,10/9/2020
7/30/2020,121,27750,4344,340721,368471,6,2256,2,1853,1,317,86,15,6,1,1020,97,19052,1648,188011,207063,10/9/2020
7/31/2020,131,27881,5508,346229,374110,8,2264,10,1863,0,317,84,15,7,1,1021,89,19141,1853,189864,209005,10/9/2020
8/1/2020,108,27989,4288,350517,378506,7,2271,2,1865,0,317,89,14,7,1,1022,88,19229,1558,191422,210651,10/9/2020
8/2/2020,84,28073,2802,353319,381392,12,2283,12,1877,2,319,87,14,8,2,1024,62,19291,1273,192695,211986,10/9/2020
8/3/2020,187,28260,5238,358557,386817,13,2296,12,1889,0,319,88,16,7,1,1025,150,19441,2202,194897,214338,10/9/2020
8/4/2020,126,28386,3691,362248,390634,8,2304,6,1895,1,320,89,12,5,2,1027,99,19540,1771,196668,216208,10/9/2020
8/5/2020,148,28534,5932,368180,396714,12,2316,10,1905,1,321,90,10,5,2,1029,118,19658,2471,199139,218797,10/9/2020
8/6/2020,169,28703,5533,373713,402416,7,2323,9,1914,0,321,88,9,4,0,1029,121,19779,2408,201547,221326,10/9/2020
8/7/2020,122,28825,4845,378558,407383,13,2336,10,1924,1,322,90,9,3,2,1031,87,19866,2145,203692,223558,10/9/2020
8/8/2020,123,28948,4106,382664,411612,19,2355,6,1930,1,323,102,8,3,1,1032,92,19958,1779,205471,225429,10/9/2020
8/9/2020,42,28990,1722,384386,413376,8,2363,10,1940,0,323,100,9,4,0,1032,35,19993,1074,206545,226538,10/9/2020
8/10/2020,149,29139,4580,388966,418105,11,2374,12,1952,0,323,99,9,4,1,1033,113,20106,2027,208572,228678,10/9/2020
8/11/2020,105,29244,4325,393291,422535,6,2380,14,1966,0,323,91,10,4,3,1036,92,20198,2266,210838,231036,10/9/2020
8/12/2020,121,29365,5184,398475,427840,8,2388,11,1977,0,323,88,9,3,1,1037,101,20299,2629,213467,233766,10/9/2020
8/13/2020,135,29500,4191,402666,432166,13,2401,12,1989,0,323,89,11,3,0,1037,95,20394,1905,215372,235766,10/9/2020
8/14/2020,145,29645,5492,408158,437803,13,2414,11,2000,0,323,91,11,4,3,1040,99,20493,1975,217347,237840,10/9/2020
8/15/2020,105,29750,4533,412691,442441,8,2422,11,2011,1,324,87,11,5,0,1040,89,20582,1693,219040,239622,10/9/2020
8/16/2020,83,29833,2471,415162,444995,7,2429,6,2017,4,328,84,8,4,6,1046,70,20652,961,220001,240653,10/9/2020
8/17/2020,106,29939,4570,419732,449671,10,2439,7,2024,0,328,87,8,5,2,1048,88,20740,2396,222397,243137,10/9/2020
8/18/2020,128,30067,4904,424636,454703,11,2450,9,2033,1,329,88,8,4,5,1053,95,20835,2755,225152,245987,10/9/2020
8/19/2020,113,30180,5065,429701,459881,8,2458,9,2042,1,330,86,9,5,0,1053,89,20924,2645,227797,248721,10/9/2020
8/20/2020,173,30353,7405,437106,467459,12,2470,6,2048,2,332,90,10,5,3,1056,139,21063,3527,231324,252387,10/9/2020
8/21/2020,151,30504,6570,443676,474180,8,2478,5,2053,1,333,92,9,4,2,1058,126,21189,2948,234272,255461,10/9/2020
8/22/2020,96,30600,5547,449223,479823,10,2488,12,2065,0,333,90,11,4,1,1059,84,21273,2610,236882,258155,10/9/2020
8/23/2020,70,30670,4365,453588,484258,11,2499,6,2071,0,333,95,11,2,1,1060,56,21329,2474,239356,260685,10/9/2020
8/24/2020,105,30775,5776,459364,490139,7,2506,10,2081,1,334,91,13,4,1,1061,77,21406,3159,242515,263921,10/9/2020
8/25/2020,108,30883,4775,464139,495022,10,2516,4,2085,1,335,96,11,4,1,1062,92,21498,2304,244819,266317,10/9/2020
8/26/2020,170,31053,9477,473616,504669,4,2520,8,2093,0,335,92,9,5,1,1063,127,21625,3093,247912,269537,10/9/2020
8/27/2020,93,31146,8592,482208,513354,6,2526,13,2106,1,336,84,6,5,2,1065,71,21696,3191,251103,272799,10/9/2020
8/28/2020,112,31258,7998,490206,521464,14,2540,4,2110,0,336,94,9,7,2,1067,87,21783,2447,253550,275333,10/9/2020
8/29/2020,65,31323,5399,495605,526928,6,2546,8,2118,1,337,91,10,6,2,1069,51,21834,1917,255467,277301,10/9/2020
8/30/2020,66,31389,4319,499924,531313,7,2553,4,2122,0,337,94,8,5,2,1071,48,21882,1996,257463,279345,10/9/2020
8/31/2020,105,31494,4863,504787,536281,12,2565,15,2137,0,337,91,8,4,1,1072,80,21962,2188,259651,281613,10/9/2020
9/1/2020,98,31592,7109,511896,543488,6,2571,9,2146,1,338,87,7,4,2,1074,65,22027,2383,262034,284061,10/9/2020
9/2/2020,125,31717,10523,522419,554136,9,2580,10,2156,1,339,85,8,4,2,1076,104,22131,3065,265099,287230,10/9/2020
9/3/2020,90,31807,11064,533483,565290,8,2588,8,2164,0,339,85,9,4,3,1079,73,22204,2585,267684,289888,10/9/2020
9/4/2020,102,31909,8952,542435,574344,11,2599,4,2168,0,339,92,9,4,1,1080,82,22286,2375,270059,292345,10/9/2020
9/5/2020,52,31961,6300,548735,580696,6,2605,9,2177,0,339,89,8,3,1,1081,42,22328,1603,271662,293990,10/9/2020
9/6/2020,87,32048,4317,553052,585100,4,2609,8,2185,1,340,84,6,3,1,1082,64,22392,1959,273621,296013,10/9/2020
9/7/2020,35,32083,3000,556052,588135,11,2620,3,2188,0,340,92,5,3,1,1083,26,22418,646,274267,296685,10/9/2020
9/8/2020,74,32157,6375,562427,594584,6,2626,12,2200,1,341,85,6,3,2,1085,66,22484,1604,275871,298355,10/9/2020
9/9/2020,118,32275,8638,571065,603340,9,2635,5,2205,1,342,88,9,3,1,1086,101,22585,2147,278018,300603,10/9/2020
9/10/2020,164,32439,11325,582390,614829,9,2644,8,2213,0,342,89,10,3,0,1086,112,22697,2277,280295,302992,10/9/2020
9/11/2020,121,32560,9448,591838,624398,11,2655,11,2224,0,342,89,10,5,0,1086,98,22795,1979,282274,305069,10/9/2020
9/12/2020,109,32669,6143,597981,630650,8,2663,5,2229,2,344,90,9,5,3,1089,97,22892,1506,283780,306672,10/9/2020
9/13/2020,58,32727,2709,600690,633417,4,2667,3,2232,0,344,91,10,5,0,1089,53,22945,858,284638,307583,10/9/2020
9/14/2020,104,32831,6421,607111,639942,5,2672,3,2235,2,346,91,10,5,1,1090,95,23040,1726,286364,309404,10/9/2020
9/15/2020,122,32953,8448,615559,648512,6,2678,2,2237,1,347,94,10,5,2,1092,124,23164,2197,288561,311725,10/9/2020
9/16/2020,137,33090,9700,625259,658349,7,2685,7,2244,2,349,92,8,6,5,1097,118,23282,1979,290540,313822,10/9/2020
9/17/2020,124,33214,9222,634481,667695,7,2692,14,2258,0,349,85,8,4,0,1097,154,23436,1955,292495,315931,10/9/2020
9/18/2020,132,33346,10016,644497,677843,7,2699,7,2265,1,350,84,11,6,2,1099,132,23568,1941,294436,318004,10/9/2020
9/19/2020,116,33462,8290,652787,686249,7,2706,3,2268,0,350,88,10,6,4,1103,112,23680,1705,296141,319821,10/9/2020
9/20/2020,60,33522,3668,656455,689977,7,2713,6,2274,2,352,87,10,8,4,1107,48,23728,1327,297468,321196,10/9/2020
9/21/2020,103,33625,7001,663456,697081,12,2725,3,2277,2,354,94,9,6,2,1109,93,23821,2417,299885,323706,10/9/2020
9/22/2020,154,33779,9269,672725,706504,12,2737,3,2280,1,355,102,8,5,1,1110,125,23946,2223,302108,326054,10/9/2020
9/23/2020,136,33915,10625,683350,717265,11,2748,7,2287,0,355,106,7,5,0,1110,125,24071,2230,304338,328409,10/9/2020
9/24/2020,119,34034,12450,695800,729834,7,2755,9,2296,1,356,103,8,5,1,1111,116,24187,3175,307513,331700,10/9/2020
9/25/2020,149,34183,10534,706334,740517,9,2764,10,2306,0,356,102,7,5,1,1112,144,24331,3028,310541,334872,10/9/2020
9/26/2020,146,34329,10544,716878,751207,12,2776,9,2315,0,356,105,7,5,1,1113,116,24447,2434,312975,337422,10/9/2020
9/27/2020,42,34371,2761,719639,754010,7,2783,5,2320,0,356,107,10,5,0,1113,33,24480,851,313826,338306,10/9/2020
9/28/2020,151,34522,7285,726924,761446,6,2789,6,2326,2,358,105,8,5,2,1115,130,24610,2269,316095,340705,10/9/2020
9/29/2020,208,34730,11008,737932,772662,11,2800,18,2344,1,359,97,7,6,1,1116,190,24800,2830,318925,343725,10/9/2020
9/30/2020,221,34951,12204,750136,785087,6,2806,6,2350,0,359,97,7,6,1,1117,186,24986,2607,321532,346518,10/9/2020
10/1/2020,184,35135,12476,762612,797747,16,2822,13,2363,1,360,99,6,4,1,1118,161,25147,2434,323966,349113,10/9/2020
10/2/2020,209,35344,12123,774735,810079,12,2834,13,2376,1,361,97,7,4,1,1119,180,25327,2512,326478,351805,10/9/2020
10/3/2020,172,35516,9631,784366,819882,9,2843,9,2385,2,363,95,8,4,2,1121,128,25455,2284,328762,354217,10/9/2020
10/4/2020,81,35597,2354,786720,822317,11,2854,9,2394,1,364,96,8,4,2,1123,71,25526,963,329725,355251,10/9/2020
10/5/2020,160,35757,8653,795373,831130,26,2880,10,2404,2,366,110,10,5,3,1126,161,25687,2806,332531,358218,10/9/2020
10/6/2020,180,35937,10868,806241,842178,12,2892,4,2408,0,366,118,12,6,0,1126,189,25876,2897,335428,361304,10/9/2020
10/7/2020,226,36163,12172,818413,854576,10,2902,14,2422,2,368,112,10,6,1,1127,251,26127,3446,338874,365001,10/9/2020
10/8/2020,182,36345,9880,828293,864638,,,,,,,,,,3,1130,167,26294,2893,341767,368061,10/9/2020
2/27/2020,0,0,0,0,0,1,1,0,0,0,0,1,0,0,0,0,0,0,0,0,0,10/13/2020
2/28/2020,0,0,0,0,0,0,1,0,0,0,0,1,1,0,0,0,0,0,0,0,0,10/13/2020
2/29/2020,0,0,0,0,0,0,1,0,0,0,0,1,1,0,0,0,0,0,0,0,0,10/13/2020
3/1/2020,2,2,2,2,4,0,1,0,0,0,0,1,1,1,0,0,2,2,2,2,4,10/13/2020
3/2/2020,0,2,1,3,5,1,2,0,0,0,0,2,2,2,0,0,0,2,1,3,5,10/13/2020
3/3/2020,0,2,2,5,7,0,2,0,0,0,0,2,2,2,0,0,0,2,2,5,7,10/13/2020
3/4/2020,0,2,12,17,19,1,3,0,0,0,0,3,2,2,0,0,0,2,10,15,17,10/13/2020
3/5/2020,0,2,4,21,23,0,3,0,0,0,0,3,2,2,0,0,1,3,4,19,22,10/13/2020
3/6/2020,1,3,12,33,36,0,3,0,0,0,0,3,2,2,0,0,0,3,11,30,33,10/13/2020
3/7/2020,0,3,19,52,55,0,3,0,0,0,0,3,2,1,0,0,0,3,19,49,52,10/13/2020
3/8/2020,0,3,18,70,73,0,3,0,0,0,0,3,2,1,0,0,0,3,18,67,70,10/13/2020
3/9/2020,1,4,15,85,89,0,3,0,0,0,0,3,2,1,0,0,1,4,15,82,86,10/13/2020
3/10/2020,2,6,25,110,116,0,3,0,0,0,0,3,2,1,0,0,1,5,23,105,110,10/13/2020
3/11/2020,0,6,34,144,150,1,4,0,0,0,0,4,1,1,0,0,0,5,34,139,144,10/13/2020
3/12/2020,9,15,41,185,200,1,5,0,0,0,0,5,1,1,0,0,8,13,38,177,190,10/13/2020
3/13/2020,6,21,50,235,256,4,9,1,1,0,0,8,1,1,0,0,6,19,48,225,244,10/13/2020
3/14/2020,0,21,90,325,346,0,9,0,1,0,0,8,1,1,0,0,0,19,86,311,330,10/13/2020
3/15/2020,1,22,54,379,401,1,10,0,1,0,0,9,2,1,0,0,1,20,54,365,385,10/13/2020
3/16/2020,2,24,95,474,498,2,12,0,1,0,0,11,2,0,0,0,2,22,92,457,479,10/13/2020
3/17/2020,12,36,162,636,672,6,18,0,1,0,0,17,2,0,0,0,11,33,151,608,641,10/13/2020
3/18/2020,9,45,116,752,797,3,21,0,1,0,0,20,2,0,0,0,11,44,110,718,762,10/13/2020
3/19/2020,15,60,262,1014,1074,2,23,1,2,0,0,21,3,0,1,1,17,61,251,969,1030,10/13/2020
3/20/2020,13,73,197,1211,1284,5,28,0,2,0,0,26,4,0,0,1,13,74,190,1159,1233,10/13/2020
3/21/2020,12,85,126,1337,1422,3,31,2,4,0,0,27,5,0,0,1,14,88,123,1282,1370,10/13/2020
3/22/2020,27,112,282,1619,1731,2,33,0,4,0,0,29,5,0,0,1,25,113,261,1543,1656,10/13/2020
3/23/2020,14,126,169,1788,1914,15,48,1,5,0,0,43,9,3,0,1,16,129,165,1708,1837,10/13/2020
3/24/2020,20,146,242,2030,2176,7,55,0,5,0,0,50,10,4,0,1,19,148,237,1945,2093,10/13/2020
3/25/2020,26,172,182,2212,2384,5,60,1,6,0,0,54,11,3,0,1,28,176,171,2116,2292,10/13/2020
3/26/2020,35,207,181,2393,2600,10,70,5,11,0,0,59,14,5,0,1,41,217,174,2290,2507,10/13/2020
3/27/2020,27,234,214,2607,2841,9,79,1,12,1,1,66,17,6,2,3,31,248,200,2490,2738,10/13/2020
3/28/2020,59,293,260,2867,3160,13,92,3,15,2,3,74,15,6,1,4,64,312,240,2730,3042,10/13/2020
3/29/2020,100,393,350,3217,3610,8,100,4,19,1,4,77,18,8,2,6,105,417,313,3043,3460,10/13/2020
3/30/2020,62,455,222,3439,3894,20,120,5,24,0,4,92,20,11,3,9,78,495,184,3227,3722,10/13/2020
3/31/2020,71,526,369,3808,4334,11,131,7,31,1,5,95,22,13,2,11,73,568,295,3522,4090,10/13/2020
4/1/2020,99,625,698,4506,5131,18,149,7,38,0,5,106,30,15,1,12,100,668,640,4162,4830,10/13/2020
4/2/2020,52,677,477,4983,5660,22,171,6,44,2,7,120,36,21,4,16,62,730,435,4597,5327,10/13/2020
4/3/2020,108,785,774,5757,6542,23,194,7,51,0,7,136,43,25,3,19,100,830,710,5307,6137,10/13/2020
4/4/2020,143,928,660,6417,7345,22,216,4,55,5,12,149,41,30,9,28,138,968,617,5924,6892,10/13/2020
4/5/2020,187,1115,1156,7573,8688,20,236,9,64,1,13,159,44,36,2,30,181,1149,1062,6986,8135,10/13/2020
4/6/2020,218,1333,1706,9279,10612,26,262,7,71,0,13,178,48,40,7,37,207,1356,1546,8532,9888,10/13/2020
4/7/2020,284,1617,1629,10908,12525,20,282,5,76,2,15,191,50,42,5,42,261,1617,1473,10005,11622,10/13/2020
4/8/2020,290,1907,1720,12628,14535,19,301,7,83,6,21,197,50,38,10,52,271,1888,1555,11560,13448,10/13/2020
4/9/2020,283,2190,1516,14144,16334,32,333,9,92,4,25,216,53,40,7,59,277,2165,1352,12912,15077,10/13/2020
4/10/2020,419,2609,2574,16718,19327,29,362,16,108,5,30,224,59,41,11,70,402,2567,2364,15276,17843,10/13/2020
4/11/2020,297,2906,1905,18623,21529,29,391,11,119,2,32,240,61,48,12,82,280,2847,1713,16989,19836,10/13/2020
4/12/2020,314,3220,1670,20293,23513,35,426,13,132,5,37,257,59,49,9,91,284,3131,1429,18418,21549,10/13/2020
4/13/2020,161,3381,935,21228,24609,35,461,13,145,3,40,276,64,54,9,100,187,3318,837,19255,22573,10/13/2020
4/14/2020,289,3670,1787,23015,26685,27,488,17,162,5,45,281,72,53,8,108,262,3580,1526,20781,24361,10/13/2020
4/15/2020,351,4021,1799,24814,28835,31,519,20,182,3,48,289,72,54,17,125,306,3886,1546,22327,26213,10/13/2020
4/16/2020,447,4468,2494,27308,31776,36,555,25,207,6,54,294,72,53,14,139,387,4273,2068,24395,28668,10/13/2020
4/17/2020,304,4772,1821,29129,33901,32,587,20,227,7,61,299,66,45,21,160,290,4563,1443,25838,30401,10/13/2020
4/18/2020,321,5093,1725,30854,35947,26,613,18,245,4,65,303,63,49,15,175,284,4847,1320,27158,32005,10/13/2020
4/19/2020,381,5474,2047,32901,38375,23,636,26,271,1,66,299,65,55,11,186,336,5183,1737,28895,34078,10/13/2020
4/20/2020,394,5868,1907,34808,40676,46,682,29,300,2,68,314,75,56,10,196,376,5559,1565,30460,36019,10/13/2020
4/21/2020,444,6312,2110,36918,43230,45,727,33,333,5,73,321,72,56,18,214,384,5943,1699,32159,38102,10/13/2020
4/22/2020,418,6730,2390,39308,46038,41,768,32,365,5,78,325,73,58,18,232,379,6322,1912,34071,40393,10/13/2020
4/23/2020,479,7209,2469,41777,48986,32,800,28,393,5,83,324,76,62,15,247,412,6734,1850,35921,42655,10/13/2020
4/24/2020,491,7700,3284,45061,52761,35,835,26,419,4,87,329,85,63,15,262,407,7141,2620,38541,45682,10/13/2020
4/25/2020,393,8093,2206,47267,55360,34,869,17,436,5,92,341,85,62,14,276,300,7441,1760,40301,47742,10/13/2020
4/26/2020,316,8409,2309,49576,57985,33,902,15,451,3,95,356,86,59,14,290,274,7715,1872,42173,49888,10/13/2020
4/27/2020,249,8658,1620,51196,59854,29,931,21,472,4,99,360,86,61,10,300,206,7921,1158,43331,51252,10/13/2020
4/28/2020,410,9068,2263,53459,62527,44,975,24,496,3,102,377,88,59,22,322,331,8252,1758,45089,53341,10/13/2020
4/29/2020,476,9544,3343,56802,66346,36,1011,38,534,11,113,364,78,53,18,340,371,8623,2417,47506,56129,10/13/2020
4/30/2020,432,9976,2769,59571,69547,33,1044,38,572,6,119,353,83,57,24,364,350,8973,1906,49412,58385,10/13/2020
5/1/2020,454,10430,3086,62657,73087,51,1095,39,611,3,122,362,84,58,14,378,324,9297,2159,51571,60868,10/13/2020
5/2/2020,257,10687,1926,64583,75270,36,1131,38,649,5,127,355,91,62,24,402,192,9489,1268,52839,62328,10/13/2020
5/3/2020,283,10970,2160,66743,77713,31,1162,26,675,8,135,352,90,61,21,423,183,9672,1572,54411,64083,10/13/2020
5/4/2020,387,11357,2098,68841,80198,30,1192,31,706,6,141,345,88,57,18,441,290,9962,1558,55969,65931,10/13/2020
5/5/2020,433,11790,2873,71714,83504,29,1221,32,738,6,147,336,82,54,16,457,300,10262,1956,57925,68187,10/13/2020
5/6/2020,488,12278,2830,74544,86822,28,1249,44,782,9,156,311,79,54,21,478,340,10602,1914,59839,70441,10/13/2020
5/7/2020,425,12703,2969,77513,90216,36,1285,41,823,5,161,301,71,52,21,499,270,10872,1958,61797,72669,10/13/2020
5/8/2020,359,13062,2598,80111,93173,30,1315,29,852,5,166,297,71,53,22,521,230,11102,1735,63532,74634,10/13/2020
5/9/2020,467,13529,3346,83457,96986,22,1337,21,873,4,170,294,69,51,15,536,290,11392,2255,65787,77179,10/13/2020
5/10/2020,285,13814,2117,85574,99388,20,1357,23,896,6,176,285,70,49,13,549,189,11581,1521,67308,78889,10/13/2020
5/11/2020,257,14071,1857,87431,101502,31,1388,16,912,6,182,294,71,49,15,564,174,11755,1300,68608,80363,10/13/2020
5/12/2020,387,14458,2611,90042,104500,23,1411,18,930,4,186,295,69,48,22,586,224,11979,1701,70309,82288,10/13/2020
5/13/2020,351,14809,3630,93672,108481,23,1434,25,955,1,187,292,69,49,13,599,199,12178,1999,72308,84486,10/13/2020
5/14/2020,329,15138,3408,97080,112218,19,1453,27,982,3,190,281,64,45,15,614,230,12408,2013,74321,86729,10/13/2020
5/15/2020,381,15519,3458,100538,116057,24,1477,41,1023,5,195,259,62,45,14,628,232,12640,1803,76124,88764,10/13/2020
5/16/2020,449,15968,4156,104694,120662,25,1502,13,1036,5,200,266,61,46,15,643,247,12887,1959,78083,90970,10/13/2020
5/17/2020,240,16208,2768,107462,123670,17,1519,8,1044,5,205,270,59,45,10,653,126,13013,1554,79637,92650,10/13/2020
5/18/2020,250,16458,2001,109463,125921,19,1538,15,1059,5,210,269,57,40,18,671,135,13148,1366,81003,94151,10/13/2020
5/19/2020,415,16873,3168,112631,129504,23,1561,32,1091,5,215,255,56,38,11,682,215,13363,1925,82928,96291,10/13/2020
5/20/2020,326,17199,2771,115402,132601,19,1580,23,1114,7,222,244,52,33,22,704,183,13546,1511,84439,97985,10/13/2020
5/21/2020,374,17573,3757,119159,136732,26,1606,15,1129,3,225,252,53,29,20,724,168,13714,1936,86375,100089,10/13/2020
5/22/2020,351,17924,3161,122320,140244,20,1626,29,1158,5,230,238,52,29,10,734,206,13920,1605,87980,101900,10/13/2020
5/23/2020,253,18177,2742,125062,143239,19,1645,11,1169,3,233,243,52,32,13,747,109,14029,1269,89249,103278,10/13/2020
5/24/2020,163,18340,1370,126432,144772,13,1658,14,1183,2,235,240,53,36,8,755,83,14112,772,90021,104133,10/13/2020
5/25/2020,147,18487,1385,127817,146304,14,1672,14,1197,0,235,240,53,34,10,765,76,14188,762,90783,104971,10/13/2020
5/26/2020,285,18772,2620,130437,149209,24,1696,22,1219,5,240,237,48,33,15,780,157,14345,1778,92561,106906,10/13/2020
5/27/2020,276,19048,2057,132494,151542,20,1716,18,1237,3,243,236,50,33,10,790,132,14477,1132,93693,108170,10/13/2020
5/28/2020,348,19396,3359,135853,155249,17,1733,29,1266,4,247,220,47,32,8,798,130,14607,1116,94809,109416,10/13/2020
5/29/2020,410,19806,3914,139767,159573,19,1752,27,1293,6,253,206,43,31,12,810,174,14781,1570,96379,111160,10/13/2020
5/30/2020,225,20031,3915,143682,163713,16,1768,19,1312,4,257,199,41,29,12,822,109,14890,1817,98196,113086,10/13/2020
5/31/2020,155,20186,1688,145370,165556,11,1779,10,1322,1,258,199,44,26,3,825,78,14968,855,99051,114019,10/13/2020
6/1/2020,212,20398,2792,148162,168560,8,1787,14,1336,1,259,192,45,29,5,830,93,15061,1383,100434,115495,10/13/2020
6/2/2020,273,20671,3022,151184,171855,8,1795,9,1345,3,262,188,38,25,10,840,98,15159,1445,101879,117038,10/13/2020
6/3/2020,254,20925,3486,154670,175595,14,1809,18,1363,6,268,178,34,25,11,851,99,15258,1657,103536,118794,10/13/2020
6/4/2020,276,21201,4471,159141,180342,7,1816,25,1388,4,272,156,31,24,11,862,107,15365,2034,105570,120935,10/13/2020
6/5/2020,215,21416,3513,162654,184070,15,1831,13,1401,6,278,152,27,21,11,873,99,15464,1570,107140,122604,10/13/2020
6/6/2020,201,21617,2616,165270,186887,10,1841,7,1408,2,280,153,29,19,6,879,67,15531,1133,108273,123804,10/13/2020
6/7/2020,83,21700,1625,166895,188595,11,1852,7,1415,1,281,156,25,17,4,883,51,15582,781,109054,124636,10/13/2020
6/8/2020,119,21819,1849,168744,190563,15,1867,12,1427,2,283,157,27,18,4,887,45,15627,957,110011,125638,10/13/2020
6/9/2020,223,22042,2673,171417,193459,10,1877,18,1445,0,283,149,28,21,1,888,64,15691,1254,111265,126956,10/13/2020
6/10/2020,209,22251,2987,174404,196655,13,1890,12,1457,2,285,148,24,17,4,892,101,15792,1464,112729,128521,10/13/2020
6/11/2020,195,22446,3513,177917,200363,7,1897,15,1472,1,286,139,25,16,6,898,88,15880,1532,114261,130141,10/13/2020
6/12/2020,209,22655,4601,182518,205173,9,1906,15,1487,1,287,132,24,16,2,900,78,15958,2178,116439,132397,10/13/2020
6/13/2020,113,22768,3036,185554,208322,6,1912,5,1492,0,287,133,20,15,3,903,49,16007,1371,117810,133817,10/13/2020
6/14/2020,81,22849,2046,187600,210449,7,1919,8,1500,1,288,131,20,14,3,906,33,16040,967,118777,134817,10/13/2020
6/15/2020,188,23037,3108,190708,213745,14,1933,14,1514,0,288,131,20,16,5,911,75,16115,1788,120565,136680,10/13/2020
6/16/2020,110,23147,3017,193725,216872,11,1944,9,1523,1,289,132,22,16,8,919,50,16165,1576,122141,138306,10/13/2020
6/17/2020,127,23274,2835,196560,219834,15,1959,20,1543,4,293,123,18,14,6,925,50,16215,1318,123459,139674,10/13/2020
6/18/2020,149,23423,3047,199607,223030,9,1968,13,1556,1,294,118,19,16,7,932,70,16285,1311,124770,141055,10/13/2020
6/19/2020,141,23564,3769,203376,226940,12,1980,11,1567,1,295,118,20,17,3,935,59,16344,1370,126140,142484,10/13/2020
6/20/2020,84,23648,1891,205267,228915,9,1989,12,1579,0,295,115,20,18,4,939,36,16380,812,126952,143332,10/13/2020
6/21/2020,37,23685,1064,206331,230016,8,1997,5,1584,0,295,118,20,18,2,941,29,16409,692,127644,144053,10/13/2020
6/22/2020,138,23823,3730,210061,233884,12,2009,16,1600,0,295,114,19,18,2,943,65,16474,1704,129348,145822,10/13/2020
6/23/2020,163,23986,3831,213892,237878,3,2012,13,1613,3,298,101,18,18,7,950,81,16555,1779,131127,147682,10/13/2020
6/24/2020,120,24106,3502,217394,241500,9,2021,10,1623,1,299,99,18,18,5,955,44,16599,1681,132808,149407,10/13/2020
6/25/2020,103,24209,2883,220277,244486,6,2027,14,1637,1,300,90,17,17,1,956,50,16649,1509,134317,150966,10/13/2020
6/26/2020,94,24303,2488,222765,247068,2,2029,10,1647,0,300,82,18,18,1,957,60,16709,1329,135646,152355,10/13/2020
6/27/2020,84,24387,3214,225979,250366,5,2034,3,1650,1,301,83,17,17,5,962,37,16746,1215,136861,153607,10/13/2020
6/28/2020,39,24426,1469,227448,251874,4,2038,4,1654,4,305,79,15,14,6,968,17,16763,595,137456,154219,10/13/2020
6/29/2020,85,24511,3697,231145,255656,4,2042,5,1659,0,305,78,14,14,1,969,39,16802,1351,138807,155609,10/13/2020
6/30/2020,57,24568,1957,233102,257670,1,2043,5,1664,1,306,73,12,11,4,973,33,16835,993,139800,156635,10/13/2020
7/1/2020,144,24712,4098,237200,261912,8,2051,10,1674,0,306,71,11,11,1,974,79,16914,1928,141728,158642,10/13/2020
7/2/2020,103,24815,2803,240003,264818,5,2056,5,1679,1,307,70,10,10,3,977,59,16973,1087,142815,159788,10/13/2020
7/3/2020,50,24865,2076,242079,266944,9,2065,6,1685,0,307,73,9,9,3,980,25,16998,777,143592,160590,10/13/2020
7/4/2020,57,24922,2345,244424,269346,2,2067,4,1689,1,308,70,10,9,2,982,33,17031,1010,144602,161633,10/13/2020
7/5/2020,49,24971,2932,247356,272327,1,2068,2,1691,1,309,68,8,8,2,984,26,17057,1441,146043,163100,10/13/2020
7/6/2020,101,25072,2811,250167,275239,6,2074,6,1697,0,309,68,9,9,4,988,57,17114,1549,147592,164706,10/13/2020
7/7/2020,81,25153,3457,253624,278777,5,2079,7,1704,0,309,66,8,8,2,990,47,17161,1534,149126,166287,10/13/2020
7/8/2020,105,25258,3403,257027,282285,4,2083,2,1706,0,309,68,9,8,0,990,64,17225,1423,150549,167774,10/13/2020
7/9/2020,94,25352,3712,260739,286091,9,2092,3,1709,0,309,74,9,8,0,990,50,17275,1624,152173,169448,10/13/2020
7/10/2020,131,25483,4431,265170,290653,6,2098,3,1712,2,311,75,7,7,3,993,80,17355,2072,154245,171600,10/13/2020
7/11/2020,63,25546,2932,268102,293648,6,2104,3,1715,1,312,77,6,6,3,996,36,17391,1315,155560,172951,10/13/2020
7/12/2020,47,25593,1836,269938,295531,1,2105,3,1718,1,313,74,6,5,3,999,34,17425,942,156502,173927,10/13/2020
7/13/2020,84,25677,3201,273139,298816,8,2113,10,1728,0,313,72,6,5,1,1000,61,17486,1503,158005,175491,10/13/2020
7/14/2020,73,25750,3291,276430,302180,7,2120,4,1732,0,313,75,5,5,1,1001,43,17529,1373,159378,176907,10/13/2020
7/15/2020,130,25880,4172,280602,306482,5,2125,7,1739,0,313,73,5,4,0,1001,99,17628,1749,161127,178755,10/13/2020
7/16/2020,102,25982,3733,284335,310317,6,2131,9,1748,0,313,70,6,5,1,1002,75,17703,1619,162746,180449,10/13/2020
7/17/2020,156,26138,4236,288571,314709,14,2145,3,1751,1,314,80,5,5,2,1004,79,17782,1845,164591,182373,10/13/2020
7/18/2020,85,26223,3267,291838,318061,5,2150,9,1760,1,315,75,5,4,4,1008,70,17852,1399,165990,183842,10/13/2020
7/19/2020,82,26305,2693,294531,320836,7,2157,3,1763,0,315,79,6,4,2,1010,57,17909,1148,167138,185047,10/13/2020
7/20/2020,71,26376,2664,297195,323571,9,2166,7,1770,0,315,81,7,5,2,1012,68,17977,1460,168598,186575,10/13/2020
7/21/2020,130,26506,4298,301493,327999,9,2175,11,1781,0,315,79,9,6,1,1013,109,18086,1918,170516,188602,10/13/2020
7/22/2020,130,26636,3927,305420,332056,11,2186,11,1792,1,316,78,7,6,1,1014,86,18172,1684,172200,190372,10/13/2020
7/23/2020,141,26777,4412,309832,336609,8,2194,6,1798,0,316,80,8,7,0,1014,115,18287,1984,174184,192471,10/13/2020
7/24/2020,172,26949,5960,315792,342741,14,2208,14,1812,0,316,80,9,7,0,1014,119,18406,2319,176503,194909,10/13/2020
7/25/2020,134,27083,4398,320190,347273,7,2215,7,1819,0,316,80,10,8,2,1016,108,18514,2096,178599,197113,10/13/2020
7/26/2020,62,27145,3027,323217,350362,8,2223,9,1828,0,316,79,11,7,1,1017,54,18568,1335,179934,198502,10/13/2020
7/27/2020,188,27333,4190,327407,354740,12,2235,7,1835,0,316,84,13,8,1,1018,138,18706,2345,182279,200985,10/13/2020
7/28/2020,105,27438,3834,331241,358679,5,2240,5,1840,0,316,84,14,7,1,1019,94,18800,1633,183912,202712,10/13/2020
7/29/2020,191,27629,5137,336378,364007,11,2251,12,1852,0,316,83,15,7,0,1019,154,18954,2322,186234,205188,10/13/2020
7/30/2020,121,27750,4344,340722,368472,6,2257,2,1854,1,317,86,15,6,1,1020,97,19051,1648,187882,206933,10/13/2020
7/31/2020,131,27881,5508,346230,374111,8,2265,10,1864,0,317,84,15,7,1,1021,89,19140,1853,189735,208875,10/13/2020
8/1/2020,108,27989,4288,350518,378507,7,2272,2,1866,0,317,89,14,7,1,1022,88,19228,1558,191293,210521,10/13/2020
8/2/2020,84,28073,2802,353320,381393,12,2284,12,1878,2,319,87,14,8,2,1024,62,19290,1273,192566,211856,10/13/2020
8/3/2020,187,28260,5238,358558,386818,13,2297,12,1890,0,319,88,16,7,1,1025,150,19440,2202,194768,214208,10/13/2020
8/4/2020,126,28386,3691,362249,390635,8,2305,6,1896,1,320,89,12,5,2,1027,99,19539,1771,196539,216078,10/13/2020
8/5/2020,148,28534,5933,368182,396716,12,2317,10,1906,1,321,90,10,5,2,1029,118,19657,2469,199008,218665,10/13/2020
8/6/2020,169,28703,5532,373714,402417,7,2324,9,1915,0,321,88,9,4,0,1029,121,19778,2406,201414,221192,10/13/2020
8/7/2020,122,28825,4845,378559,407384,13,2337,10,1925,1,322,90,9,3,2,1031,87,19865,2141,203555,223420,10/13/2020
8/8/2020,123,28948,4106,382665,411613,19,2356,6,1931,1,323,102,8,3,1,1032,92,19957,1779,205334,225291,10/13/2020
8/9/2020,42,28990,1722,384387,413377,8,2364,10,1941,0,323,100,9,4,0,1032,35,19992,1073,206407,226399,10/13/2020
8/10/2020,149,29139,4580,388967,418106,11,2375,12,1953,0,323,99,9,4,1,1033,113,20105,2023,208430,228535,10/13/2020
8/11/2020,105,29244,4325,393292,422536,6,2381,14,1967,0,323,91,10,4,3,1036,92,20197,2265,210695,230892,10/13/2020
8/12/2020,121,29365,5184,398476,427841,8,2389,11,1978,0,323,88,9,3,1,1037,101,20298,2628,213323,233621,10/13/2020
8/13/2020,135,29500,4191,402667,432167,13,2402,12,1990,0,323,89,11,3,0,1037,95,20393,1905,215228,235621,10/13/2020
8/14/2020,145,29645,5492,408159,437804,13,2415,11,2001,0,323,91,11,4,3,1040,99,20492,1971,217199,237691,10/13/2020
8/15/2020,105,29750,4533,412692,442442,9,2424,11,2012,1,324,88,11,5,0,1040,89,20581,1691,218890,239471,10/13/2020
8/16/2020,83,29833,2471,415163,444996,7,2431,6,2018,4,328,85,8,4,6,1046,70,20651,961,219851,240502,10/13/2020
8/17/2020,106,29939,4570,419733,449672,10,2441,7,2025,0,328,88,8,5,2,1048,88,20739,2395,222246,242985,10/13/2020
8/18/2020,128,30067,4904,424637,454704,11,2452,9,2034,1,329,89,8,4,5,1053,94,20833,2755,225001,245834,10/13/2020
8/19/2020,113,30180,5065,429702,459882,8,2460,9,2043,1,330,87,9,5,0,1053,90,20923,2645,227646,248569,10/13/2020
8/20/2020,173,30353,7405,437107,467460,12,2472,6,2049,2,332,91,10,5,3,1056,139,21062,3526,231172,252234,10/13/2020
8/21/2020,151,30504,6570,443677,474181,8,2480,5,2054,1,333,93,9,4,2,1058,125,21187,2947,234119,255306,10/13/2020
8/22/2020,96,30600,5547,449224,479824,10,2490,12,2066,0,333,91,11,4,1,1059,84,21271,2609,236728,257999,10/13/2020
8/23/2020,70,30670,4365,453589,484259,11,2501,6,2072,0,333,96,11,2,1,1060,56,21327,2472,239200,260527,10/13/2020
8/24/2020,105,30775,5775,459364,490139,7,2508,10,2082,1,334,92,13,4,1,1061,77,21404,3155,242355,263759,10/13/2020
8/25/2020,108,30883,4757,464121,495004,10,2518,4,2086,1,335,97,11,4,1,1062,92,21496,2294,244649,266145,10/13/2020
8/26/2020,170,31053,9476,473597,504650,4,2522,8,2094,0,335,93,9,5,1,1063,127,21623,3090,247739,269362,10/13/2020
8/27/2020,92,31145,8563,482160,513305,6,2528,13,2107,1,336,85,6,5,2,1065,70,21693,3172,250911,272604,10/13/2020
8/28/2020,112,31257,7991,490151,521408,14,2542,4,2111,0,336,95,9,7,2,1067,87,21780,2442,253353,275133,10/13/2020
8/29/2020,65,31322,5368,495519,526841,6,2548,8,2119,1,337,92,10,6,2,1069,51,21831,1916,255269,277100,10/13/2020
8/30/2020,66,31388,4314,499833,531221,7,2555,4,2123,0,337,95,8,5,2,1071,48,21879,1994,257263,279142,10/13/2020
8/31/2020,105,31493,4862,504695,536188,12,2567,15,2138,0,337,92,8,4,1,1072,81,21960,2189,259452,281412,10/13/2020
9/1/2020,98,31591,7109,511804,543395,6,2573,9,2147,1,338,88,7,4,2,1074,65,22025,2383,261835,283860,10/13/2020
9/2/2020,125,31716,10524,522328,554044,9,2582,10,2157,1,339,86,8,4,2,1076,104,22129,3062,264897,287026,10/13/2020
9/3/2020,90,31806,11065,533393,565199,8,2590,8,2165,0,339,86,9,4,3,1079,73,22202,2586,267483,289685,10/13/2020
9/4/2020,102,31908,8952,542345,574253,11,2601,4,2169,0,339,93,9,4,1,1080,83,22285,2376,269859,292144,10/13/2020
9/5/2020,52,31960,6300,548645,580605,6,2607,9,2178,0,339,90,8,3,1,1081,42,22327,1603,271462,293789,10/13/2020
9/6/2020,87,32047,4317,552962,585009,4,2611,8,2186,1,340,85,6,3,1,1082,64,22391,1957,273419,295810,10/13/2020
9/7/2020,35,32082,3000,555962,588044,11,2622,3,2189,0,340,93,5,3,1,1083,26,22417,646,274065,296482,10/13/2020
9/8/2020,74,32156,6375,562337,594493,6,2628,12,2201,1,341,86,6,3,2,1085,66,22483,1603,275668,298151,10/13/2020
9/9/2020,118,32274,8640,570977,603251,9,2637,5,2206,1,342,89,9,3,1,1086,102,22585,2148,277816,300401,10/13/2020
9/10/2020,164,32438,11326,582303,614741,9,2646,8,2214,0,342,90,10,3,0,1086,111,22696,2277,280093,302789,10/13/2020
9/11/2020,121,32559,9448,591751,624310,11,2657,11,2225,0,342,90,10,5,0,1086,98,22794,1977,282070,304864,10/13/2020
9/12/2020,109,32668,6143,597894,630562,8,2665,5,2230,2,344,91,9,5,3,1089,97,22891,1506,283576,306467,10/13/2020
9/13/2020,58,32726,2709,600603,633329,4,2669,3,2233,0,344,92,10,5,0,1089,54,22945,859,284435,307380,10/13/2020
9/14/2020,104,32830,6421,607024,639854,5,2674,3,2236,2,346,92,10,5,1,1090,95,23040,1727,286162,309202,10/13/2020
9/15/2020,122,32952,8449,615473,648425,6,2680,2,2238,1,347,95,10,5,2,1092,124,23164,2197,288359,311523,10/13/2020
9/16/2020,137,33089,9701,625174,658263,7,2687,7,2245,2,349,93,8,6,5,1097,118,23282,1976,290335,313617,10/13/2020
9/17/2020,124,33213,9222,634396,667609,7,2694,14,2259,0,349,86,8,4,0,1097,154,23436,1952,292287,315723,10/13/2020
9/18/2020,132,33345,10016,644412,677757,7,2701,7,2266,1,350,85,11,6,2,1099,132,23568,1936,294223,317791,10/13/2020
9/19/2020,116,33461,8290,652702,686163,7,2708,3,2269,0,350,89,10,6,4,1103,112,23680,1704,295927,319607,10/13/2020
9/20/2020,60,33521,3668,656370,689891,7,2715,6,2275,2,352,88,10,8,4,1107,48,23728,1327,297254,320982,10/13/2020
9/21/2020,103,33624,7001,663371,696995,12,2727,3,2278,2,354,95,9,6,2,1109,93,23821,2415,299669,323490,10/13/2020
9/22/2020,154,33778,9269,672640,706418,12,2739,3,2281,1,355,103,8,5,1,1110,125,23946,2215,301884,325830,10/13/2020
9/23/2020,136,33914,10625,683265,717179,10,2749,7,2288,0,355,106,7,5,0,1110,127,24073,2224,304108,328181,10/13/2020
9/24/2020,119,34033,12451,695716,729749,7,2756,9,2297,1,356,103,8,5,1,1111,117,24190,3173,307281,331471,10/13/2020
9/25/2020,149,34182,10534,706250,740432,9,2765,10,2307,0,356,102,7,5,1,1112,144,24334,3026,310307,334641,10/13/2020
9/26/2020,146,34328,10544,716794,751122,12,2777,9,2316,0,356,105,7,5,1,1113,117,24451,2431,312738,337189,10/13/2020
9/27/2020,42,34370,2761,719555,753925,7,2784,5,2321,0,356,107,10,5,0,1113,34,24485,849,313587,338072,10/13/2020
9/28/2020,151,34521,7285,726840,761361,6,2790,6,2327,2,358,105,8,5,2,1115,132,24617,2266,315853,340470,10/13/2020
9/29/2020,208,34729,11017,737857,772586,11,2801,18,2345,1,359,97,7,6,1,1116,190,24807,2832,318685,343492,10/13/2020
9/30/2020,221,34950,12206,750063,785013,6,2807,6,2351,0,359,97,7,6,1,1117,186,24993,2603,321288,346281,10/13/2020
10/1/2020,184,35134,12481,762544,797678,16,2823,13,2364,1,360,99,6,4,1,1118,161,25154,2438,323726,348880,10/13/2020
10/2/2020,209,35343,12127,774671,810014,12,2835,13,2377,1,361,97,7,4,1,1119,182,25336,2511,326237,351573,10/13/2020
10/3/2020,157,35500,9304,783975,819475,9,2844,9,2386,2,363,95,8,4,2,1121,146,25482,2040,328277,353759,10/13/2020
10/4/2020,81,35581,2356,786331,821912,11,2855,9,2395,1,364,96,8,4,2,1123,75,25557,960,329237,354794,10/13/2020
10/5/2020,174,35755,8935,795266,831021,28,2883,10,2405,2,366,112,10,5,3,1126,147,25704,3060,332297,358001,10/13/2020
10/6/2020,176,35931,10827,806093,842024,11,2894,4,2409,0,366,119,12,6,0,1126,189,25893,2915,335212,361105,10/13/2020
10/7/2020,228,36159,12340,818433,854592,12,2906,14,2423,2,368,115,10,6,1,1127,253,26146,3552,338764,364910,10/13/2020
10/8/2020,262,36421,14862,833295,869716,14,2920,12,2435,1,369,116,9,5,3,1130,260,26406,4213,342977,369383,10/13/2020
10/9/2020,214,36635,12820,846115,882750,14,2934,11,2446,0,369,119,12,5,2,1132,174,26580,4294,347271,373851,10/13/2020
10/10/2020,230,36865,13470,859585,896450,16,2950,9,2455,1,370,125,13,5,2,1134,170,26750,3829,351100,377850,10/13/2020
10/11/2020,94,36959,3250,862835,899794,11,2961,8,2463,2,372,126,13,4,3,1137,81,26831,1169,352269,379100,10/13/2020
10/12/2020,140,37099,5715,868550,905649,,,,,,,,,,2,1139,129,26960,1465,353734,380694,10/13/2020
2/27/2020,0,0,0,0,0,1,1,0,0,0,0,1,0,0,0,0,0,0,0,0,0,10/14/2020
2/28/2020,0,0,0,0,0,0,1,0,0,0,0,1,1,0,0,0,0,0,0,0,0,10/14/2020
2/29/2020,0,0,0,0,0,0,1,0,0,0,0,1,1,0,0,0,0,0,0,0,0,10/14/2020
3/1/2020,2,2,2,2,4,0,1,0,0,0,0,1,1,1,0,0,2,2,2,2,4,10/14/2020
3/2/2020,0,2,1,3,5,1,2,0,0,0,0,2,2,2,0,0,0,2,1,3,5,10/14/2020
3/3/2020,0,2,2,5,7,0,2,0,0,0,0,2,2,2,0,0,0,2,2,5,7,10/14/2020
3/4/2020,0,2,12,17,19,1,3,0,0,0,0,3,2,2,0,0,0,2,10,15,17,10/14/2020
3/5/2020,0,2,4,21,23,0,3,0,0,0,0,3,2,2,0,0,1,3,4,19,22,10/14/2020
3/6/2020,1,3,12,33,36,0,3,0,0,0,0,3,2,2,0,0,0,3,11,30,33,10/14/2020
3/7/2020,0,3,19,52,55,0,3,0,0,0,0,3,2,1,0,0,0,3,19,49,52,10/14/2020
3/8/2020,0,3,18,70,73,0,3,0,0,0,0,3,2,1,0,0,0,3,18,67,70,10/14/2020
3/9/2020,1,4,15,85,89,0,3,0,0,0,0,3,2,1,0,0,1,4,15,82,86,10/14/2020
3/10/2020,2,6,25,110,116,0,3,0,0,0,0,3,2,1,0,0,1,5,23,105,110,10/14/2020
3/11/2020,0,6,34,144,150,1,4,0,0,0,0,4,1,1,0,0,0,5,34,139,144,10/14/2020
3/12/2020,9,15,41,185,200,1,5,0,0,0,0,5,1,1,0,0,8,13,38,177,190,10/14/2020
3/13/2020,6,21,50,235,256,4,9,1,1,0,0,8,1,1,0,0,6,19,48,225,244,10/14/2020
3/14/2020,0,21,90,325,346,0,9,0,1,0,0,8,1,1,0,0,0,19,86,311,330,10/14/2020
3/15/2020,1,22,54,379,401,1,10,0,1,0,0,9,2,1,0,0,1,20,54,365,385,10/14/2020
3/16/2020,2,24,95,474,498,2,12,0,1,0,0,11,2,0,0,0,2,22,92,457,479,10/14/2020
3/17/2020,12,36,162,636,672,6,18,0,1,0,0,17,2,0,0,0,11,33,151,608,641,10/14/2020
3/18/2020,9,45,116,752,797,3,21,0,1,0,0,20,2,0,0,0,11,44,110,718,762,10/14/2020
3/19/2020,15,60,262,1014,1074,2,23,1,2,0,0,21,3,0,1,1,17,61,251,969,1030,10/14/2020
3/20/2020,13,73,197,1211,1284,5,28,0,2,0,0,26,4,0,0,1,13,74,190,1159,1233,10/14/2020
3/21/2020,12,85,126,1337,1422,3,31,2,4,0,0,27,5,0,0,1,14,88,123,1282,1370,10/14/2020
3/22/2020,27,112,282,1619,1731,2,33,0,4,0,0,29,5,0,0,1,25,113,261,1543,1656,10/14/2020
3/23/2020,14,126,169,1788,1914,15,48,1,5,0,0,43,9,3,0,1,16,129,165,1708,1837,10/14/2020
3/24/2020,20,146,242,2030,2176,7,55,0,5,0,0,50,10,4,0,1,19,148,237,1945,2093,10/14/2020
3/25/2020,26,172,182,2212,2384,5,60,1,6,0,0,54,11,3,0,1,28,176,171,2116,2292,10/14/2020
3/26/2020,35,207,181,2393,2600,10,70,5,11,0,0,59,14,5,0,1,41,217,174,2290,2507,10/14/2020
3/27/2020,27,234,214,2607,2841,9,79,1,12,1,1,66,17,6,2,3,31,248,200,2490,2738,10/14/2020
3/28/2020,59,293,260,2867,3160,13,92,3,15,2,3,74,15,6,1,4,64,312,240,2730,3042,10/14/2020
3/29/2020,100,393,350,3217,3610,8,100,4,19,1,4,77,18,8,2,6,105,417,313,3043,3460,10/14/2020
3/30/2020,62,455,222,3439,3894,20,120,5,24,0,4,92,20,11,3,9,78,495,184,3227,3722,10/14/2020
3/31/2020,71,526,369,3808,4334,11,131,7,31,1,5,95,22,13,2,11,73,568,295,3522,4090,10/14/2020
4/1/2020,99,625,698,4506,5131,18,149,7,38,0,5,106,30,15,1,12,100,668,640,4162,4830,10/14/2020
4/2/2020,52,677,477,4983,5660,22,171,6,44,2,7,120,36,21,4,16,62,730,435,4597,5327,10/14/2020
4/3/2020,108,785,774,5757,6542,23,194,7,51,0,7,136,43,25,3,19,100,830,709,5306,6136,10/14/2020
4/4/2020,143,928,660,6417,7345,22,216,4,55,5,12,149,41,30,9,28,138,968,616,5922,6890,10/14/2020
4/5/2020,187,1115,1156,7573,8688,20,236,9,64,1,13,159,44,36,2,30,181,1149,1062,6984,8133,10/14/2020
4/6/2020,218,1333,1706,9279,10612,26,262,7,71,0,13,178,48,40,7,37,207,1356,1545,8529,9885,10/14/2020
4/7/2020,284,1617,1629,10908,12525,20,282,5,76,2,15,191,50,42,5,42,261,1617,1473,10002,11619,10/14/2020
4/8/2020,290,1907,1720,12628,14535,19,301,7,83,6,21,197,50,38,10,52,271,1888,1554,11556,13444,10/14/2020
4/9/2020,283,2190,1516,14144,16334,32,333,9,92,4,25,216,53,40,7,59,277,2165,1352,12908,15073,10/14/2020
4/10/2020,419,2609,2574,16718,19327,29,362,16,108,5,30,224,59,41,11,70,401,2566,2364,15272,17838,10/14/2020
4/11/2020,297,2906,1905,18623,21529,29,391,11,119,2,32,240,61,48,12,82,281,2847,1713,16985,19832,10/14/2020
4/12/2020,314,3220,1670,20293,23513,35,426,13,132,5,37,257,59,49,9,91,284,3131,1429,18414,21545,10/14/2020
4/13/2020,161,3381,935,21228,24609,35,461,13,145,3,40,276,64,54,9,100,187,3318,837,19251,22569,10/14/2020
4/14/2020,289,3670,1787,23015,26685,27,488,17,162,5,45,281,72,53,8,108,262,3580,1526,20777,24357,10/14/2020
4/15/2020,351,4021,1799,24814,28835,31,519,20,182,3,48,289,72,54,17,125,306,3886,1546,22323,26209,10/14/2020
4/16/2020,447,4468,2494,27308,31776,36,555,25,207,6,54,294,72,53,14,139,387,4273,2068,24391,28664,10/14/2020
4/17/2020,304,4772,1821,29129,33901,32,587,20,227,7,61,299,66,45,21,160,290,4563,1443,25834,30397,10/14/2020
4/18/2020,321,5093,1725,30854,35947,26,613,18,245,4,65,303,63,49,15,175,284,4847,1320,27154,32001,10/14/2020
4/19/2020,381,5474,2047,32901,38375,23,636,26,271,1,66,299,65,55,11,186,336,5183,1737,28891,34074,10/14/2020
4/20/2020,394,5868,1907,34808,40676,46,682,29,300,2,68,314,75,56,10,196,376,5559,1565,30456,36015,10/14/2020
4/21/2020,444,6312,2110,36918,43230,45,727,33,333,5,73,321,72,56,18,214,384,5943,1699,32155,38098,10/14/2020
4/22/2020,418,6730,2390,39308,46038,41,768,32,365,5,78,325,73,58,18,232,379,6322,1912,34067,40389,10/14/2020
4/23/2020,479,7209,2469,41777,48986,32,800,28,393,5,83,324,76,62,15,247,412,6734,1850,35917,42651,10/14/2020
4/24/2020,491,7700,3284,45061,52761,35,835,26,419,4,87,329,85,63,15,262,407,7141,2620,38537,45678,10/14/2020
4/25/2020,393,8093,2206,47267,55360,34,869,17,436,5,92,341,85,62,14,276,300,7441,1760,40297,47738,10/14/2020
4/26/2020,316,8409,2309,49576,57985,33,902,15,451,3,95,356,86,59,14,290,274,7715,1872,42169,49884,10/14/2020
4/27/2020,249,8658,1620,51196,59854,29,931,21,472,4,99,360,86,61,10,300,206,7921,1156,43325,51246,10/14/2020
4/28/2020,410,9068,2263,53459,62527,44,975,24,496,3,102,377,88,59,22,322,331,8252,1757,45082,53334,10/14/2020
4/29/2020,476,9544,3343,56802,66346,36,1011,38,534,11,113,364,78,53,18,340,371,8623,2417,47499,56122,10/14/2020
4/30/2020,432,9976,2769,59571,69547,33,1044,38,572,6,119,353,83,57,24,364,350,8973,1906,49405,58378,10/14/2020
5/1/2020,454,10430,3086,62657,73087,51,1095,39,611,3,122,362,84,58,14,378,324,9297,2159,51564,60861,10/14/2020
5/2/2020,257,10687,1926,64583,75270,36,1131,38,649,5,127,355,91,62,24,402,192,9489,1268,52832,62321,10/14/2020
5/3/2020,283,10970,2160,66743,77713,31,1162,27,676,8,135,351,90,61,21,423,183,9672,1572,54404,64076,10/14/2020
5/4/2020,387,11357,2098,68841,80198,30,1192,31,707,5,140,345,88,57,18,441,290,9962,1558,55962,65924,10/14/2020
5/5/2020,433,11790,2873,71714,83504,29,1221,32,739,6,146,336,82,54,16,457,300,10262,1955,57917,68179,10/14/2020
5/6/2020,488,12278,2830,74544,86822,28,1249,44,783,9,155,311,79,54,21,478,340,10602,1914,59831,70433,10/14/2020
5/7/2020,425,12703,2969,77513,90216,36,1285,41,824,5,160,301,71,52,21,499,270,10872,1957,61788,72660,10/14/2020
5/8/2020,359,13062,2598,80111,93173,30,1315,29,853,5,165,297,71,53,22,521,229,11101,1735,63523,74624,10/14/2020
5/9/2020,467,13529,3346,83457,96986,22,1337,21,874,4,169,294,69,51,15,536,290,11391,2252,65775,77166,10/14/2020
5/10/2020,285,13814,2117,85574,99388,20,1357,23,897,6,175,285,70,49,13,549,189,11580,1520,67295,78875,10/14/2020
5/11/2020,257,14071,1857,87431,101502,31,1388,16,913,6,181,294,71,49,15,564,174,11754,1299,68594,80348,10/14/2020
5/12/2020,387,14458,2611,90042,104500,23,1411,18,931,4,185,295,69,48,22,586,224,11978,1701,70295,82273,10/14/2020
5/13/2020,351,14809,3630,93672,108481,23,1434,25,956,1,186,292,69,49,13,599,199,12177,1999,72294,84471,10/14/2020
5/14/2020,329,15138,3408,97080,112218,19,1453,27,983,3,189,281,64,45,15,614,230,12407,2013,74307,86714,10/14/2020
5/15/2020,381,15519,3458,100538,116057,24,1477,41,1024,5,194,259,62,45,14,628,232,12639,1803,76110,88749,10/14/2020
5/16/2020,449,15968,4156,104694,120662,25,1502,13,1037,5,199,266,61,46,15,643,247,12886,1959,78069,90955,10/14/2020
5/17/2020,240,16208,2768,107462,123670,17,1519,8,1045,5,204,270,59,45,10,653,126,13012,1554,79623,92635,10/14/2020
5/18/2020,250,16458,2001,109463,125921,19,1538,15,1060,5,209,269,57,40,18,671,135,13147,1366,80989,94136,10/14/2020
5/19/2020,415,16873,3168,112631,129504,23,1561,32,1092,5,214,255,56,38,11,682,215,13362,1925,82914,96276,10/14/2020
5/20/2020,326,17199,2771,115402,132601,19,1580,23,1115,7,221,244,52,33,22,704,183,13545,1510,84424,97969,10/14/2020
5/21/2020,374,17573,3757,119159,136732,26,1606,15,1130,3,224,252,53,29,20,724,168,13713,1936,86360,100073,10/14/2020
5/22/2020,351,17924,3161,122320,140244,20,1626,29,1159,5,229,238,52,29,10,734,206,13919,1605,87965,101884,10/14/2020
5/23/2020,253,18177,2742,125062,143239,19,1645,11,1170,3,232,243,52,32,13,747,109,14028,1269,89234,103262,10/14/2020
5/24/2020,163,18340,1370,126432,144772,13,1658,14,1184,2,234,240,53,36,8,755,83,14111,772,90006,104117,10/14/2020
5/25/2020,147,18487,1385,127817,146304,14,1672,14,1198,0,234,240,53,34,10,765,76,14187,762,90768,104955,10/14/2020
5/26/2020,285,18772,2620,130437,149209,24,1696,22,1220,5,239,237,48,33,15,780,158,14345,1778,92546,106891,10/14/2020
5/27/2020,276,19048,2057,132494,151542,20,1716,18,1238,3,242,236,50,33,10,790,132,14477,1131,93677,108154,10/14/2020
5/28/2020,348,19396,3359,135853,155249,17,1733,29,1267,4,246,220,47,32,8,798,130,14607,1116,94793,109400,10/14/2020
5/29/2020,410,19806,3914,139767,159573,19,1752,27,1294,6,252,206,43,31,12,810,174,14781,1570,96363,111144,10/14/2020
5/30/2020,225,20031,3915,143682,163713,16,1768,19,1313,4,256,199,41,29,12,822,109,14890,1817,98180,113070,10/14/2020
5/31/2020,155,20186,1688,145370,165556,11,1779,10,1323,1,257,199,44,26,3,825,78,14968,855,99035,114003,10/14/2020
6/1/2020,212,20398,2792,148162,168560,8,1787,14,1337,1,258,192,45,29,5,830,93,15061,1383,100418,115479,10/14/2020
6/2/2020,273,20671,3022,151184,171855,8,1795,9,1346,3,261,188,38,25,10,840,98,15159,1444,101862,117021,10/14/2020
6/3/2020,254,20925,3486,154670,175595,14,1809,18,1364,6,267,178,34,25,11,851,99,15258,1657,103519,118777,10/14/2020
6/4/2020,276,21201,4471,159141,180342,7,1816,25,1389,4,271,156,31,24,12,863,107,15365,2033,105552,120917,10/14/2020
6/5/2020,215,21416,3513,162654,184070,15,1831,13,1402,6,277,152,27,21,11,874,99,15464,1570,107122,122586,10/14/2020
6/6/2020,201,21617,2616,165270,186887,10,1841,7,1409,2,279,153,29,19,6,880,67,15531,1133,108255,123786,10/14/2020
6/7/2020,83,21700,1625,166895,188595,11,1852,7,1416,1,280,156,25,17,4,884,51,15582,781,109036,124618,10/14/2020
6/8/2020,119,21819,1849,168744,190563,15,1867,12,1428,2,282,157,27,18,4,888,45,15627,956,109992,125619,10/14/2020
6/9/2020,223,22042,2673,171417,193459,10,1877,18,1446,0,282,149,28,21,1,889,64,15691,1254,111246,126937,10/14/2020
6/10/2020,209,22251,2987,174404,196655,13,1890,12,1458,2,284,148,24,17,4,893,101,15792,1464,112710,128502,10/14/2020
6/11/2020,195,22446,3513,177917,200363,7,1897,15,1473,1,285,139,25,16,6,899,88,15880,1531,114241,130121,10/14/2020
6/12/2020,209,22655,4601,182518,205173,9,1906,15,1488,1,286,132,24,16,2,901,78,15958,2178,116419,132377,10/14/2020
6/13/2020,113,22768,3036,185554,208322,6,1912,5,1493,0,286,133,20,15,3,904,49,16007,1371,117790,133797,10/14/2020
6/14/2020,81,22849,2046,187600,210449,7,1919,8,1501,1,287,131,20,14,3,907,33,16040,967,118757,134797,10/14/2020
6/15/2020,188,23037,3108,190708,213745,14,1933,14,1515,0,287,131,20,16,5,912,75,16115,1788,120545,136660,10/14/2020
6/16/2020,110,23147,3017,193725,216872,11,1944,9,1524,1,288,132,22,16,8,920,50,16165,1575,122120,138285,10/14/2020
6/17/2020,127,23274,2835,196560,219834,15,1959,20,1544,4,292,123,18,14,6,926,50,16215,1318,123438,139653,10/14/2020
6/18/2020,149,23423,3047,199607,223030,9,1968,13,1557,1,293,118,19,16,7,933,70,16285,1311,124749,141034,10/14/2020
6/19/2020,141,23564,3769,203376,226940,12,1980,11,1568,1,294,118,20,17,3,936,59,16344,1369,126118,142462,10/14/2020
6/20/2020,84,23648,1891,205267,228915,9,1989,12,1580,0,294,115,20,18,4,940,36,16380,812,126930,143310,10/14/2020
6/21/2020,37,23685,1064,206331,230016,8,1997,5,1585,0,294,118,20,18,2,942,29,16409,692,127622,144031,10/14/2020
6/22/2020,138,23823,3730,210061,233884,12,2009,16,1601,0,294,114,19,18,2,944,65,16474,1703,129325,145799,10/14/2020
6/23/2020,163,23986,3831,213892,237878,3,2012,13,1614,3,297,101,18,18,7,951,81,16555,1779,131104,147659,10/14/2020
6/24/2020,120,24106,3502,217394,241500,9,2021,10,1624,1,298,99,18,18,5,956,44,16599,1680,132784,149383,10/14/2020
6/25/2020,103,24209,2883,220277,244486,6,2027,14,1638,1,299,90,17,17,1,957,50,16649,1509,134293,150942,10/14/2020
6/26/2020,94,24303,2488,222765,247068,2,2029,10,1648,0,299,82,18,18,1,958,60,16709,1329,135622,152331,10/14/2020
6/27/2020,84,24387,3214,225979,250366,5,2034,3,1651,1,300,83,17,17,5,963,37,16746,1215,136837,153583,10/14/2020
6/28/2020,39,24426,1469,227448,251874,4,2038,4,1655,4,304,79,15,14,6,969,17,16763,594,137431,154194,10/14/2020
6/29/2020,85,24511,3697,231145,255656,4,2042,5,1660,0,304,78,14,14,1,970,39,16802,1351,138782,155584,10/14/2020
6/30/2020,57,24568,1957,233102,257670,1,2043,5,1665,1,305,73,12,11,4,974,33,16835,993,139775,156610,10/14/2020
7/1/2020,144,24712,4098,237200,261912,8,2051,10,1675,0,305,71,11,11,1,975,79,16914,1927,141702,158616,10/14/2020
7/2/2020,103,24815,2803,240003,264818,5,2056,5,1680,1,306,70,10,10,3,978,59,16973,1087,142789,159762,10/14/2020
7/3/2020,50,24865,2076,242079,266944,9,2065,6,1686,0,306,73,9,9,3,981,25,16998,777,143566,160564,10/14/2020
7/4/2020,57,24922,2345,244424,269346,2,2067,4,1690,1,307,70,10,9,2,983,33,17031,1009,144575,161606,10/14/2020
7/5/2020,49,24971,2932,247356,272327,1,2068,2,1692,1,308,68,8,8,2,985,26,17057,1441,146016,163073,10/14/2020
7/6/2020,101,25072,2811,250167,275239,6,2074,6,1698,0,308,68,9,9,4,989,57,17114,1548,147564,164678,10/14/2020
7/7/2020,81,25153,3457,253624,278777,5,2079,7,1705,0,308,66,8,8,2,991,47,17161,1534,149098,166259,10/14/2020
7/8/2020,105,25258,3403,257027,282285,4,2083,2,1707,0,308,68,9,8,0,991,64,17225,1423,150521,167746,10/14/2020
7/9/2020,94,25352,3712,260739,286091,9,2092,3,1710,0,308,74,9,8,0,991,50,17275,1623,152144,169419,10/14/2020
7/10/2020,131,25483,4431,265170,290653,6,2098,3,1713,2,310,75,7,7,3,994,80,17355,2071,154215,171570,10/14/2020
7/11/2020,63,25546,2932,268102,293648,6,2104,3,1716,1,311,77,6,6,3,997,36,17391,1315,155530,172921,10/14/2020
7/12/2020,47,25593,1836,269938,295531,1,2105,3,1719,1,312,74,6,5,3,1000,34,17425,942,156472,173897,10/14/2020
7/13/2020,84,25677,3201,273139,298816,8,2113,10,1729,0,312,72,6,5,1,1001,61,17486,1503,157975,175461,10/14/2020
7/14/2020,73,25750,3291,276430,302180,7,2120,4,1733,0,312,75,5,5,1,1002,43,17529,1373,159348,176877,10/14/2020
7/15/2020,130,25880,4172,280602,306482,5,2125,7,1740,0,312,73,5,4,0,1002,99,17628,1749,161097,178725,10/14/2020
7/16/2020,102,25982,3733,284335,310317,6,2131,9,1749,0,312,70,6,5,1,1003,75,17703,1619,162716,180419,10/14/2020
7/17/2020,156,26138,4236,288571,314709,14,2145,3,1752,1,313,80,5,5,2,1005,79,17782,1844,164560,182342,10/14/2020
7/18/2020,85,26223,3267,291838,318061,5,2150,9,1761,1,314,75,5,4,4,1009,70,17852,1399,165959,183811,10/14/2020
7/19/2020,82,26305,2693,294531,320836,7,2157,3,1764,0,314,79,6,4,2,1011,57,17909,1147,167106,185015,10/14/2020
7/20/2020,71,26376,2664,297195,323571,9,2166,7,1771,0,314,81,7,5,2,1013,68,17977,1460,168566,186543,10/14/2020
7/21/2020,130,26506,4298,301493,327999,9,2175,11,1782,0,314,79,9,6,1,1014,109,18086,1918,170484,188570,10/14/2020
7/22/2020,130,26636,3927,305420,332056,11,2186,11,1793,1,315,78,7,6,1,1015,86,18172,1684,172168,190340,10/14/2020
7/23/2020,141,26777,4412,309832,336609,8,2194,6,1799,0,315,80,8,7,0,1015,115,18287,1984,174152,192439,10/14/2020
7/24/2020,172,26949,5960,315792,342741,14,2208,14,1813,0,315,80,9,7,0,1015,119,18406,2317,176469,194875,10/14/2020
7/25/2020,134,27083,4398,320190,347273,7,2215,7,1820,0,315,80,10,8,2,1017,108,18514,2096,178565,197079,10/14/2020
7/26/2020,62,27145,3027,323217,350362,8,2223,9,1829,0,315,79,11,7,1,1018,54,18568,1335,179900,198468,10/14/2020
7/27/2020,188,27333,4190,327407,354740,12,2235,7,1836,0,315,84,13,8,1,1019,138,18706,2344,182244,200950,10/14/2020
7/28/2020,105,27438,3834,331241,358679,5,2240,5,1841,0,315,84,14,7,1,1020,94,18800,1633,183877,202677,10/14/2020
7/29/2020,191,27629,5137,336378,364007,11,2251,12,1853,0,315,83,15,7,0,1020,154,18954,2322,186199,205153,10/14/2020
7/30/2020,121,27750,4344,340722,368472,6,2257,2,1855,1,316,86,15,6,1,1021,97,19051,1648,187847,206898,10/14/2020
7/31/2020,131,27881,5508,346230,374111,8,2265,10,1865,0,316,84,15,7,1,1022,89,19140,1853,189700,208840,10/14/2020
8/1/2020,108,27989,4288,350518,378507,7,2272,2,1867,0,316,89,14,7,1,1023,88,19228,1558,191258,210486,10/14/2020
8/2/2020,84,28073,2802,353320,381393,12,2284,12,1879,2,318,87,14,8,2,1025,62,19290,1271,192529,211819,10/14/2020
8/3/2020,187,28260,5238,358558,386818,13,2297,12,1891,0,318,88,16,7,1,1026,150,19440,2202,194731,214171,10/14/2020
8/4/2020,126,28386,3691,362249,390635,8,2305,6,1897,1,319,89,12,5,2,1028,99,19539,1771,196502,216041,10/14/2020
8/5/2020,148,28534,5933,368182,396716,12,2317,10,1907,1,320,90,10,5,2,1030,118,19657,2469,198971,218628,10/14/2020
8/6/2020,169,28703,5532,373714,402417,7,2324,9,1916,0,320,88,9,4,0,1030,121,19778,2406,201377,221155,10/14/2020
8/7/2020,122,28825,4845,378559,407384,13,2337,10,1926,1,321,90,9,3,2,1032,87,19865,2141,203518,223383,10/14/2020
8/8/2020,123,28948,4106,382665,411613,19,2356,6,1932,1,322,102,8,3,1,1033,92,19957,1779,205297,225254,10/14/2020
8/9/2020,42,28990,1722,384387,413377,8,2364,10,1942,0,322,100,9,4,0,1033,35,19992,1072,206369,226361,10/14/2020
8/10/2020,149,29139,4580,388967,418106,11,2375,12,1954,0,322,99,9,4,1,1034,113,20105,2021,208390,228495,10/14/2020
8/11/2020,105,29244,4325,393292,422536,6,2381,14,1968,0,322,91,10,4,3,1037,92,20197,2265,210655,230852,10/14/2020
8/12/2020,121,29365,5184,398476,427841,8,2389,11,1979,0,322,88,9,3,1,1038,101,20298,2627,213282,233580,10/14/2020
8/13/2020,135,29500,4191,402667,432167,13,2402,12,1991,0,322,89,11,3,0,1038,95,20393,1904,215186,235579,10/14/2020
8/14/2020,145,29645,5492,408159,437804,13,2415,11,2002,0,322,91,11,4,3,1041,99,20492,1971,217157,237649,10/14/2020
8/15/2020,105,29750,4533,412692,442442,9,2424,11,2013,1,323,88,11,5,0,1041,89,20581,1691,218848,239429,10/14/2020
8/16/2020,83,29833,2471,415163,444996,7,2431,6,2019,4,327,85,8,4,6,1047,70,20651,961,219809,240460,10/14/2020
8/17/2020,106,29939,4570,419733,449672,10,2441,7,2026,0,327,88,8,5,2,1049,88,20739,2394,222203,242942,10/14/2020
8/18/2020,128,30067,4904,424637,454704,11,2452,9,2035,1,328,89,8,4,5,1054,94,20833,2754,224957,245790,10/14/2020
8/19/2020,113,30180,5065,429702,459882,8,2460,9,2044,1,329,87,9,5,0,1054,90,20923,2644,227601,248524,10/14/2020
8/20/2020,173,30353,7405,437107,467460,12,2472,6,2050,2,331,91,10,5,3,1057,139,21062,3526,231127,252189,10/14/2020
8/21/2020,151,30504,6570,443677,474181,8,2480,5,2055,1,332,93,9,4,2,1059,125,21187,2946,234073,255260,10/14/2020
8/22/2020,96,30600,5547,449224,479824,10,2490,12,2067,0,332,91,11,4,1,1060,84,21271,2609,236682,257953,10/14/2020
8/23/2020,70,30670,4365,453589,484259,11,2501,6,2073,0,332,96,11,2,1,1061,56,21327,2472,239154,260481,10/14/2020
8/24/2020,105,30775,5775,459364,490139,7,2508,10,2083,1,333,92,13,4,1,1062,77,21404,3154,242308,263712,10/14/2020
8/25/2020,108,30883,4757,464121,495004,10,2518,4,2087,1,334,97,11,4,1,1063,92,21496,2293,244601,266097,10/14/2020
8/26/2020,170,31053,9476,473597,504650,4,2522,8,2095,0,334,93,9,5,1,1064,127,21623,3090,247691,269314,10/14/2020
8/27/2020,92,31145,8563,482160,513305,6,2528,13,2108,1,335,85,6,5,2,1066,70,21693,3172,250863,272556,10/14/2020
8/28/2020,112,31257,7991,490151,521408,14,2542,4,2112,0,335,95,9,7,2,1068,87,21780,2442,253305,275085,10/14/2020
8/29/2020,65,31322,5368,495519,526841,6,2548,8,2120,1,336,92,10,6,2,1070,51,21831,1915,255220,277051,10/14/2020
8/30/2020,66,31388,4314,499833,531221,7,2555,4,2124,0,336,95,8,5,2,1072,48,21879,1994,257214,279093,10/14/2020
8/31/2020,105,31493,4862,504695,536188,12,2567,15,2139,0,336,92,8,4,1,1073,81,21960,2188,259402,281362,10/14/2020
9/1/2020,98,31591,7109,511804,543395,6,2573,9,2148,1,337,88,7,4,2,1075,65,22025,2383,261785,283810,10/14/2020
9/2/2020,125,31716,10524,522328,554044,9,2582,10,2158,1,338,86,8,4,2,1077,104,22129,3062,264847,286976,10/14/2020
9/3/2020,90,31806,11065,533393,565199,8,2590,8,2166,0,338,86,9,4,3,1080,73,22202,2585,267432,289634,10/14/2020
9/4/2020,102,31908,8952,542345,574253,11,2601,4,2170,0,338,93,9,4,1,1081,83,22285,2375,269807,292092,10/14/2020
9/5/2020,52,31960,6300,548645,580605,6,2607,9,2179,0,338,90,8,3,1,1082,42,22327,1603,271410,293737,10/14/2020
9/6/2020,87,32047,4317,552962,585009,4,2611,8,2187,1,339,85,6,3,1,1083,64,22391,1957,273367,295758,10/14/2020
9/7/2020,35,32082,3000,555962,588044,11,2622,3,2190,0,339,93,5,3,1,1084,26,22417,646,274013,296430,10/14/2020
9/8/2020,74,32156,6375,562337,594493,6,2628,12,2202,1,340,86,6,3,2,1086,66,22483,1602,275615,298098,10/14/2020
9/9/2020,118,32274,8640,570977,603251,9,2637,5,2207,1,341,89,9,3,1,1087,102,22585,2148,277763,300348,10/14/2020
9/10/2020,164,32438,11326,582303,614741,9,2646,8,2215,0,341,90,10,3,0,1087,111,22696,2277,280040,302736,10/14/2020
9/11/2020,121,32559,9448,591751,624310,11,2657,11,2226,0,341,90,10,5,0,1087,98,22794,1976,282016,304810,10/14/2020
9/12/2020,109,32668,6143,597894,630562,8,2665,5,2231,2,343,91,9,5,3,1090,97,22891,1506,283522,306413,10/14/2020
9/13/2020,58,32726,2709,600603,633329,4,2669,3,2234,0,343,92,10,5,0,1090,54,22945,859,284381,307326,10/14/2020
9/14/2020,104,32830,6421,607024,639854,5,2674,3,2237,2,345,92,10,5,1,1091,95,23040,1727,286108,309148,10/14/2020
9/15/2020,122,32952,8449,615473,648425,6,2680,2,2239,1,346,95,10,5,2,1093,124,23164,2195,288303,311467,10/14/2020
9/16/2020,137,33089,9701,625174,658263,7,2687,7,2246,2,348,93,8,6,5,1098,118,23282,1974,290277,313559,10/14/2020
9/17/2020,124,33213,9222,634396,667609,7,2694,14,2260,0,348,86,8,4,0,1098,154,23436,1952,292229,315665,10/14/2020
9/18/2020,132,33345,10016,644412,677757,7,2701,7,2267,1,349,85,11,6,2,1100,132,23568,1936,294165,317733,10/14/2020
9/19/2020,116,33461,8290,652702,686163,7,2708,3,2270,0,349,89,10,6,4,1104,112,23680,1704,295869,319549,10/14/2020
9/20/2020,60,33521,3668,656370,689891,7,2715,6,2276,2,351,88,10,8,4,1108,48,23728,1327,297196,320924,10/14/2020
9/21/2020,103,33624,7001,663371,696995,12,2727,3,2279,2,353,95,9,6,2,1110,93,23821,2415,299611,323432,10/14/2020
9/22/2020,154,33778,9269,672640,706418,12,2739,3,2282,1,354,103,8,5,1,1111,125,23946,2214,301825,325771,10/14/2020
9/23/2020,136,33914,10625,683265,717179,11,2750,7,2289,0,354,107,7,5,0,1111,127,24073,2221,304046,328119,10/14/2020
9/24/2020,119,34033,12451,695716,729749,7,2757,9,2298,1,355,104,8,5,1,1112,117,24190,3173,307219,331409,10/14/2020
9/25/2020,149,34182,10534,706250,740432,9,2766,10,2308,0,355,103,7,5,1,1113,143,24333,3026,310245,334578,10/14/2020
9/26/2020,146,34328,10544,716794,751122,12,2778,9,2317,0,355,106,7,5,1,1114,117,24450,2431,312676,337126,10/14/2020
9/27/2020,42,34370,2761,719555,753925,7,2785,5,2322,0,355,108,10,5,0,1114,34,24484,849,313525,338009,10/14/2020
9/28/2020,151,34521,7285,726840,761361,6,2791,6,2328,2,357,106,8,5,2,1116,132,24616,2265,315790,340406,10/14/2020
9/29/2020,208,34729,11017,737857,772586,11,2802,18,2346,1,358,98,7,6,1,1117,190,24806,2832,318622,343428,10/14/2020
9/30/2020,221,34950,12206,750063,785013,6,2808,6,2352,0,358,98,7,6,1,1118,186,24992,2603,321225,346217,10/14/2020
10/1/2020,184,35134,12481,762544,797678,16,2824,13,2365,1,359,100,6,4,1,1119,161,25153,2438,323663,348816,10/14/2020
10/2/2020,209,35343,12127,774671,810014,12,2836,13,2378,1,360,98,7,4,1,1120,182,25335,2508,326171,351506,10/14/2020
10/3/2020,157,35500,9304,783975,819475,9,2845,9,2387,2,362,96,8,4,2,1122,133,25468,2039,328210,353678,10/14/2020
10/4/2020,81,35581,2357,786332,821913,11,2856,9,2396,1,363,97,8,4,2,1124,73,25541,960,329170,354711,10/14/2020
10/5/2020,174,35755,8935,795267,831022,29,2885,10,2406,2,365,114,10,5,3,1127,160,25701,3059,332229,357930,10/14/2020
10/6/2020,176,35931,10827,806094,842025,11,2896,4,2410,0,365,121,12,6,0,1127,189,25890,2915,335144,361034,10/14/2020
10/7/2020,228,36159,12340,818434,854593,12,2908,14,2424,2,367,117,10,6,2,1129,240,26130,3550,338694,364824,10/14/2020
10/8/2020,262,36421,14862,833296,869717,14,2922,12,2436,1,368,118,9,5,3,1132,271,26401,4211,342905,369306,10/14/2020
10/9/2020,214,36635,12825,846121,882756,17,2939,12,2448,0,368,123,12,5,2,1134,185,26586,4313,347218,373804,10/14/2020
10/10/2020,229,36864,13453,859574,896438,17,2956,10,2458,1,369,129,13,5,2,1136,188,26774,3840,351058,377832,10/14/2020
10/11/2020,94,36958,3250,862824,899782,11,2967,8,2466,1,370,131,14,4,4,1140,84,26858,1169,352227,379085,10/14/2020
10/12/2020,165,37123,6358,869182,906305,17,2984,15,2481,2,372,131,13,4,3,1143,146,27004,1749,353976,380980,10/14/2020
10/13/2020,183,37306,5771,874953,912259,,,,,,,,,,4,1147,160,27164,1923,355899,383063,10/14/2020
2/27/2020,0,0,0,0,0,1,1,0,0,0,0,1,0,0,0,0,0,0,0,0,0,10/15/2020
2/28/2020,0,0,0,0,0,0,1,0,0,0,0,1,1,0,0,0,0,0,0,0,0,10/15/2020
2/29/2020,0,0,0,0,0,0,1,0,0,0,0,1,1,0,0,0,0,0,0,0,0,10/15/2020
3/1/2020,2,2,2,2,4,0,1,0,0,0,0,1,1,1,0,0,2,2,2,2,4,10/15/2020
3/2/2020,0,2,1,3,5,1,2,0,0,0,0,2,2,2,0,0,0,2,1,3,5,10/15/2020
3/3/2020,0,2,2,5,7,0,2,0,0,0,0,2,2,2,0,0,0,2,2,5,7,10/15/2020
3/4/2020,0,2,12,17,19,1,3,0,0,0,0,3,2,2,0,0,0,2,10,15,17,10/15/2020
3/5/2020,0,2,4,21,23,0,3,0,0,0,0,3,2,2,0,0,1,3,4,19,22,10/15/2020
3/6/2020,1,3,12,33,36,0,3,0,0,0,0,3,2,2,0,0,0,3,11,30,33,10/15/2020
3/7/2020,0,3,19,52,55,0,3,0,0,0,0,3,2,1,0,0,0,3,19,49,52,10/15/2020
3/8/2020,0,3,18,70,73,0,3,0,0,0,0,3,2,1,0,0,0,3,18,67,70,10/15/2020
3/9/2020,1,4,15,85,89,0,3,0,0,0,0,3,2,1,0,0,1,4,15,82,86,10/15/2020
3/10/2020,2,6,25,110,116,0,3,0,0,0,0,3,2,1,0,0,1,5,23,105,110,10/15/2020
3/11/2020,0,6,34,144,150,1,4,0,0,0,0,4,1,1,0,0,0,5,34,139,144,10/15/2020
3/12/2020,9,15,41,185,200,1,5,0,0,0,0,5,1,1,0,0,8,13,38,177,190,10/15/2020
3/13/2020,6,21,50,235,256,4,9,1,1,0,0,8,1,1,0,0,6,19,48,225,244,10/15/2020
3/14/2020,0,21,90,325,346,0,9,0,1,0,0,8,1,1,0,0,0,19,86,311,330,10/15/2020
3/15/2020,1,22,54,379,401,1,10,0,1,0,0,9,2,1,0,0,1,20,54,365,385,10/15/2020
3/16/2020,2,24,95,474,498,2,12,0,1,0,0,11,2,0,0,0,2,22,92,457,479,10/15/2020
3/17/2020,12,36,162,636,672,6,18,0,1,0,0,17,2,0,0,0,11,33,151,608,641,10/15/2020
3/18/2020,9,45,116,752,797,3,21,0,1,0,0,20,2,0,0,0,11,44,110,718,762,10/15/2020
3/19/2020,15,60,262,1014,1074,2,23,1,2,0,0,21,3,0,1,1,17,61,251,969,1030,10/15/2020
3/20/2020,13,73,197,1211,1284,5,28,0,2,0,0,26,4,0,0,1,13,74,190,1159,1233,10/15/2020
3/21/2020,12,85,126,1337,1422,3,31,2,4,0,0,27,5,0,0,1,14,88,123,1282,1370,10/15/2020
3/22/2020,27,112,282,1619,1731,2,33,0,4,0,0,29,5,0,0,1,25,113,261,1543,1656,10/15/2020
3/23/2020,14,126,169,1788,1914,15,48,1,5,0,0,43,9,3,0,1,16,129,165,1708,1837,10/15/2020
3/24/2020,20,146,242,2030,2176,7,55,0,5,0,0,50,10,4,0,1,19,148,237,1945,2093,10/15/2020
3/25/2020,26,172,182,2212,2384,5,60,1,6,0,0,54,11,3,0,1,28,176,171,2116,2292,10/15/2020
3/26/2020,35,207,181,2393,2600,10,70,5,11,0,0,59,14,5,0,1,41,217,174,2290,2507,10/15/2020
3/27/2020,27,234,214,2607,2841,9,79,1,12,1,1,66,17,6,2,3,31,248,200,2490,2738,10/15/2020
3/28/2020,59,293,260,2867,3160,13,92,3,15,2,3,74,15,6,1,4,64,312,240,2730,3042,10/15/2020
3/29/2020,100,393,350,3217,3610,8,100,4,19,1,4,77,18,8,2,6,105,417,313,3043,3460,10/15/2020
3/30/2020,62,455,222,3439,3894,20,120,5,24,0,4,92,20,11,3,9,78,495,184,3227,3722,10/15/2020
3/31/2020,71,526,369,3808,4334,11,131,7,31,1,5,95,22,13,2,11,73,568,295,3522,4090,10/15/2020
4/1/2020,99,625,698,4506,5131,18,149,7,38,0,5,106,30,15,1,12,100,668,640,4162,4830,10/15/2020
4/2/2020,52,677,477,4983,5660,22,171,6,44,2,7,120,36,21,4,16,62,730,435,4597,5327,10/15/2020
4/3/2020,108,785,774,5757,6542,23,194,7,51,0,7,136,43,25,3,19,100,830,708,5305,6135,10/15/2020
4/4/2020,143,928,660,6417,7345,22,216,4,55,5,12,149,41,30,9,28,138,968,616,5921,6889,10/15/2020
4/5/2020,187,1115,1156,7573,8688,20,236,9,64,1,13,159,44,36,2,30,181,1149,1061,6982,8131,10/15/2020
4/6/2020,218,1333,1706,9279,10612,26,262,7,71,0,13,178,48,40,7,37,207,1356,1545,8527,9883,10/15/2020
4/7/2020,284,1617,1629,10908,12525,20,282,5,76,2,15,191,50,42,5,42,261,1617,1472,9999,11616,10/15/2020
4/8/2020,290,1907,1720,12628,14535,19,301,7,83,6,21,197,50,38,10,52,271,1888,1554,11553,13441,10/15/2020
4/9/2020,283,2190,1516,14144,16334,32,333,9,92,4,25,216,53,40,7,59,277,2165,1352,12905,15070,10/15/2020
4/10/2020,419,2609,2574,16718,19327,29,362,16,108,5,30,224,59,41,11,70,401,2566,2362,15267,17833,10/15/2020
4/11/2020,297,2906,1905,18623,21529,29,391,11,119,2,32,240,61,48,12,82,281,2847,1713,16980,19827,10/15/2020
4/12/2020,314,3220,1670,20293,23513,35,426,13,132,5,37,257,59,49,9,91,284,3131,1427,18407,21538,10/15/2020
4/13/2020,161,3381,935,21228,24609,35,461,13,145,3,40,276,64,54,9,100,187,3318,837,19244,22562,10/15/2020
4/14/2020,289,3670,1787,23015,26685,27,488,17,162,5,45,281,72,53,8,108,262,3580,1525,20769,24349,10/15/2020
4/15/2020,351,4021,1799,24814,28835,31,519,20,182,3,48,289,72,54,17,125,306,3886,1546,22315,26201,10/15/2020
4/16/2020,447,4468,2494,27308,31776,36,555,25,207,6,54,294,72,53,14,139,387,4273,2068,24383,28656,10/15/2020
4/17/2020,304,4772,1821,29129,33901,32,587,20,227,7,61,299,66,45,21,160,290,4563,1443,25826,30389,10/15/2020
4/18/2020,321,5093,1725,30854,35947,26,613,18,245,4,65,303,63,49,15,175,284,4847,1320,27146,31993,10/15/2020
4/19/2020,381,5474,2047,32901,38375,23,636,26,271,1,66,299,65,55,11,186,336,5183,1737,28883,34066,10/15/2020
4/20/2020,394,5868,1907,34808,40676,46,682,29,300,2,68,314,75,56,10,196,376,5559,1565,30448,36007,10/15/2020
4/21/2020,444,6312,2110,36918,43230,45,727,33,333,5,73,321,72,56,18,214,384,5943,1699,32147,38090,10/15/2020
4/22/2020,418,6730,2390,39308,46038,41,768,32,365,5,78,325,73,58,18,232,379,6322,1912,34059,40381,10/15/2020
4/23/2020,479,7209,2469,41777,48986,32,800,28,393,5,83,324,76,62,15,247,412,6734,1850,35909,42643,10/15/2020
4/24/2020,491,7700,3284,45061,52761,35,835,26,419,4,87,329,85,63,15,262,407,7141,2620,38529,45670,10/15/2020
4/25/2020,393,8093,2206,47267,55360,34,869,17,436,5,92,341,85,62,14,276,300,7441,1759,40288,47729,10/15/2020
4/26/2020,316,8409,2309,49576,57985,33,902,15,451,3,95,356,86,59,14,290,274,7715,1872,42160,49875,10/15/2020
4/27/2020,249,8658,1620,51196,59854,29,931,21,472,4,99,360,86,61,10,300,206,7921,1156,43316,51237,10/15/2020
4/28/2020,410,9068,2263,53459,62527,44,975,24,496,3,102,377,88,59,22,322,331,8252,1755,45071,53323,10/15/2020
4/29/2020,476,9544,3343,56802,66346,36,1011,38,534,11,113,364,78,53,18,340,371,8623,2415,47486,56109,10/15/2020
4/30/2020,432,9976,2769,59571,69547,33,1044,38,572,6,119,353,83,57,24,364,350,8973,1901,49387,58360,10/15/2020
5/1/2020,454,10430,3086,62657,73087,51,1095,39,611,3,122,362,84,58,14,378,324,9297,2158,51545,60842,10/15/2020
5/2/2020,257,10687,1926,64583,75270,36,1131,38,649,5,127,355,91,62,24,402,192,9489,1265,52810,62299,10/15/2020
5/3/2020,283,10970,2160,66743,77713,31,1162,26,675,8,135,352,90,61,21,423,183,9672,1569,54379,64051,10/15/2020
5/4/2020,387,11357,2098,68841,80198,30,1192,31,706,6,141,345,88,57,18,441,290,9962,1557,55936,65898,10/15/2020
5/5/2020,433,11790,2873,71714,83504,29,1221,32,738,6,147,336,82,54,16,457,300,10262,1954,57890,68152,10/15/2020
5/6/2020,488,12278,2830,74544,86822,28,1249,44,782,9,156,311,79,54,21,478,340,10602,1914,59804,70406,10/15/2020
5/7/2020,425,12703,2969,77513,90216,36,1285,41,823,5,161,301,71,52,21,499,270,10872,1957,61761,72633,10/15/2020
5/8/2020,359,13062,2598,80111,93173,30,1315,29,852,5,166,297,71,53,22,521,229,11101,1735,63496,74597,10/15/2020
5/9/2020,467,13529,3346,83457,96986,22,1337,21,873,4,170,294,69,51,15,536,290,11391,2251,65747,77138,10/15/2020
5/10/2020,285,13814,2117,85574,99388,20,1357,23,896,6,176,285,70,49,13,549,189,11580,1519,67266,78846,10/15/2020
5/11/2020,257,14071,1857,87431,101502,31,1388,16,912,6,182,294,71,49,15,564,174,11754,1299,68565,80319,10/15/2020
5/12/2020,387,14458,2611,90042,104500,23,1411,18,930,4,186,295,69,48,22,586,224,11978,1701,70266,82244,10/15/2020
5/13/2020,351,14809,3630,93672,108481,23,1434,25,955,1,187,292,69,49,13,599,199,12177,1999,72265,84442,10/15/2020
5/14/2020,329,15138,3408,97080,112218,19,1453,27,982,3,190,281,64,45,15,614,230,12407,2013,74278,86685,10/15/2020
5/15/2020,381,15519,3458,100538,116057,24,1477,41,1023,5,195,259,62,45,14,628,232,12639,1801,76079,88718,10/15/2020
5/16/2020,449,15968,4156,104694,120662,25,1502,13,1036,5,200,266,61,46,15,643,247,12886,1959,78038,90924,10/15/2020
5/17/2020,240,16208,2768,107462,123670,17,1519,8,1044,5,205,270,59,45,10,653,126,13012,1553,79591,92603,10/15/2020
5/18/2020,250,16458,2001,109463,125921,19,1538,15,1059,5,210,269,57,40,18,671,135,13147,1366,80957,94104,10/15/2020
5/19/2020,415,16873,3168,112631,129504,23,1561,32,1091,5,215,255,56,38,11,682,215,13362,1924,82881,96243,10/15/2020
5/20/2020,326,17199,2771,115402,132601,19,1580,23,1114,7,222,244,52,33,22,704,183,13545,1510,84391,97936,10/15/2020
5/21/2020,374,17573,3757,119159,136732,26,1606,15,1129,3,225,252,53,29,20,724,168,13713,1935,86326,100039,10/15/2020
5/22/2020,351,17924,3161,122320,140244,20,1626,29,1158,5,230,238,52,29,10,734,206,13919,1605,87931,101850,10/15/2020
5/23/2020,253,18177,2742,125062,143239,19,1645,11,1169,3,233,243,52,32,13,747,109,14028,1269,89200,103228,10/15/2020
5/24/2020,163,18340,1370,126432,144772,13,1658,14,1183,2,235,240,53,36,8,755,83,14111,772,89972,104083,10/15/2020
5/25/2020,147,18487,1385,127817,146304,14,1672,14,1197,0,235,240,53,34,10,765,76,14187,762,90734,104921,10/15/2020
5/26/2020,285,18772,2620,130437,149209,24,1696,22,1219,5,240,237,48,33,15,780,158,14345,1778,92512,106857,10/15/2020
5/27/2020,276,19048,2057,132494,151542,20,1716,18,1237,3,243,236,50,33,10,790,132,14477,1131,93643,108120,10/15/2020
5/28/2020,348,19396,3359,135853,155249,17,1733,29,1266,4,247,220,47,32,8,798,130,14607,1116,94759,109366,10/15/2020
5/29/2020,410,19806,3914,139767,159573,19,1752,27,1293,6,253,206,43,31,12,810,174,14781,1570,96329,111110,10/15/2020
5/30/2020,225,20031,3915,143682,163713,16,1768,19,1312,4,257,199,41,29,12,822,109,14890,1817,98146,113036,10/15/2020
5/31/2020,155,20186,1688,145370,165556,11,1779,10,1322,1,258,199,44,26,3,825,78,14968,854,99000,113968,10/15/2020
6/1/2020,212,20398,2792,148162,168560,8,1787,14,1336,1,259,192,45,29,5,830,93,15061,1383,100383,115444,10/15/2020
6/2/2020,273,20671,3022,151184,171855,8,1795,9,1345,3,262,188,38,25,10,840,98,15159,1443,101826,116985,10/15/2020
6/3/2020,254,20925,3486,154670,175595,14,1809,18,1363,6,268,178,34,25,11,851,99,15258,1656,103482,118740,10/15/2020
6/4/2020,276,21201,4471,159141,180342,7,1816,25,1388,4,272,156,31,24,12,863,107,15365,2033,105515,120880,10/15/2020
6/5/2020,215,21416,3513,162654,184070,15,1831,13,1401,6,278,152,27,21,11,874,99,15464,1570,107085,122549,10/15/2020
6/6/2020,201,21617,2616,165270,186887,10,1841,7,1408,2,280,153,29,19,6,880,67,15531,1132,108217,123748,10/15/2020
6/7/2020,83,21700,1625,166895,188595,11,1852,7,1415,1,281,156,25,17,4,884,51,15582,781,108998,124580,10/15/2020
6/8/2020,119,21819,1849,168744,190563,15,1867,12,1427,2,283,157,27,18,4,888,45,15627,955,109953,125580,10/15/2020
6/9/2020,223,22042,2673,171417,193459,10,1877,18,1445,0,283,149,28,21,1,889,64,15691,1254,111207,126898,10/15/2020
6/10/2020,209,22251,2987,174404,196655,13,1890,12,1457,2,285,148,24,17,4,893,101,15792,1464,112671,128463,10/15/2020
6/11/2020,195,22446,3513,177917,200363,7,1897,15,1472,1,286,139,25,16,6,899,88,15880,1531,114202,130082,10/15/2020
6/12/2020,209,22655,4601,182518,205173,9,1906,15,1487,1,287,132,24,16,2,901,78,15958,2177,116379,132337,10/15/2020
6/13/2020,113,22768,3036,185554,208322,6,1912,5,1492,0,287,133,20,15,3,904,49,16007,1371,117750,133757,10/15/2020
6/14/2020,81,22849,2046,187600,210449,7,1919,8,1500,1,288,131,20,14,3,907,33,16040,966,118716,134756,10/15/2020
6/15/2020,188,23037,3108,190708,213745,14,1933,14,1514,0,288,131,20,16,5,912,75,16115,1788,120504,136619,10/15/2020
6/16/2020,110,23147,3017,193725,216872,11,1944,9,1523,1,289,132,22,16,8,920,50,16165,1574,122078,138243,10/15/2020
6/17/2020,127,23274,2835,196560,219834,15,1959,20,1543,4,293,123,18,14,6,926,50,16215,1318,123396,139611,10/15/2020
6/18/2020,149,23423,3047,199607,223030,9,1968,13,1556,1,294,118,19,16,7,933,70,16285,1311,124707,140992,10/15/2020
6/19/2020,141,23564,3769,203376,226940,12,1980,11,1567,1,295,118,20,17,3,936,59,16344,1369,126076,142420,10/15/2020
6/20/2020,84,23648,1891,205267,228915,9,1989,12,1579,0,295,115,20,18,4,940,36,16380,812,126888,143268,10/15/2020
6/21/2020,37,23685,1064,206331,230016,8,1997,5,1584,0,295,118,20,18,2,942,29,16409,692,127580,143989,10/15/2020
6/22/2020,138,23823,3730,210061,233884,12,2009,16,1600,0,295,114,19,18,2,944,65,16474,1703,129283,145757,10/15/2020
6/23/2020,163,23986,3831,213892,237878,3,2012,13,1613,3,298,101,18,18,7,951,81,16555,1778,131061,147616,10/15/2020
6/24/2020,120,24106,3502,217394,241500,9,2021,10,1623,1,299,99,18,18,5,956,44,16599,1680,132741,149340,10/15/2020
6/25/2020,103,24209,2883,220277,244486,6,2027,14,1637,1,300,90,17,17,1,957,50,16649,1509,134250,150899,10/15/2020
6/26/2020,94,24303,2488,222765,247068,2,2029,10,1647,0,300,82,18,18,1,958,60,16709,1329,135579,152288,10/15/2020
6/27/2020,84,24387,3214,225979,250366,5,2034,3,1650,1,301,83,17,17,5,963,37,16746,1215,136794,153540,10/15/2020
6/28/2020,39,24426,1469,227448,251874,4,2038,4,1654,4,305,79,15,14,6,969,17,16763,594,137388,154151,10/15/2020
6/29/2020,85,24511,3697,231145,255656,4,2042,5,1659,0,305,78,14,14,1,970,39,16802,1351,138739,155541,10/15/2020
6/30/2020,57,24568,1957,233102,257670,1,2043,5,1664,1,306,73,12,11,4,974,33,16835,993,139732,156567,10/15/2020
7/1/2020,144,24712,4098,237200,261912,8,2051,10,1674,0,306,71,11,11,1,975,79,16914,1927,141659,158573,10/15/2020
7/2/2020,103,24815,2803,240003,264818,5,2056,5,1679,1,307,70,10,10,3,978,59,16973,1087,142746,159719,10/15/2020
7/3/2020,50,24865,2076,242079,266944,9,2065,6,1685,0,307,73,9,9,3,981,25,16998,777,143523,160521,10/15/2020
7/4/2020,57,24922,2345,244424,269346,2,2067,4,1689,1,308,70,10,9,2,983,33,17031,1009,144532,161563,10/15/2020
7/5/2020,49,24971,2932,247356,272327,1,2068,2,1691,1,309,68,8,8,2,985,26,17057,1441,145973,163030,10/15/2020
7/6/2020,101,25072,2811,250167,275239,6,2074,6,1697,0,309,68,9,9,4,989,57,17114,1548,147521,164635,10/15/2020
7/7/2020,81,25153,3457,253624,278777,5,2079,7,1704,0,309,66,8,8,2,991,47,17161,1534,149055,166216,10/15/2020
7/8/2020,105,25258,3403,257027,282285,4,2083,2,1706,0,309,68,9,8,0,991,64,17225,1423,150478,167703,10/15/2020
7/9/2020,94,25352,3712,260739,286091,9,2092,3,1709,0,309,74,9,8,0,991,50,17275,1621,152099,169374,10/15/2020
7/10/2020,131,25483,4431,265170,290653,6,2098,3,1712,2,311,75,7,7,3,994,80,17355,2071,154170,171525,10/15/2020
7/11/2020,63,25546,2932,268102,293648,6,2104,3,1715,1,312,77,6,6,3,997,36,17391,1314,155484,172875,10/15/2020
7/12/2020,47,25593,1836,269938,295531,1,2105,3,1718,1,313,74,6,5,3,1000,34,17425,942,156426,173851,10/15/2020
7/13/2020,84,25677,3201,273139,298816,8,2113,10,1728,0,313,72,6,5,1,1001,61,17486,1503,157929,175415,10/15/2020
7/14/2020,73,25750,3292,276431,302181,7,2120,4,1732,0,313,75,5,5,1,1002,43,17529,1373,159302,176831,10/15/2020
7/15/2020,130,25880,4172,280603,306483,5,2125,7,1739,0,313,73,5,4,0,1002,99,17628,1749,161051,178679,10/15/2020
7/16/2020,102,25982,3733,284336,310318,6,2131,9,1748,0,313,70,6,5,1,1003,75,17703,1617,162668,180371,10/15/2020
7/17/2020,156,26138,4236,288572,314710,14,2145,3,1751,1,314,80,5,5,2,1005,79,17782,1844,164512,182294,10/15/2020
7/18/2020,85,26223,3267,291839,318062,5,2150,9,1760,1,315,75,5,4,4,1009,70,17852,1398,165910,183762,10/15/2020
7/19/2020,82,26305,2693,294532,320837,7,2157,3,1763,0,315,79,6,4,2,1011,57,17909,1147,167057,184966,10/15/2020
7/20/2020,71,26376,2664,297196,323572,9,2166,7,1770,0,315,81,7,5,2,1013,68,17977,1459,168516,186493,10/15/2020
7/21/2020,130,26506,4298,301494,328000,9,2175,11,1781,0,315,79,9,6,1,1014,109,18086,1918,170434,188520,10/15/2020
7/22/2020,130,26636,3927,305421,332057,11,2186,11,1792,1,316,78,7,6,1,1015,86,18172,1683,172117,190289,10/15/2020
7/23/2020,141,26777,4412,309833,336610,8,2194,6,1798,0,316,80,8,7,0,1015,115,18287,1983,174100,192387,10/15/2020
7/24/2020,172,26949,5960,315793,342742,14,2208,14,1812,0,316,80,9,7,0,1015,119,18406,2316,176416,194822,10/15/2020
7/25/2020,134,27083,4398,320191,347274,7,2215,7,1819,0,316,80,10,8,2,1017,108,18514,2096,178512,197026,10/15/2020
7/26/2020,62,27145,3027,323218,350363,8,2223,9,1828,0,316,79,11,7,1,1018,54,18568,1334,179846,198414,10/15/2020
7/27/2020,188,27333,4190,327408,354741,12,2235,7,1835,0,316,84,13,8,1,1019,138,18706,2343,182189,200895,10/15/2020
7/28/2020,105,27438,3834,331242,358680,5,2240,5,1840,0,316,84,14,7,1,1020,94,18800,1633,183822,202622,10/15/2020
7/29/2020,191,27629,5137,336379,364008,11,2251,12,1852,0,316,83,15,7,0,1020,154,18954,2321,186143,205097,10/15/2020
7/30/2020,121,27750,4344,340723,368473,6,2257,2,1854,1,317,86,15,6,1,1021,97,19051,1647,187790,206841,10/15/2020
7/31/2020,131,27881,5508,346231,374112,8,2265,10,1864,0,317,84,15,7,1,1022,89,19140,1853,189643,208783,10/15/2020
8/1/2020,108,27989,4288,350519,378508,7,2272,2,1866,0,317,89,14,7,1,1023,88,19228,1558,191201,210429,10/15/2020
8/2/2020,84,28073,2802,353321,381394,12,2284,12,1878,2,319,87,14,8,2,1025,62,19290,1270,192471,211761,10/15/2020
8/3/2020,187,28260,5238,358559,386819,13,2297,12,1890,0,319,88,16,7,1,1026,150,19440,2201,194672,214112,10/15/2020
8/4/2020,126,28386,3691,362250,390636,8,2305,6,1896,1,320,89,12,5,2,1028,99,19539,1770,196442,215981,10/15/2020
8/5/2020,148,28534,5933,368183,396717,12,2317,10,1906,1,321,90,10,5,2,1030,118,19657,2468,198910,218567,10/15/2020
8/6/2020,169,28703,5532,373715,402418,7,2324,9,1915,0,321,88,9,4,0,1030,121,19778,2406,201316,221094,10/15/2020
8/7/2020,122,28825,4845,378560,407385,13,2337,10,1925,1,322,90,9,3,2,1032,87,19865,2141,203457,223322,10/15/2020
8/8/2020,123,28948,4106,382666,411614,19,2356,6,1931,1,323,102,8,3,1,1033,92,19957,1779,205236,225193,10/15/2020
8/9/2020,42,28990,1722,384388,413378,8,2364,10,1941,0,323,100,9,4,0,1033,35,19992,1072,206308,226300,10/15/2020
8/10/2020,149,29139,4580,388968,418107,11,2375,12,1953,0,323,99,9,4,1,1034,113,20105,2020,208328,228433,10/15/2020
8/11/2020,105,29244,4325,393293,422537,6,2381,14,1967,0,323,91,10,4,3,1037,92,20197,2264,210592,230789,10/15/2020
8/12/2020,121,29365,5184,398477,427842,8,2389,11,1978,0,323,88,9,3,1,1038,101,20298,2627,213219,233517,10/15/2020
8/13/2020,135,29500,4191,402668,432168,13,2402,12,1990,0,323,89,11,3,0,1038,95,20393,1903,215122,235515,10/15/2020
8/14/2020,145,29645,5492,408160,437805,13,2415,11,2001,0,323,91,11,4,3,1041,99,20492,1971,217093,237585,10/15/2020
8/15/2020,105,29750,4533,412693,442443,9,2424,11,2012,1,324,88,11,5,0,1041,89,20581,1691,218784,239365,10/15/2020
8/16/2020,83,29833,2471,415164,444997,7,2431,6,2018,4,328,85,8,4,6,1047,70,20651,961,219745,240396,10/15/2020
8/17/2020,106,29939,4570,419734,449673,10,2441,7,2025,0,328,88,8,5,2,1049,88,20739,2392,222137,242876,10/15/2020
8/18/2020,128,30067,4904,424638,454705,11,2452,9,2034,1,329,89,8,4,5,1054,94,20833,2754,224891,245724,10/15/2020
8/19/2020,113,30180,5065,429703,459883,8,2460,9,2043,1,330,87,9,5,0,1054,90,20923,2643,227534,248457,10/15/2020
8/20/2020,173,30353,7405,437108,467461,12,2472,6,2049,2,332,91,10,5,3,1057,139,21062,3526,231060,252122,10/15/2020
8/21/2020,151,30504,6570,443678,474182,8,2480,5,2054,1,333,93,9,4,2,1059,125,21187,2945,234005,255192,10/15/2020
8/22/2020,96,30600,5547,449225,479825,10,2490,12,2066,0,333,91,11,4,1,1060,84,21271,2609,236614,257885,10/15/2020
8/23/2020,70,30670,4365,453590,484260,11,2501,6,2072,0,333,96,11,2,1,1061,56,21327,2472,239086,260413,10/15/2020
8/24/2020,105,30775,5775,459365,490140,7,2508,10,2082,1,334,92,13,4,1,1062,77,21404,3154,242240,263644,10/15/2020
8/25/2020,108,30883,4757,464122,495005,10,2518,4,2086,1,335,97,11,4,1,1063,92,21496,2293,244533,266029,10/15/2020
8/26/2020,170,31053,9476,473598,504651,4,2522,8,2094,0,335,93,9,5,1,1064,127,21623,3089,247622,269245,10/15/2020
8/27/2020,92,31145,8563,482161,513306,6,2528,13,2107,1,336,85,6,5,2,1066,70,21693,3171,250793,272486,10/15/2020
8/28/2020,112,31257,7991,490152,521409,14,2542,4,2111,0,336,95,9,7,2,1068,87,21780,2441,253234,275014,10/15/2020
8/29/2020,65,31322,5368,495520,526842,6,2548,8,2119,1,337,92,10,6,2,1070,51,21831,1914,255148,276979,10/15/2020
8/30/2020,66,31388,4314,499834,531222,7,2555,4,2123,0,337,95,8,5,2,1072,48,21879,1994,257142,279021,10/15/2020
8/31/2020,105,31493,4862,504696,536189,12,2567,15,2138,0,337,92,8,4,1,1073,81,21960,2187,259329,281289,10/15/2020
9/1/2020,98,31591,7109,511805,543396,6,2573,9,2147,1,338,88,7,4,2,1075,65,22025,2383,261712,283737,10/15/2020
9/2/2020,125,31716,10524,522329,554045,9,2582,10,2157,1,339,86,8,4,2,1077,104,22129,3062,264774,286903,10/15/2020
9/3/2020,90,31806,11065,533394,565200,8,2590,8,2165,0,339,86,9,4,3,1080,73,22202,2585,267359,289561,10/15/2020
9/4/2020,102,31908,8952,542346,574254,11,2601,4,2169,0,339,93,9,4,1,1081,83,22285,2375,269734,292019,10/15/2020
9/5/2020,52,31960,6300,548646,580606,6,2607,9,2178,0,339,90,8,3,1,1082,42,22327,1603,271337,293664,10/15/2020
9/6/2020,87,32047,4317,552963,585010,4,2611,8,2186,1,340,85,6,3,1,1083,64,22391,1957,273294,295685,10/15/2020
9/7/2020,35,32082,3000,555963,588045,11,2622,3,2189,0,340,93,5,3,1,1084,26,22417,646,273940,296357,10/15/2020
9/8/2020,74,32156,6375,562338,594494,6,2628,12,2201,1,341,86,6,3,2,1086,66,22483,1602,275542,298025,10/15/2020
9/9/2020,118,32274,8640,570978,603252,9,2637,5,2206,1,342,89,9,3,1,1087,102,22585,2147,277689,300274,10/15/2020
9/10/2020,164,32438,11326,582304,614742,9,2646,8,2214,0,342,90,10,3,0,1087,111,22696,2275,279964,302660,10/15/2020
9/11/2020,121,32559,9448,591752,624311,11,2657,11,2225,0,342,90,10,5,0,1087,98,22794,1976,281940,304734,10/15/2020
9/12/2020,109,32668,6143,597895,630563,8,2665,5,2230,2,344,91,9,5,3,1090,97,22891,1506,283446,306337,10/15/2020
9/13/2020,58,32726,2709,600604,633330,4,2669,3,2233,0,344,92,10,5,0,1090,54,22945,859,284305,307250,10/15/2020
9/14/2020,104,32830,6421,607025,639855,5,2674,3,2236,2,346,92,10,5,1,1091,95,23040,1727,286032,309072,10/15/2020
9/15/2020,122,32952,8449,615474,648426,6,2680,2,2238,1,347,95,10,5,2,1093,124,23164,2194,288226,311390,10/15/2020
9/16/2020,137,33089,9701,625175,658264,7,2687,7,2245,2,349,93,8,6,5,1098,118,23282,1974,290200,313482,10/15/2020
9/17/2020,124,33213,9222,634397,667610,7,2694,14,2259,0,349,86,8,4,0,1098,154,23436,1952,292152,315588,10/15/2020
9/18/2020,132,33345,10016,644413,677758,7,2701,7,2266,1,350,85,11,6,2,1100,132,23568,1936,294088,317656,10/15/2020
9/19/2020,116,33461,8290,652703,686164,7,2708,3,2269,0,350,89,10,6,4,1104,112,23680,1702,295790,319470,10/15/2020
9/20/2020,60,33521,3668,656371,689892,7,2715,6,2275,2,352,88,10,8,4,1108,48,23728,1327,297117,320845,10/15/2020
9/21/2020,103,33624,7001,663372,696996,12,2727,3,2278,2,354,95,9,6,2,1110,93,23821,2415,299532,323353,10/15/2020
9/22/2020,154,33778,9269,672641,706419,12,2739,3,2281,1,355,103,8,5,1,1111,125,23946,2212,301744,325690,10/15/2020
9/23/2020,136,33914,10625,683266,717180,11,2750,7,2288,0,355,107,7,5,0,1111,127,24073,2220,303964,328037,10/15/2020
9/24/2020,119,34033,12451,695717,729750,7,2757,9,2297,1,356,104,8,5,1,1112,117,24190,3173,307137,331327,10/15/2020
9/25/2020,149,34182,10534,706251,740433,9,2766,10,2307,0,356,103,7,5,1,1113,143,24333,3023,310160,334493,10/15/2020
9/26/2020,146,34328,10544,716795,751123,12,2778,9,2316,0,356,106,7,5,1,1114,117,24450,2431,312591,337041,10/15/2020
9/27/2020,42,34370,2761,719556,753926,7,2785,5,2321,0,356,108,10,5,0,1114,33,24483,849,313440,337923,10/15/2020
9/28/2020,151,34521,7285,726841,761362,6,2791,6,2327,2,358,106,8,5,2,1116,132,24615,2265,315705,340320,10/15/2020
9/29/2020,208,34729,11017,737858,772587,11,2802,18,2345,1,359,98,7,6,1,1117,190,24805,2831,318536,343341,10/15/2020
9/30/2020,221,34950,12206,750064,785014,6,2808,6,2351,0,359,98,7,6,1,1118,186,24991,2603,321139,346130,10/15/2020
10/1/2020,184,35134,12481,762545,797679,16,2824,13,2364,1,360,100,6,4,1,1119,161,25152,2437,323576,348728,10/15/2020
10/2/2020,209,35343,12127,774672,810015,12,2836,13,2377,1,361,98,7,4,1,1120,182,25334,2506,326082,351416,10/15/2020
10/3/2020,157,35500,9304,783976,819476,9,2845,9,2386,2,363,96,8,4,2,1122,133,25467,2039,328121,353588,10/15/2020
10/4/2020,81,35581,2365,786341,821922,11,2856,9,2395,1,364,97,8,4,2,1124,73,25540,966,329087,354627,10/15/2020
10/5/2020,174,35755,8935,795276,831031,29,2885,10,2405,2,366,114,10,5,3,1127,160,25700,3056,332143,357843,10/15/2020
10/6/2020,176,35931,10827,806103,842034,11,2896,4,2409,0,366,121,12,6,0,1127,188,25888,2915,335058,360946,10/15/2020
10/7/2020,228,36159,12340,818443,854602,12,2908,14,2423,2,368,117,10,6,2,1129,240,26128,3547,338605,364733,10/15/2020
10/8/2020,262,36421,14862,833305,869726,15,2923,12,2435,1,369,119,9,5,3,1132,272,26400,4205,342810,369210,10/15/2020
10/9/2020,214,36635,12825,846130,882765,18,2941,12,2447,0,369,125,12,6,2,1134,187,26587,4308,347118,373705,10/15/2020
10/10/2020,229,36864,13453,859583,896447,17,2958,10,2457,1,370,131,13,6,2,1136,188,26775,3840,350958,377733,10/15/2020
10/11/2020,94,36958,3250,862833,899791,11,2969,8,2465,1,371,133,14,5,4,1140,84,26859,1169,352127,378986,10/15/2020
10/12/2020,165,37123,6358,869191,906314,17,2986,15,2480,2,373,133,13,5,3,1143,146,27005,1748,353875,380880,10/15/2020
10/13/2020,208,37331,8350,877541,914872,13,2999,13,2493,4,377,129,12,5,4,1147,205,27210,2258,356133,383343,10/15/2020
10/14/2020,269,37600,12043,889584,927184,,,,,,,,,,2,1149,228,27438,3205,359338,386776,10/15/2020
2/27/2020,0,0,0,0,0,1,1,0,0,0,0,1,0,0,0,0,0,0,0,0,0,10/16/2020
2/28/2020,0,0,0,0,0,0,1,0,0,0,0,1,1,0,0,0,0,0,0,0,0,10/16/2020
2/29/2020,0,0,0,0,0,0,1,0,0,0,0,1,1,0,0,0,0,0,0,0,0,10/16/2020
3/1/2020,2,2,2,2,4,0,1,0,0,0,0,1,1,1,0,0,2,2,2,2,4,10/16/2020
3/2/2020,0,2,1,3,5,1,2,0,0,0,0,2,2,2,0,0,0,2,1,3,5,10/16/2020
3/3/2020,0,2,2,5,7,0,2,0,0,0,0,2,2,2,0,0,0,2,2,5,7,10/16/2020
3/4/2020,0,2,12,17,19,1,3,0,0,0,0,3,2,2,0,0,0,2,10,15,17,10/16/2020
3/5/2020,0,2,4,21,23,0,3,0,0,0,0,3,2,2,0,0,1,3,4,19,22,10/16/2020
3/6/2020,1,3,12,33,36,0,3,0,0,0,0,3,2,2,0,0,0,3,11,30,33,10/16/2020
3/7/2020,0,3,19,52,55,0,3,0,0,0,0,3,2,1,0,0,0,3,19,49,52,10/16/2020
3/8/2020,0,3,18,70,73,0,3,0,0,0,0,3,2,1,0,0,0,3,18,67,70,10/16/2020
3/9/2020,1,4,15,85,89,0,3,0,0,0,0,3,2,1,0,0,1,4,15,82,86,10/16/2020
3/10/2020,2,6,25,110,116,0,3,0,0,0,0,3,2,1,0,0,1,5,23,105,110,10/16/2020
3/11/2020,0,6,34,144,150,1,4,0,0,0,0,4,1,1,0,0,0,5,34,139,144,10/16/2020
3/12/2020,9,15,41,185,200,1,5,0,0,0,0,5,1,1,0,0,8,13,38,177,190,10/16/2020
3/13/2020,6,21,50,235,256,4,9,1,1,0,0,8,1,1,0,0,6,19,48,225,244,10/16/2020
3/14/2020,0,21,90,325,346,0,9,0,1,0,0,8,1,1,0,0,0,19,86,311,330,10/16/2020
3/15/2020,1,22,54,379,401,1,10,0,1,0,0,9,2,1,0,0,1,20,54,365,385,10/16/2020
3/16/2020,2,24,95,474,498,2,12,0,1,0,0,11,2,0,0,0,2,22,92,457,479,10/16/2020
3/17/2020,12,36,162,636,672,6,18,0,1,0,0,17,2,0,0,0,11,33,151,608,641,10/16/2020
3/18/2020,9,45,116,752,797,3,21,0,1,0,0,20,2,0,0,0,11,44,110,718,762,10/16/2020
3/19/2020,15,60,262,1014,1074,2,23,1,2,0,0,21,3,0,1,1,17,61,251,969,1030,10/16/2020
3/20/2020,13,73,197,1211,1284,5,28,0,2,0,0,26,4,0,0,1,13,74,190,1159,1233,10/16/2020
3/21/2020,12,85,126,1337,1422,3,31,2,4,0,0,27,5,0,0,1,14,88,123,1282,1370,10/16/2020
3/22/2020,27,112,282,1619,1731,2,33,0,4,0,0,29,5,0,0,1,25,113,260,1542,1655,10/16/2020
3/23/2020,14,126,169,1788,1914,15,48,1,5,0,0,43,9,3,0,1,16,129,165,1707,1836,10/16/2020
3/24/2020,20,146,242,2030,2176,7,55,0,5,0,0,50,10,4,0,1,19,148,236,1943,2091,10/16/2020
3/25/2020,26,172,182,2212,2384,5,60,1,6,0,0,54,11,3,0,1,28,176,171,2114,2290,10/16/2020
3/26/2020,35,207,181,2393,2600,10,70,5,11,0,0,59,14,5,0,1,41,217,174,2288,2505,10/16/2020
3/27/2020,27,234,214,2607,2841,9,79,1,12,1,1,66,17,6,2,3,31,248,200,2488,2736,10/16/2020
3/28/2020,59,293,260,2867,3160,13,92,3,15,2,3,74,15,6,1,4,64,312,240,2728,3040,10/16/2020
3/29/2020,100,393,350,3217,3610,8,100,4,19,1,4,77,18,8,2,6,105,417,313,3041,3458,10/16/2020
3/30/2020,62,455,222,3439,3894,20,120,5,24,0,4,92,20,11,3,9,78,495,184,3225,3720,10/16/2020
3/31/2020,71,526,369,3808,4334,11,131,7,31,1,5,95,22,13,2,11,73,568,295,3520,4088,10/16/2020
4/1/2020,99,625,698,4506,5131,18,149,7,38,0,5,106,30,15,1,12,100,668,640,4160,4828,10/16/2020
4/2/2020,52,677,477,4983,5660,22,171,6,44,2,7,120,36,21,4,16,62,730,435,4595,5325,10/16/2020
4/3/2020,108,785,774,5757,6542,23,194,7,51,0,7,136,43,25,3,19,100,830,708,5303,6133,10/16/2020
4/4/2020,143,928,660,6417,7345,22,216,4,55,5,12,149,41,30,9,28,138,968,616,5919,6887,10/16/2020
4/5/2020,187,1115,1156,7573,8688,20,236,9,64,1,13,159,44,36,2,30,181,1149,1059,6978,8127,10/16/2020
4/6/2020,218,1333,1706,9279,10612,26,262,7,71,0,13,178,48,40,7,37,207,1356,1545,8523,9879,10/16/2020
4/7/2020,284,1617,1629,10908,12525,20,282,5,76,2,15,191,50,42,5,42,261,1617,1472,9995,11612,10/16/2020
4/8/2020,290,1907,1720,12628,14535,19,301,7,83,6,21,197,50,38,10,52,271,1888,1552,11547,13435,10/16/2020
4/9/2020,283,2190,1516,14144,16334,32,333,9,92,4,25,216,53,40,7,59,277,2165,1352,12899,15064,10/16/2020
4/10/2020,419,2609,2574,16718,19327,29,362,16,108,5,30,224,59,41,11,70,401,2566,2360,15259,17825,10/16/2020
4/11/2020,297,2906,1905,18623,21529,29,391,11,119,2,32,240,61,48,12,82,281,2847,1713,16972,19819,10/16/2020
4/12/2020,314,3220,1670,20293,23513,35,426,13,132,5,37,257,59,49,9,91,284,3131,1427,18399,21530,10/16/2020
4/13/2020,161,3381,935,21228,24609,35,461,13,145,3,40,276,64,54,9,100,187,3318,837,19236,22554,10/16/2020
4/14/2020,289,3670,1787,23015,26685,27,488,17,162,5,45,281,72,53,8,108,262,3580,1524,20760,24340,10/16/2020
4/15/2020,351,4021,1799,24814,28835,31,519,20,182,3,48,289,72,54,17,125,306,3886,1545,22305,26191,10/16/2020
4/16/2020,447,4468,2494,27308,31776,36,555,25,207,6,54,294,72,53,14,139,387,4273,2068,24373,28646,10/16/2020
4/17/2020,304,4772,1821,29129,33901,32,587,20,227,7,61,299,66,45,21,160,290,4563,1442,25815,30378,10/16/2020
4/18/2020,321,5093,1725,30854,35947,26,613,18,245,4,65,303,63,49,15,175,284,4847,1320,27135,31982,10/16/2020
4/19/2020,381,5474,2047,32901,38375,23,636,26,271,1,66,299,65,55,11,186,336,5183,1737,28872,34055,10/16/2020
4/20/2020,394,5868,1907,34808,40676,46,682,29,300,2,68,314,75,56,10,196,376,5559,1565,30437,35996,10/16/2020
4/21/2020,444,6312,2110,36918,43230,45,727,33,333,5,73,321,72,56,18,214,384,5943,1698,32135,38078,10/16/2020
4/22/2020,418,6730,2390,39308,46038,41,768,32,365,5,78,325,73,58,18,232,379,6322,1912,34047,40369,10/16/2020
4/23/2020,479,7209,2469,41777,48986,32,800,28,393,5,83,324,76,62,15,247,412,6734,1848,35895,42629,10/16/2020
4/24/2020,491,7700,3284,45061,52761,35,835,26,419,4,87,329,85,63,15,262,407,7141,2620,38515,45656,10/16/2020
4/25/2020,393,8093,2206,47267,55360,34,869,17,436,5,92,341,85,62,14,276,300,7441,1758,40273,47714,10/16/2020
4/26/2020,316,8409,2309,49576,57985,33,902,15,451,3,95,356,86,59,14,290,274,7715,1870,42143,49858,10/16/2020
4/27/2020,249,8658,1620,51196,59854,29,931,21,472,4,99,360,86,61,10,300,206,7921,1156,43299,51220,10/16/2020
4/28/2020,410,9068,2263,53459,62527,44,975,24,496,3,102,377,88,59,22,322,331,8252,1752,45051,53303,10/16/2020
4/29/2020,476,9544,3343,56802,66346,36,1011,38,534,11,113,364,78,53,18,340,371,8623,2415,47466,56089,10/16/2020
4/30/2020,432,9976,2769,59571,69547,33,1044,38,572,6,119,353,83,57,24,364,350,8973,1901,49367,58340,10/16/2020
5/1/2020,454,10430,3086,62657,73087,51,1095,39,611,3,122,362,84,58,14,378,324,9297,2157,51524,60821,10/16/2020
5/2/2020,257,10687,1926,64583,75270,36,1131,38,649,5,127,355,91,62,24,402,192,9489,1263,52787,62276,10/16/2020
5/3/2020,283,10970,2160,66743,77713,31,1162,26,675,8,135,352,90,61,21,423,183,9672,1568,54355,64027,10/16/2020
5/4/2020,387,11357,2098,68841,80198,30,1192,31,706,6,141,345,88,57,18,441,290,9962,1555,55910,65872,10/16/2020
5/5/2020,433,11790,2873,71714,83504,29,1221,32,738,6,147,336,82,54,16,457,300,10262,1954,57864,68126,10/16/2020
5/6/2020,488,12278,2830,74544,86822,28,1249,44,782,9,156,311,79,54,21,478,340,10602,1913,59777,70379,10/16/2020
5/7/2020,425,12703,2969,77513,90216,36,1285,41,823,5,161,301,71,52,21,499,270,10872,1956,61733,72605,10/16/2020
5/8/2020,359,13062,2598,80111,93173,30,1315,29,852,5,166,297,71,53,22,521,229,11101,1735,63468,74569,10/16/2020
5/9/2020,467,13529,3346,83457,96986,22,1337,21,873,4,170,294,69,51,15,536,290,11391,2251,65719,77110,10/16/2020
5/10/2020,285,13814,2117,85574,99388,20,1357,23,896,6,176,285,70,49,13,549,189,11580,1518,67237,78817,10/16/2020
5/11/2020,257,14071,1857,87431,101502,31,1388,16,912,6,182,294,71,49,15,564,174,11754,1299,68536,80290,10/16/2020
5/12/2020,387,14458,2611,90042,104500,23,1411,18,930,4,186,295,69,48,22,586,224,11978,1701,70237,82215,10/16/2020
5/13/2020,351,14809,3630,93672,108481,23,1434,25,955,1,187,292,69,49,13,599,199,12177,1998,72235,84412,10/16/2020
5/14/2020,329,15138,3408,97080,112218,19,1453,27,982,3,190,281,64,45,15,614,230,12407,2012,74247,86654,10/16/2020
5/15/2020,381,15519,3458,100538,116057,24,1477,41,1023,5,195,259,62,45,14,628,232,12639,1801,76048,88687,10/16/2020
5/16/2020,449,15968,4156,104694,120662,25,1502,13,1036,5,200,266,61,46,15,643,247,12886,1956,78004,90890,10/16/2020
5/17/2020,240,16208,2768,107462,123670,17,1519,8,1044,5,205,270,59,45,10,653,126,13012,1540,79544,92556,10/16/2020
5/18/2020,250,16458,2001,109463,125921,19,1538,15,1059,5,210,269,57,40,18,671,135,13147,1366,80910,94057,10/16/2020
5/19/2020,415,16873,3168,112631,129504,23,1561,32,1091,5,215,255,56,38,11,682,215,13362,1924,82834,96196,10/16/2020
5/20/2020,326,17199,2771,115402,132601,19,1580,23,1114,7,222,244,52,33,22,704,183,13545,1510,84344,97889,10/16/2020
5/21/2020,374,17573,3757,119159,136732,26,1606,15,1129,3,225,252,53,29,20,724,168,13713,1935,86279,99992,10/16/2020
5/22/2020,351,17924,3161,122320,140244,20,1626,29,1158,5,230,238,52,29,10,734,206,13919,1604,87883,101802,10/16/2020
5/23/2020,253,18177,2742,125062,143239,19,1645,11,1169,3,233,243,52,32,13,747,109,14028,1269,89152,103180,10/16/2020
5/24/2020,163,18340,1370,126432,144772,13,1658,14,1183,2,235,240,53,36,8,755,83,14111,772,89924,104035,10/16/2020
5/25/2020,147,18487,1385,127817,146304,14,1672,14,1197,0,235,240,53,34,10,765,76,14187,761,90685,104872,10/16/2020
5/26/2020,285,18772,2620,130437,149209,24,1696,22,1219,5,240,237,48,33,15,780,158,14345,1777,92462,106807,10/16/2020
5/27/2020,276,19048,2057,132494,151542,20,1716,18,1237,3,243,236,50,33,10,790,132,14477,1131,93593,108070,10/16/2020
5/28/2020,348,19396,3359,135853,155249,17,1733,29,1266,4,247,220,47,32,8,798,130,14607,1116,94709,109316,10/16/2020
5/29/2020,410,19806,3914,139767,159573,19,1752,27,1293,6,253,206,43,31,12,810,174,14781,1570,96279,111060,10/16/2020
5/30/2020,225,20031,3915,143682,163713,16,1768,19,1312,4,257,199,41,29,12,822,109,14890,1817,98096,112986,10/16/2020
5/31/2020,155,20186,1688,145370,165556,11,1779,10,1322,1,258,199,44,26,3,825,78,14968,854,98950,113918,10/16/2020
6/1/2020,212,20398,2792,148162,168560,8,1787,14,1336,1,259,192,45,29,5,830,93,15061,1383,100333,115394,10/16/2020
6/2/2020,273,20671,3022,151184,171855,8,1795,9,1345,3,262,188,38,25,10,840,98,15159,1442,101775,116934,10/16/2020
6/3/2020,254,20925,3486,154670,175595,14,1809,18,1363,6,268,178,34,25,11,851,99,15258,1656,103431,118689,10/16/2020
6/4/2020,276,21201,4471,159141,180342,7,1816,25,1388,4,272,156,31,24,12,863,107,15365,2033,105464,120829,10/16/2020
6/5/2020,215,21416,3513,162654,184070,15,1831,13,1401,6,278,152,27,21,11,874,99,15464,1570,107034,122498,10/16/2020
6/6/2020,201,21617,2616,165270,186887,10,1841,7,1408,2,280,153,29,19,6,880,67,15531,1130,108164,123695,10/16/2020
6/7/2020,83,21700,1625,166895,188595,11,1852,7,1415,1,281,156,25,17,4,884,51,15582,781,108945,124527,10/16/2020
6/8/2020,119,21819,1849,168744,190563,15,1867,12,1427,2,283,157,27,18,4,888,45,15627,955,109900,125527,10/16/2020
6/9/2020,223,22042,2673,171417,193459,10,1877,18,1445,0,283,149,28,21,1,889,64,15691,1254,111154,126845,10/16/2020
6/10/2020,209,22251,2987,174404,196655,13,1890,12,1457,2,285,148,24,17,4,893,101,15792,1464,112618,128410,10/16/2020
6/11/2020,195,22446,3513,177917,200363,7,1897,15,1472,1,286,139,25,16,6,899,88,15880,1530,114148,130028,10/16/2020
6/12/2020,209,22655,4601,182518,205173,9,1906,15,1487,1,287,132,24,16,2,901,78,15958,2175,116323,132281,10/16/2020
6/13/2020,113,22768,3036,185554,208322,6,1912,5,1492,0,287,133,20,15,3,904,49,16007,1371,117694,133701,10/16/2020
6/14/2020,81,22849,2046,187600,210449,7,1919,8,1500,1,288,131,20,14,3,907,33,16040,966,118660,134700,10/16/2020
6/15/2020,188,23037,3108,190708,213745,14,1933,14,1514,0,288,131,20,16,5,912,75,16115,1787,120447,136562,10/16/2020
6/16/2020,110,23147,3017,193725,216872,11,1944,9,1523,1,289,132,22,16,8,920,50,16165,1572,122019,138184,10/16/2020
6/17/2020,127,23274,2835,196560,219834,15,1959,20,1543,4,293,123,18,14,6,926,50,16215,1318,123337,139552,10/16/2020
6/18/2020,149,23423,3047,199607,223030,9,1968,13,1556,1,294,118,19,16,7,933,70,16285,1311,124648,140933,10/16/2020
6/19/2020,141,23564,3769,203376,226940,12,1980,11,1567,1,295,118,20,17,3,936,59,16344,1368,126016,142360,10/16/2020
6/20/2020,84,23648,1891,205267,228915,9,1989,12,1579,0,295,115,20,18,4,940,36,16380,812,126828,143208,10/16/2020
6/21/2020,37,23685,1064,206331,230016,8,1997,5,1584,0,295,118,20,18,2,942,29,16409,692,127520,143929,10/16/2020
6/22/2020,138,23823,3730,210061,233884,12,2009,16,1600,0,295,114,19,18,2,944,65,16474,1703,129223,145697,10/16/2020
6/23/2020,163,23986,3831,213892,237878,3,2012,13,1613,3,298,101,18,18,7,951,81,16555,1778,131001,147556,10/16/2020
6/24/2020,120,24106,3502,217394,241500,9,2021,10,1623,1,299,99,18,18,5,956,44,16599,1680,132681,149280,10/16/2020
6/25/2020,103,24209,2883,220277,244486,6,2027,14,1637,1,300,90,17,17,1,957,50,16649,1509,134190,150839,10/16/2020
6/26/2020,94,24303,2488,222765,247068,2,2029,10,1647,0,300,82,18,18,1,958,60,16709,1329,135519,152228,10/16/2020
6/27/2020,84,24387,3214,225979,250366,5,2034,3,1650,1,301,83,17,17,5,963,37,16746,1215,136734,153480,10/16/2020
6/28/2020,39,24426,1469,227448,251874,4,2038,4,1654,4,305,79,15,14,6,969,17,16763,594,137328,154091,10/16/2020
6/29/2020,85,24511,3697,231145,255656,4,2042,5,1659,0,305,78,14,14,1,970,39,16802,1351,138679,155481,10/16/2020
6/30/2020,57,24568,1957,233102,257670,1,2043,5,1664,1,306,73,12,11,4,974,33,16835,993,139672,156507,10/16/2020
7/1/2020,144,24712,4098,237200,261912,8,2051,10,1674,0,306,71,11,11,1,975,79,16914,1927,141599,158513,10/16/2020
7/2/2020,103,24815,2803,240003,264818,5,2056,5,1679,1,307,70,10,10,3,978,59,16973,1085,142684,159657,10/16/2020
7/3/2020,50,24865,2076,242079,266944,9,2065,6,1685,0,307,73,9,9,3,981,25,16998,777,143461,160459,10/16/2020
7/4/2020,57,24922,2345,244424,269346,2,2067,4,1689,1,308,70,10,9,2,983,33,17031,1009,144470,161501,10/16/2020
7/5/2020,49,24971,2932,247356,272327,1,2068,2,1691,1,309,68,8,8,2,985,26,17057,1440,145910,162967,10/16/2020
7/6/2020,101,25072,2811,250167,275239,6,2074,6,1697,0,309,68,9,9,4,989,57,17114,1548,147458,164572,10/16/2020
7/7/2020,81,25153,3457,253624,278777,5,2079,7,1704,0,309,66,8,8,2,991,47,17161,1534,148992,166153,10/16/2020
7/8/2020,105,25258,3403,257027,282285,4,2083,2,1706,0,309,68,9,8,0,991,64,17225,1422,150414,167639,10/16/2020
7/9/2020,94,25352,3712,260739,286091,9,2092,3,1709,0,309,74,9,8,0,991,50,17275,1621,152035,169310,10/16/2020
7/10/2020,131,25483,4431,265170,290653,6,2098,3,1712,2,311,75,7,7,3,994,80,17355,2069,154104,171459,10/16/2020
7/11/2020,63,25546,2932,268102,293648,6,2104,3,1715,1,312,77,6,6,3,997,36,17391,1313,155417,172808,10/16/2020
7/12/2020,47,25593,1836,269938,295531,1,2105,3,1718,1,313,74,6,5,3,1000,34,17425,942,156359,173784,10/16/2020
7/13/2020,84,25677,3201,273139,298816,8,2113,10,1728,0,313,72,6,5,1,1001,61,17486,1503,157862,175348,10/16/2020
7/14/2020,73,25750,3292,276431,302181,7,2120,4,1732,0,313,75,5,5,1,1002,43,17529,1373,159235,176764,10/16/2020
7/15/2020,130,25880,4172,280603,306483,5,2125,7,1739,0,313,73,5,4,0,1002,99,17628,1749,160984,178612,10/16/2020
7/16/2020,102,25982,3733,284336,310318,6,2131,9,1748,0,313,70,6,5,1,1003,75,17703,1617,162601,180304,10/16/2020
7/17/2020,156,26138,4236,288572,314710,14,2145,3,1751,1,314,80,5,5,2,1005,79,17782,1844,164445,182227,10/16/2020
7/18/2020,85,26223,3267,291839,318062,5,2150,9,1760,1,315,75,5,4,4,1009,70,17852,1396,165841,183693,10/16/2020
7/19/2020,82,26305,2693,294532,320837,7,2157,3,1763,0,315,79,6,4,2,1011,57,17909,1147,166988,184897,10/16/2020
7/20/2020,71,26376,2664,297196,323572,9,2166,7,1770,0,315,81,7,5,2,1013,68,17977,1459,168447,186424,10/16/2020
7/21/2020,130,26506,4298,301494,328000,9,2175,11,1781,0,315,79,9,6,1,1014,109,18086,1917,170364,188450,10/16/2020
7/22/2020,130,26636,3927,305421,332057,11,2186,11,1792,1,316,78,7,6,1,1015,86,18172,1683,172047,190219,10/16/2020
7/23/2020,141,26777,4412,309833,336610,8,2194,6,1798,0,316,80,8,7,0,1015,115,18287,1983,174030,192317,10/16/2020
7/24/2020,172,26949,5960,315793,342742,14,2208,14,1812,0,316,80,9,7,0,1015,119,18406,2315,176345,194751,10/16/2020
7/25/2020,134,27083,4398,320191,347274,7,2215,7,1819,0,316,80,10,8,2,1017,108,18514,2095,178440,196954,10/16/2020
7/26/2020,62,27145,3027,323218,350363,8,2223,9,1828,0,316,79,11,7,1,1018,54,18568,1334,179774,198342,10/16/2020
7/27/2020,188,27333,4190,327408,354741,12,2235,7,1835,0,316,84,13,8,1,1019,138,18706,2343,182117,200823,10/16/2020
7/28/2020,105,27438,3834,331242,358680,5,2240,5,1840,0,316,84,14,7,1,1020,94,18800,1632,183749,202549,10/16/2020
7/29/2020,191,27629,5137,336379,364008,11,2251,12,1852,0,316,83,15,7,0,1020,154,18954,2318,186067,205021,10/16/2020
7/30/2020,121,27750,4344,340723,368473,6,2257,2,1854,1,317,86,15,6,1,1021,97,19051,1646,187713,206764,10/16/2020
7/31/2020,131,27881,5508,346231,374112,8,2265,10,1864,0,317,84,15,7,1,1022,89,19140,1853,189566,208706,10/16/2020
8/1/2020,108,27989,4288,350519,378508,7,2272,2,1866,0,317,89,14,7,1,1023,88,19228,1558,191124,210352,10/16/2020
8/2/2020,84,28073,2802,353321,381394,12,2284,12,1878,2,319,87,14,8,2,1025,62,19290,1269,192393,211683,10/16/2020
8/3/2020,187,28260,5238,358559,386819,13,2297,12,1890,0,319,88,16,7,1,1026,150,19440,2201,194594,214034,10/16/2020
8/4/2020,126,28386,3691,362250,390636,8,2305,6,1896,1,320,89,12,5,2,1028,99,19539,1770,196364,215903,10/16/2020
8/5/2020,148,28534,5933,368183,396717,12,2317,10,1906,1,321,90,10,5,2,1030,118,19657,2468,198832,218489,10/16/2020
8/6/2020,169,28703,5532,373715,402418,7,2324,9,1915,0,321,88,9,4,0,1030,121,19778,2405,201237,221015,10/16/2020
8/7/2020,122,28825,4845,378560,407385,13,2337,10,1925,1,322,90,9,3,2,1032,87,19865,2140,203377,223242,10/16/2020
8/8/2020,123,28948,4106,382666,411614,19,2356,6,1931,1,323,102,8,3,1,1033,92,19957,1779,205156,225113,10/16/2020
8/9/2020,42,28990,1722,384388,413378,8,2364,10,1941,0,323,100,9,4,0,1033,35,19992,1072,206228,226220,10/16/2020
8/10/2020,149,29139,4580,388968,418107,11,2375,12,1953,0,323,99,9,4,1,1034,113,20105,2020,208248,228353,10/16/2020
8/11/2020,105,29244,4325,393293,422537,6,2381,14,1967,0,323,91,10,4,3,1037,92,20197,2264,210512,230709,10/16/2020
8/12/2020,121,29365,5184,398477,427842,8,2389,11,1978,0,323,88,9,3,1,1038,101,20298,2627,213139,233437,10/16/2020
8/13/2020,135,29500,4191,402668,432168,13,2402,12,1990,0,323,89,11,3,0,1038,95,20393,1902,215041,235434,10/16/2020
8/14/2020,145,29645,5492,408160,437805,13,2415,11,2001,0,323,91,11,4,3,1041,99,20492,1971,217012,237504,10/16/2020
8/15/2020,105,29750,4533,412693,442443,9,2424,11,2012,1,324,88,11,5,0,1041,89,20581,1691,218703,239284,10/16/2020
8/16/2020,83,29833,2471,415164,444997,7,2431,6,2018,4,328,85,8,4,6,1047,70,20651,961,219664,240315,10/16/2020
8/17/2020,106,29939,4570,419734,449673,10,2441,7,2025,0,328,88,8,5,2,1049,88,20739,2392,222056,242795,10/16/2020
8/18/2020,128,30067,4904,424638,454705,11,2452,9,2034,1,329,89,8,4,5,1054,94,20833,2753,224809,245642,10/16/2020
8/19/2020,113,30180,5065,429703,459883,8,2460,9,2043,1,330,87,9,5,0,1054,90,20923,2643,227452,248375,10/16/2020
8/20/2020,173,30353,7405,437108,467461,12,2472,6,2049,2,332,91,10,5,3,1057,139,21062,3524,230976,252038,10/16/2020
8/21/2020,151,30504,6570,443678,474182,8,2480,5,2054,1,333,93,9,4,2,1059,125,21187,2945,233921,255108,10/16/2020
8/22/2020,96,30600,5547,449225,479825,10,2490,12,2066,0,333,91,11,4,1,1060,84,21271,2609,236530,257801,10/16/2020
8/23/2020,70,30670,4365,453590,484260,11,2501,6,2072,0,333,96,11,2,1,1061,56,21327,2472,239002,260329,10/16/2020
8/24/2020,105,30775,5775,459365,490140,7,2508,10,2082,1,334,92,13,4,1,1062,77,21404,3154,242156,263560,10/16/2020
8/25/2020,108,30883,4757,464122,495005,10,2518,4,2086,1,335,97,11,4,1,1063,92,21496,2293,244449,265945,10/16/2020
8/26/2020,170,31053,9476,473598,504651,4,2522,8,2094,0,335,93,9,5,1,1064,127,21623,3089,247538,269161,10/16/2020
8/27/2020,92,31145,8563,482161,513306,6,2528,13,2107,1,336,85,6,5,2,1066,70,21693,3170,250708,272401,10/16/2020
8/28/2020,112,31257,7991,490152,521409,14,2542,4,2111,0,336,95,9,7,2,1068,87,21780,2440,253148,274928,10/16/2020
8/29/2020,65,31322,5368,495520,526842,6,2548,8,2119,1,337,92,10,6,2,1070,51,21831,1913,255061,276892,10/16/2020
8/30/2020,66,31388,4314,499834,531222,7,2555,4,2123,0,337,95,8,5,2,1072,48,21879,1994,257055,278934,10/16/2020
8/31/2020,105,31493,4862,504696,536189,12,2567,15,2138,0,337,92,8,4,1,1073,81,21960,2187,259242,281202,10/16/2020
9/1/2020,98,31591,7109,511805,543396,6,2573,9,2147,1,338,88,7,4,2,1075,65,22025,2383,261625,283650,10/16/2020
9/2/2020,125,31716,10524,522329,554045,9,2582,10,2157,1,339,86,8,4,2,1077,104,22129,3062,264687,286816,10/16/2020
9/3/2020,90,31806,11065,533394,565200,8,2590,8,2165,0,339,86,9,4,3,1080,73,22202,2585,267272,289474,10/16/2020
9/4/2020,102,31908,8952,542346,574254,11,2601,4,2169,0,339,93,9,4,1,1081,83,22285,2375,269647,291932,10/16/2020
9/5/2020,52,31960,6300,548646,580606,6,2607,9,2178,0,339,90,8,3,1,1082,42,22327,1603,271250,293577,10/16/2020
9/6/2020,87,32047,4317,552963,585010,4,2611,8,2186,1,340,85,6,3,1,1083,64,22391,1956,273206,295597,10/16/2020
9/7/2020,35,32082,3000,555963,588045,11,2622,3,2189,0,340,93,5,3,1,1084,26,22417,646,273852,296269,10/16/2020
9/8/2020,74,32156,6375,562338,594494,6,2628,12,2201,1,341,86,6,3,2,1086,66,22483,1602,275454,297937,10/16/2020
9/9/2020,118,32274,8640,570978,603252,9,2637,5,2206,1,342,89,9,3,1,1087,102,22585,2147,277601,300186,10/16/2020
9/10/2020,164,32438,11326,582304,614742,9,2646,8,2214,0,342,90,10,3,0,1087,111,22696,2275,279876,302572,10/16/2020
9/11/2020,121,32559,9448,591752,624311,11,2657,11,2225,0,342,90,10,5,0,1087,98,22794,1976,281852,304646,10/16/2020
9/12/2020,109,32668,6143,597895,630563,8,2665,5,2230,2,344,91,9,5,3,1090,97,22891,1506,283358,306249,10/16/2020
9/13/2020,58,32726,2709,600604,633330,4,2669,3,2233,0,344,92,10,5,0,1090,54,22945,859,284217,307162,10/16/2020
9/14/2020,104,32830,6421,607025,639855,5,2674,3,2236,2,346,92,10,5,1,1091,95,23040,1727,285944,308984,10/16/2020
9/15/2020,122,32952,8449,615474,648426,6,2680,2,2238,1,347,95,10,5,2,1093,124,23164,2192,288136,311300,10/16/2020
9/16/2020,137,33089,9701,625175,658264,7,2687,7,2245,2,349,93,8,6,5,1098,118,23282,1974,290110,313392,10/16/2020
9/17/2020,124,33213,9222,634397,667610,7,2694,14,2259,0,349,86,8,4,0,1098,154,23436,1952,292062,315498,10/16/2020
9/18/2020,132,33345,10016,644413,677758,7,2701,7,2266,1,350,85,11,6,2,1100,132,23568,1936,293998,317566,10/16/2020
9/19/2020,116,33461,8290,652703,686164,7,2708,3,2269,0,350,89,10,6,4,1104,112,23680,1702,295700,319380,10/16/2020
9/20/2020,60,33521,3668,656371,689892,7,2715,6,2275,2,352,88,9,8,4,1108,48,23728,1326,297026,320754,10/16/2020
9/21/2020,103,33624,7002,663373,696997,12,2727,3,2278,2,354,95,8,6,2,1110,93,23821,2416,299442,323263,10/16/2020
9/22/2020,154,33778,9269,672642,706420,12,2739,3,2281,1,355,103,7,5,1,1111,125,23946,2209,301651,325597,10/16/2020
9/23/2020,136,33914,10625,683267,717181,11,2750,7,2288,0,355,107,6,5,0,1111,127,24073,2219,303870,327943,10/16/2020
9/24/2020,119,34033,12452,695719,729752,7,2757,9,2297,1,356,104,7,5,1,1112,117,24190,3172,307042,331232,10/16/2020
9/25/2020,149,34182,10534,706253,740435,9,2766,10,2307,0,356,103,6,5,1,1113,143,24333,3022,310064,334397,10/16/2020
9/26/2020,146,34328,10544,716797,751125,12,2778,9,2316,0,356,106,6,5,1,1114,118,24451,2430,312494,336945,10/16/2020
9/27/2020,42,34370,2761,719558,753928,7,2785,5,2321,0,356,108,9,5,0,1114,33,24484,849,313343,337827,10/16/2020
9/28/2020,151,34521,7285,726843,761364,6,2791,6,2327,2,358,106,7,5,2,1116,132,24616,2265,315608,340224,10/16/2020
9/29/2020,208,34729,11017,737860,772589,11,2802,18,2345,1,359,98,6,6,1,1117,190,24806,2830,318438,343244,10/16/2020
9/30/2020,221,34950,12206,750066,785016,6,2808,6,2351,0,359,98,6,6,1,1118,186,24992,2603,321041,346033,10/16/2020
10/1/2020,184,35134,12481,762547,797681,16,2824,13,2364,1,360,100,5,4,1,1119,161,25153,2436,323477,348630,10/16/2020
10/2/2020,209,35343,12127,774674,810017,12,2836,13,2377,1,361,98,6,4,2,1121,182,25335,2506,325983,351318,10/16/2020
10/3/2020,157,35500,9304,783978,819478,9,2845,9,2386,2,363,96,7,4,2,1123,133,25468,2039,328022,353490,10/16/2020
10/4/2020,81,35581,2365,786343,821924,11,2856,9,2395,1,364,97,6,4,2,1125,75,25543,966,328988,354531,10/16/2020
10/5/2020,174,35755,8935,795278,831033,29,2885,10,2405,2,366,114,8,5,3,1128,160,25703,3054,332042,357745,10/16/2020
10/6/2020,176,35931,10827,806105,842036,11,2896,4,2409,0,366,121,10,6,0,1128,188,25891,2913,334955,360846,10/16/2020
10/7/2020,228,36159,12340,818445,854604,12,2908,14,2423,2,368,117,8,6,2,1130,243,26134,3546,338501,364635,10/16/2020
10/8/2020,262,36421,14862,833307,869728,16,2924,12,2435,1,369,120,7,5,3,1133,272,26406,4202,342703,369109,10/16/2020
10/9/2020,214,36635,12825,846132,882767,18,2942,12,2447,0,369,126,10,6,2,1135,189,26595,4308,347011,373606,10/16/2020
10/10/2020,229,36864,13453,859585,896449,17,2959,10,2457,1,370,132,12,6,2,1137,189,26784,3837,350848,377632,10/16/2020
10/11/2020,94,36958,3250,862835,899793,12,2971,9,2466,1,371,134,13,5,5,1142,85,26869,1168,352016,378885,10/16/2020
10/12/2020,165,37123,6358,869193,906316,17,2988,15,2481,2,373,134,13,5,3,1145,139,27008,1748,353764,380772,10/16/2020
10/13/2020,209,37332,8419,877612,914944,14,3002,13,2494,4,377,131,12,5,5,1150,206,27214,2295,356059,383273,10/16/2020
10/14/2020,297,37629,13783,891395,929024,13,3015,7,2501,0,377,137,14,5,2,1152,279,27493,3976,360035,387528,10/16/2020
10/15/2020,214,37843,6385,897780,935623,,,,,,,,,,0,1152,198,27691,2451,362486,390177,10/16/2020
2/27/2020,0,0,0,0,0,1,1,0,0,0,0,1,0,0,0,0,0,0,0,0,0,10/19/2020
2/28/2020,0,0,0,0,0,0,1,0,0,0,0,1,1,0,0,0,0,0,0,0,0,10/19/2020
2/29/2020,0,0,0,0,0,0,1,0,0,0,0,1,1,0,0,0,0,0,0,0,0,10/19/2020
3/1/2020,2,2,2,2,4,0,1,0,0,0,0,1,1,1,0,0,2,2,2,2,4,10/19/2020
3/2/2020,0,2,1,3,5,1,2,0,0,0,0,2,2,2,0,0,0,2,1,3,5,10/19/2020
3/3/2020,0,2,2,5,7,0,2,0,0,0,0,2,2,2,0,0,0,2,2,5,7,10/19/2020
3/4/2020,0,2,12,17,19,1,3,0,0,0,0,3,2,2,0,0,0,2,10,15,17,10/19/2020
3/5/2020,0,2,4,21,23,0,3,0,0,0,0,3,2,2,0,0,1,3,4,19,22,10/19/2020
3/6/2020,1,3,12,33,36,0,3,0,0,0,0,3,2,2,0,0,0,3,11,30,33,10/19/2020
3/7/2020,0,3,19,52,55,0,3,0,0,0,0,3,2,1,0,0,0,3,19,49,52,10/19/2020
3/8/2020,0,3,18,70,73,0,3,0,0,0,0,3,2,1,0,0,0,3,18,67,70,10/19/2020
3/9/2020,1,4,15,85,89,0,3,0,0,0,0,3,2,1,0,0,1,4,15,82,86,10/19/2020
3/10/2020,2,6,25,110,116,0,3,0,0,0,0,3,2,1,0,0,1,5,23,105,110,10/19/2020
3/11/2020,0,6,34,144,150,1,4,0,0,0,0,4,1,1,0,0,0,5,34,139,144,10/19/2020
3/12/2020,9,15,41,185,200,1,5,0,0,0,0,5,1,1,0,0,8,13,38,177,190,10/19/2020
3/13/2020,6,21,50,235,256,4,9,1,1,0,0,8,1,1,0,0,6,19,48,225,244,10/19/2020
3/14/2020,0,21,90,325,346,0,9,0,1,0,0,8,1,1,0,0,0,19,86,311,330,10/19/2020
3/15/2020,1,22,54,379,401,1,10,0,1,0,0,9,2,1,0,0,1,20,54,365,385,10/19/2020
3/16/2020,2,24,95,474,498,2,12,0,1,0,0,11,2,0,0,0,2,22,92,457,479,10/19/2020
3/17/2020,12,36,162,636,672,6,18,0,1,0,0,17,2,0,0,0,11,33,151,608,641,10/19/2020
3/18/2020,9,45,116,752,797,3,21,0,1,0,0,20,2,0,0,0,11,44,110,718,762,10/19/2020
3/19/2020,15,60,262,1014,1074,2,23,1,2,0,0,21,3,0,1,1,17,61,251,969,1030,10/19/2020
3/20/2020,13,73,197,1211,1284,5,28,0,2,0,0,26,4,0,0,1,13,74,190,1159,1233,10/19/2020
3/21/2020,12,85,126,1337,1422,3,31,2,4,0,0,27,5,0,0,1,14,88,123,1282,1370,10/19/2020
3/22/2020,27,112,282,1619,1731,2,33,0,4,0,0,29,5,0,0,1,25,113,260,1542,1655,10/19/2020
3/23/2020,14,126,169,1788,1914,15,48,1,5,0,0,43,9,3,0,1,16,129,165,1707,1836,10/19/2020
3/24/2020,20,146,242,2030,2176,7,55,0,5,0,0,50,10,4,0,1,19,148,235,1942,2090,10/19/2020
3/25/2020,26,172,182,2212,2384,5,60,1,6,0,0,54,11,3,0,1,28,176,171,2113,2289,10/19/2020
3/26/2020,35,207,181,2393,2600,10,70,5,11,0,0,59,14,5,0,1,41,217,174,2287,2504,10/19/2020
3/27/2020,27,234,214,2607,2841,9,79,1,12,1,1,66,17,6,2,3,31,248,200,2487,2735,10/19/2020
3/28/2020,59,293,260,2867,3160,13,92,3,15,2,3,74,15,6,1,4,64,312,240,2727,3039,10/19/2020
3/29/2020,100,393,350,3217,3610,8,100,4,19,1,4,77,18,8,2,6,105,417,313,3040,3457,10/19/2020
3/30/2020,62,455,222,3439,3894,20,120,5,24,0,4,92,20,11,3,9,78,495,184,3224,3719,10/19/2020
3/31/2020,71,526,369,3808,4334,11,131,7,31,1,5,95,22,13,2,11,73,568,294,3518,4086,10/19/2020
4/1/2020,99,625,698,4506,5131,18,149,7,38,0,5,106,30,15,1,12,100,668,640,4158,4826,10/19/2020
4/2/2020,52,677,477,4983,5660,22,171,6,44,2,7,120,36,21,4,16,62,730,434,4592,5322,10/19/2020
4/3/2020,108,785,774,5757,6542,23,194,7,51,0,7,136,43,25,3,19,100,830,707,5299,6129,10/19/2020
4/4/2020,143,928,660,6417,7345,22,216,4,55,5,12,149,41,30,9,28,138,968,616,5915,6883,10/19/2020
4/5/2020,187,1115,1156,7573,8688,20,236,9,64,1,13,159,44,36,2,30,181,1149,1057,6972,8121,10/19/2020
4/6/2020,218,1333,1706,9279,10612,26,262,7,71,0,13,178,48,40,7,37,207,1356,1545,8517,9873,10/19/2020
4/7/2020,284,1617,1629,10908,12525,20,282,5,76,2,15,191,50,42,5,42,261,1617,1471,9988,11605,10/19/2020
4/8/2020,290,1907,1720,12628,14535,19,301,7,83,6,21,197,50,38,10,52,271,1888,1550,11538,13426,10/19/2020
4/9/2020,283,2190,1516,14144,16334,32,333,9,92,4,25,216,53,40,7,59,277,2165,1351,12889,15054,10/19/2020
4/10/2020,419,2609,2574,16718,19327,29,362,16,108,5,30,224,59,41,11,70,401,2566,2359,15248,17814,10/19/2020
4/11/2020,297,2906,1905,18623,21529,29,391,11,119,2,32,240,61,48,12,82,281,2847,1712,16960,19807,10/19/2020
4/12/2020,314,3220,1670,20293,23513,35,426,13,132,5,37,257,59,49,9,91,284,3131,1427,18387,21518,10/19/2020
4/13/2020,161,3381,935,21228,24609,35,461,13,145,3,40,276,64,54,9,100,187,3318,835,19222,22540,10/19/2020
4/14/2020,289,3670,1787,23015,26685,27,488,17,162,5,45,281,72,53,8,108,262,3580,1524,20746,24326,10/19/2020
4/15/2020,351,4021,1799,24814,28835,31,519,20,182,3,48,289,72,54,17,125,306,3886,1544,22290,26176,10/19/2020
4/16/2020,447,4468,2494,27308,31776,36,555,25,207,6,54,294,72,53,14,139,387,4273,2067,24357,28630,10/19/2020
4/17/2020,304,4772,1821,29129,33901,32,587,20,227,7,61,299,66,45,21,160,290,4563,1440,25797,30360,10/19/2020
4/18/2020,321,5093,1725,30854,35947,26,613,18,245,4,65,303,63,49,15,175,284,4847,1319,27116,31963,10/19/2020
4/19/2020,381,5474,2047,32901,38375,23,636,26,271,1,66,299,65,55,11,186,336,5183,1737,28853,34036,10/19/2020
4/20/2020,394,5868,1907,34808,40676,46,682,29,300,2,68,314,75,56,10,196,376,5559,1564,30417,35976,10/19/2020
4/21/2020,444,6312,2110,36918,43230,45,727,33,333,5,73,321,72,56,18,214,384,5943,1696,32113,38056,10/19/2020
4/22/2020,418,6730,2390,39308,46038,41,768,32,365,5,78,325,73,58,18,232,379,6322,1909,34022,40344,10/19/2020
4/23/2020,479,7209,2469,41777,48986,32,800,28,393,5,83,324,76,62,15,247,412,6734,1846,35868,42602,10/19/2020
4/24/2020,491,7700,3284,45061,52761,35,835,26,419,4,87,329,85,63,15,262,407,7141,2617,38485,45626,10/19/2020
4/25/2020,393,8093,2206,47267,55360,34,869,17,436,5,92,341,85,62,14,276,300,7441,1757,40242,47683,10/19/2020
4/26/2020,316,8409,2309,49576,57985,33,902,15,451,3,95,356,86,59,14,290,274,7715,1867,42109,49824,10/19/2020
4/27/2020,249,8658,1620,51196,59854,29,931,21,472,4,99,360,86,61,10,300,206,7921,1156,43265,51186,10/19/2020
4/28/2020,410,9068,2263,53459,62527,44,975,24,496,3,102,377,88,59,22,322,331,8252,1751,45016,53268,10/19/2020
4/29/2020,476,9544,3343,56802,66346,36,1011,38,534,11,113,364,78,53,18,340,371,8623,2414,47430,56053,10/19/2020
4/30/2020,432,9976,2769,59571,69547,33,1044,38,572,6,119,353,83,57,24,364,350,8973,1901,49331,58304,10/19/2020
5/1/2020,454,10430,3086,62657,73087,51,1095,39,611,3,122,362,84,58,14,378,324,9297,2153,51484,60781,10/19/2020
5/2/2020,257,10687,1926,64583,75270,36,1131,38,649,5,127,355,91,62,24,402,192,9489,1262,52746,62235,10/19/2020
5/3/2020,283,10970,2160,66743,77713,31,1162,26,675,8,135,352,90,61,21,423,183,9672,1564,54310,63982,10/19/2020
5/4/2020,387,11357,2098,68841,80198,30,1192,31,706,6,141,345,88,57,18,441,290,9962,1555,55865,65827,10/19/2020
5/5/2020,433,11790,2873,71714,83504,29,1221,32,738,6,147,336,82,54,16,457,300,10262,1951,57816,68078,10/19/2020
5/6/2020,488,12278,2830,74544,86822,28,1249,44,782,9,156,311,79,54,21,478,340,10602,1912,59728,70330,10/19/2020
5/7/2020,425,12703,2969,77513,90216,36,1285,41,823,5,161,301,71,52,21,499,270,10872,1955,61683,72555,10/19/2020
5/8/2020,359,13062,2598,80111,93173,30,1315,29,852,5,166,297,71,53,22,521,229,11101,1734,63417,74518,10/19/2020
5/9/2020,467,13529,3346,83457,96986,22,1337,21,873,4,170,294,69,51,15,536,290,11391,2248,65665,77056,10/19/2020
5/10/2020,285,13814,2117,85574,99388,20,1357,23,896,6,176,285,70,49,13,549,189,11580,1516,67181,78761,10/19/2020
5/11/2020,257,14071,1857,87431,101502,31,1388,16,912,6,182,294,71,49,15,564,174,11754,1298,68479,80233,10/19/2020
5/12/2020,387,14458,2611,90042,104500,23,1411,18,930,4,186,295,69,48,22,586,224,11978,1698,70177,82155,10/19/2020
5/13/2020,351,14809,3630,93672,108481,23,1434,25,955,1,187,292,69,49,13,599,199,12177,1991,72168,84345,10/19/2020
5/14/2020,329,15138,3408,97080,112218,19,1453,27,982,3,190,281,64,45,15,614,231,12408,2011,74179,86587,10/19/2020
5/15/2020,381,15519,3458,100538,116057,24,1477,41,1023,5,195,259,62,45,14,628,232,12640,1801,75980,88620,10/19/2020
5/16/2020,449,15968,4156,104694,120662,25,1502,13,1036,5,200,266,61,46,15,643,247,12887,1949,77929,90816,10/19/2020
5/17/2020,240,16208,2768,107462,123670,17,1519,8,1044,5,205,270,59,45,10,653,126,13013,1537,79466,92479,10/19/2020
5/18/2020,250,16458,2001,109463,125921,19,1538,15,1059,5,210,269,57,40,18,671,135,13148,1366,80832,93980,10/19/2020
5/19/2020,415,16873,3168,112631,129504,23,1561,32,1091,5,215,255,56,38,11,682,215,13363,1922,82754,96117,10/19/2020
5/20/2020,326,17199,2771,115402,132601,19,1580,23,1114,7,222,244,52,33,22,704,183,13546,1509,84263,97809,10/19/2020
5/21/2020,374,17573,3757,119159,136732,26,1606,15,1129,3,225,252,53,29,20,724,168,13714,1933,86196,99910,10/19/2020
5/22/2020,351,17924,3161,122320,140244,20,1626,29,1158,5,230,238,52,29,10,734,206,13920,1604,87800,101720,10/19/2020
5/23/2020,253,18177,2742,125062,143239,19,1645,11,1169,3,233,243,52,32,13,747,109,14029,1267,89067,103096,10/19/2020
5/24/2020,163,18340,1370,126432,144772,13,1658,14,1183,2,235,240,53,36,8,755,83,14112,772,89839,103951,10/19/2020
5/25/2020,147,18487,1385,127817,146304,14,1672,14,1197,0,235,240,53,34,10,765,76,14188,761,90600,104788,10/19/2020
5/26/2020,285,18772,2620,130437,149209,24,1696,22,1219,5,240,237,48,33,15,780,158,14346,1777,92377,106723,10/19/2020
5/27/2020,276,19048,2057,132494,151542,20,1716,18,1237,3,243,236,50,33,10,790,132,14478,1130,93507,107985,10/19/2020
5/28/2020,348,19396,3359,135853,155249,17,1733,29,1266,4,247,220,47,32,8,798,130,14608,1115,94622,109230,10/19/2020
5/29/2020,410,19806,3914,139767,159573,19,1752,27,1293,6,253,206,43,31,12,810,174,14782,1569,96191,110973,10/19/2020
5/30/2020,225,20031,3915,143682,163713,16,1768,19,1312,4,257,199,41,29,12,822,109,14891,1817,98008,112899,10/19/2020
5/31/2020,155,20186,1688,145370,165556,11,1779,10,1322,1,258,199,44,26,3,825,78,14969,854,98862,113831,10/19/2020
6/1/2020,212,20398,2792,148162,168560,8,1787,14,1336,1,259,192,45,29,5,830,93,15062,1380,100242,115304,10/19/2020
6/2/2020,273,20671,3022,151184,171855,8,1795,9,1345,3,262,188,38,25,10,840,98,15160,1442,101684,116844,10/19/2020
6/3/2020,254,20925,3486,154670,175595,14,1809,18,1363,6,268,178,34,25,11,851,99,15259,1655,103339,118598,10/19/2020
6/4/2020,276,21201,4471,159141,180342,7,1816,25,1388,4,272,156,31,24,12,863,107,15366,2032,105371,120737,10/19/2020
6/5/2020,215,21416,3513,162654,184070,15,1831,13,1401,6,278,152,27,21,11,874,99,15465,1570,106941,122406,10/19/2020
6/6/2020,201,21617,2616,165270,186887,10,1841,7,1408,2,280,153,29,19,6,880,67,15532,1128,108069,123601,10/19/2020
6/7/2020,83,21700,1625,166895,188595,11,1852,7,1415,1,281,156,25,17,4,884,51,15583,781,108850,124433,10/19/2020
6/8/2020,119,21819,1849,168744,190563,15,1867,12,1427,2,283,157,27,18,4,888,45,15628,954,109804,125432,10/19/2020
6/9/2020,223,22042,2673,171417,193459,10,1877,18,1445,0,283,149,28,21,1,889,64,15692,1253,111057,126749,10/19/2020
6/10/2020,209,22251,2987,174404,196655,13,1890,12,1457,2,285,148,24,17,4,893,101,15793,1463,112520,128313,10/19/2020
6/11/2020,195,22446,3513,177917,200363,7,1897,15,1472,1,286,139,25,16,6,899,88,15881,1530,114050,129931,10/19/2020
6/12/2020,209,22655,4601,182518,205173,9,1906,15,1487,1,287,132,24,16,2,901,78,15959,2171,116221,132180,10/19/2020
6/13/2020,113,22768,3036,185554,208322,6,1912,5,1492,0,287,133,20,15,3,904,49,16008,1365,117586,133594,10/19/2020
6/14/2020,81,22849,2046,187600,210449,7,1919,8,1500,1,288,131,20,14,3,907,33,16041,965,118551,134592,10/19/2020
6/15/2020,188,23037,3108,190708,213745,14,1933,14,1514,0,288,131,20,16,5,912,75,16116,1787,120338,136454,10/19/2020
6/16/2020,110,23147,3017,193725,216872,11,1944,9,1523,1,289,132,22,16,8,920,50,16166,1559,121897,138063,10/19/2020
6/17/2020,127,23274,2835,196560,219834,15,1959,20,1543,4,293,123,18,14,6,926,50,16216,1316,123213,139429,10/19/2020
6/18/2020,149,23423,3047,199607,223030,9,1968,13,1556,1,294,118,19,16,7,933,70,16286,1309,124522,140808,10/19/2020
6/19/2020,141,23564,3769,203376,226940,12,1980,11,1567,1,295,118,20,17,3,936,59,16345,1365,125887,142232,10/19/2020
6/20/2020,84,23648,1891,205267,228915,9,1989,12,1579,0,295,115,20,18,4,940,36,16381,812,126699,143080,10/19/2020
6/21/2020,37,23685,1064,206331,230016,8,1997,5,1584,0,295,118,20,18,2,942,29,16410,691,127390,143800,10/19/2020
6/22/2020,138,23823,3730,210061,233884,12,2009,16,1600,0,295,114,19,18,2,944,65,16475,1703,129093,145568,10/19/2020
6/23/2020,163,23986,3831,213892,237878,3,2012,13,1613,3,298,101,18,18,7,951,81,16556,1777,130870,147426,10/19/2020
6/24/2020,120,24106,3502,217394,241500,9,2021,10,1623,1,299,99,18,18,5,956,44,16600,1679,132549,149149,10/19/2020
6/25/2020,103,24209,2883,220277,244486,6,2027,14,1637,1,300,90,17,17,1,957,50,16650,1505,134054,150704,10/19/2020
6/26/2020,94,24303,2488,222765,247068,2,2029,10,1647,0,300,82,18,18,1,958,60,16710,1329,135383,152093,10/19/2020
6/27/2020,84,24387,3214,225979,250366,5,2034,3,1650,1,301,83,17,17,5,963,37,16747,1215,136598,153345,10/19/2020
6/28/2020,39,24426,1469,227448,251874,4,2038,4,1654,4,305,79,15,14,6,969,17,16764,594,137192,153956,10/19/2020
6/29/2020,85,24511,3697,231145,255656,4,2042,5,1659,0,305,78,14,14,1,970,39,16803,1349,138541,155344,10/19/2020
6/30/2020,57,24568,1957,233102,257670,1,2043,5,1664,1,306,73,12,11,4,974,33,16836,993,139534,156370,10/19/2020
7/1/2020,144,24712,4098,237200,261912,8,2051,10,1674,0,306,71,11,11,1,975,79,16915,1926,141460,158375,10/19/2020
7/2/2020,103,24815,2803,240003,264818,5,2056,5,1679,1,307,70,10,10,3,978,59,16974,1085,142545,159519,10/19/2020
7/3/2020,50,24865,2076,242079,266944,9,2065,6,1685,0,307,73,9,9,3,981,25,16999,777,143322,160321,10/19/2020
7/4/2020,57,24922,2345,244424,269346,2,2067,4,1689,1,308,70,10,9,2,983,33,17032,1006,144328,161360,10/19/2020
7/5/2020,49,24971,2932,247356,272327,1,2068,2,1691,1,309,68,8,8,2,985,26,17058,1438,145766,162824,10/19/2020
7/6/2020,101,25072,2811,250167,275239,6,2074,6,1697,0,309,68,9,9,4,989,57,17115,1547,147313,164428,10/19/2020
7/7/2020,81,25153,3457,253624,278777,5,2079,7,1704,0,309,66,8,8,2,991,47,17162,1534,148847,166009,10/19/2020
7/8/2020,105,25258,3403,257027,282285,4,2083,2,1706,0,309,68,9,8,0,991,64,17226,1422,150269,167495,10/19/2020
7/9/2020,94,25352,3712,260739,286091,9,2092,3,1709,0,309,74,9,8,0,991,50,17276,1620,151889,169165,10/19/2020
7/10/2020,131,25483,4431,265170,290653,6,2098,3,1712,2,311,75,7,7,3,994,80,17356,2068,153957,171313,10/19/2020
7/11/2020,63,25546,2932,268102,293648,6,2104,3,1715,1,312,77,6,6,3,997,36,17392,1313,155270,172662,10/19/2020
7/12/2020,47,25593,1836,269938,295531,1,2105,3,1718,1,313,74,6,5,3,1000,34,17426,941,156211,173637,10/19/2020
7/13/2020,84,25677,3201,273139,298816,8,2113,10,1728,0,313,72,6,5,1,1001,61,17487,1503,157714,175201,10/19/2020
7/14/2020,73,25750,3292,276431,302181,7,2120,4,1732,0,313,75,5,5,1,1002,43,17530,1373,159087,176617,10/19/2020
7/15/2020,130,25880,4172,280603,306483,5,2125,7,1739,0,313,73,5,4,0,1002,99,17629,1748,160835,178464,10/19/2020
7/16/2020,102,25982,3733,284336,310318,6,2131,9,1748,0,313,70,6,5,1,1003,75,17704,1616,162451,180155,10/19/2020
7/17/2020,156,26138,4236,288572,314710,14,2145,3,1751,1,314,80,5,5,2,1005,79,17783,1842,164293,182076,10/19/2020
7/18/2020,85,26223,3267,291839,318062,5,2150,9,1760,1,315,75,5,4,4,1009,70,17853,1396,165689,183542,10/19/2020
7/19/2020,82,26305,2693,294532,320837,7,2157,3,1763,0,315,79,6,4,2,1011,57,17910,1147,166836,184746,10/19/2020
7/20/2020,71,26376,2664,297196,323572,9,2166,7,1770,0,315,81,7,5,2,1013,68,17978,1458,168294,186272,10/19/2020
7/21/2020,130,26506,4299,301495,328001,9,2175,11,1781,0,315,79,9,6,1,1014,109,18087,1917,170211,188298,10/19/2020
7/22/2020,130,26636,3927,305422,332058,11,2186,11,1792,1,316,78,7,6,1,1015,86,18173,1683,171894,190067,10/19/2020
7/23/2020,141,26777,4412,309834,336611,8,2194,6,1798,0,316,80,8,7,0,1015,115,18288,1981,173875,192163,10/19/2020
7/24/2020,172,26949,5960,315794,342743,14,2208,14,1812,0,316,80,9,7,0,1015,119,18407,2315,176190,194597,10/19/2020
7/25/2020,134,27083,4398,320192,347275,7,2215,7,1819,0,316,80,10,8,2,1017,108,18515,2093,178283,196798,10/19/2020
7/26/2020,62,27145,3027,323219,350364,8,2223,9,1828,0,316,79,11,7,1,1018,54,18569,1334,179617,198186,10/19/2020
7/27/2020,188,27333,4190,327409,354742,12,2235,7,1835,0,316,84,13,8,1,1019,138,18707,2343,181960,200667,10/19/2020
7/28/2020,105,27438,3834,331243,358681,5,2240,5,1840,0,316,84,14,7,1,1020,94,18801,1632,183592,202393,10/19/2020
7/29/2020,191,27629,5137,336380,364009,11,2251,12,1852,0,316,83,15,7,0,1020,154,18955,2316,185908,204863,10/19/2020
7/30/2020,121,27750,4344,340724,368474,6,2257,2,1854,1,317,86,15,6,1,1021,97,19052,1646,187554,206606,10/19/2020
7/31/2020,131,27881,5508,346232,374113,8,2265,10,1864,0,317,84,15,7,1,1022,89,19141,1850,189404,208545,10/19/2020
8/1/2020,108,27989,4288,350520,378509,7,2272,2,1866,0,317,89,14,7,1,1023,88,19229,1558,190962,210191,10/19/2020
8/2/2020,84,28073,2802,353322,381395,12,2284,12,1878,2,319,87,14,8,2,1025,62,19291,1269,192231,211522,10/19/2020
8/3/2020,187,28260,5238,358560,386820,13,2297,12,1890,0,319,88,16,7,1,1026,150,19441,2200,194431,213872,10/19/2020
8/4/2020,126,28386,3691,362251,390637,9,2306,6,1896,1,320,90,12,5,2,1028,99,19540,1769,196200,215740,10/19/2020
8/5/2020,148,28534,5933,368184,396718,12,2318,10,1906,1,321,91,10,5,2,1030,118,19658,2468,198668,218326,10/19/2020
8/6/2020,169,28703,5532,373716,402419,7,2325,9,1915,0,321,89,9,4,0,1030,121,19779,2404,201072,220851,10/19/2020
8/7/2020,122,28825,4845,378561,407386,13,2338,10,1925,1,322,91,9,3,2,1032,87,19866,2140,203212,223078,10/19/2020
8/8/2020,123,28948,4106,382667,411615,19,2357,6,1931,1,323,103,8,3,1,1033,92,19958,1777,204989,224947,10/19/2020
8/9/2020,42,28990,1722,384389,413379,8,2365,10,1941,0,323,101,9,4,0,1033,35,19993,1072,206061,226054,10/19/2020
8/10/2020,149,29139,4580,388969,418108,11,2376,12,1953,0,323,100,9,4,1,1034,113,20106,2020,208081,228187,10/19/2020
8/11/2020,105,29244,4325,393294,422538,6,2382,14,1967,0,323,92,10,4,3,1037,92,20198,2262,210343,230541,10/19/2020
8/12/2020,121,29365,5184,398478,427843,8,2390,11,1978,0,323,89,9,3,1,1038,101,20299,2623,212966,233265,10/19/2020
8/13/2020,135,29500,4191,402669,432169,13,2403,12,1990,0,323,90,11,3,0,1038,95,20394,1901,214867,235261,10/19/2020
8/14/2020,145,29645,5492,408161,437806,13,2416,11,2001,0,323,92,11,4,3,1041,99,20493,1969,216836,237329,10/19/2020
8/15/2020,105,29750,4533,412694,442444,9,2425,11,2012,1,324,89,11,5,0,1041,89,20582,1690,218526,239108,10/19/2020
8/16/2020,83,29833,2471,415165,444998,7,2432,6,2018,4,328,86,8,4,6,1047,70,20652,961,219487,240139,10/19/2020
8/17/2020,106,29939,4570,419735,449674,10,2442,7,2025,0,328,89,8,5,2,1049,88,20740,2391,221878,242618,10/19/2020
8/18/2020,128,30067,4904,424639,454706,11,2453,9,2034,1,329,90,8,4,5,1054,94,20834,2750,224628,245462,10/19/2020
8/19/2020,113,30180,5065,429704,459884,8,2461,9,2043,1,330,88,9,5,0,1054,90,20924,2641,227269,248193,10/19/2020
8/20/2020,173,30353,7405,437109,467462,12,2473,6,2049,2,332,92,10,5,3,1057,139,21063,3519,230788,251851,10/19/2020
8/21/2020,151,30504,6570,443679,474183,8,2481,5,2054,1,333,94,9,4,2,1059,125,21188,2944,233732,254920,10/19/2020
8/22/2020,96,30600,5547,449226,479826,10,2491,12,2066,0,333,92,11,4,1,1060,84,21272,2606,236338,257610,10/19/2020
8/23/2020,70,30670,4365,453591,484261,11,2502,6,2072,0,333,97,11,2,1,1061,56,21328,2469,238807,260135,10/19/2020
8/24/2020,105,30775,5775,459366,490141,7,2509,10,2082,1,334,93,13,4,1,1062,77,21405,3152,241959,263364,10/19/2020
8/25/2020,108,30883,4757,464123,495006,10,2519,4,2086,1,335,98,11,4,1,1063,92,21497,2292,244251,265748,10/19/2020
8/26/2020,170,31053,9476,473599,504652,4,2523,8,2094,0,335,94,9,5,1,1064,127,21624,3086,247337,268961,10/19/2020
8/27/2020,92,31145,8563,482162,513307,6,2529,13,2107,1,336,86,6,5,2,1066,70,21694,3168,250505,272199,10/19/2020
8/28/2020,112,31257,7991,490153,521410,14,2543,4,2111,0,336,96,9,7,2,1068,87,21781,2439,252944,274725,10/19/2020
8/29/2020,65,31322,5368,495521,526843,6,2549,8,2119,1,337,93,10,6,2,1070,51,21832,1913,254857,276689,10/19/2020
8/30/2020,66,31388,4314,499835,531223,7,2556,4,2123,0,337,96,8,5,2,1072,48,21880,1991,256848,278728,10/19/2020
8/31/2020,105,31493,4862,504697,536190,12,2568,15,2138,0,337,93,8,4,1,1073,81,21961,2187,259035,280996,10/19/2020
9/1/2020,98,31591,7109,511806,543397,6,2574,9,2147,1,338,89,7,4,2,1075,65,22026,2379,261414,283440,10/19/2020
9/2/2020,125,31716,10524,522330,554046,9,2583,10,2157,1,339,87,8,4,2,1077,104,22130,3058,264472,286602,10/19/2020
9/3/2020,90,31806,11065,533395,565201,8,2591,8,2165,0,339,87,9,4,3,1080,73,22203,2585,267057,289260,10/19/2020
9/4/2020,102,31908,8952,542347,574255,11,2602,4,2169,0,339,94,9,4,1,1081,83,22286,2372,269429,291715,10/19/2020
9/5/2020,52,31960,6300,548647,580607,6,2608,9,2178,0,339,91,8,3,1,1082,42,22328,1602,271031,293359,10/19/2020
9/6/2020,87,32047,4317,552964,585011,4,2612,8,2186,1,340,86,6,3,1,1083,64,22392,1954,272985,295377,10/19/2020
9/7/2020,35,32082,3000,555964,588046,11,2623,3,2189,0,340,94,5,3,1,1084,26,22418,645,273630,296048,10/19/2020
9/8/2020,74,32156,6375,562339,594495,6,2629,12,2201,1,341,87,6,3,2,1086,66,22484,1602,275232,297716,10/19/2020
9/9/2020,118,32274,8640,570979,603253,9,2638,5,2206,1,342,90,9,3,1,1087,102,22586,2147,277379,299965,10/19/2020
9/10/2020,164,32438,11326,582305,614743,9,2647,8,2214,0,342,91,10,3,0,1087,111,22697,2275,279654,302351,10/19/2020
9/11/2020,121,32559,9448,591753,624312,11,2658,11,2225,0,342,91,10,5,0,1087,98,22795,1972,281626,304421,10/19/2020
9/12/2020,109,32668,6143,597896,630564,8,2666,5,2230,2,344,92,9,5,3,1090,97,22892,1506,283132,306024,10/19/2020
9/13/2020,58,32726,2709,600605,633331,4,2670,3,2233,0,344,93,10,5,0,1090,54,22946,858,283990,306936,10/19/2020
9/14/2020,104,32830,6421,607026,639856,5,2675,3,2236,2,346,93,10,5,1,1091,95,23041,1726,285716,308757,10/19/2020
9/15/2020,122,32952,8449,615475,648427,6,2681,2,2238,1,347,96,10,5,2,1093,124,23165,2191,287907,311072,10/19/2020
9/16/2020,137,33089,9701,625176,658265,7,2688,7,2245,2,349,94,9,6,5,1098,118,23283,1971,289878,313161,10/19/2020
9/17/2020,124,33213,9222,634398,667611,7,2695,14,2259,0,349,87,8,4,0,1098,154,23437,1952,291830,315267,10/19/2020
9/18/2020,132,33345,10016,644414,677759,7,2702,7,2266,1,350,86,11,6,2,1100,132,23569,1935,293765,317334,10/19/2020
9/19/2020,116,33461,8290,652704,686165,7,2709,3,2269,0,350,90,10,6,4,1104,112,23681,1698,295463,319144,10/19/2020
9/20/2020,60,33521,3668,656372,689893,7,2716,6,2275,2,352,89,9,8,4,1108,48,23729,1326,296789,320518,10/19/2020
9/21/2020,103,33624,7002,663374,696998,12,2728,3,2278,2,354,96,8,6,2,1110,94,23823,2415,299204,323027,10/19/2020
9/22/2020,154,33778,9269,672643,706421,12,2740,3,2281,1,355,104,7,5,1,1111,125,23948,2207,301411,325359,10/19/2020
9/23/2020,136,33914,10625,683268,717182,12,2752,7,2288,0,355,109,6,5,0,1111,127,24075,2218,303629,327704,10/19/2020
9/24/2020,119,34033,12452,695720,729753,7,2759,9,2297,1,356,106,7,5,1,1112,119,24194,3170,306799,330993,10/19/2020
9/25/2020,149,34182,10534,706254,740436,9,2768,10,2307,0,356,105,6,5,1,1113,143,24337,3020,309819,334156,10/19/2020
9/26/2020,146,34328,10544,716798,751126,12,2780,9,2316,0,356,108,6,5,1,1114,118,24455,2430,312249,336704,10/19/2020
9/27/2020,42,34370,2761,719559,753929,7,2787,5,2321,0,356,110,9,5,0,1114,33,24488,849,313098,337586,10/19/2020
9/28/2020,151,34521,7285,726844,761365,6,2793,6,2327,2,358,108,7,5,2,1116,132,24620,2262,315360,339980,10/19/2020
9/29/2020,208,34729,11017,737861,772590,11,2804,18,2345,1,359,100,6,6,1,1117,190,24810,2829,318189,342999,10/19/2020
9/30/2020,221,34950,12206,750067,785017,6,2810,6,2351,0,359,100,6,6,1,1118,186,24996,2602,320791,345787,10/19/2020
10/1/2020,184,35134,12481,762548,797682,16,2826,13,2364,1,360,102,5,4,1,1119,161,25157,2435,323226,348383,10/19/2020
10/2/2020,209,35343,12127,774675,810018,12,2838,13,2377,1,361,100,6,4,2,1121,182,25339,2504,325730,351069,10/19/2020
10/3/2020,157,35500,9304,783979,819479,9,2847,9,2386,2,363,98,7,4,2,1123,132,25471,2037,327767,353238,10/19/2020
10/4/2020,81,35581,2365,786344,821925,11,2858,9,2395,1,364,99,6,4,2,1125,75,25546,962,328729,354275,10/19/2020
10/5/2020,174,35755,8935,795279,831034,29,2887,10,2405,2,366,116,8,5,4,1129,162,25708,3049,331778,357486,10/19/2020
10/6/2020,176,35931,11169,806448,842379,11,2898,4,2409,0,366,123,10,6,0,1129,189,25897,2916,334694,360591,10/19/2020
10/7/2020,228,36159,12402,818850,855009,12,2910,14,2423,2,368,119,8,6,2,1131,245,26142,3547,338241,364383,10/19/2020
10/8/2020,262,36421,15176,834026,870447,16,2926,12,2435,1,369,122,7,5,3,1134,272,26414,4210,342451,368865,10/19/2020
10/9/2020,214,36635,13187,847213,883848,19,2945,12,2447,0,369,129,10,7,2,1136,190,26604,4315,346766,373370,10/19/2020
10/10/2020,229,36864,13806,861019,897883,17,2962,10,2457,1,370,135,12,6,2,1138,189,26793,3830,350596,377389,10/19/2020
10/11/2020,94,36958,3250,864269,901227,12,2974,9,2466,1,371,137,13,5,6,1144,85,26878,1168,351764,378642,10/19/2020
10/12/2020,165,37123,6359,870628,907751,17,2991,15,2481,2,373,137,13,5,3,1147,145,27023,1747,353511,380534,10/19/2020
10/13/2020,209,37332,8471,879099,916431,14,3005,13,2494,4,377,134,12,5,7,1154,206,27229,2313,355824,383053,10/19/2020
10/14/2020,320,37652,14977,894076,931728,15,3020,7,2501,0,377,142,14,5,2,1156,284,27513,4069,359893,387406,10/19/2020
10/15/2020,263,37915,14530,908606,946521,9,3029,16,2517,1,378,134,12,5,1,1157,252,27765,3595,363488,391253,10/19/2020
10/16/2020,265,38180,14221,922827,961007,10,3039,18,2535,1,379,125,13,4,1,1158,213,27978,3308,366796,394774,10/19/2020
10/17/2020,335,38515,13642,936469,974984,11,3050,11,2546,1,380,124,16,4,0,1158,284,28262,3166,369962,398224,10/19/2020
10/18/2020,104,38619,2823,939292,977911,,,,,,,,,,1,1159,85,28347,1017,370979,399326,10/19/2020
2/27/2020,0,0,0,0,0,1,1,0,0,0,0,1,0,0,0,0,0,0,0,0,0,10/20/2020
2/28/2020,0,0,0,0,0,0,1,0,0,0,0,1,1,0,0,0,0,0,0,0,0,10/20/2020
2/29/2020,0,0,0,0,0,0,1,0,0,0,0,1,1,0,0,0,0,0,0,0,0,10/20/2020
3/1/2020,2,2,2,2,4,0,1,0,0,0,0,1,1,1,0,0,2,2,2,2,4,10/20/2020
3/2/2020,0,2,1,3,5,1,2,0,0,0,0,2,2,2,0,0,0,2,1,3,5,10/20/2020
3/3/2020,0,2,2,5,7,0,2,0,0,0,0,2,2,2,0,0,0,2,2,5,7,10/20/2020
3/4/2020,0,2,12,17,19,1,3,0,0,0,0,3,2,2,0,0,0,2,10,15,17,10/20/2020
3/5/2020,0,2,4,21,23,0,3,0,0,0,0,3,2,2,0,0,1,3,4,19,22,10/20/2020
3/6/2020,1,3,12,33,36,0,3,0,0,0,0,3,2,2,0,0,0,3,11,30,33,10/20/2020
3/7/2020,0,3,19,52,55,0,3,0,0,0,0,3,2,1,0,0,0,3,19,49,52,10/20/2020
3/8/2020,0,3,18,70,73,0,3,0,0,0,0,3,2,1,0,0,0,3,18,67,70,10/20/2020
3/9/2020,1,4,15,85,89,0,3,0,0,0,0,3,2,1,0,0,1,4,15,82,86,10/20/2020
3/10/2020,2,6,25,110,116,0,3,0,0,0,0,3,2,1,0,0,1,5,23,105,110,10/20/2020
3/11/2020,0,6,34,144,150,1,4,0,0,0,0,4,1,1,0,0,0,5,34,139,144,10/20/2020
3/12/2020,9,15,41,185,200,1,5,0,0,0,0,5,1,1,0,0,8,13,38,177,190,10/20/2020
3/13/2020,6,21,50,235,256,4,9,1,1,0,0,8,1,1,0,0,6,19,48,225,244,10/20/2020
3/14/2020,0,21,90,325,346,0,9,0,1,0,0,8,1,1,0,0,0,19,86,311,330,10/20/2020
3/15/2020,1,22,54,379,401,1,10,0,1,0,0,9,2,1,0,0,1,20,54,365,385,10/20/2020
3/16/2020,2,24,95,474,498,2,12,0,1,0,0,11,2,0,0,0,2,22,92,457,479,10/20/2020
3/17/2020,12,36,162,636,672,6,18,0,1,0,0,17,2,0,0,0,11,33,151,608,641,10/20/2020
3/18/2020,9,45,116,752,797,3,21,0,1,0,0,20,2,0,0,0,11,44,110,718,762,10/20/2020
3/19/2020,15,60,262,1014,1074,2,23,1,2,0,0,21,3,0,1,1,17,61,251,969,1030,10/20/2020
3/20/2020,13,73,197,1211,1284,5,28,0,2,0,0,26,4,0,0,1,13,74,190,1159,1233,10/20/2020
3/21/2020,12,85,126,1337,1422,3,31,2,4,0,0,27,5,0,0,1,14,88,123,1282,1370,10/20/2020
3/22/2020,27,112,282,1619,1731,2,33,0,4,0,0,29,5,0,0,1,25,113,260,1542,1655,10/20/2020
3/23/2020,14,126,169,1788,1914,15,48,1,5,0,0,43,9,3,0,1,16,129,165,1707,1836,10/20/2020
3/24/2020,20,146,242,2030,2176,7,55,0,5,0,0,50,10,4,0,1,19,148,235,1942,2090,10/20/2020
3/25/2020,26,172,182,2212,2384,5,60,1,6,0,0,54,11,3,0,1,28,176,171,2113,2289,10/20/2020
3/26/2020,35,207,181,2393,2600,10,70,5,11,0,0,59,14,5,0,1,41,217,174,2287,2504,10/20/2020
3/27/2020,27,234,214,2607,2841,9,79,1,12,1,1,66,17,6,2,3,31,248,200,2487,2735,10/20/2020
3/28/2020,59,293,260,2867,3160,13,92,3,15,2,3,74,15,6,1,4,64,312,240,2727,3039,10/20/2020
3/29/2020,100,393,350,3217,3610,8,100,4,19,1,4,77,18,8,2,6,105,417,313,3040,3457,10/20/2020
3/30/2020,62,455,222,3439,3894,20,120,5,24,0,4,92,20,11,3,9,78,495,184,3224,3719,10/20/2020
3/31/2020,71,526,369,3808,4334,11,131,7,31,1,5,95,22,13,2,11,73,568,294,3518,4086,10/20/2020
4/1/2020,99,625,698,4506,5131,18,149,7,38,0,5,106,30,15,1,12,100,668,640,4158,4826,10/20/2020
4/2/2020,52,677,477,4983,5660,22,171,6,44,2,7,120,36,21,4,16,62,730,434,4592,5322,10/20/2020
4/3/2020,108,785,774,5757,6542,23,194,7,51,0,7,136,43,25,3,19,100,830,707,5299,6129,10/20/2020
4/4/2020,143,928,660,6417,7345,22,216,4,55,5,12,149,41,30,9,28,138,968,616,5915,6883,10/20/2020
4/5/2020,187,1115,1156,7573,8688,20,236,9,64,1,13,159,44,36,2,30,181,1149,1057,6972,8121,10/20/2020
4/6/2020,218,1333,1706,9279,10612,26,262,7,71,0,13,178,48,40,7,37,207,1356,1544,8516,9872,10/20/2020
4/7/2020,284,1617,1629,10908,12525,20,282,5,76,2,15,191,50,42,5,42,261,1617,1471,9987,11604,10/20/2020
4/8/2020,290,1907,1720,12628,14535,19,301,7,83,6,21,197,50,38,10,52,271,1888,1550,11537,13425,10/20/2020
4/9/2020,283,2190,1516,14144,16334,32,333,9,92,4,25,216,53,40,7,59,277,2165,1350,12887,15052,10/20/2020
4/10/2020,419,2609,2574,16718,19327,29,362,16,108,5,30,224,59,41,11,70,401,2566,2358,15245,17811,10/20/2020
4/11/2020,297,2906,1905,18623,21529,29,391,11,119,2,32,240,61,48,12,82,281,2847,1712,16957,19804,10/20/2020
4/12/2020,314,3220,1670,20293,23513,35,426,13,132,5,37,257,59,49,9,91,284,3131,1426,18383,21514,10/20/2020
4/13/2020,161,3381,935,21228,24609,35,461,13,145,3,40,276,64,54,9,100,187,3318,835,19218,22536,10/20/2020
4/14/2020,289,3670,1787,23015,26685,27,488,17,162,5,45,281,72,53,8,108,262,3580,1524,20742,24322,10/20/2020
4/15/2020,351,4021,1799,24814,28835,31,519,20,182,3,48,289,72,54,17,125,306,3886,1543,22285,26171,10/20/2020
4/16/2020,447,4468,2494,27308,31776,36,555,25,207,6,54,294,72,53,14,139,387,4273,2067,24352,28625,10/20/2020
4/17/2020,304,4772,1821,29129,33901,32,587,20,227,7,61,299,66,45,21,160,290,4563,1440,25792,30355,10/20/2020
4/18/2020,321,5093,1725,30854,35947,26,613,18,245,4,65,303,63,49,15,175,284,4847,1319,27111,31958,10/20/2020
4/19/2020,381,5474,2047,32901,38375,23,636,26,271,1,66,299,65,55,11,186,336,5183,1736,28847,34030,10/20/2020
4/20/2020,394,5868,1907,34808,40676,46,682,29,300,2,68,314,75,56,10,196,376,5559,1563,30410,35969,10/20/2020
4/21/2020,444,6312,2110,36918,43230,45,727,33,333,5,73,321,72,56,18,214,384,5943,1696,32106,38049,10/20/2020
4/22/2020,418,6730,2390,39308,46038,41,768,32,365,5,78,325,73,58,18,232,379,6322,1904,34010,40332,10/20/2020
4/23/2020,479,7209,2469,41777,48986,32,800,28,393,5,83,324,76,62,15,247,412,6734,1846,35856,42590,10/20/2020
4/24/2020,491,7700,3284,45061,52761,35,835,26,419,4,87,329,85,63,15,262,407,7141,2615,38471,45612,10/20/2020
4/25/2020,393,8093,2206,47267,55360,34,869,17,436,5,92,341,85,62,14,276,300,7441,1756,40227,47668,10/20/2020
4/26/2020,316,8409,2309,49576,57985,33,902,15,451,3,95,356,86,59,14,290,274,7715,1867,42094,49809,10/20/2020
4/27/2020,249,8658,1620,51196,59854,29,931,21,472,4,99,360,86,61,10,300,206,7921,1156,43250,51171,10/20/2020
4/28/2020,410,9068,2263,53459,62527,44,975,24,496,3,102,377,88,59,22,322,331,8252,1751,45001,53253,10/20/2020
4/29/2020,476,9544,3343,56802,66346,36,1011,38,534,11,113,364,78,53,18,340,371,8623,2414,47415,56038,10/20/2020
4/30/2020,432,9976,2769,59571,69547,33,1044,38,572,6,119,353,83,57,24,364,350,8973,1900,49315,58288,10/20/2020
5/1/2020,454,10430,3086,62657,73087,51,1095,39,611,3,122,362,84,58,14,378,324,9297,2152,51467,60764,10/20/2020
5/2/2020,257,10687,1926,64583,75270,36,1131,38,649,5,127,355,91,62,24,402,192,9489,1262,52729,62218,10/20/2020
5/3/2020,283,10970,2160,66743,77713,31,1162,27,676,8,135,351,90,61,21,423,183,9672,1563,54292,63964,10/20/2020
5/4/2020,387,11357,2098,68841,80198,30,1192,31,707,5,140,345,88,57,18,441,290,9962,1555,55847,65809,10/20/2020
5/5/2020,433,11790,2873,71714,83504,29,1221,32,739,6,146,336,82,54,16,457,300,10262,1951,57798,68060,10/20/2020
5/6/2020,488,12278,2830,74544,86822,28,1249,44,783,9,155,311,79,54,21,478,340,10602,1911,59709,70311,10/20/2020
5/7/2020,425,12703,2969,77513,90216,36,1285,41,824,5,160,301,71,52,21,499,270,10872,1955,61664,72536,10/20/2020
5/8/2020,359,13062,2598,80111,93173,30,1315,29,853,5,165,297,71,53,22,521,229,11101,1733,63397,74498,10/20/2020
5/9/2020,467,13529,3346,83457,96986,22,1337,21,874,4,169,294,69,51,15,536,290,11391,2248,65645,77036,10/20/2020
5/10/2020,285,13814,2117,85574,99388,20,1357,23,897,6,175,285,70,49,13,549,189,11580,1515,67160,78740,10/20/2020
5/11/2020,257,14071,1857,87431,101502,31,1388,16,913,6,181,294,71,49,15,564,174,11754,1298,68458,80212,10/20/2020
5/12/2020,387,14458,2611,90042,104500,23,1411,18,931,4,185,295,69,48,22,586,224,11978,1697,70155,82133,10/20/2020
5/13/2020,351,14809,3630,93672,108481,23,1434,25,956,1,186,292,69,49,13,599,199,12177,1988,72143,84320,10/20/2020
5/14/2020,329,15138,3408,97080,112218,19,1453,27,983,3,189,281,64,45,15,614,231,12408,2011,74154,86562,10/20/2020
5/15/2020,381,15519,3458,100538,116057,24,1477,41,1024,5,194,259,62,45,14,628,232,12640,1800,75954,88594,10/20/2020
5/16/2020,449,15968,4156,104694,120662,25,1502,13,1037,5,199,266,61,46,15,643,247,12887,1949,77903,90790,10/20/2020
5/17/2020,240,16208,2768,107462,123670,17,1519,8,1045,5,204,270,59,45,10,653,126,13013,1537,79440,92453,10/20/2020
5/18/2020,250,16458,2001,109463,125921,19,1538,15,1060,5,209,269,57,40,18,671,135,13148,1366,80806,93954,10/20/2020
5/19/2020,415,16873,3168,112631,129504,23,1561,32,1092,5,214,255,56,38,11,682,215,13363,1921,82727,96090,10/20/2020
5/20/2020,326,17199,2771,115402,132601,19,1580,23,1115,7,221,244,52,33,22,704,183,13546,1509,84236,97782,10/20/2020
5/21/2020,374,17573,3757,119159,136732,26,1606,15,1130,3,224,252,53,29,20,724,168,13714,1932,86168,99882,10/20/2020
5/22/2020,351,17924,3161,122320,140244,20,1626,29,1159,5,229,238,52,29,10,734,206,13920,1604,87772,101692,10/20/2020
5/23/2020,253,18177,2742,125062,143239,19,1645,11,1170,3,232,243,52,32,13,747,109,14029,1267,89039,103068,10/20/2020
5/24/2020,163,18340,1370,126432,144772,13,1658,14,1184,2,234,240,53,36,8,755,83,14112,772,89811,103923,10/20/2020
5/25/2020,147,18487,1385,127817,146304,14,1672,14,1198,0,234,240,53,34,10,765,76,14188,761,90572,104760,10/20/2020
5/26/2020,285,18772,2620,130437,149209,24,1696,22,1220,5,239,237,48,33,15,780,158,14346,1777,92349,106695,10/20/2020
5/27/2020,276,19048,2057,132494,151542,20,1716,18,1238,3,242,236,50,33,10,790,132,14478,1130,93479,107957,10/20/2020
5/28/2020,348,19396,3359,135853,155249,17,1733,29,1267,4,246,220,47,32,8,798,130,14608,1115,94594,109202,10/20/2020
5/29/2020,410,19806,3914,139767,159573,19,1752,27,1294,6,252,206,43,31,12,810,174,14782,1569,96163,110945,10/20/2020
5/30/2020,225,20031,3915,143682,163713,16,1768,19,1313,4,256,199,41,29,12,822,109,14891,1817,97980,112871,10/20/2020
5/31/2020,155,20186,1688,145370,165556,11,1779,10,1323,1,257,199,44,26,3,825,78,14969,854,98834,113803,10/20/2020
6/1/2020,212,20398,2792,148162,168560,8,1787,14,1337,1,258,192,45,29,5,830,93,15062,1380,100214,115276,10/20/2020
6/2/2020,273,20671,3022,151184,171855,8,1795,9,1346,3,261,188,38,25,10,840,98,15160,1442,101656,116816,10/20/2020
6/3/2020,254,20925,3486,154670,175595,14,1809,18,1364,6,267,178,34,25,11,851,99,15259,1655,103311,118570,10/20/2020
6/4/2020,276,21201,4471,159141,180342,7,1816,25,1389,4,271,156,31,24,12,863,107,15366,2032,105343,120709,10/20/2020
6/5/2020,215,21416,3513,162654,184070,15,1831,13,1402,6,277,152,27,21,11,874,99,15465,1570,106913,122378,10/20/2020
6/6/2020,201,21617,2616,165270,186887,10,1841,7,1409,2,279,153,29,19,6,880,67,15532,1128,108041,123573,10/20/2020
6/7/2020,83,21700,1625,166895,188595,11,1852,7,1416,1,280,156,25,17,4,884,51,15583,781,108822,124405,10/20/2020
6/8/2020,119,21819,1849,168744,190563,15,1867,12,1428,2,282,157,27,18,4,888,45,15628,954,109776,125404,10/20/2020
6/9/2020,223,22042,2673,171417,193459,10,1877,18,1446,0,282,149,28,21,1,889,64,15692,1253,111029,126721,10/20/2020
6/10/2020,209,22251,2987,174404,196655,13,1890,12,1458,2,284,148,24,17,4,893,101,15793,1463,112492,128285,10/20/2020
6/11/2020,195,22446,3513,177917,200363,7,1897,15,1473,1,285,139,25,16,6,899,88,15881,1530,114022,129903,10/20/2020
6/12/2020,209,22655,4601,182518,205173,9,1906,15,1488,1,286,132,24,16,2,901,78,15959,2171,116193,132152,10/20/2020
6/13/2020,113,22768,3036,185554,208322,6,1912,5,1493,0,286,133,20,15,3,904,49,16008,1365,117558,133566,10/20/2020
6/14/2020,81,22849,2046,187600,210449,7,1919,8,1501,1,287,131,20,14,3,907,33,16041,964,118522,134563,10/20/2020
6/15/2020,188,23037,3108,190708,213745,14,1933,14,1515,0,287,131,20,16,5,912,75,16116,1787,120309,136425,10/20/2020
6/16/2020,110,23147,3017,193725,216872,11,1944,9,1524,1,288,132,22,16,8,920,50,16166,1558,121867,138033,10/20/2020
6/17/2020,127,23274,2835,196560,219834,15,1959,20,1544,4,292,123,18,14,6,926,50,16216,1316,123183,139399,10/20/2020
6/18/2020,149,23423,3047,199607,223030,9,1968,13,1557,1,293,118,19,16,7,933,70,16286,1309,124492,140778,10/20/2020
6/19/2020,141,23564,3769,203376,226940,12,1980,11,1568,1,294,118,20,17,3,936,59,16345,1365,125857,142202,10/20/2020
6/20/2020,84,23648,1891,205267,228915,9,1989,12,1580,0,294,115,20,18,4,940,36,16381,812,126669,143050,10/20/2020
6/21/2020,37,23685,1064,206331,230016,8,1997,5,1585,0,294,118,20,18,2,942,29,16410,690,127359,143769,10/20/2020
6/22/2020,138,23823,3730,210061,233884,12,2009,16,1601,0,294,114,19,18,2,944,65,16475,1703,129062,145537,10/20/2020
6/23/2020,163,23986,3831,213892,237878,3,2012,13,1614,3,297,101,18,18,7,951,81,16556,1777,130839,147395,10/20/2020
6/24/2020,120,24106,3502,217394,241500,9,2021,10,1624,1,298,99,18,18,5,956,44,16600,1679,132518,149118,10/20/2020
6/25/2020,103,24209,2883,220277,244486,6,2027,14,1638,1,299,90,17,17,1,957,50,16650,1505,134023,150673,10/20/2020
6/26/2020,94,24303,2488,222765,247068,2,2029,10,1648,0,299,82,18,18,1,958,60,16710,1328,135351,152061,10/20/2020
6/27/2020,84,24387,3214,225979,250366,5,2034,3,1651,1,300,83,17,17,5,963,37,16747,1215,136566,153313,10/20/2020
6/28/2020,39,24426,1469,227448,251874,4,2038,4,1655,4,304,79,15,14,6,969,17,16764,594,137160,153924,10/20/2020
6/29/2020,85,24511,3697,231145,255656,4,2042,5,1660,0,304,78,14,14,1,970,39,16803,1349,138509,155312,10/20/2020
6/30/2020,57,24568,1957,233102,257670,1,2043,5,1665,1,305,73,12,11,4,974,33,16836,993,139502,156338,10/20/2020
7/1/2020,144,24712,4098,237200,261912,8,2051,10,1675,0,305,71,11,11,1,975,79,16915,1926,141428,158343,10/20/2020
7/2/2020,103,24815,2803,240003,264818,5,2056,5,1680,1,306,70,10,10,3,978,59,16974,1084,142512,159486,10/20/2020
7/3/2020,50,24865,2076,242079,266944,9,2065,6,1686,0,306,73,9,9,3,981,25,16999,777,143289,160288,10/20/2020
7/4/2020,57,24922,2345,244424,269346,2,2067,4,1690,1,307,70,10,9,2,983,33,17032,1006,144295,161327,10/20/2020
7/5/2020,49,24971,2932,247356,272327,1,2068,2,1692,1,308,68,8,8,2,985,26,17058,1438,145733,162791,10/20/2020
7/6/2020,101,25072,2811,250167,275239,6,2074,6,1698,0,308,68,9,9,4,989,57,17115,1547,147280,164395,10/20/2020
7/7/2020,81,25153,3457,253624,278777,5,2079,7,1705,0,308,66,8,8,2,991,47,17162,1534,148814,165976,10/20/2020
7/8/2020,105,25258,3403,257027,282285,4,2083,2,1707,0,308,68,9,8,0,991,64,17226,1422,150236,167462,10/20/2020
7/9/2020,94,25352,3712,260739,286091,9,2092,3,1710,0,308,74,9,8,0,991,50,17276,1620,151856,169132,10/20/2020
7/10/2020,131,25483,4431,265170,290653,6,2098,3,1713,2,310,75,7,7,3,994,80,17356,2068,153924,171280,10/20/2020
7/11/2020,63,25546,2932,268102,293648,6,2104,3,1716,1,311,77,6,6,3,997,36,17392,1313,155237,172629,10/20/2020
7/12/2020,47,25593,1836,269938,295531,1,2105,3,1719,1,312,74,6,5,3,1000,34,17426,941,156178,173604,10/20/2020
7/13/2020,84,25677,3201,273139,298816,8,2113,10,1729,0,312,72,6,5,1,1001,61,17487,1503,157681,175168,10/20/2020
7/14/2020,73,25750,3292,276431,302181,7,2120,4,1733,0,312,75,5,5,1,1002,43,17530,1373,159054,176584,10/20/2020
7/15/2020,130,25880,4172,280603,306483,5,2125,7,1740,0,312,73,5,4,0,1002,99,17629,1748,160802,178431,10/20/2020
7/16/2020,102,25982,3733,284336,310318,6,2131,9,1749,0,312,70,6,5,1,1003,75,17704,1614,162416,180120,10/20/2020
7/17/2020,156,26138,4236,288572,314710,14,2145,3,1752,1,313,80,5,5,2,1005,79,17783,1842,164258,182041,10/20/2020
7/18/2020,85,26223,3267,291839,318062,5,2150,9,1761,1,314,75,5,4,4,1009,70,17853,1396,165654,183507,10/20/2020
7/19/2020,82,26305,2693,294532,320837,7,2157,3,1764,0,314,79,6,4,2,1011,57,17910,1147,166801,184711,10/20/2020
7/20/2020,71,26376,2664,297196,323572,9,2166,7,1771,0,314,81,7,5,2,1013,68,17978,1458,168259,186237,10/20/2020
7/21/2020,130,26506,4299,301495,328001,9,2175,11,1782,0,314,79,9,6,1,1014,109,18087,1916,170175,188262,10/20/2020
7/22/2020,130,26636,3927,305422,332058,11,2186,11,1793,1,315,78,7,6,1,1015,86,18173,1682,171857,190030,10/20/2020
7/23/2020,141,26777,4412,309834,336611,8,2194,6,1799,0,315,80,8,7,0,1015,115,18288,1981,173838,192126,10/20/2020
7/24/2020,172,26949,5960,315794,342743,14,2208,14,1813,0,315,80,9,7,0,1015,119,18407,2315,176153,194560,10/20/2020
7/25/2020,134,27083,4398,320192,347275,7,2215,7,1820,0,315,80,10,8,2,1017,108,18515,2093,178246,196761,10/20/2020
7/26/2020,62,27145,3027,323219,350364,8,2223,9,1829,0,315,79,11,7,1,1018,54,18569,1333,179579,198148,10/20/2020
7/27/2020,188,27333,4190,327409,354742,12,2235,7,1836,0,315,84,13,8,1,1019,138,18707,2343,181922,200629,10/20/2020
7/28/2020,105,27438,3834,331243,358681,5,2240,5,1841,0,315,84,14,7,1,1020,94,18801,1632,183554,202355,10/20/2020
7/29/2020,191,27629,5137,336380,364009,11,2251,12,1853,0,315,83,15,7,0,1020,154,18955,2315,185869,204824,10/20/2020
7/30/2020,121,27750,4344,340724,368474,6,2257,2,1855,1,316,86,15,6,1,1021,97,19052,1646,187515,206567,10/20/2020
7/31/2020,131,27881,5508,346232,374113,8,2265,10,1865,0,316,84,15,7,1,1022,89,19141,1850,189365,208506,10/20/2020
8/1/2020,108,27989,4288,350520,378509,7,2272,2,1867,0,316,89,14,7,1,1023,88,19229,1557,190922,210151,10/20/2020
8/2/2020,84,28073,2802,353322,381395,12,2284,12,1879,2,318,87,14,8,2,1025,62,19291,1269,192191,211482,10/20/2020
8/3/2020,187,28260,5238,358560,386820,13,2297,12,1891,0,318,88,16,7,1,1026,150,19441,2199,194390,213831,10/20/2020
8/4/2020,126,28386,3691,362251,390637,9,2306,6,1897,1,319,90,12,5,2,1028,99,19540,1769,196159,215699,10/20/2020
8/5/2020,148,28534,5933,368184,396718,12,2318,10,1907,1,320,91,10,5,2,1030,118,19658,2468,198627,218285,10/20/2020
8/6/2020,169,28703,5532,373716,402419,7,2325,9,1916,0,320,89,9,4,0,1030,121,19779,2403,201030,220809,10/20/2020
8/7/2020,122,28825,4845,378561,407386,13,2338,10,1926,1,321,91,9,3,2,1032,87,19866,2140,203170,223036,10/20/2020
8/8/2020,123,28948,4106,382667,411615,19,2357,6,1932,1,322,103,8,3,1,1033,92,19958,1776,204946,224904,10/20/2020
8/9/2020,42,28990,1722,384389,413379,8,2365,10,1942,0,322,101,9,4,0,1033,35,19993,1071,206017,226010,10/20/2020
8/10/2020,149,29139,4580,388969,418108,11,2376,12,1954,0,322,100,9,4,1,1034,113,20106,2020,208037,228143,10/20/2020
8/11/2020,105,29244,4325,393294,422538,6,2382,14,1968,0,322,92,10,4,3,1037,92,20198,2261,210298,230496,10/20/2020
8/12/2020,121,29365,5184,398478,427843,8,2390,11,1979,0,322,89,9,3,1,1038,101,20299,2623,212921,233220,10/20/2020
8/13/2020,135,29500,4191,402669,432169,13,2403,12,1991,0,322,90,11,3,0,1038,95,20394,1901,214822,235216,10/20/2020
8/14/2020,145,29645,5492,408161,437806,13,2416,11,2002,0,322,92,11,4,3,1041,99,20493,1969,216791,237284,10/20/2020
8/15/2020,105,29750,4533,412694,442444,9,2425,11,2013,1,323,89,11,5,0,1041,89,20582,1690,218481,239063,10/20/2020
8/16/2020,83,29833,2471,415165,444998,7,2432,6,2019,4,327,86,8,4,6,1047,70,20652,961,219442,240094,10/20/2020
8/17/2020,106,29939,4570,419735,449674,10,2442,7,2026,0,327,89,8,5,2,1049,88,20740,2391,221833,242573,10/20/2020
8/18/2020,128,30067,4904,424639,454706,11,2453,9,2035,1,328,90,8,4,5,1054,94,20834,2749,224582,245416,10/20/2020
8/19/2020,113,30180,5065,429704,459884,8,2461,9,2044,1,329,88,9,5,0,1054,90,20924,2641,227223,248147,10/20/2020
8/20/2020,173,30353,7405,437109,467462,12,2473,6,2050,2,331,92,10,5,3,1057,139,21063,3519,230742,251805,10/20/2020
8/21/2020,151,30504,6570,443679,474183,8,2481,5,2055,1,332,94,9,4,2,1059,125,21188,2944,233686,254874,10/20/2020
8/22/2020,96,30600,5547,449226,479826,10,2491,12,2067,0,332,92,11,4,1,1060,84,21272,2606,236292,257564,10/20/2020
8/23/2020,70,30670,4365,453591,484261,11,2502,6,2073,0,332,97,11,2,1,1061,56,21328,2467,238759,260087,10/20/2020
8/24/2020,105,30775,5775,459366,490141,7,2509,10,2083,1,333,93,13,4,1,1062,77,21405,3151,241910,263315,10/20/2020
8/25/2020,108,30883,4757,464123,495006,10,2519,4,2087,1,334,98,11,4,1,1063,92,21497,2292,244202,265699,10/20/2020
8/26/2020,170,31053,9476,473599,504652,4,2523,8,2095,0,334,94,9,5,1,1064,127,21624,3086,247288,268912,10/20/2020
8/27/2020,92,31145,8563,482162,513307,6,2529,13,2108,1,335,86,6,5,2,1066,70,21694,3167,250455,272149,10/20/2020
8/28/2020,112,31257,7991,490153,521410,14,2543,4,2112,0,335,96,9,7,2,1068,87,21781,2439,252894,274675,10/20/2020
8/29/2020,65,31322,5368,495521,526843,6,2549,8,2120,1,336,93,10,6,2,1070,51,21832,1913,254807,276639,10/20/2020
8/30/2020,66,31388,4314,499835,531223,7,2556,4,2124,0,336,96,8,5,2,1072,48,21880,1991,256798,278678,10/20/2020
8/31/2020,105,31493,4862,504697,536190,12,2568,15,2139,0,336,93,8,4,1,1073,81,21961,2187,258985,280946,10/20/2020
9/1/2020,98,31591,7109,511806,543397,6,2574,9,2148,1,337,89,7,4,2,1075,65,22026,2379,261364,283390,10/20/2020
9/2/2020,125,31716,10524,522330,554046,9,2583,10,2158,1,338,87,8,4,2,1077,104,22130,3057,264421,286551,10/20/2020
9/3/2020,90,31806,11065,533395,565201,8,2591,8,2166,0,338,87,9,4,3,1080,73,22203,2585,267006,289209,10/20/2020
9/4/2020,102,31908,8952,542347,574255,11,2602,4,2170,0,338,94,9,4,1,1081,83,22286,2372,269378,291664,10/20/2020
9/5/2020,52,31960,6300,548647,580607,6,2608,9,2179,0,338,91,8,3,1,1082,42,22328,1602,270980,293308,10/20/2020
9/6/2020,87,32047,4317,552964,585011,4,2612,8,2187,1,339,86,6,3,1,1083,65,22393,1952,272932,295325,10/20/2020
9/7/2020,35,32082,3000,555964,588046,11,2623,3,2190,0,339,94,5,3,1,1084,26,22419,645,273577,295996,10/20/2020
9/8/2020,74,32156,6375,562339,594495,6,2629,12,2202,1,340,87,6,3,2,1086,66,22485,1601,275178,297663,10/20/2020
9/9/2020,118,32274,8640,570979,603253,9,2638,5,2207,1,341,90,9,3,1,1087,102,22587,2147,277325,299912,10/20/2020
9/10/2020,164,32438,11326,582305,614743,9,2647,8,2215,0,341,91,10,3,0,1087,111,22698,2274,279599,302297,10/20/2020
9/11/2020,121,32559,9448,591753,624312,11,2658,11,2226,0,341,91,10,5,0,1087,98,22796,1971,281570,304366,10/20/2020
9/12/2020,109,32668,6143,597896,630564,8,2666,5,2231,2,343,92,9,5,3,1090,97,22893,1506,283076,305969,10/20/2020
9/13/2020,58,32726,2709,600605,633331,4,2670,3,2234,0,343,93,10,5,0,1090,54,22947,858,283934,306881,10/20/2020
9/14/2020,104,32830,6421,607026,639856,5,2675,3,2237,2,345,93,10,5,1,1091,95,23042,1726,285660,308702,10/20/2020
9/15/2020,122,32952,8449,615475,648427,6,2681,2,2239,1,346,96,10,5,2,1093,124,23166,2191,287851,311017,10/20/2020
9/16/2020,137,33089,9701,625176,658265,7,2688,7,2246,2,348,94,9,6,5,1098,118,23284,1971,289822,313106,10/20/2020
9/17/2020,124,33213,9222,634398,667611,7,2695,14,2260,0,348,87,8,4,0,1098,154,23438,1951,291773,315211,10/20/2020
9/18/2020,132,33345,10016,644414,677759,7,2702,7,2267,1,349,86,11,6,2,1100,132,23570,1935,293708,317278,10/20/2020
9/19/2020,116,33461,8290,652704,686165,7,2709,3,2270,0,349,90,10,6,4,1104,112,23682,1698,295406,319088,10/20/2020
9/20/2020,60,33521,3668,656372,689893,7,2716,6,2276,2,351,89,9,8,4,1108,48,23730,1326,296732,320462,10/20/2020
9/21/2020,103,33624,7002,663374,696998,12,2728,3,2279,2,353,96,8,6,2,1110,94,23824,2415,299147,322971,10/20/2020
9/22/2020,154,33778,9269,672643,706421,12,2740,3,2282,1,354,104,7,5,1,1111,125,23949,2207,301354,325303,10/20/2020
9/23/2020,136,33914,10625,683268,717182,12,2752,7,2289,0,354,109,6,5,0,1111,127,24076,2218,303572,327648,10/20/2020
9/24/2020,119,34033,12452,695720,729753,7,2759,9,2298,1,355,106,7,5,1,1112,119,24195,3169,306741,330936,10/20/2020
9/25/2020,149,34182,10534,706254,740436,9,2768,10,2308,0,355,105,6,5,1,1113,142,24337,3018,309759,334096,10/20/2020
9/26/2020,146,34328,10544,716798,751126,12,2780,9,2317,0,355,108,6,5,1,1114,118,24455,2429,312188,336643,10/20/2020
9/27/2020,42,34370,2761,719559,753929,7,2787,5,2322,0,355,110,9,5,0,1114,33,24488,849,313037,337525,10/20/2020
9/28/2020,151,34521,7285,726844,761365,6,2793,6,2328,2,357,108,7,5,2,1116,132,24620,2262,315299,339919,10/20/2020
9/29/2020,208,34729,11017,737861,772590,11,2804,18,2346,1,358,100,6,6,1,1117,190,24810,2828,318127,342937,10/20/2020
9/30/2020,221,34950,12206,750067,785017,6,2810,6,2352,0,358,100,6,6,1,1118,186,24996,2602,320729,345725,10/20/2020
10/1/2020,184,35134,12481,762548,797682,16,2826,13,2365,1,359,102,5,4,1,1119,161,25157,2434,323163,348320,10/20/2020
10/2/2020,209,35343,12127,774675,810018,13,2839,13,2378,1,360,101,6,4,2,1121,182,25339,2504,325667,351006,10/20/2020
10/3/2020,157,35500,9304,783979,819479,9,2848,9,2387,2,362,99,7,4,2,1123,133,25472,2036,327703,353175,10/20/2020
10/4/2020,81,35581,2365,786344,821925,11,2859,9,2396,1,363,100,6,4,2,1125,75,25547,962,328665,354212,10/20/2020
10/5/2020,174,35755,8935,795279,831034,29,2888,10,2406,2,365,117,8,5,4,1129,161,25708,3044,331709,357417,10/20/2020
10/6/2020,176,35931,11169,806448,842379,11,2899,4,2410,0,365,124,10,6,0,1129,189,25897,2914,334623,360520,10/20/2020
10/7/2020,228,36159,12402,818850,855009,13,2912,14,2424,2,367,121,8,6,2,1131,243,26140,3546,338169,364309,10/20/2020
10/8/2020,262,36421,15173,834023,870444,16,2928,12,2436,1,368,124,7,5,3,1134,272,26412,4210,342379,368791,10/20/2020
10/9/2020,214,36635,13191,847214,883849,19,2947,12,2448,0,368,131,10,7,2,1136,199,26611,4315,346694,373305,10/20/2020
10/10/2020,229,36864,13805,861019,897883,17,2964,10,2458,1,369,137,12,6,2,1138,197,26808,3830,350524,377332,10/20/2020
10/11/2020,94,36958,3250,864269,901227,12,2976,9,2467,1,370,139,13,5,6,1144,87,26895,1167,351691,378586,10/20/2020
10/12/2020,165,37123,6381,870650,907773,17,2993,15,2482,2,372,139,13,5,4,1148,158,27053,1751,353442,380495,10/20/2020
10/13/2020,209,37332,8477,879127,916459,14,3007,13,2495,4,376,136,12,5,7,1155,206,27259,2315,355757,383016,10/20/2020
10/14/2020,320,37652,14986,894113,931765,15,3022,7,2502,0,376,144,14,5,2,1157,308,27567,4073,359830,387397,10/20/2020
10/15/2020,263,37915,14549,908662,946577,9,3031,16,2518,1,377,136,12,5,2,1159,255,27822,3595,363425,391247,10/20/2020
10/16/2020,270,38185,14910,923572,961757,12,3043,18,2536,1,378,129,13,4,2,1161,261,28083,3402,366827,394910,10/20/2020
10/17/2020,340,38525,13881,937453,975978,15,3058,11,2547,1,379,132,16,4,2,1163,295,28378,3225,370052,398430,10/20/2020
10/18/2020,126,38651,3658,941111,979762,14,3072,11,2558,0,379,135,16,6,1,1164,115,28493,1149,371201,399694,10/20/2020
10/19/2020,175,38826,5383,946494,985320,,,,,,,,,,0,1164,156,28649,1205,372406,401055,10/20/2020
2/27/2020,0,0,0,0,0,1,1,0,0,0,0,1,0,0,0,0,0,0,0,0,0,10/21/2020
2/28/2020,0,0,0,0,0,0,1,0,0,0,0,1,1,0,0,0,0,0,0,0,0,10/21/2020
2/29/2020,0,0,0,0,0,0,1,0,0,0,0,1,1,0,0,0,0,0,0,0,0,10/21/2020
3/1/2020,2,2,2,2,4,0,1,0,0,0,0,1,1,1,0,0,2,2,2,2,4,10/21/2020
3/2/2020,0,2,1,3,5,1,2,0,0,0,0,2,2,2,0,0,0,2,1,3,5,10/21/2020
3/3/2020,0,2,2,5,7,0,2,0,0,0,0,2,2,2,0,0,0,2,2,5,7,10/21/2020
3/4/2020,0,2,12,17,19,1,3,0,0,0,0,3,2,2,0,0,0,2,10,15,17,10/21/2020
3/5/2020,0,2,4,21,23,0,3,0,0,0,0,3,2,2,0,0,1,3,4,19,22,10/21/2020
3/6/2020,1,3,12,33,36,0,3,0,0,0,0,3,2,2,0,0,0,3,11,30,33,10/21/2020
3/7/2020,0,3,19,52,55,0,3,0,0,0,0,3,2,1,0,0,0,3,19,49,52,10/21/2020
3/8/2020,0,3,18,70,73,0,3,0,0,0,0,3,2,1,0,0,0,3,18,67,70,10/21/2020
3/9/2020,1,4,15,85,89,0,3,0,0,0,0,3,2,1,0,0,1,4,15,82,86,10/21/2020
3/10/2020,2,6,25,110,116,0,3,0,0,0,0,3,2,1,0,0,1,5,23,105,110,10/21/2020
3/11/2020,0,6,34,144,150,1,4,0,0,0,0,4,1,1,0,0,0,5,34,139,144,10/21/2020
3/12/2020,9,15,41,185,200,1,5,0,0,0,0,5,1,1,0,0,8,13,38,177,190,10/21/2020
3/13/2020,6,21,50,235,256,4,9,1,1,0,0,8,1,1,0,0,6,19,48,225,244,10/21/2020
3/14/2020,0,21,90,325,346,0,9,0,1,0,0,8,1,1,0,0,0,19,86,311,330,10/21/2020
3/15/2020,1,22,54,379,401,1,10,0,1,0,0,9,2,1,0,0,1,20,54,365,385,10/21/2020
3/16/2020,2,24,95,474,498,2,12,0,1,0,0,11,2,0,0,0,2,22,92,457,479,10/21/2020
3/17/2020,12,36,162,636,672,6,18,0,1,0,0,17,2,0,0,0,11,33,151,608,641,10/21/2020
3/18/2020,9,45,116,752,797,3,21,0,1,0,0,20,2,0,0,0,11,44,110,718,762,10/21/2020
3/19/2020,15,60,262,1014,1074,2,23,1,2,0,0,21,3,0,1,1,17,61,250,968,1029,10/21/2020
3/20/2020,13,73,197,1211,1284,5,28,0,2,0,0,26,4,0,0,1,13,74,190,1158,1232,10/21/2020
3/21/2020,12,85,126,1337,1422,3,31,2,4,0,0,27,5,0,0,1,14,88,122,1280,1368,10/21/2020
3/22/2020,27,112,282,1619,1731,2,33,0,4,0,0,29,5,0,0,1,25,113,260,1540,1653,10/21/2020
3/23/2020,14,126,169,1788,1914,15,48,1,5,0,0,43,9,3,0,1,16,129,165,1705,1834,10/21/2020
3/24/2020,20,146,242,2030,2176,7,55,0,5,0,0,50,10,4,0,1,19,148,234,1939,2087,10/21/2020
3/25/2020,26,172,182,2212,2384,5,60,1,6,0,0,54,11,3,0,1,28,176,171,2110,2286,10/21/2020
3/26/2020,35,207,181,2393,2600,10,70,5,11,0,0,59,14,5,0,1,41,217,173,2283,2500,10/21/2020
3/27/2020,27,234,214,2607,2841,9,79,1,12,1,1,66,17,6,2,3,31,248,200,2483,2731,10/21/2020
3/28/2020,59,293,260,2867,3160,13,92,3,15,2,3,74,15,6,1,4,64,312,240,2723,3035,10/21/2020
3/29/2020,100,393,350,3217,3610,8,100,4,19,1,4,77,18,8,2,6,105,417,313,3036,3453,10/21/2020
3/30/2020,62,455,222,3439,3894,20,120,5,24,0,4,92,20,11,3,9,78,495,184,3220,3715,10/21/2020
3/31/2020,71,526,369,3808,4334,11,131,7,31,1,5,95,22,13,2,11,73,568,294,3514,4082,10/21/2020
4/1/2020,99,625,698,4506,5131,18,149,7,38,0,5,106,30,15,1,12,100,668,639,4153,4821,10/21/2020
4/2/2020,52,677,477,4983,5660,22,171,6,44,2,7,120,36,21,4,16,62,730,433,4586,5316,10/21/2020
4/3/2020,108,785,774,5757,6542,23,194,7,51,0,7,136,43,25,3,19,100,830,706,5292,6122,10/21/2020
4/4/2020,143,928,660,6417,7345,22,216,4,55,5,12,149,41,30,9,28,138,968,615,5907,6875,10/21/2020
4/5/2020,187,1115,1156,7573,8688,20,236,9,64,1,13,159,44,36,2,30,181,1149,1057,6964,8113,10/21/2020
4/6/2020,218,1333,1706,9279,10612,26,262,7,71,0,13,178,48,40,7,37,207,1356,1544,8508,9864,10/21/2020
4/7/2020,284,1617,1629,10908,12525,20,282,5,76,2,15,191,50,42,5,42,261,1617,1471,9979,11596,10/21/2020
4/8/2020,290,1907,1720,12628,14535,19,301,7,83,6,21,197,50,38,10,52,271,1888,1547,11526,13414,10/21/2020
4/9/2020,283,2190,1516,14144,16334,32,333,9,92,4,25,216,53,40,7,59,277,2165,1349,12875,15040,10/21/2020
4/10/2020,419,2609,2574,16718,19327,29,362,16,108,5,30,224,59,41,11,70,401,2566,2358,15233,17799,10/21/2020
4/11/2020,297,2906,1905,18623,21529,29,391,11,119,2,32,240,61,48,12,82,281,2847,1712,16945,19792,10/21/2020
4/12/2020,314,3220,1670,20293,23513,35,426,13,132,5,37,257,59,49,9,91,284,3131,1426,18371,21502,10/21/2020
4/13/2020,161,3381,935,21228,24609,35,461,13,145,3,40,276,64,54,9,100,187,3318,835,19206,22524,10/21/2020
4/14/2020,289,3670,1787,23015,26685,27,488,17,162,5,45,281,72,53,8,108,262,3580,1523,20729,24309,10/21/2020
4/15/2020,351,4021,1799,24814,28835,31,519,20,182,3,48,289,72,54,17,125,306,3886,1542,22271,26157,10/21/2020
4/16/2020,447,4468,2494,27308,31776,36,555,25,207,6,54,294,72,53,14,139,387,4273,2066,24337,28610,10/21/2020
4/17/2020,304,4772,1821,29129,33901,32,587,20,227,7,61,299,66,45,21,160,290,4563,1439,25776,30339,10/21/2020
4/18/2020,321,5093,1725,30854,35947,26,613,18,245,4,65,303,63,49,15,175,284,4847,1316,27092,31939,10/21/2020
4/19/2020,381,5474,2047,32901,38375,23,636,26,271,1,66,299,65,55,11,186,336,5183,1730,28822,34005,10/21/2020
4/20/2020,394,5868,1907,34808,40676,46,682,29,300,2,68,314,75,56,10,196,376,5559,1563,30385,35944,10/21/2020
4/21/2020,444,6312,2110,36918,43230,45,727,33,333,5,73,321,72,56,18,214,384,5943,1696,32081,38024,10/21/2020
4/22/2020,418,6730,2390,39308,46038,41,768,32,365,5,78,325,73,58,18,232,379,6322,1904,33985,40307,10/21/2020
4/23/2020,479,7209,2469,41777,48986,32,800,28,393,5,83,324,76,62,15,247,412,6734,1843,35828,42562,10/21/2020
4/24/2020,491,7700,3284,45061,52761,35,835,26,419,4,87,329,85,63,15,262,407,7141,2613,38441,45582,10/21/2020
4/25/2020,393,8093,2206,47267,55360,34,869,17,436,5,92,341,85,62,14,276,300,7441,1755,40196,47637,10/21/2020
4/26/2020,316,8409,2309,49576,57985,33,902,15,451,3,95,356,86,59,14,290,274,7715,1864,42060,49775,10/21/2020
4/27/2020,249,8658,1620,51196,59854,29,931,21,472,4,99,360,86,61,10,300,206,7921,1156,43216,51137,10/21/2020
4/28/2020,410,9068,2263,53459,62527,44,975,24,496,3,102,377,88,59,22,322,331,8252,1750,44966,53218,10/21/2020
4/29/2020,476,9544,3343,56802,66346,36,1011,38,534,11,113,364,78,53,18,340,371,8623,2411,47377,56000,10/21/2020
4/30/2020,432,9976,2769,59571,69547,33,1044,38,572,6,119,353,83,57,24,364,350,8973,1900,49277,58250,10/21/2020
5/1/2020,454,10430,3086,62657,73087,51,1095,39,611,3,122,362,84,58,14,378,324,9297,2152,51429,60726,10/21/2020
5/2/2020,257,10687,1926,64583,75270,36,1131,38,649,5,127,355,91,62,24,402,192,9489,1261,52690,62179,10/21/2020
5/3/2020,283,10970,2160,66743,77713,31,1162,27,676,8,135,351,90,61,21,423,183,9672,1562,54252,63924,10/21/2020
5/4/2020,387,11357,2098,68841,80198,30,1192,31,707,5,140,345,88,57,18,441,290,9962,1555,55807,65769,10/21/2020
5/5/2020,433,11790,2873,71714,83504,29,1221,32,739,6,146,336,82,54,16,457,301,10263,1951,57758,68021,10/21/2020
5/6/2020,488,12278,2830,74544,86822,28,1249,44,783,9,155,311,79,54,21,478,340,10603,1911,59669,70272,10/21/2020
5/7/2020,425,12703,2969,77513,90216,36,1285,41,824,5,160,301,71,52,21,499,270,10873,1954,61623,72496,10/21/2020
5/8/2020,359,13062,2598,80111,93173,30,1315,29,853,5,165,297,71,53,22,521,229,11102,1733,63356,74458,10/21/2020
5/9/2020,467,13529,3346,83457,96986,22,1337,21,874,4,169,294,69,51,15,536,290,11392,2248,65604,76996,10/21/2020
5/10/2020,285,13814,2117,85574,99388,20,1357,23,897,6,175,285,70,49,13,549,189,11581,1515,67119,78700,10/21/2020
5/11/2020,257,14071,1857,87431,101502,31,1388,16,913,6,181,294,71,49,15,564,174,11755,1298,68417,80172,10/21/2020
5/12/2020,387,14458,2611,90042,104500,23,1411,18,931,4,185,295,69,48,22,586,224,11979,1695,70112,82091,10/21/2020
5/13/2020,351,14809,3630,93672,108481,23,1434,25,956,1,186,292,69,49,13,599,199,12178,1983,72095,84273,10/21/2020
5/14/2020,329,15138,3408,97080,112218,19,1453,27,983,3,189,281,64,45,15,614,231,12409,2010,74105,86514,10/21/2020
5/15/2020,381,15519,3458,100538,116057,24,1477,41,1024,5,194,259,62,45,14,628,232,12641,1800,75905,88546,10/21/2020
5/16/2020,449,15968,4156,104694,120662,25,1502,13,1037,5,199,266,61,46,15,643,247,12888,1949,77854,90742,10/21/2020
5/17/2020,240,16208,2768,107462,123670,17,1519,8,1045,5,204,270,59,45,10,653,126,13014,1537,79391,92405,10/21/2020
5/18/2020,250,16458,2001,109463,125921,19,1538,15,1060,5,209,269,57,40,18,671,135,13149,1365,80756,93905,10/21/2020
5/19/2020,415,16873,3168,112631,129504,23,1561,32,1092,5,214,255,56,38,11,682,215,13364,1917,82673,96037,10/21/2020
5/20/2020,326,17199,2771,115402,132601,19,1580,23,1115,7,221,244,52,33,22,704,183,13547,1509,84182,97729,10/21/2020
5/21/2020,374,17573,3757,119159,136732,26,1606,15,1130,3,224,252,53,29,20,724,168,13715,1932,86114,99829,10/21/2020
5/22/2020,351,17924,3161,122320,140244,20,1626,29,1159,5,229,238,52,29,11,735,206,13921,1604,87718,101639,10/21/2020
5/23/2020,253,18177,2742,125062,143239,19,1645,11,1170,3,232,243,52,32,13,748,109,14030,1267,88985,103015,10/21/2020
5/24/2020,163,18340,1370,126432,144772,13,1658,14,1184,2,234,240,53,36,8,756,83,14113,772,89757,103870,10/21/2020
5/25/2020,147,18487,1385,127817,146304,14,1672,14,1198,0,234,240,53,34,10,766,76,14189,761,90518,104707,10/21/2020
5/26/2020,285,18772,2620,130437,149209,24,1696,22,1220,5,239,237,48,33,15,781,158,14347,1777,92295,106642,10/21/2020
5/27/2020,276,19048,2057,132494,151542,20,1716,18,1238,3,242,236,50,33,10,791,132,14479,1130,93425,107904,10/21/2020
5/28/2020,348,19396,3359,135853,155249,17,1733,29,1267,4,246,220,47,32,8,799,130,14609,1114,94539,109148,10/21/2020
5/29/2020,410,19806,3915,139768,159574,19,1752,27,1294,6,252,206,43,31,12,811,174,14783,1570,96109,110892,10/21/2020
5/30/2020,225,20031,3915,143683,163714,16,1768,19,1313,4,256,199,41,29,12,823,109,14892,1817,97926,112818,10/21/2020
5/31/2020,155,20186,1688,145371,165557,11,1779,10,1323,1,257,199,44,26,3,826,78,14970,854,98780,113750,10/21/2020
6/1/2020,212,20398,2792,148163,168561,8,1787,14,1337,1,258,192,45,29,5,831,93,15063,1380,100160,115223,10/21/2020
6/2/2020,273,20671,3022,151185,171856,8,1795,9,1346,3,261,188,38,25,10,841,98,15161,1442,101602,116763,10/21/2020
6/3/2020,254,20925,3486,154671,175596,14,1809,18,1364,6,267,178,34,25,11,852,99,15260,1655,103257,118517,10/21/2020
6/4/2020,276,21201,4471,159142,180343,7,1816,25,1389,4,271,156,31,24,12,864,107,15367,2032,105289,120656,10/21/2020
6/5/2020,215,21416,3513,162655,184071,15,1831,13,1402,6,277,152,27,21,11,875,99,15466,1570,106859,122325,10/21/2020
6/6/2020,201,21617,2616,165271,186888,10,1841,7,1409,2,279,153,29,19,6,881,67,15533,1128,107987,123520,10/21/2020
6/7/2020,83,21700,1625,166896,188596,11,1852,7,1416,1,280,156,25,17,4,885,51,15584,781,108768,124352,10/21/2020
6/8/2020,119,21819,1849,168745,190564,15,1867,12,1428,2,282,157,27,18,4,889,45,15629,954,109722,125351,10/21/2020
6/9/2020,223,22042,2673,171418,193460,10,1877,18,1446,0,282,149,28,21,1,890,64,15693,1252,110974,126667,10/21/2020
6/10/2020,209,22251,2987,174405,196656,13,1890,12,1458,2,284,148,24,17,4,894,101,15794,1463,112437,128231,10/21/2020
6/11/2020,195,22446,3513,177918,200364,7,1897,15,1473,1,285,139,25,16,6,900,88,15882,1530,113967,129849,10/21/2020
6/12/2020,209,22655,4601,182519,205174,9,1906,15,1488,1,286,132,24,16,2,902,78,15960,2170,116137,132097,10/21/2020
6/13/2020,113,22768,3036,185555,208323,6,1912,5,1493,0,286,133,20,15,3,905,49,16009,1365,117502,133511,10/21/2020
6/14/2020,81,22849,2046,187601,210450,7,1919,8,1501,1,287,131,20,14,3,908,33,16042,964,118466,134508,10/21/2020
6/15/2020,188,23037,3108,190709,213746,14,1933,14,1515,0,287,131,20,16,5,913,75,16117,1787,120253,136370,10/21/2020
6/16/2020,110,23147,3017,193726,216873,11,1944,9,1524,1,288,132,22,16,8,921,50,16167,1558,121811,137978,10/21/2020
6/17/2020,127,23274,2835,196561,219835,15,1959,20,1544,4,292,123,18,14,6,927,50,16217,1316,123127,139344,10/21/2020
6/18/2020,149,23423,3048,199609,223032,9,1968,13,1557,1,293,118,19,16,7,934,70,16287,1310,124437,140724,10/21/2020
6/19/2020,141,23564,3769,203378,226942,12,1980,11,1568,1,294,118,20,17,3,937,59,16346,1363,125800,142146,10/21/2020
6/20/2020,84,23648,1891,205269,228917,9,1989,12,1580,0,294,115,20,18,4,941,36,16382,812,126612,142994,10/21/2020
6/21/2020,37,23685,1064,206333,230018,8,1997,5,1585,0,294,118,20,18,2,943,29,16411,690,127302,143713,10/21/2020
6/22/2020,138,23823,3730,210063,233886,12,2009,16,1601,0,294,114,19,18,2,945,65,16476,1703,129005,145481,10/21/2020
6/23/2020,163,23986,3831,213894,237880,3,2012,13,1614,3,297,101,18,18,7,952,81,16557,1776,130781,147338,10/21/2020
6/24/2020,120,24106,3502,217396,241502,9,2021,10,1624,1,298,99,18,18,5,957,44,16601,1678,132459,149060,10/21/2020
6/25/2020,103,24209,2883,220279,244488,6,2027,14,1638,1,299,90,17,17,1,958,50,16651,1504,133963,150614,10/21/2020
6/26/2020,94,24303,2488,222767,247070,2,2029,10,1648,0,299,82,18,18,1,959,60,16711,1328,135291,152002,10/21/2020
6/27/2020,84,24387,3216,225983,250370,5,2034,3,1651,1,300,83,17,17,5,964,37,16748,1217,136508,153256,10/21/2020
6/28/2020,39,24426,1469,227452,251878,4,2038,4,1655,4,304,79,15,14,6,970,17,16765,593,137101,153866,10/21/2020
6/29/2020,85,24511,3697,231149,255660,4,2042,5,1660,0,304,78,14,14,1,971,39,16804,1349,138450,155254,10/21/2020
6/30/2020,57,24568,1958,233107,257675,1,2043,5,1665,1,305,73,12,11,4,975,33,16837,994,139444,156281,10/21/2020
7/1/2020,144,24712,4098,237205,261917,8,2051,10,1675,0,305,71,11,11,1,976,79,16916,1925,141369,158285,10/21/2020
7/2/2020,103,24815,2803,240008,264823,5,2056,5,1680,1,306,70,10,10,3,979,59,16975,1084,142453,159428,10/21/2020
7/3/2020,50,24865,2078,242086,266951,9,2065,6,1686,0,306,73,9,9,3,982,25,17000,779,143232,160232,10/21/2020
7/4/2020,57,24922,2345,244431,269353,2,2067,4,1690,1,307,70,10,9,2,984,33,17033,1006,144238,161271,10/21/2020
7/5/2020,49,24971,2932,247363,272334,1,2068,2,1692,1,308,68,8,8,2,986,26,17059,1437,145675,162734,10/21/2020
7/6/2020,101,25072,2811,250174,275246,6,2074,6,1698,0,308,68,9,9,4,990,57,17116,1547,147222,164338,10/21/2020
7/7/2020,81,25153,3457,253631,278784,5,2079,7,1705,0,308,66,8,8,2,992,47,17163,1534,148756,165919,10/21/2020
7/8/2020,105,25258,3409,257040,282298,4,2083,2,1707,0,308,68,9,8,0,992,64,17227,1427,150183,167410,10/21/2020
7/9/2020,94,25352,3714,260754,286106,9,2092,3,1710,0,308,74,9,8,0,992,50,17277,1620,151803,169080,10/21/2020
7/10/2020,132,25484,4432,265186,290670,6,2098,3,1713,2,310,75,7,7,3,995,81,17358,2068,153871,171229,10/21/2020
7/11/2020,63,25547,2932,268118,293665,6,2104,3,1716,1,311,77,6,6,3,998,36,17394,1313,155184,172578,10/21/2020
7/12/2020,47,25594,1837,269955,295549,1,2105,3,1719,1,312,74,6,5,3,1001,34,17428,942,156126,173554,10/21/2020
7/13/2020,84,25678,3201,273156,298834,8,2113,10,1729,0,312,72,6,5,1,1002,61,17489,1502,157628,175117,10/21/2020
7/14/2020,73,25751,3293,276449,302200,7,2120,4,1733,0,312,75,5,5,1,1003,43,17532,1372,159000,176532,10/21/2020
7/15/2020,130,25881,4173,280622,306503,5,2125,7,1740,0,312,73,5,4,0,1003,99,17631,1746,160746,178377,10/21/2020
7/16/2020,102,25983,3734,284356,310339,6,2131,9,1749,0,312,70,6,5,1,1004,75,17706,1613,162359,180065,10/21/2020
7/17/2020,156,26139,4236,288592,314731,14,2145,3,1752,1,313,80,5,5,2,1006,79,17785,1842,164201,181986,10/21/2020
7/18/2020,85,26224,3269,291861,318085,5,2150,9,1761,1,314,75,5,4,4,1010,70,17855,1396,165597,183452,10/21/2020
7/19/2020,82,26306,2694,294555,320861,7,2157,3,1764,0,314,79,6,4,2,1012,57,17912,1148,166745,184657,10/21/2020
7/20/2020,71,26377,2664,297219,323596,9,2166,7,1771,0,314,81,7,5,2,1014,68,17980,1457,168202,186182,10/21/2020
7/21/2020,130,26507,4299,301518,328025,9,2175,11,1782,0,314,79,9,6,1,1015,109,18089,1913,170115,188204,10/21/2020
7/22/2020,130,26637,3927,305445,332082,11,2186,11,1793,1,315,78,7,6,1,1016,86,18175,1681,171796,189971,10/21/2020
7/23/2020,141,26778,4413,309858,336636,8,2194,6,1799,0,315,80,8,7,0,1016,115,18290,1979,173775,192065,10/21/2020
7/24/2020,172,26950,5961,315819,342769,14,2208,14,1813,0,315,80,9,7,0,1016,119,18409,2316,176091,194500,10/21/2020
7/25/2020,134,27084,4399,320218,347302,7,2215,7,1820,0,315,80,10,8,2,1018,108,18517,2092,178183,196700,10/21/2020
7/26/2020,62,27146,3027,323245,350391,8,2223,9,1829,0,315,79,11,7,1,1019,54,18571,1333,179516,198087,10/21/2020
7/27/2020,188,27334,4190,327435,354769,12,2235,7,1836,0,315,84,13,8,1,1020,138,18709,2342,181858,200567,10/21/2020
7/28/2020,106,27440,3834,331269,358709,5,2240,5,1841,0,315,84,14,7,1,1021,95,18804,1632,183490,202294,10/21/2020
7/29/2020,191,27631,5137,336406,364037,11,2251,12,1853,0,315,83,15,7,0,1021,154,18958,2314,185804,204762,10/21/2020
7/30/2020,121,27752,4344,340750,368502,6,2257,2,1855,1,316,86,15,6,1,1022,97,19055,1644,187448,206503,10/21/2020
7/31/2020,131,27883,5509,346259,374142,8,2265,10,1865,0,316,84,15,7,1,1023,89,19144,1848,189296,208440,10/21/2020
8/1/2020,108,27991,4292,350551,378542,7,2272,2,1867,0,316,89,14,7,1,1024,88,19232,1559,190855,210087,10/21/2020
8/2/2020,84,28075,2802,353353,381428,12,2284,12,1879,2,318,87,14,8,2,1026,62,19294,1269,192124,211418,10/21/2020
8/3/2020,187,28262,5238,358591,386853,13,2297,12,1891,0,318,88,16,7,1,1027,150,19444,2195,194319,213763,10/21/2020
8/4/2020,126,28388,3691,362282,390670,9,2306,6,1897,1,319,90,12,5,2,1029,99,19543,1769,196088,215631,10/21/2020
8/5/2020,148,28536,5934,368216,396752,12,2318,10,1907,1,320,91,10,5,2,1031,118,19661,2468,198556,218217,10/21/2020
8/6/2020,169,28705,5533,373749,402454,7,2325,9,1916,0,320,89,9,4,0,1031,121,19782,2401,200957,220739,10/21/2020
8/7/2020,122,28827,4847,378596,407423,13,2338,10,1926,1,321,91,9,3,2,1033,87,19869,2141,203098,222967,10/21/2020
8/8/2020,123,28950,4107,382703,411653,19,2357,6,1932,1,322,103,8,3,1,1034,92,19961,1777,204875,224836,10/21/2020
8/9/2020,42,28992,1722,384425,413417,8,2365,10,1942,0,322,101,9,4,0,1034,35,19996,1070,205945,225941,10/21/2020
8/10/2020,149,29141,4584,389009,418150,11,2376,12,1954,0,322,100,9,4,1,1035,113,20109,2020,207965,228074,10/21/2020
8/11/2020,105,29246,4329,393338,422584,6,2382,14,1968,0,322,92,10,4,3,1038,92,20201,2262,210227,230428,10/21/2020
8/12/2020,121,29367,5184,398522,427889,8,2390,11,1979,0,322,89,9,3,1,1039,101,20302,2622,212849,233151,10/21/2020
8/13/2020,135,29502,4192,402714,432216,13,2403,12,1991,0,322,90,11,3,0,1039,95,20397,1900,214749,235146,10/21/2020
8/14/2020,145,29647,5494,408208,437855,13,2416,11,2002,0,322,92,11,4,3,1042,99,20496,1971,216720,237216,10/21/2020
8/15/2020,105,29752,4533,412741,442493,9,2425,11,2013,1,323,89,11,5,0,1042,89,20585,1689,218409,238994,10/21/2020
8/16/2020,83,29835,2472,415213,445048,7,2432,6,2019,4,327,86,8,4,6,1048,70,20655,961,219370,240025,10/21/2020
8/17/2020,106,29941,4570,419783,449724,10,2442,7,2026,0,327,89,8,5,2,1050,88,20743,2391,221761,242504,10/21/2020
8/18/2020,128,30069,4904,424687,454756,11,2453,9,2035,1,328,90,8,4,5,1055,94,20837,2748,224509,245346,10/21/2020
8/19/2020,113,30182,5065,429752,459934,8,2461,9,2044,1,329,88,9,5,0,1055,90,20927,2641,227150,248077,10/21/2020
8/20/2020,173,30355,7405,437157,467512,12,2473,6,2050,2,331,92,10,5,3,1058,139,21066,3515,230665,251731,10/21/2020
8/21/2020,151,30506,6571,443728,474234,8,2481,5,2055,1,332,94,9,4,2,1060,125,21191,2945,233610,254801,10/21/2020
8/22/2020,96,30602,5547,449275,479877,10,2491,12,2067,0,332,92,11,4,1,1061,84,21275,2605,236215,257490,10/21/2020
8/23/2020,70,30672,4370,453645,484317,11,2502,6,2073,0,332,97,11,2,1,1062,56,21331,2470,238685,260016,10/21/2020
8/24/2020,105,30777,5776,459421,490198,7,2509,10,2083,1,333,93,13,4,1,1063,77,21408,3152,241837,263245,10/21/2020
8/25/2020,108,30885,4759,464180,495065,10,2519,4,2087,1,334,98,11,4,1,1064,92,21500,2290,244127,265627,10/21/2020
8/26/2020,170,31055,9477,473657,504712,4,2523,8,2095,0,334,94,9,5,1,1065,127,21627,3085,247212,268839,10/21/2020
8/27/2020,92,31147,8564,482221,513368,6,2529,13,2108,1,335,86,6,5,2,1067,70,21697,3165,250377,272074,10/21/2020
8/28/2020,112,31259,7991,490212,521471,14,2543,4,2112,0,335,96,9,7,2,1069,87,21784,2434,252811,274595,10/21/2020
8/29/2020,65,31324,5368,495580,526904,6,2549,8,2120,1,336,93,10,6,2,1071,51,21835,1912,254723,276558,10/21/2020
8/30/2020,66,31390,4320,499900,531290,7,2556,4,2124,0,336,96,8,5,2,1073,48,21883,1994,256717,278600,10/21/2020
8/31/2020,105,31495,4863,504763,536258,12,2568,15,2139,0,336,93,8,4,1,1074,81,21964,2186,258903,280867,10/21/2020
9/1/2020,98,31593,7109,511872,543465,6,2574,9,2148,1,337,89,7,4,2,1076,65,22029,2379,261282,283311,10/21/2020
9/2/2020,125,31718,10524,522396,554114,9,2583,10,2158,1,338,87,8,4,2,1078,104,22133,3056,264338,286471,10/21/2020
9/3/2020,90,31808,11065,533461,565269,8,2591,8,2166,0,338,87,9,4,3,1081,73,22206,2585,266923,289129,10/21/2020
9/4/2020,102,31910,8953,542414,574324,11,2602,4,2170,0,338,94,9,4,1,1082,83,22289,2371,269294,291583,10/21/2020
9/5/2020,52,31962,6301,548715,580677,6,2608,9,2179,0,338,91,8,3,1,1083,42,22331,1602,270896,293227,10/21/2020
9/6/2020,87,32049,4317,553032,585081,4,2612,8,2187,1,339,86,6,3,1,1084,64,22395,1950,272846,295241,10/21/2020
9/7/2020,35,32084,3001,556033,588117,11,2623,3,2190,0,339,94,5,3,1,1085,26,22421,646,273492,295913,10/21/2020
9/8/2020,74,32158,6375,562408,594566,6,2629,12,2202,1,340,87,6,3,2,1087,66,22487,1601,275093,297580,10/21/2020
9/9/2020,118,32276,8641,571049,603325,9,2638,5,2207,1,341,90,9,3,1,1088,102,22589,2146,277239,299828,10/21/2020
9/10/2020,164,32440,11327,582376,614816,9,2647,8,2215,0,341,91,10,3,1,1089,111,22700,2275,279514,302214,10/21/2020
9/11/2020,121,32561,9449,591825,624386,11,2658,11,2226,0,341,91,10,5,0,1089,98,22798,1972,281486,304284,10/21/2020
9/12/2020,109,32670,6144,597969,630639,8,2666,5,2231,2,343,92,9,5,3,1092,97,22895,1507,282993,305888,10/21/2020
9/13/2020,58,32728,2710,600679,633407,4,2670,3,2234,0,343,93,10,5,0,1092,54,22949,859,283852,306801,10/21/2020
9/14/2020,104,32832,6421,607100,639932,5,2675,3,2237,2,345,93,10,5,1,1093,95,23044,1725,285577,308621,10/21/2020
9/15/2020,122,32954,8449,615549,648503,7,2682,2,2239,1,346,97,10,5,2,1095,124,23168,2191,287768,310936,10/21/2020
9/16/2020,137,33091,9701,625250,658341,7,2689,7,2246,2,348,95,9,6,5,1100,118,23286,1970,289738,313024,10/21/2020
9/17/2020,124,33215,9222,634472,667687,7,2696,14,2260,0,348,88,8,4,0,1100,154,23440,1950,291688,315128,10/21/2020
9/18/2020,132,33347,10017,644489,677836,7,2703,7,2267,1,349,87,11,6,2,1102,132,23572,1936,293624,317196,10/21/2020
9/19/2020,116,33463,8291,652780,686243,7,2710,3,2270,0,349,91,10,6,4,1106,112,23684,1698,295322,319006,10/21/2020
9/20/2020,60,33523,3668,656448,689971,7,2717,6,2276,2,351,90,9,8,4,1110,48,23732,1325,296647,320379,10/21/2020
9/21/2020,103,33626,7002,663450,697076,12,2729,3,2279,2,353,97,8,6,2,1112,94,23826,2414,299061,322887,10/21/2020
9/22/2020,154,33780,9269,672719,706499,12,2741,3,2282,1,354,105,7,5,1,1113,125,23951,2206,301267,325218,10/21/2020
9/23/2020,136,33916,10626,683345,717261,12,2753,7,2289,0,354,110,6,5,0,1113,127,24078,2218,303485,327563,10/21/2020
9/24/2020,119,34035,12453,695798,729833,7,2760,9,2298,1,355,107,7,5,1,1114,119,24197,3169,306654,330851,10/21/2020
9/25/2020,149,34184,10534,706332,740516,9,2769,10,2308,0,355,106,6,5,1,1115,142,24339,3017,309671,334010,10/21/2020
9/26/2020,146,34330,10545,716877,751207,12,2781,9,2317,0,355,109,6,5,1,1116,118,24457,2430,312101,336558,10/21/2020
9/27/2020,43,34373,2761,719638,754011,7,2788,5,2322,0,355,111,9,5,0,1116,34,24491,847,312948,337439,10/21/2020
9/28/2020,151,34524,7286,726924,761448,6,2794,6,2328,2,357,109,7,5,2,1118,132,24623,2263,315211,339834,10/21/2020
9/29/2020,208,34732,11020,737944,772676,11,2805,18,2346,1,358,101,6,6,1,1119,190,24813,2828,318039,342852,10/21/2020
9/30/2020,221,34953,12206,750150,785103,6,2811,6,2352,0,358,101,6,6,1,1120,186,24999,2601,320640,345639,10/21/2020
10/1/2020,184,35137,12483,762633,797770,16,2827,13,2365,1,359,103,5,4,2,1122,162,25161,2434,323074,348235,10/21/2020
10/2/2020,209,35346,12127,774760,810106,13,2840,13,2378,1,360,102,6,4,2,1124,181,25342,2504,325578,350920,10/21/2020
10/3/2020,157,35503,9305,784065,819568,9,2849,9,2387,2,362,100,7,4,2,1126,133,25475,2034,327612,353087,10/21/2020
10/4/2020,81,35584,2365,786430,822014,11,2860,9,2396,1,363,101,6,4,2,1128,75,25550,962,328574,354124,10/21/2020
10/5/2020,174,35758,8938,795368,831126,29,2889,10,2406,2,365,118,8,5,4,1132,161,25711,3042,331616,357327,10/21/2020
10/6/2020,176,35934,11171,806539,842473,11,2900,4,2410,0,365,125,10,6,0,1132,189,25900,2913,334529,360429,10/21/2020
10/7/2020,228,36162,12404,818943,855105,13,2913,14,2424,2,367,122,8,6,2,1134,243,26143,3544,338073,364216,10/21/2020
10/8/2020,263,36425,15176,834119,870544,16,2929,12,2436,1,368,125,7,5,3,1137,274,26417,4208,342281,368698,10/21/2020
10/9/2020,214,36639,13192,847311,883950,19,2948,12,2448,0,368,132,10,7,3,1140,198,26615,4314,346595,373210,10/21/2020
10/10/2020,229,36868,13808,861119,897987,17,2965,10,2458,1,369,138,12,6,2,1142,197,26812,3829,350424,377236,10/21/2020
10/11/2020,94,36962,3251,864370,901332,12,2977,9,2467,1,370,140,13,5,6,1148,87,26899,1166,351590,378489,10/21/2020
10/12/2020,165,37127,6389,870759,907886,17,2994,15,2482,2,372,140,13,5,4,1152,159,27058,1751,353341,380399,10/21/2020
10/13/2020,210,37337,8481,879240,916577,14,3008,13,2495,4,376,137,12,5,7,1159,207,27265,2315,355656,382921,10/21/2020
10/14/2020,320,37657,14988,894228,931885,15,3023,7,2502,0,376,145,14,5,2,1161,309,27574,4070,359726,387300,10/21/2020
10/15/2020,263,37920,14553,908781,946701,9,3032,16,2518,1,377,137,12,5,2,1163,254,27828,3590,363316,391144,10/21/2020
10/16/2020,273,38193,14937,923718,961911,13,3045,18,2536,1,378,131,13,4,2,1165,265,28093,3406,366722,394815,10/21/2020
10/17/2020,348,38541,13970,937688,976229,17,3062,11,2547,1,379,136,16,4,2,1167,305,28398,3266,369988,398386,10/21/2020
10/18/2020,137,38678,3770,941458,980136,16,3078,11,2558,0,379,141,16,6,1,1168,124,28522,1202,371190,399712,10/21/2020
10/19/2020,334,39012,7210,948668,987680,13,3091,22,2580,2,381,130,14,6,0,1168,317,28839,2137,373327,402166,10/21/2020
10/20/2020,312,39324,10568,959236,998560,,,,,,,,,,1,1169,284,29123,2230,375557,404680,10/21/2020
2/27/2020,0,0,0,0,0,1,1,0,0,0,0,1,0,0,0,0,0,0,0,0,0,10/22/2020
2/28/2020,0,0,0,0,0,0,1,0,0,0,0,1,1,0,0,0,0,0,0,0,0,10/22/2020
2/29/2020,0,0,0,0,0,0,1,0,0,0,0,1,1,0,0,0,0,0,0,0,0,10/22/2020
3/1/2020,2,2,2,2,4,0,1,0,0,0,0,1,1,1,0,0,2,2,2,2,4,10/22/2020
3/2/2020,0,2,1,3,5,1,2,0,0,0,0,2,2,2,0,0,0,2,1,3,5,10/22/2020
3/3/2020,0,2,2,5,7,0,2,0,0,0,0,2,2,2,0,0,0,2,2,5,7,10/22/2020
3/4/2020,0,2,12,17,19,1,3,0,0,0,0,3,2,2,0,0,0,2,10,15,17,10/22/2020
3/5/2020,0,2,4,21,23,0,3,0,0,0,0,3,2,2,0,0,1,3,4,19,22,10/22/2020
3/6/2020,1,3,12,33,36,0,3,0,0,0,0,3,2,2,0,0,0,3,11,30,33,10/22/2020
3/7/2020,0,3,19,52,55,0,3,0,0,0,0,3,2,1,0,0,0,3,19,49,52,10/22/2020
3/8/2020,0,3,18,70,73,0,3,0,0,0,0,3,2,1,0,0,0,3,18,67,70,10/22/2020
3/9/2020,1,4,15,85,89,0,3,0,0,0,0,3,2,1,0,0,1,4,15,82,86,10/22/2020
3/10/2020,2,6,25,110,116,0,3,0,0,0,0,3,2,1,0,0,1,5,23,105,110,10/22/2020
3/11/2020,0,6,34,144,150,1,4,0,0,0,0,4,1,1,0,0,0,5,34,139,144,10/22/2020
3/12/2020,9,15,41,185,200,1,5,0,0,0,0,5,1,1,0,0,8,13,38,177,190,10/22/2020
3/13/2020,6,21,50,235,256,4,9,1,1,0,0,8,1,1,0,0,6,19,48,225,244,10/22/2020
3/14/2020,0,21,90,325,346,0,9,0,1,0,0,8,1,1,0,0,0,19,86,311,330,10/22/2020
3/15/2020,1,22,54,379,401,1,10,0,1,0,0,9,2,1,0,0,1,20,54,365,385,10/22/2020
3/16/2020,2,24,95,474,498,2,12,0,1,0,0,11,2,0,0,0,2,22,92,457,479,10/22/2020
3/17/2020,12,36,162,636,672,6,18,0,1,0,0,17,2,0,0,0,11,33,151,608,641,10/22/2020
3/18/2020,9,45,116,752,797,3,21,0,1,0,0,20,2,0,0,0,11,44,110,718,762,10/22/2020
3/19/2020,15,60,262,1014,1074,2,23,1,2,0,0,21,3,0,1,1,17,61,250,968,1029,10/22/2020
3/20/2020,13,73,197,1211,1284,5,28,0,2,0,0,26,4,0,0,1,13,74,190,1158,1232,10/22/2020
3/21/2020,12,85,126,1337,1422,3,31,2,4,0,0,27,5,0,0,1,14,88,122,1280,1368,10/22/2020
3/22/2020,27,112,282,1619,1731,2,33,0,4,0,0,29,5,0,0,1,25,113,260,1540,1653,10/22/2020
3/23/2020,14,126,169,1788,1914,15,48,1,5,0,0,43,9,3,0,1,16,129,165,1705,1834,10/22/2020
3/24/2020,20,146,242,2030,2176,7,55,0,5,0,0,50,10,4,0,1,19,148,234,1939,2087,10/22/2020
3/25/2020,26,172,182,2212,2384,5,60,1,6,0,0,54,11,3,0,1,28,176,171,2110,2286,10/22/2020
3/26/2020,35,207,181,2393,2600,10,70,5,11,0,0,59,14,5,0,1,41,217,173,2283,2500,10/22/2020
3/27/2020,27,234,214,2607,2841,9,79,1,12,1,1,66,17,6,2,3,31,248,200,2483,2731,10/22/2020
3/28/2020,59,293,260,2867,3160,13,92,3,15,2,3,74,15,6,1,4,64,312,240,2723,3035,10/22/2020
3/29/2020,100,393,350,3217,3610,8,100,4,19,1,4,77,18,8,2,6,105,417,313,3036,3453,10/22/2020
3/30/2020,62,455,222,3439,3894,20,120,5,24,0,4,92,20,11,3,9,78,495,184,3220,3715,10/22/2020
3/31/2020,71,526,369,3808,4334,11,131,7,31,1,5,95,22,13,2,11,73,568,294,3514,4082,10/22/2020
4/1/2020,99,625,698,4506,5131,18,149,7,38,0,5,106,30,15,1,12,100,668,639,4153,4821,10/22/2020
4/2/2020,52,677,477,4983,5660,22,171,6,44,2,7,120,36,21,4,16,62,730,433,4586,5316,10/22/2020
4/3/2020,108,785,774,5757,6542,23,194,7,51,0,7,136,43,25,3,19,100,830,706,5292,6122,10/22/2020
4/4/2020,143,928,660,6417,7345,22,216,4,55,5,12,149,41,30,9,28,138,968,615,5907,6875,10/22/2020
4/5/2020,187,1115,1156,7573,8688,20,236,9,64,1,13,159,44,36,2,30,181,1149,1057,6964,8113,10/22/2020
4/6/2020,218,1333,1706,9279,10612,26,262,7,71,0,13,178,48,40,7,37,207,1356,1543,8507,9863,10/22/2020
4/7/2020,284,1617,1629,10908,12525,20,282,5,76,2,15,191,50,42,5,42,261,1617,1471,9978,11595,10/22/2020
4/8/2020,290,1907,1720,12628,14535,19,301,7,83,6,21,197,50,38,10,52,271,1888,1546,11524,13412,10/22/2020
4/9/2020,283,2190,1516,14144,16334,32,333,9,92,4,25,216,53,40,7,59,277,2165,1349,12873,15038,10/22/2020
4/10/2020,419,2609,2574,16718,19327,29,362,16,108,5,30,224,59,41,11,70,401,2566,2358,15231,17797,10/22/2020
4/11/2020,297,2906,1905,18623,21529,29,391,11,119,2,32,240,61,48,12,82,281,2847,1710,16941,19788,10/22/2020
4/12/2020,314,3220,1670,20293,23513,35,426,13,132,5,37,257,59,49,9,91,284,3131,1425,18366,21497,10/22/2020
4/13/2020,161,3381,935,21228,24609,35,461,13,145,3,40,276,64,54,9,100,187,3318,835,19201,22519,10/22/2020
4/14/2020,289,3670,1787,23015,26685,27,488,17,162,5,45,281,72,53,8,108,262,3580,1522,20723,24303,10/22/2020
4/15/2020,351,4021,1799,24814,28835,31,519,20,182,3,48,289,72,54,17,125,306,3886,1541,22264,26150,10/22/2020
4/16/2020,447,4468,2494,27308,31776,36,555,25,207,6,54,294,72,53,14,139,387,4273,2066,24330,28603,10/22/2020
4/17/2020,304,4772,1821,29129,33901,32,587,20,227,7,61,299,66,45,21,160,290,4563,1439,25769,30332,10/22/2020
4/18/2020,321,5093,1725,30854,35947,26,613,18,245,4,65,303,63,49,15,175,284,4847,1316,27085,31932,10/22/2020
4/19/2020,381,5474,2047,32901,38375,23,636,26,271,1,66,299,65,55,11,186,336,5183,1728,28813,33996,10/22/2020
4/20/2020,394,5868,1907,34808,40676,46,682,29,300,2,68,314,75,56,10,196,376,5559,1563,30376,35935,10/22/2020
4/21/2020,444,6312,2110,36918,43230,45,727,33,333,5,73,321,72,56,18,214,385,5944,1693,32069,38013,10/22/2020
4/22/2020,418,6730,2390,39308,46038,41,768,32,365,5,78,325,73,58,18,232,379,6323,1904,33973,40296,10/22/2020
4/23/2020,479,7209,2469,41777,48986,32,800,28,393,5,83,324,76,62,15,247,412,6735,1843,35816,42551,10/22/2020
4/24/2020,491,7700,3284,45061,52761,35,835,26,419,4,87,329,85,63,15,262,407,7142,2609,38425,45567,10/22/2020
4/25/2020,393,8093,2206,47267,55360,34,869,17,436,5,92,341,85,62,14,276,300,7442,1754,40179,47621,10/22/2020
4/26/2020,316,8409,2309,49576,57985,33,902,15,451,3,95,356,86,59,14,290,274,7716,1864,42043,49759,10/22/2020
4/27/2020,249,8658,1620,51196,59854,29,931,21,472,4,99,360,86,61,10,300,206,7922,1155,43198,51120,10/22/2020
4/28/2020,410,9068,2263,53459,62527,44,975,24,496,3,102,377,88,59,22,322,331,8253,1749,44947,53200,10/22/2020
4/29/2020,476,9544,3343,56802,66346,36,1011,38,534,11,113,364,78,53,18,340,371,8624,2409,47356,55980,10/22/2020
4/30/2020,432,9976,2769,59571,69547,33,1044,38,572,6,119,353,83,57,24,364,350,8974,1900,49256,58230,10/22/2020
5/1/2020,454,10430,3086,62657,73087,51,1095,40,612,3,122,361,84,58,14,378,324,9298,2151,51407,60705,10/22/2020
5/2/2020,257,10687,1926,64583,75270,36,1131,37,649,5,127,355,91,62,24,402,192,9490,1261,52668,62158,10/22/2020
5/3/2020,283,10970,2160,66743,77713,31,1162,26,675,8,135,352,90,61,21,423,183,9673,1560,54228,63901,10/22/2020
5/4/2020,387,11357,2098,68841,80198,30,1192,31,706,6,141,345,88,57,18,441,290,9963,1553,55781,65744,10/22/2020
5/5/2020,433,11790,2873,71714,83504,29,1221,32,738,6,147,336,82,54,16,457,301,10264,1947,57728,67992,10/22/2020
5/6/2020,488,12278,2830,74544,86822,28,1249,44,782,9,156,311,79,54,21,478,340,10604,1908,59636,70240,10/22/2020
5/7/2020,425,12703,2969,77513,90216,36,1285,41,823,5,161,301,71,52,21,499,270,10874,1952,61588,72462,10/22/2020
5/8/2020,359,13062,2598,80111,93173,30,1315,29,852,5,166,297,71,53,22,521,229,11103,1732,63320,74423,10/22/2020
5/9/2020,467,13529,3346,83457,96986,22,1337,21,873,4,170,294,69,51,15,536,290,11393,2248,65568,76961,10/22/2020
5/10/2020,285,13814,2117,85574,99388,20,1357,23,896,6,176,285,70,49,13,549,189,11582,1514,67082,78664,10/22/2020
5/11/2020,257,14071,1857,87431,101502,31,1388,16,912,6,182,294,71,49,15,564,174,11756,1294,68376,80132,10/22/2020
5/12/2020,387,14458,2611,90042,104500,23,1411,18,930,4,186,295,69,48,22,586,224,11980,1695,70071,82051,10/22/2020
5/13/2020,351,14809,3630,93672,108481,23,1434,25,955,1,187,292,69,49,13,599,199,12179,1983,72054,84233,10/22/2020
5/14/2020,329,15138,3408,97080,112218,19,1453,27,982,3,190,281,64,45,15,614,231,12410,2010,74064,86474,10/22/2020
5/15/2020,381,15519,3458,100538,116057,24,1477,41,1023,5,195,259,62,45,14,628,232,12642,1800,75864,88506,10/22/2020
5/16/2020,449,15968,4156,104694,120662,25,1502,13,1036,5,200,266,61,46,15,643,247,12889,1949,77813,90702,10/22/2020
5/17/2020,240,16208,2768,107462,123670,17,1519,8,1044,5,205,270,59,45,10,653,126,13015,1537,79350,92365,10/22/2020
5/18/2020,250,16458,2001,109463,125921,19,1538,15,1059,5,210,269,57,40,18,671,135,13150,1365,80715,93865,10/22/2020
5/19/2020,415,16873,3168,112631,129504,23,1561,32,1091,5,215,255,56,38,11,682,215,13365,1917,82632,95997,10/22/2020
5/20/2020,326,17199,2771,115402,132601,19,1580,23,1114,7,222,244,52,33,22,704,183,13548,1509,84141,97689,10/22/2020
5/21/2020,374,17573,3757,119159,136732,26,1606,15,1129,3,225,252,53,29,20,724,168,13716,1932,86073,99789,10/22/2020
5/22/2020,351,17924,3161,122320,140244,20,1626,29,1158,5,230,238,52,29,11,735,206,13922,1604,87677,101599,10/22/2020
5/23/2020,253,18177,2742,125062,143239,19,1645,11,1169,3,233,243,52,32,13,748,109,14031,1265,88942,102973,10/22/2020
5/24/2020,163,18340,1370,126432,144772,13,1658,14,1183,2,235,240,53,36,8,756,83,14114,771,89713,103827,10/22/2020
5/25/2020,147,18487,1385,127817,146304,14,1672,14,1197,0,235,240,53,34,10,766,76,14190,761,90474,104664,10/22/2020
5/26/2020,285,18772,2620,130437,149209,24,1696,22,1219,5,240,237,48,33,15,781,158,14348,1776,92250,106598,10/22/2020
5/27/2020,276,19048,2057,132494,151542,20,1716,18,1237,3,243,236,50,33,10,791,132,14480,1130,93380,107860,10/22/2020
5/28/2020,348,19396,3359,135853,155249,17,1733,29,1266,4,247,220,47,32,8,799,130,14610,1114,94494,109104,10/22/2020
5/29/2020,410,19806,3915,139768,159574,19,1752,27,1293,6,253,206,43,31,12,811,174,14784,1570,96064,110848,10/22/2020
5/30/2020,225,20031,3915,143683,163714,16,1768,19,1312,4,257,199,41,29,12,823,109,14893,1817,97881,112774,10/22/2020
5/31/2020,155,20186,1689,145372,165558,11,1779,10,1322,1,258,199,44,26,3,826,78,14971,854,98735,113706,10/22/2020
6/1/2020,212,20398,2792,148164,168562,8,1787,14,1336,1,259,192,45,29,5,831,93,15064,1379,100114,115178,10/22/2020
6/2/2020,273,20671,3022,151186,171857,8,1795,9,1345,3,262,188,38,25,10,841,98,15162,1441,101555,116717,10/22/2020
6/3/2020,254,20925,3486,154672,175597,14,1809,18,1363,6,268,178,34,25,11,852,99,15261,1653,103208,118469,10/22/2020
6/4/2020,276,21201,4471,159143,180344,7,1816,25,1388,4,272,156,31,24,12,864,107,15368,2031,105239,120607,10/22/2020
6/5/2020,215,21416,3513,162656,184072,15,1831,13,1401,6,278,152,27,21,11,875,99,15467,1570,106809,122276,10/22/2020
6/6/2020,201,21617,2616,165272,186889,10,1841,7,1408,2,280,153,29,19,6,881,67,15534,1128,107937,123471,10/22/2020
6/7/2020,83,21700,1625,166897,188597,11,1852,7,1415,1,281,156,25,17,4,885,51,15585,780,108717,124302,10/22/2020
6/8/2020,119,21819,1849,168746,190565,15,1867,12,1427,2,283,157,27,18,4,889,45,15630,953,109670,125300,10/22/2020
6/9/2020,223,22042,2673,171419,193461,10,1877,18,1445,0,283,149,28,21,1,890,64,15694,1252,110922,126616,10/22/2020
6/10/2020,209,22251,2987,174406,196657,13,1890,12,1457,2,285,148,24,17,4,894,101,15795,1463,112385,128180,10/22/2020
6/11/2020,195,22446,3513,177919,200365,7,1897,15,1472,1,286,139,25,16,6,900,88,15883,1528,113913,129796,10/22/2020
6/12/2020,209,22655,4601,182520,205175,9,1906,15,1487,1,287,132,24,16,2,902,78,15961,2169,116082,132043,10/22/2020
6/13/2020,113,22768,3036,185556,208324,6,1912,5,1492,0,287,133,20,15,3,905,49,16010,1364,117446,133456,10/22/2020
6/14/2020,81,22849,2046,187602,210451,7,1919,8,1500,1,288,131,20,14,3,908,33,16043,963,118409,134452,10/22/2020
6/15/2020,188,23037,3108,190710,213747,14,1933,14,1514,0,288,131,20,16,5,913,75,16118,1786,120195,136313,10/22/2020
6/16/2020,110,23147,3017,193727,216874,11,1944,9,1523,1,289,132,22,16,8,921,50,16168,1558,121753,137921,10/22/2020
6/17/2020,127,23274,2835,196562,219836,15,1959,20,1543,4,293,123,18,14,6,927,50,16218,1315,123068,139286,10/22/2020
6/18/2020,149,23423,3048,199610,223033,9,1968,13,1556,1,294,118,19,16,7,934,70,16288,1310,124378,140666,10/22/2020
6/19/2020,141,23564,3769,203379,226943,12,1980,11,1567,1,295,118,20,17,3,937,59,16347,1363,125741,142088,10/22/2020
6/20/2020,84,23648,1891,205270,228918,9,1989,12,1579,0,295,115,20,18,4,941,36,16383,812,126553,142936,10/22/2020
6/21/2020,37,23685,1064,206334,230019,8,1997,5,1584,0,295,118,20,18,2,943,29,16412,690,127243,143655,10/22/2020
6/22/2020,138,23823,3730,210064,233887,12,2009,16,1600,0,295,114,19,18,2,945,65,16477,1701,128944,145421,10/22/2020
6/23/2020,163,23986,3831,213895,237881,3,2012,13,1613,3,298,101,18,18,7,952,81,16558,1774,130718,147276,10/22/2020
6/24/2020,120,24106,3502,217397,241503,9,2021,10,1623,1,299,99,18,18,5,957,44,16602,1678,132396,148998,10/22/2020
6/25/2020,103,24209,2883,220280,244489,6,2027,14,1637,1,300,90,17,17,1,958,50,16652,1504,133900,150552,10/22/2020
6/26/2020,94,24303,2488,222768,247071,2,2029,10,1647,0,300,82,18,18,1,959,60,16712,1328,135228,151940,10/22/2020
6/27/2020,84,24387,3216,225984,250371,5,2034,3,1650,1,301,83,17,17,5,964,37,16749,1217,136445,153194,10/22/2020
6/28/2020,39,24426,1469,227453,251879,4,2038,4,1654,4,305,79,15,14,6,970,17,16766,593,137038,153804,10/22/2020
6/29/2020,85,24511,3697,231150,255661,4,2042,5,1659,0,305,78,14,14,1,971,39,16805,1349,138387,155192,10/22/2020
6/30/2020,57,24568,1958,233108,257676,1,2043,5,1664,1,306,73,12,11,4,975,33,16838,994,139381,156219,10/22/2020
7/1/2020,144,24712,4098,237206,261918,8,2051,10,1674,0,306,71,11,11,1,976,79,16917,1924,141305,158222,10/22/2020
7/2/2020,103,24815,2803,240009,264824,5,2056,5,1679,1,307,70,10,10,3,979,59,16976,1083,142388,159364,10/22/2020
7/3/2020,50,24865,2078,242087,266952,9,2065,6,1685,0,307,73,9,9,3,982,25,17001,779,143167,160168,10/22/2020
7/4/2020,57,24922,2345,244432,269354,2,2067,4,1689,1,308,70,10,9,2,984,33,17034,1006,144173,161207,10/22/2020
7/5/2020,49,24971,2932,247364,272335,1,2068,2,1691,1,309,68,8,8,2,986,26,17060,1437,145610,162670,10/22/2020
7/6/2020,101,25072,2811,250175,275247,6,2074,6,1697,0,309,68,9,9,4,990,57,17117,1546,147156,164273,10/22/2020
7/7/2020,81,25153,3457,253632,278785,5,2079,7,1704,0,309,66,8,8,2,992,47,17164,1534,148690,165854,10/22/2020
7/8/2020,105,25258,3409,257041,282299,4,2083,2,1706,0,309,68,9,8,0,992,64,17228,1427,150117,167345,10/22/2020
7/9/2020,94,25352,3714,260755,286107,9,2092,3,1709,0,309,74,9,8,0,992,50,17278,1619,151736,169014,10/22/2020
7/10/2020,132,25484,4432,265187,290671,6,2098,3,1712,2,311,75,7,7,3,995,81,17359,2066,153802,171161,10/22/2020
7/11/2020,63,25547,2932,268119,293666,6,2104,3,1715,1,312,77,6,6,3,998,36,17395,1313,155115,172510,10/22/2020
7/12/2020,47,25594,1837,269956,295550,1,2105,3,1718,1,313,74,6,5,3,1001,34,17429,942,156057,173486,10/22/2020
7/13/2020,84,25678,3201,273157,298835,8,2113,10,1728,0,313,72,6,5,1,1002,61,17490,1502,157559,175049,10/22/2020
7/14/2020,73,25751,3293,276450,302201,7,2120,4,1732,0,313,75,5,5,1,1003,43,17533,1372,158931,176464,10/22/2020
7/15/2020,130,25881,4173,280623,306504,5,2125,7,1739,0,313,73,5,4,0,1003,99,17632,1746,160677,178309,10/22/2020
7/16/2020,102,25983,3734,284357,310340,6,2131,9,1748,0,313,70,6,5,1,1004,75,17707,1613,162290,179997,10/22/2020
7/17/2020,156,26139,4236,288593,314732,14,2145,3,1751,1,314,80,5,5,2,1006,79,17786,1842,164132,181918,10/22/2020
7/18/2020,85,26224,3269,291862,318086,5,2150,9,1760,1,315,75,5,4,4,1010,70,17856,1395,165527,183383,10/22/2020
7/19/2020,82,26306,2694,294556,320862,7,2157,3,1763,0,315,79,6,4,2,1012,57,17913,1148,166675,184588,10/22/2020
7/20/2020,71,26377,2664,297220,323597,9,2166,7,1770,0,315,81,7,5,2,1014,68,17981,1455,168130,186111,10/22/2020
7/21/2020,130,26507,4299,301519,328026,9,2175,11,1781,0,315,79,9,6,1,1015,109,18090,1911,170041,188131,10/22/2020
7/22/2020,130,26637,3927,305446,332083,11,2186,11,1792,1,316,78,7,6,1,1016,86,18176,1681,171722,189898,10/22/2020
7/23/2020,141,26778,4413,309859,336637,8,2194,6,1798,0,316,80,8,7,0,1016,115,18291,1978,173700,191991,10/22/2020
7/24/2020,172,26950,5961,315820,342770,14,2208,14,1812,0,316,80,9,7,0,1016,119,18410,2313,176013,194423,10/22/2020
7/25/2020,134,27084,4399,320219,347303,7,2215,7,1819,0,316,80,10,8,3,1019,108,18518,2092,178105,196623,10/22/2020
7/26/2020,62,27146,3027,323246,350392,8,2223,9,1828,0,316,79,11,7,1,1020,54,18572,1333,179438,198010,10/22/2020
7/27/2020,188,27334,4190,327436,354770,12,2235,7,1835,0,316,84,13,8,1,1021,138,18710,2341,181779,200489,10/22/2020
7/28/2020,106,27440,3834,331270,358710,5,2240,5,1840,0,316,84,14,7,1,1022,95,18805,1632,183411,202216,10/22/2020
7/29/2020,191,27631,5137,336407,364038,11,2251,12,1852,0,316,83,15,7,0,1022,154,18959,2313,185724,204683,10/22/2020
7/30/2020,121,27752,4344,340751,368503,6,2257,2,1854,1,317,86,15,6,1,1023,97,19056,1644,187368,206424,10/22/2020
7/31/2020,131,27883,5509,346260,374143,8,2265,10,1864,0,317,84,15,7,1,1024,89,19145,1846,189214,208359,10/22/2020
8/1/2020,108,27991,4292,350552,378543,7,2272,2,1866,0,317,89,14,7,1,1025,88,19233,1559,190773,210006,10/22/2020
8/2/2020,84,28075,2802,353354,381429,12,2284,12,1878,2,319,87,14,8,2,1027,62,19295,1269,192042,211337,10/22/2020
8/3/2020,187,28262,5238,358592,386854,13,2297,12,1890,0,319,88,16,7,1,1028,150,19445,2195,194237,213682,10/22/2020
8/4/2020,126,28388,3691,362283,390671,9,2306,6,1896,1,320,90,12,5,2,1030,99,19544,1769,196006,215550,10/22/2020
8/5/2020,148,28536,5934,368217,396753,12,2318,10,1906,1,321,91,10,5,2,1032,118,19662,2467,198473,218135,10/22/2020
8/6/2020,169,28705,5533,373750,402455,7,2325,9,1915,0,321,89,9,4,0,1032,121,19783,2400,200873,220656,10/22/2020
8/7/2020,122,28827,4847,378597,407424,13,2338,10,1925,1,322,91,9,3,2,1034,87,19870,2140,203013,222883,10/22/2020
8/8/2020,123,28950,4107,382704,411654,19,2357,6,1931,1,323,103,8,3,1,1035,92,19962,1777,204790,224752,10/22/2020
8/9/2020,42,28992,1722,384426,413418,8,2365,10,1941,0,323,101,9,4,0,1035,35,19997,1070,205860,225857,10/22/2020
8/10/2020,149,29141,4584,389010,418151,11,2376,12,1953,0,323,100,9,4,1,1036,113,20110,2019,207879,227989,10/22/2020
8/11/2020,105,29246,4329,393339,422585,6,2382,14,1967,0,323,92,10,4,3,1039,92,20202,2262,210141,230343,10/22/2020
8/12/2020,121,29367,5184,398523,427890,8,2390,11,1978,0,323,89,9,3,1,1040,101,20303,2622,212763,233066,10/22/2020
8/13/2020,135,29502,4192,402715,432217,13,2403,12,1990,0,323,90,11,3,0,1040,95,20398,1898,214661,235059,10/22/2020
8/14/2020,145,29647,5494,408209,437856,13,2416,11,2001,0,323,92,11,4,3,1043,99,20497,1971,216632,237129,10/22/2020
8/15/2020,105,29752,4533,412742,442494,9,2425,11,2012,1,324,89,11,5,0,1043,89,20586,1688,218320,238906,10/22/2020
8/16/2020,83,29835,2472,415214,445049,7,2432,6,2018,4,328,86,8,4,6,1049,70,20656,961,219281,239937,10/22/2020
8/17/2020,106,29941,4570,419784,449725,10,2442,7,2025,0,328,89,8,5,2,1051,88,20744,2390,221671,242415,10/22/2020
8/18/2020,128,30069,4904,424688,454757,11,2453,9,2034,1,329,90,8,4,5,1056,94,20838,2748,224419,245257,10/22/2020
8/19/2020,113,30182,5065,429753,459935,8,2461,9,2043,1,330,88,9,5,0,1056,90,20928,2641,227060,247988,10/22/2020
8/20/2020,173,30355,7405,437158,467513,12,2473,6,2049,2,332,92,10,5,3,1059,139,21067,3514,230574,251641,10/22/2020
8/21/2020,151,30506,6571,443729,474235,8,2481,5,2054,1,333,94,9,4,2,1061,125,21192,2945,233519,254711,10/22/2020
8/22/2020,96,30602,5547,449276,479878,10,2491,12,2066,0,333,92,11,4,1,1062,84,21276,2604,236123,257399,10/22/2020
8/23/2020,70,30672,4370,453646,484318,11,2502,6,2072,0,333,97,11,2,1,1063,56,21332,2470,238593,259925,10/22/2020
8/24/2020,105,30777,5776,459422,490199,7,2509,10,2082,1,334,93,13,4,1,1064,77,21409,3151,241744,263153,10/22/2020
8/25/2020,108,30885,4759,464181,495066,10,2519,4,2086,1,335,98,11,4,1,1065,92,21501,2289,244033,265534,10/22/2020
8/26/2020,170,31055,9477,473658,504713,4,2523,8,2094,0,335,94,9,5,1,1066,127,21628,3085,247118,268746,10/22/2020
8/27/2020,92,31147,8564,482222,513369,6,2529,13,2107,1,336,86,6,5,2,1068,70,21698,3164,250282,271980,10/22/2020
8/28/2020,112,31259,7991,490213,521472,14,2543,4,2111,0,336,96,9,7,2,1070,87,21785,2431,252713,274498,10/22/2020
8/29/2020,65,31324,5368,495581,526905,6,2549,8,2119,1,337,93,10,6,2,1072,51,21836,1912,254625,276461,10/22/2020
8/30/2020,66,31390,4320,499901,531291,7,2556,4,2123,0,337,96,8,5,2,1074,48,21884,1993,256618,278502,10/22/2020
8/31/2020,105,31495,4863,504764,536259,12,2568,15,2138,0,337,93,8,4,1,1075,81,21965,2186,258804,280769,10/22/2020
9/1/2020,98,31593,7109,511873,543466,6,2574,9,2147,1,338,89,7,4,2,1077,65,22030,2379,261183,283213,10/22/2020
9/2/2020,125,31718,10524,522397,554115,9,2583,10,2157,1,339,87,8,4,2,1079,104,22134,3054,264237,286371,10/22/2020
9/3/2020,90,31808,11065,533462,565270,8,2591,8,2165,0,339,87,9,4,3,1082,73,22207,2584,266821,289028,10/22/2020
9/4/2020,102,31910,8953,542415,574325,11,2602,4,2169,0,339,94,9,4,1,1083,83,22290,2370,269191,291481,10/22/2020
9/5/2020,52,31962,6301,548716,580678,6,2608,9,2178,0,339,91,8,3,1,1084,42,22332,1601,270792,293124,10/22/2020
9/6/2020,87,32049,4317,553033,585082,4,2612,8,2186,1,340,86,6,3,1,1085,64,22396,1949,272741,295137,10/22/2020
9/7/2020,35,32084,3001,556034,588118,11,2623,3,2189,0,340,94,5,3,1,1086,26,22422,646,273387,295809,10/22/2020
9/8/2020,74,32158,6375,562409,594567,6,2629,12,2201,1,341,87,6,3,2,1088,66,22488,1601,274988,297476,10/22/2020
9/9/2020,118,32276,8641,571050,603326,9,2638,5,2206,1,342,90,9,3,1,1089,102,22590,2145,277133,299723,10/22/2020
9/10/2020,164,32440,11327,582377,614817,9,2647,8,2214,0,342,91,10,3,1,1090,111,22701,2275,279408,302109,10/22/2020
9/11/2020,121,32561,9449,591826,624387,11,2658,11,2225,0,342,91,10,5,0,1090,98,22799,1971,281379,304178,10/22/2020
9/12/2020,109,32670,6160,597986,630656,8,2666,5,2230,2,344,92,9,5,3,1093,97,22896,1522,282901,305797,10/22/2020
9/13/2020,58,32728,2710,600696,633424,4,2670,3,2233,0,344,93,10,5,0,1093,54,22950,858,283759,306709,10/22/2020
9/14/2020,104,32832,6433,607129,639961,5,2675,3,2236,2,346,93,10,5,1,1094,95,23045,1737,285496,308541,10/22/2020
9/15/2020,122,32954,8462,615591,648545,7,2682,2,2238,1,347,97,10,5,2,1096,124,23169,2204,287700,310869,10/22/2020
9/16/2020,137,33091,9711,625302,658393,7,2689,7,2245,2,349,95,9,6,5,1101,118,23287,1979,289679,312966,10/22/2020
9/17/2020,124,33215,9233,634535,667750,7,2696,14,2259,0,349,88,8,4,0,1101,154,23441,1958,291637,315078,10/22/2020
9/18/2020,132,33347,10034,644569,677916,7,2703,7,2266,1,350,87,11,6,2,1103,132,23573,1937,293574,317147,10/22/2020
9/19/2020,116,33463,8296,652865,686328,7,2710,3,2269,0,350,91,10,6,4,1107,112,23685,1698,295272,318957,10/22/2020
9/20/2020,60,33523,3668,656533,690056,7,2717,6,2275,2,352,90,9,8,4,1111,48,23733,1325,296597,320330,10/22/2020
9/21/2020,103,33626,7015,663548,697174,12,2729,3,2278,2,354,97,8,6,2,1113,94,23827,2416,299013,322840,10/22/2020
9/22/2020,154,33780,9282,672830,706610,12,2741,3,2281,1,355,105,7,5,1,1114,125,23952,2211,301224,325176,10/22/2020
9/23/2020,136,33916,10638,683468,717384,12,2753,7,2288,0,355,110,6,5,0,1114,127,24079,2221,303445,327524,10/22/2020
9/24/2020,119,34035,12464,695932,729967,7,2760,9,2297,1,356,107,7,5,1,1115,120,24199,3171,306616,330815,10/22/2020
9/25/2020,149,34184,10541,706473,740657,9,2769,10,2307,0,356,106,6,5,1,1116,141,24340,3019,309635,333975,10/22/2020
9/26/2020,146,34330,10549,717022,751352,11,2780,9,2316,0,356,108,6,5,1,1117,119,24459,2431,312066,336525,10/22/2020
9/27/2020,43,34373,2761,719783,754156,7,2787,5,2321,0,356,110,8,5,0,1117,34,24493,847,312913,337406,10/22/2020
9/28/2020,151,34524,7299,727082,761606,6,2793,6,2327,2,358,108,6,5,2,1119,132,24625,2264,315177,339802,10/22/2020
9/29/2020,208,34732,11033,738115,772847,11,2804,18,2345,1,359,100,5,6,1,1120,190,24815,2832,318009,342824,10/22/2020
9/30/2020,221,34953,12217,750332,785285,6,2810,6,2351,0,359,100,5,6,1,1121,186,25001,2605,320614,345615,10/22/2020
10/1/2020,184,35137,12493,762825,797962,16,2826,13,2364,1,360,102,4,4,2,1123,164,25165,2436,323050,348215,10/22/2020
10/2/2020,209,35346,12134,774959,810305,13,2839,13,2377,1,361,101,5,4,2,1125,181,25346,2508,325558,350904,10/22/2020
10/3/2020,157,35503,9314,784273,819776,9,2848,9,2386,2,363,99,6,4,2,1127,133,25479,2036,327594,353073,10/22/2020
10/4/2020,81,35584,2365,786638,822222,11,2859,9,2395,1,364,100,5,4,2,1129,75,25554,962,328556,354110,10/22/2020
10/5/2020,174,35758,8959,795597,831355,29,2888,10,2405,2,366,117,7,5,4,1133,160,25714,3043,331599,357313,10/22/2020
10/6/2020,176,35934,11171,806768,842702,11,2899,4,2409,0,366,124,9,5,0,1133,188,25902,2912,334511,360413,10/22/2020
10/7/2020,228,36162,12421,819189,855351,13,2912,14,2423,2,368,121,7,5,2,1135,243,26145,3547,338058,364203,10/22/2020
10/8/2020,263,36425,15183,834372,870797,16,2928,12,2435,1,369,124,6,4,3,1138,274,26419,4204,342262,368681,10/22/2020
10/9/2020,214,36639,13212,847584,884223,20,2948,12,2447,0,369,132,9,6,3,1141,198,26617,4316,346578,373195,10/22/2020
10/10/2020,230,36869,13821,861405,898274,17,2965,10,2457,1,370,138,12,6,2,1143,198,26815,3832,350410,377225,10/22/2020
10/11/2020,94,36963,3252,864657,901620,12,2977,9,2466,1,371,140,13,4,6,1149,87,26902,1165,351575,378477,10/22/2020
10/12/2020,165,37128,6411,871068,908196,17,2994,15,2481,2,373,140,13,4,4,1153,159,27061,1752,353327,380388,10/22/2020
10/13/2020,210,37338,8484,879552,916890,14,3008,13,2494,4,377,137,12,4,7,1160,206,27267,2314,355641,382908,10/22/2020
10/14/2020,320,37658,14998,894550,932208,15,3023,7,2501,0,377,145,14,4,2,1162,309,27576,4070,359711,387287,10/22/2020
10/15/2020,263,37921,14578,909128,947049,9,3032,16,2517,1,378,137,12,4,2,1164,255,27831,3593,363304,391135,10/22/2020
10/16/2020,274,38195,14943,924071,962266,13,3045,18,2535,0,378,132,13,4,2,1166,268,28099,3408,366712,394811,10/22/2020
10/17/2020,348,38543,13980,938051,976594,17,3062,11,2546,1,379,137,16,4,2,1168,300,28399,3268,369980,398379,10/22/2020
10/18/2020,137,38680,3770,941821,980501,17,3079,11,2557,0,379,143,16,6,1,1169,121,28520,1202,371182,399702,10/22/2020
10/19/2020,336,39016,7602,949423,988439,19,3098,22,2579,2,381,138,14,6,1,1170,307,28827,2160,373342,402169,10/22/2020
10/20/2020,359,39375,12006,961429,1000804,18,3116,16,2595,0,381,140,13,8,1,1171,369,29196,2456,375798,404994,10/22/2020
10/21/2020,441,39816,14475,975904,1015720,,,,,,,,,,2,1173,398,29594,2910,378708,408302,10/22/2020
2/27/2020,0,0,0,0,0,1,1,0,0,0,0,1,0,0,0,0,0,0,0,0,0,10/23/2020
2/28/2020,0,0,0,0,0,0,1,0,0,0,0,1,1,0,0,0,0,0,0,0,0,10/23/2020
2/29/2020,0,0,0,0,0,0,1,0,0,0,0,1,1,0,0,0,0,0,0,0,0,10/23/2020
3/1/2020,2,2,2,2,4,0,1,0,0,0,0,1,1,1,0,0,2,2,2,2,4,10/23/2020
3/2/2020,0,2,1,3,5,1,2,0,0,0,0,2,2,2,0,0,0,2,1,3,5,10/23/2020
3/3/2020,0,2,2,5,7,0,2,0,0,0,0,2,2,2,0,0,0,2,2,5,7,10/23/2020
3/4/2020,0,2,12,17,19,1,3,0,0,0,0,3,2,2,0,0,0,2,10,15,17,10/23/2020
3/5/2020,0,2,4,21,23,0,3,0,0,0,0,3,2,2,0,0,1,3,4,19,22,10/23/2020
3/6/2020,1,3,12,33,36,0,3,0,0,0,0,3,2,2,0,0,0,3,11,30,33,10/23/2020
3/7/2020,0,3,19,52,55,0,3,0,0,0,0,3,2,1,0,0,0,3,19,49,52,10/23/2020
3/8/2020,0,3,18,70,73,0,3,0,0,0,0,3,2,1,0,0,0,3,18,67,70,10/23/2020
3/9/2020,1,4,15,85,89,0,3,0,0,0,0,3,2,1,0,0,1,4,15,82,86,10/23/2020
3/10/2020,2,6,25,110,116,0,3,0,0,0,0,3,2,1,0,0,1,5,23,105,110,10/23/2020
3/11/2020,0,6,34,144,150,1,4,0,0,0,0,4,1,1,0,0,0,5,34,139,144,10/23/2020
3/12/2020,9,15,41,185,200,1,5,0,0,0,0,5,1,1,0,0,8,13,38,177,190,10/23/2020
3/13/2020,6,21,50,235,256,4,9,1,1,0,0,8,1,1,0,0,6,19,48,225,244,10/23/2020
3/14/2020,0,21,90,325,346,0,9,0,1,0,0,8,1,1,0,0,0,19,86,311,330,10/23/2020
3/15/2020,1,22,54,379,401,1,10,0,1,0,0,9,2,1,0,0,1,20,54,365,385,10/23/2020
3/16/2020,2,24,95,474,498,2,12,0,1,0,0,11,2,0,0,0,2,22,92,457,479,10/23/2020
3/17/2020,12,36,162,636,672,6,18,0,1,0,0,17,2,0,0,0,11,33,151,608,641,10/23/2020
3/18/2020,9,45,116,752,797,3,21,0,1,0,0,20,2,0,0,0,11,44,110,718,762,10/23/2020
3/19/2020,15,60,262,1014,1074,2,23,1,2,0,0,21,3,0,1,1,17,61,249,967,1028,10/23/2020
3/20/2020,13,73,197,1211,1284,5,28,0,2,0,0,26,4,0,0,1,13,74,190,1157,1231,10/23/2020
3/21/2020,12,85,126,1337,1422,3,31,2,4,0,0,27,5,0,0,1,14,88,122,1279,1367,10/23/2020
3/22/2020,27,112,282,1619,1731,2,33,0,4,0,0,29,5,0,0,1,25,113,260,1539,1652,10/23/2020
3/23/2020,14,126,169,1788,1914,15,48,1,5,0,0,43,9,3,0,1,16,129,164,1703,1832,10/23/2020
3/24/2020,20,146,242,2030,2176,7,55,0,5,0,0,50,10,4,0,1,19,148,234,1937,2085,10/23/2020
3/25/2020,26,172,182,2212,2384,5,60,1,6,0,0,54,11,3,0,1,28,176,170,2107,2283,10/23/2020
3/26/2020,35,207,181,2393,2600,10,70,5,11,0,0,59,14,5,0,1,41,217,173,2280,2497,10/23/2020
3/27/2020,27,234,214,2607,2841,9,79,1,12,1,1,66,17,6,2,3,31,248,200,2480,2728,10/23/2020
3/28/2020,59,293,260,2867,3160,13,92,3,15,2,3,74,15,6,1,4,64,312,240,2720,3032,10/23/2020
3/29/2020,100,393,350,3217,3610,8,100,4,19,1,4,77,18,8,2,6,105,417,312,3032,3449,10/23/2020
3/30/2020,62,455,222,3439,3894,20,120,5,24,0,4,92,20,11,3,9,78,495,184,3216,3711,10/23/2020
3/31/2020,71,526,369,3808,4334,11,131,7,31,1,5,95,22,13,2,11,73,568,294,3510,4078,10/23/2020
4/1/2020,99,625,698,4506,5131,18,149,7,38,0,5,106,30,15,1,12,100,668,639,4149,4817,10/23/2020
4/2/2020,52,677,477,4983,5660,22,171,6,44,2,7,120,36,21,4,16,62,730,433,4582,5312,10/23/2020
4/3/2020,108,785,774,5757,6542,23,194,7,51,0,7,136,43,25,3,19,100,830,705,5287,6117,10/23/2020
4/4/2020,143,928,660,6417,7345,22,216,4,55,5,12,149,41,30,9,28,138,968,614,5901,6869,10/23/2020
4/5/2020,187,1115,1156,7573,8688,20,236,9,64,1,13,159,44,36,2,30,181,1149,1056,6957,8106,10/23/2020
4/6/2020,218,1333,1706,9279,10612,26,262,7,71,0,13,178,48,40,7,37,207,1356,1542,8499,9855,10/23/2020
4/7/2020,284,1617,1629,10908,12525,20,282,5,76,2,15,191,50,42,5,42,261,1617,1471,9970,11587,10/23/2020
4/8/2020,290,1907,1720,12628,14535,19,301,7,83,6,21,197,50,38,10,52,271,1888,1545,11515,13403,10/23/2020
4/9/2020,283,2190,1516,14144,16334,32,333,9,92,4,25,216,53,40,7,59,277,2165,1349,12864,15029,10/23/2020
4/10/2020,419,2609,2574,16718,19327,29,362,16,108,5,30,224,59,41,11,70,401,2566,2357,15221,17787,10/23/2020
4/11/2020,297,2906,1905,18623,21529,29,391,11,119,2,32,240,61,48,12,82,281,2847,1709,16930,19777,10/23/2020
4/12/2020,314,3220,1670,20293,23513,35,426,13,132,5,37,257,59,49,9,91,284,3131,1424,18354,21485,10/23/2020
4/13/2020,161,3381,935,21228,24609,35,461,13,145,3,40,276,64,54,9,100,187,3318,835,19189,22507,10/23/2020
4/14/2020,289,3670,1787,23015,26685,27,488,17,162,5,45,281,72,53,8,108,262,3580,1521,20710,24290,10/23/2020
4/15/2020,351,4021,1799,24814,28835,31,519,20,182,3,48,289,72,54,17,125,306,3886,1540,22250,26136,10/23/2020
4/16/2020,447,4468,2494,27308,31776,36,555,25,207,6,54,294,72,53,14,139,387,4273,2066,24316,28589,10/23/2020
4/17/2020,304,4772,1821,29129,33901,32,587,20,227,7,61,299,66,45,21,160,290,4563,1436,25752,30315,10/23/2020
4/18/2020,321,5093,1725,30854,35947,26,613,18,245,4,65,303,63,49,15,175,284,4847,1315,27067,31914,10/23/2020
4/19/2020,381,5474,2047,32901,38375,23,636,26,271,1,66,299,65,55,11,186,336,5183,1728,28795,33978,10/23/2020
4/20/2020,394,5868,1907,34808,40676,46,682,29,300,2,68,314,75,56,10,196,376,5559,1563,30358,35917,10/23/2020
4/21/2020,444,6312,2110,36918,43230,45,727,33,333,5,73,321,72,56,18,214,385,5944,1690,32048,37992,10/23/2020
4/22/2020,418,6730,2390,39308,46038,41,768,32,365,5,78,325,73,58,18,232,379,6323,1903,33951,40274,10/23/2020
4/23/2020,479,7209,2469,41777,48986,32,800,28,393,5,83,324,76,62,15,247,412,6735,1842,35793,42528,10/23/2020
4/24/2020,491,7700,3284,45061,52761,35,835,26,419,4,87,329,85,63,15,262,407,7142,2607,38400,45542,10/23/2020
4/25/2020,393,8093,2206,47267,55360,34,869,17,436,5,92,341,85,62,14,276,300,7442,1753,40153,47595,10/23/2020
4/26/2020,316,8409,2309,49576,57985,33,902,15,451,3,95,356,86,59,14,290,274,7716,1861,42014,49730,10/23/2020
4/27/2020,249,8658,1620,51196,59854,29,931,21,472,4,99,360,86,61,10,300,206,7922,1154,43168,51090,10/23/2020
4/28/2020,410,9068,2263,53459,62527,44,975,24,496,3,102,377,88,59,22,322,332,8254,1748,44916,53170,10/23/2020
4/29/2020,476,9544,3343,56802,66346,36,1011,38,534,11,113,364,78,53,18,340,371,8625,2406,47322,55947,10/23/2020
4/30/2020,432,9976,2769,59571,69547,33,1044,38,572,6,119,353,83,57,24,364,350,8975,1898,49220,58195,10/23/2020
5/1/2020,454,10430,3086,62657,73087,51,1095,39,611,3,122,362,84,58,14,378,324,9299,2148,51368,60667,10/23/2020
5/2/2020,257,10687,1926,64583,75270,36,1131,38,649,5,127,355,91,62,24,402,192,9491,1259,52627,62118,10/23/2020
5/3/2020,283,10970,2160,66743,77713,31,1162,26,675,8,135,352,90,61,21,423,183,9674,1559,54186,63860,10/23/2020
5/4/2020,387,11357,2098,68841,80198,30,1192,31,706,6,141,345,88,57,18,441,290,9964,1551,55737,65701,10/23/2020
5/5/2020,433,11790,2873,71714,83504,29,1221,32,738,6,147,336,82,54,16,457,301,10265,1946,57683,67948,10/23/2020
5/6/2020,488,12278,2830,74544,86822,28,1249,44,782,9,156,311,79,54,21,478,340,10605,1907,59590,70195,10/23/2020
5/7/2020,425,12703,2969,77513,90216,36,1285,41,823,5,161,301,71,52,21,499,270,10875,1950,61540,72415,10/23/2020
5/8/2020,359,13062,2598,80111,93173,30,1315,29,852,5,166,297,71,53,22,521,229,11104,1731,63271,74375,10/23/2020
5/9/2020,467,13529,3346,83457,96986,22,1337,21,873,4,170,294,69,51,15,536,290,11394,2244,65515,76909,10/23/2020
5/10/2020,285,13814,2117,85574,99388,20,1357,23,896,6,176,285,70,49,14,550,189,11583,1512,67027,78610,10/23/2020
5/11/2020,257,14071,1857,87431,101502,31,1388,16,912,6,182,294,71,49,15,565,174,11757,1293,68320,80077,10/23/2020
5/12/2020,387,14458,2611,90042,104500,23,1411,18,930,4,186,295,69,48,22,587,224,11981,1693,70013,81994,10/23/2020
5/13/2020,351,14809,3630,93672,108481,23,1434,25,955,1,187,292,69,49,13,600,199,12180,1957,71970,84150,10/23/2020
5/14/2020,329,15138,3408,97080,112218,19,1453,27,982,3,190,281,64,45,15,615,231,12411,2007,73977,86388,10/23/2020
5/15/2020,381,15519,3458,100538,116057,24,1477,41,1023,5,195,259,62,45,14,629,232,12643,1797,75774,88417,10/23/2020
5/16/2020,449,15968,4156,104694,120662,25,1502,13,1036,5,200,266,61,46,15,644,247,12890,1944,77718,90608,10/23/2020
5/17/2020,240,16208,2768,107462,123670,17,1519,8,1044,5,205,270,59,45,10,654,126,13016,1531,79249,92265,10/23/2020
5/18/2020,250,16458,2001,109463,125921,19,1538,15,1059,5,210,269,57,40,18,672,135,13151,1365,80614,93765,10/23/2020
5/19/2020,415,16873,3168,112631,129504,23,1561,32,1091,5,215,255,56,38,11,683,215,13366,1915,82529,95895,10/23/2020
5/20/2020,326,17199,2771,115402,132601,19,1580,23,1114,7,222,244,52,33,22,705,183,13549,1509,84038,97587,10/23/2020
5/21/2020,374,17573,3757,119159,136732,26,1606,15,1129,3,225,252,53,29,20,725,168,13717,1929,85967,99684,10/23/2020
5/22/2020,351,17924,3161,122320,140244,20,1626,29,1158,5,230,238,52,29,11,736,206,13923,1602,87569,101492,10/23/2020
5/23/2020,253,18177,2742,125062,143239,19,1645,11,1169,3,233,243,52,32,13,749,109,14032,1265,88834,102866,10/23/2020
5/24/2020,163,18340,1370,126432,144772,13,1658,14,1183,2,235,240,53,36,8,757,83,14115,770,89604,103719,10/23/2020
5/25/2020,147,18487,1385,127817,146304,14,1672,14,1197,0,235,240,53,34,10,767,76,14191,761,90365,104556,10/23/2020
5/26/2020,285,18772,2620,130437,149209,24,1696,22,1219,5,240,237,48,33,15,782,158,14349,1776,92141,106490,10/23/2020
5/27/2020,276,19048,2057,132494,151542,20,1716,18,1237,3,243,236,50,33,10,792,132,14481,1129,93270,107751,10/23/2020
5/28/2020,348,19396,3359,135853,155249,17,1733,29,1266,4,247,220,47,32,8,800,130,14611,1113,94383,108994,10/23/2020
5/29/2020,410,19806,3915,139768,159574,19,1752,27,1293,6,253,206,43,31,12,812,174,14785,1570,95953,110738,10/23/2020
5/30/2020,225,20031,3915,143683,163714,16,1768,19,1312,4,257,199,41,29,12,824,109,14894,1815,97768,112662,10/23/2020
5/31/2020,155,20186,1689,145372,165558,11,1779,10,1322,1,258,199,44,26,3,827,78,14972,854,98622,113594,10/23/2020
6/1/2020,212,20398,2792,148164,168562,8,1787,14,1336,1,259,192,45,29,5,832,93,15065,1378,100000,115065,10/23/2020
6/2/2020,273,20671,3022,151186,171857,8,1795,9,1345,3,262,188,38,25,10,842,98,15163,1439,101439,116602,10/23/2020
6/3/2020,254,20925,3486,154672,175597,14,1809,18,1363,6,268,178,34,25,11,853,99,15262,1651,103090,118352,10/23/2020
6/4/2020,276,21201,4471,159143,180344,7,1816,25,1388,4,272,156,31,24,12,865,107,15369,2029,105119,120488,10/23/2020
6/5/2020,215,21416,3513,162656,184072,15,1831,13,1401,6,278,152,27,21,11,876,99,15468,1569,106688,122156,10/23/2020
6/6/2020,201,21617,2616,165272,186889,10,1841,7,1408,2,280,153,29,19,6,882,67,15535,1127,107815,123350,10/23/2020
6/7/2020,83,21700,1625,166897,188597,11,1852,7,1415,1,281,156,25,17,4,886,51,15586,780,108595,124181,10/23/2020
6/8/2020,119,21819,1849,168746,190565,15,1867,12,1427,2,283,157,27,18,4,890,45,15631,953,109548,125179,10/23/2020
6/9/2020,223,22042,2673,171419,193461,10,1877,18,1445,0,283,149,28,21,1,891,64,15695,1250,110798,126493,10/23/2020
6/10/2020,209,22251,2987,174406,196657,13,1890,12,1457,2,285,148,24,17,4,895,101,15796,1463,112261,128057,10/23/2020
6/11/2020,195,22446,3513,177919,200365,7,1897,15,1472,1,286,139,25,16,6,901,88,15884,1527,113788,129672,10/23/2020
6/12/2020,209,22655,4601,182520,205175,9,1906,15,1487,1,287,132,24,16,2,903,78,15962,2167,115955,131917,10/23/2020
6/13/2020,113,22768,3036,185556,208324,6,1912,5,1492,0,287,133,20,15,3,906,49,16011,1364,117319,133330,10/23/2020
6/14/2020,81,22849,2046,187602,210451,7,1919,8,1500,1,288,131,20,14,3,909,33,16044,963,118282,134326,10/23/2020
6/15/2020,188,23037,3108,190710,213747,14,1933,14,1514,0,288,131,20,16,5,914,75,16119,1781,120063,136182,10/23/2020
6/16/2020,110,23147,3017,193727,216874,11,1944,9,1523,1,289,132,22,16,8,922,50,16169,1541,121604,137773,10/23/2020
6/17/2020,127,23274,2835,196562,219836,15,1959,20,1543,4,293,123,18,14,6,928,50,16219,1315,122919,139138,10/23/2020
6/18/2020,149,23423,3048,199610,223033,9,1968,13,1556,1,294,118,19,16,7,935,70,16289,1310,124229,140518,10/23/2020
6/19/2020,141,23564,3769,203379,226943,12,1980,11,1567,1,295,118,20,17,3,938,59,16348,1360,125589,141937,10/23/2020
6/20/2020,84,23648,1891,205270,228918,9,1989,12,1579,0,295,115,20,18,4,942,36,16384,812,126401,142785,10/23/2020
6/21/2020,37,23685,1064,206334,230019,8,1997,5,1584,0,295,118,20,18,2,944,29,16413,689,127090,143503,10/23/2020
6/22/2020,138,23823,3730,210064,233887,12,2009,16,1600,0,295,114,19,18,2,946,65,16478,1700,128790,145268,10/23/2020
6/23/2020,163,23986,3831,213895,237881,3,2012,13,1613,3,298,101,18,18,7,953,81,16559,1773,130563,147122,10/23/2020
6/24/2020,120,24106,3502,217397,241503,9,2021,10,1623,1,299,99,18,18,5,958,44,16603,1677,132240,148843,10/23/2020
6/25/2020,103,24209,2883,220280,244489,6,2027,14,1637,1,300,90,17,17,1,959,50,16653,1500,133740,150393,10/23/2020
6/26/2020,94,24303,2488,222768,247071,2,2029,10,1647,0,300,82,18,18,1,960,60,16713,1327,135067,151780,10/23/2020
6/27/2020,84,24387,3216,225984,250371,5,2034,3,1650,1,301,83,17,17,5,965,37,16750,1216,136283,153033,10/23/2020
6/28/2020,39,24426,1469,227453,251879,4,2038,4,1654,4,305,79,15,14,6,971,17,16767,593,136876,153643,10/23/2020
6/29/2020,85,24511,3697,231150,255661,4,2042,5,1659,0,305,78,14,14,1,972,39,16806,1348,138224,155030,10/23/2020
6/30/2020,57,24568,1958,233108,257676,1,2043,5,1664,1,306,73,12,11,4,976,33,16839,994,139218,156057,10/23/2020
7/1/2020,144,24712,4098,237206,261918,8,2051,10,1674,0,306,71,11,11,1,977,79,16918,1922,141140,158058,10/23/2020
7/2/2020,103,24815,2803,240009,264824,5,2056,5,1679,1,307,70,10,10,3,980,59,16977,1082,142222,159199,10/23/2020
7/3/2020,50,24865,2078,242087,266952,9,2065,6,1685,0,307,73,9,9,3,983,25,17002,778,143000,160002,10/23/2020
7/4/2020,57,24922,2345,244432,269354,2,2067,4,1689,1,308,70,10,9,2,985,33,17035,1005,144005,161040,10/23/2020
7/5/2020,49,24971,2932,247364,272335,1,2068,2,1691,1,309,68,8,8,2,987,26,17061,1437,145442,162503,10/23/2020
7/6/2020,101,25072,2811,250175,275247,6,2074,6,1697,0,309,68,9,9,4,991,57,17118,1546,146988,164106,10/23/2020
7/7/2020,81,25153,3457,253632,278785,5,2079,7,1704,0,309,66,8,8,2,993,47,17165,1533,148521,165686,10/23/2020
7/8/2020,105,25258,3409,257041,282299,4,2083,2,1706,0,309,68,9,8,0,993,64,17229,1426,149947,167176,10/23/2020
7/9/2020,94,25352,3714,260755,286107,9,2092,3,1709,0,309,74,9,8,0,993,50,17279,1615,151562,168841,10/23/2020
7/10/2020,132,25484,4432,265187,290671,6,2098,3,1712,2,311,75,7,7,3,996,80,17359,2065,153627,170986,10/23/2020
7/11/2020,63,25547,2932,268119,293666,6,2104,3,1715,1,312,77,6,6,3,999,36,17395,1312,154939,172334,10/23/2020
7/12/2020,47,25594,1837,269956,295550,1,2105,3,1718,1,313,74,6,5,3,1002,34,17429,942,155881,173310,10/23/2020
7/13/2020,84,25678,3201,273157,298835,8,2113,10,1728,0,313,72,6,5,1,1003,61,17490,1502,157383,174873,10/23/2020
7/14/2020,73,25751,3293,276450,302201,7,2120,4,1732,0,313,75,5,5,1,1004,43,17533,1371,158754,176287,10/23/2020
7/15/2020,130,25881,4173,280623,306504,5,2125,7,1739,0,313,73,5,4,0,1004,99,17632,1745,160499,178131,10/23/2020
7/16/2020,102,25983,3734,284357,310340,6,2131,9,1748,0,313,70,6,5,1,1005,75,17707,1613,162112,179819,10/23/2020
7/17/2020,156,26139,4236,288593,314732,14,2145,3,1751,1,314,80,5,5,2,1007,79,17786,1842,163954,181740,10/23/2020
7/18/2020,85,26224,3269,291862,318086,5,2150,9,1760,1,315,75,5,4,4,1011,70,17856,1394,165348,183204,10/23/2020
7/19/2020,82,26306,2694,294556,320862,7,2157,3,1763,0,315,79,6,4,2,1013,57,17913,1147,166495,184408,10/23/2020
7/20/2020,71,26377,2664,297220,323597,9,2166,7,1770,0,315,81,7,5,2,1015,68,17981,1454,167949,185930,10/23/2020
7/21/2020,130,26507,4299,301519,328026,9,2175,11,1781,0,315,79,9,6,1,1016,109,18090,1911,169860,187950,10/23/2020
7/22/2020,130,26637,3927,305446,332083,11,2186,11,1792,1,316,78,7,6,1,1017,86,18176,1680,171540,189716,10/23/2020
7/23/2020,141,26778,4413,309859,336637,8,2194,6,1798,0,316,80,8,7,0,1017,115,18291,1975,173515,191806,10/23/2020
7/24/2020,172,26950,5961,315820,342770,14,2208,14,1812,0,316,80,9,7,0,1017,119,18410,2312,175827,194237,10/23/2020
7/25/2020,134,27084,4399,320219,347303,7,2215,7,1819,0,316,80,10,8,3,1020,108,18518,2089,177916,196434,10/23/2020
7/26/2020,62,27146,3027,323246,350392,8,2223,9,1828,0,316,79,11,7,1,1021,54,18572,1331,179247,197819,10/23/2020
7/27/2020,188,27334,4190,327436,354770,12,2235,7,1835,0,316,84,13,8,1,1022,138,18710,2340,181587,200297,10/23/2020
7/28/2020,106,27440,3834,331270,358710,5,2240,5,1840,0,316,84,14,7,1,1023,95,18805,1631,183218,202023,10/23/2020
7/29/2020,191,27631,5137,336407,364038,11,2251,12,1852,0,316,83,15,7,0,1023,154,18959,2309,185527,204486,10/23/2020
7/30/2020,121,27752,4344,340751,368503,6,2257,2,1854,1,317,86,15,6,1,1024,97,19056,1644,187171,206227,10/23/2020
7/31/2020,131,27883,5509,346260,374143,8,2265,10,1864,0,317,84,15,7,1,1025,89,19145,1844,189015,208160,10/23/2020
8/1/2020,108,27991,4292,350552,378543,7,2272,2,1866,0,317,89,14,7,1,1026,88,19233,1556,190571,209804,10/23/2020
8/2/2020,84,28075,2802,353354,381429,12,2284,12,1878,2,319,87,14,8,2,1028,62,19295,1268,191839,211134,10/23/2020
8/3/2020,187,28262,5238,358592,386854,13,2297,12,1890,0,319,88,16,7,1,1029,150,19445,2195,194034,213479,10/23/2020
8/4/2020,126,28388,3691,362283,390671,9,2306,6,1896,1,320,90,12,5,2,1031,99,19544,1767,195801,215345,10/23/2020
8/5/2020,148,28536,5934,368217,396753,12,2318,10,1906,1,321,91,10,5,2,1033,118,19662,2463,198264,217926,10/23/2020
8/6/2020,169,28705,5533,373750,402455,7,2325,9,1915,0,321,89,9,4,0,1033,121,19783,2399,200663,220446,10/23/2020
8/7/2020,122,28827,4847,378597,407424,13,2338,10,1925,1,322,91,9,3,2,1035,87,19870,2140,202803,222673,10/23/2020
8/8/2020,123,28950,4107,382704,411654,19,2357,6,1931,1,323,103,8,3,1,1036,92,19962,1775,204578,224540,10/23/2020
8/9/2020,42,28992,1722,384426,413418,8,2365,10,1941,0,323,101,9,4,0,1036,35,19997,1069,205647,225644,10/23/2020
8/10/2020,149,29141,4584,389010,418151,11,2376,12,1953,0,323,100,9,4,1,1037,113,20110,2018,207665,227775,10/23/2020
8/11/2020,105,29246,4329,393339,422585,6,2382,14,1967,0,323,92,10,4,3,1040,92,20202,2262,209927,230129,10/23/2020
8/12/2020,121,29367,5184,398523,427890,8,2390,11,1978,0,323,89,9,3,1,1041,101,20303,2622,212549,232852,10/23/2020
8/13/2020,135,29502,4192,402715,432217,13,2403,12,1990,0,323,90,11,3,0,1041,95,20398,1898,214447,234845,10/23/2020
8/14/2020,145,29647,5494,408209,437856,13,2416,11,2001,0,323,92,11,4,3,1044,99,20497,1971,216418,236915,10/23/2020
8/15/2020,105,29752,4533,412742,442494,9,2425,11,2012,1,324,89,11,5,0,1044,88,20585,1687,218105,238690,10/23/2020
8/16/2020,83,29835,2472,415214,445049,7,2432,6,2018,4,328,86,8,4,6,1050,70,20655,960,219065,239720,10/23/2020
8/17/2020,106,29941,4570,419784,449725,10,2442,7,2025,0,328,89,8,5,2,1052,87,20742,2388,221453,242195,10/23/2020
8/18/2020,128,30069,4904,424688,454757,11,2453,9,2034,1,329,90,8,4,5,1057,94,20836,2748,224201,245037,10/23/2020
8/19/2020,113,30182,5065,429753,459935,8,2461,9,2043,1,330,88,9,5,0,1057,90,20926,2639,226840,247766,10/23/2020
8/20/2020,173,30355,7405,437158,467513,12,2473,6,2049,2,332,92,10,5,3,1060,139,21065,3512,230352,251417,10/23/2020
8/21/2020,151,30506,6571,443729,474235,8,2481,5,2054,1,333,94,9,4,2,1062,125,21190,2945,233297,254487,10/23/2020
8/22/2020,96,30602,5547,449276,479878,10,2491,12,2066,0,333,92,11,4,1,1063,84,21274,2604,235901,257175,10/23/2020
8/23/2020,70,30672,4370,453646,484318,11,2502,6,2072,0,333,97,11,2,1,1064,56,21330,2469,238370,259700,10/23/2020
8/24/2020,105,30777,5776,459422,490199,7,2509,10,2082,1,334,93,13,4,1,1065,77,21407,3149,241519,262926,10/23/2020
8/25/2020,108,30885,4759,464181,495066,10,2519,4,2086,1,335,98,11,4,1,1066,92,21499,2288,243807,265306,10/23/2020
8/26/2020,170,31055,9477,473658,504713,4,2523,8,2094,0,335,94,9,5,1,1067,127,21626,3085,246892,268518,10/23/2020
8/27/2020,92,31147,8564,482222,513369,6,2529,13,2107,1,336,86,6,5,2,1069,70,21696,3164,250056,271752,10/23/2020
8/28/2020,112,31259,7991,490213,521472,14,2543,4,2111,0,336,96,9,7,2,1071,87,21783,2431,252487,274270,10/23/2020
8/29/2020,65,31324,5368,495581,526905,6,2549,8,2119,1,337,93,10,6,2,1073,51,21834,1910,254397,276231,10/23/2020
8/30/2020,66,31390,4320,499901,531291,7,2556,4,2123,0,337,96,8,5,2,1075,48,21882,1993,256390,278272,10/23/2020
8/31/2020,105,31495,4863,504764,536259,12,2568,15,2138,0,337,93,8,4,1,1076,81,21963,2186,258576,280539,10/23/2020
9/1/2020,98,31593,7109,511873,543466,6,2574,9,2147,1,338,89,7,4,2,1078,65,22028,2378,260954,282982,10/23/2020
9/2/2020,125,31718,10524,522397,554115,9,2583,10,2157,1,339,87,8,4,2,1080,104,22132,3052,264006,286138,10/23/2020
9/3/2020,90,31808,11065,533462,565270,8,2591,8,2165,0,339,87,9,4,3,1083,73,22205,2584,266590,288795,10/23/2020
9/4/2020,102,31910,8953,542415,574325,11,2602,4,2169,0,339,94,9,4,1,1084,83,22288,2370,268960,291248,10/23/2020
9/5/2020,52,31962,6301,548716,580678,6,2608,9,2178,0,339,91,8,3,1,1085,42,22330,1600,270560,292890,10/23/2020
9/6/2020,87,32049,4317,553033,585082,4,2612,8,2186,1,340,86,6,3,1,1086,64,22394,1947,272507,294901,10/23/2020
9/7/2020,35,32084,3001,556034,588118,11,2623,3,2189,0,340,94,5,3,1,1087,26,22420,645,273152,295572,10/23/2020
9/8/2020,74,32158,6375,562409,594567,6,2629,12,2201,1,341,87,6,3,2,1089,66,22486,1600,274752,297238,10/23/2020
9/9/2020,118,32276,8641,571050,603326,9,2638,5,2206,1,342,90,9,3,1,1090,102,22588,2145,276897,299485,10/23/2020
9/10/2020,164,32440,11327,582377,614817,9,2647,8,2214,0,342,91,10,3,1,1091,111,22699,2275,279172,301871,10/23/2020
9/11/2020,121,32561,9449,591826,624387,11,2658,11,2225,0,342,91,10,5,0,1091,98,22797,1966,281138,303935,10/23/2020
9/12/2020,109,32670,6160,597986,630656,8,2666,5,2230,2,344,92,9,5,3,1094,97,22894,1520,282658,305552,10/23/2020
9/13/2020,58,32728,2710,600696,633424,4,2670,3,2233,0,344,93,10,5,0,1094,54,22948,858,283516,306464,10/23/2020
9/14/2020,104,32832,6433,607129,639961,5,2675,3,2236,2,346,93,10,5,2,1096,95,23043,1736,285252,308295,10/23/2020
9/15/2020,122,32954,8462,615591,648545,7,2682,2,2238,1,347,97,10,5,2,1098,124,23167,2201,287453,310620,10/23/2020
9/16/2020,137,33091,9711,625302,658393,7,2689,7,2245,2,349,95,9,6,5,1103,118,23285,1976,289429,312714,10/23/2020
9/17/2020,124,33215,9233,634535,667750,7,2696,14,2259,0,349,88,8,4,0,1103,154,23439,1956,291385,314824,10/23/2020
9/18/2020,132,33347,10034,644569,677916,7,2703,7,2266,1,350,87,11,6,2,1105,132,23571,1936,293321,316892,10/23/2020
9/19/2020,116,33463,8296,652865,686328,7,2710,3,2269,0,350,91,10,6,4,1109,112,23683,1696,295017,318700,10/23/2020
9/20/2020,60,33523,3668,656533,690056,7,2717,6,2275,2,352,90,9,8,4,1113,48,23731,1325,296342,320073,10/23/2020
9/21/2020,103,33626,7015,663548,697174,12,2729,3,2278,2,354,97,8,6,2,1115,94,23825,2415,298757,322582,10/23/2020
9/22/2020,154,33780,9282,672830,706610,12,2741,3,2281,1,355,105,7,5,1,1116,124,23949,2210,300967,324916,10/23/2020
9/23/2020,136,33916,10638,683468,717384,12,2753,7,2288,0,355,110,6,5,0,1116,127,24076,2220,303187,327263,10/23/2020
9/24/2020,119,34035,12464,695932,729967,7,2760,9,2297,1,356,107,7,5,1,1117,120,24196,3169,306356,330552,10/23/2020
9/25/2020,149,34184,10541,706473,740657,9,2769,10,2307,0,356,106,6,5,1,1118,141,24337,3019,309375,333712,10/23/2020
9/26/2020,146,34330,10549,717022,751352,12,2781,9,2316,0,356,109,6,5,1,1119,118,24455,2430,311805,336260,10/23/2020
9/27/2020,43,34373,2761,719783,754156,7,2788,5,2321,0,356,111,9,5,0,1119,34,24489,847,312652,337141,10/23/2020
9/28/2020,151,34524,7299,727082,761606,6,2794,6,2327,2,358,109,7,5,2,1121,132,24621,2264,314916,339537,10/23/2020
9/29/2020,208,34732,11033,738115,772847,12,2806,18,2345,1,359,102,6,6,1,1122,190,24811,2830,317746,342557,10/23/2020
9/30/2020,221,34953,12217,750332,785285,6,2812,6,2351,0,359,102,6,6,1,1123,186,24997,2603,320349,345346,10/23/2020
10/1/2020,184,35137,12493,762825,797962,16,2828,13,2364,1,360,104,5,4,2,1125,164,25161,2435,322784,347945,10/23/2020
10/2/2020,209,35346,12134,774959,810305,13,2841,13,2377,1,361,103,6,4,2,1127,181,25342,2506,325290,350632,10/23/2020
10/3/2020,157,35503,9314,784273,819776,9,2850,9,2386,2,363,101,7,4,2,1129,133,25475,2034,327324,352799,10/23/2020
10/4/2020,81,35584,2365,786638,822222,11,2861,9,2395,1,364,102,6,4,2,1131,75,25550,961,328285,353835,10/23/2020
10/5/2020,174,35758,8959,795597,831355,29,2890,10,2405,2,366,119,8,5,4,1135,160,25710,3038,331323,357033,10/23/2020
10/6/2020,176,35934,11171,806768,842702,11,2901,4,2409,0,366,126,10,6,0,1135,188,25898,2911,334234,360132,10/23/2020
10/7/2020,228,36162,12421,819189,855351,13,2914,14,2423,2,368,123,8,6,2,1137,242,26140,3544,337778,363918,10/23/2020
10/8/2020,263,36425,15183,834372,870797,16,2930,12,2435,1,369,126,7,5,3,1140,274,26414,4202,341980,368394,10/23/2020
10/9/2020,214,36639,13212,847584,884223,20,2950,12,2447,0,369,134,10,7,3,1143,198,26612,4312,346292,372904,10/23/2020
10/10/2020,230,36869,13821,861405,898274,17,2967,10,2457,1,370,140,13,7,2,1145,198,26810,3832,350124,376934,10/23/2020
10/11/2020,94,36963,3252,864657,901620,12,2979,9,2466,1,371,142,14,5,6,1151,87,26897,1165,351289,378186,10/23/2020
10/12/2020,165,37128,6411,871068,908196,18,2997,15,2481,2,373,143,14,5,4,1155,159,27056,1751,353040,380096,10/23/2020
10/13/2020,210,37338,8485,879553,916891,14,3011,13,2494,4,377,140,13,5,7,1162,206,27262,2313,355353,382615,10/23/2020
10/14/2020,320,37658,15012,894565,932223,15,3026,7,2501,0,377,148,15,5,2,1164,309,27571,4074,359427,386998,10/23/2020
10/15/2020,263,37921,14579,909144,947065,9,3035,16,2517,1,378,140,13,5,2,1166,255,27826,3589,363016,390842,10/23/2020
10/16/2020,276,38197,14970,924114,962311,13,3048,18,2535,1,379,134,13,4,2,1168,268,28094,3419,366435,394529,10/23/2020
10/17/2020,348,38545,14021,938135,976680,17,3065,11,2546,1,380,139,16,4,2,1170,300,28394,3284,369719,398113,10/23/2020
10/18/2020,153,38698,3944,942079,980777,17,3082,11,2557,0,380,145,16,6,1,1171,122,28516,1289,371008,399524,10/23/2020
10/19/2020,380,39078,8359,950438,989516,19,3101,22,2579,2,382,140,14,6,1,1172,310,28826,2537,373545,402371,10/23/2020
10/20/2020,431,39509,12900,963338,1002847,17,3118,16,2595,0,382,141,13,8,2,1174,373,29199,2917,376462,405661,10/23/2020
10/21/2020,538,40047,17114,980452,1020499,8,3126,7,2602,2,384,140,13,9,3,1177,470,29669,3474,379936,409605,10/23/2020
10/22/2020,503,40550,13570,994022,1034572,,,,,,,,,,0,1177,449,30118,2796,382732,412850,10/23/2020
2/27/2020,0,0,0,0,0,1,1,0,0,0,0,1,0,0,0,0,0,0,0,0,0,10/26/2020
2/28/2020,0,0,0,0,0,0,1,0,0,0,0,1,1,0,0,0,0,0,0,0,0,10/26/2020
2/29/2020,0,0,0,0,0,0,1,0,0,0,0,1,1,0,0,0,0,0,0,0,0,10/26/2020
3/1/2020,2,2,2,2,4,0,1,0,0,0,0,1,1,1,0,0,2,2,2,2,4,10/26/2020
3/2/2020,0,2,1,3,5,1,2,0,0,0,0,2,2,2,0,0,0,2,1,3,5,10/26/2020
3/3/2020,0,2,2,5,7,0,2,0,0,0,0,2,2,2,0,0,0,2,2,5,7,10/26/2020
3/4/2020,0,2,12,17,19,1,3,0,0,0,0,3,2,2,0,0,0,2,10,15,17,10/26/2020
3/5/2020,0,2,4,21,23,0,3,0,0,0,0,3,2,2,0,0,1,3,4,19,22,10/26/2020
3/6/2020,1,3,12,33,36,0,3,0,0,0,0,3,2,2,0,0,0,3,11,30,33,10/26/2020
3/7/2020,0,3,19,52,55,0,3,0,0,0,0,3,2,1,0,0,0,3,19,49,52,10/26/2020
3/8/2020,0,3,18,70,73,0,3,0,0,0,0,3,2,1,0,0,0,3,18,67,70,10/26/2020
3/9/2020,1,4,15,85,89,0,3,0,0,0,0,3,2,1,0,0,1,4,15,82,86,10/26/2020
3/10/2020,2,6,25,110,116,0,3,0,0,0,0,3,2,1,0,0,1,5,23,105,110,10/26/2020
3/11/2020,0,6,34,144,150,1,4,0,0,0,0,4,1,1,0,0,0,5,34,139,144,10/26/2020
3/12/2020,9,15,41,185,200,1,5,0,0,0,0,5,1,1,0,0,8,13,38,177,190,10/26/2020
3/13/2020,6,21,50,235,256,4,9,1,1,0,0,8,1,1,0,0,6,19,48,225,244,10/26/2020
3/14/2020,0,21,90,325,346,0,9,0,1,0,0,8,1,1,0,0,0,19,86,311,330,10/26/2020
3/15/2020,1,22,54,379,401,1,10,0,1,0,0,9,2,1,0,0,1,20,54,365,385,10/26/2020
3/16/2020,2,24,95,474,498,2,12,0,1,0,0,11,2,0,0,0,2,22,92,457,479,10/26/2020
3/17/2020,12,36,162,636,672,6,18,0,1,0,0,17,2,0,0,0,11,33,150,607,640,10/26/2020
3/18/2020,9,45,116,752,797,3,21,0,1,0,0,20,2,0,0,0,11,44,110,717,761,10/26/2020
3/19/2020,15,60,262,1014,1074,2,23,1,2,0,0,21,3,0,1,1,17,61,249,966,1027,10/26/2020
3/20/2020,13,73,197,1211,1284,5,28,0,2,0,0,26,4,0,0,1,13,74,190,1156,1230,10/26/2020
3/21/2020,12,85,126,1337,1422,3,31,2,4,0,0,27,5,0,0,1,14,88,122,1278,1366,10/26/2020
3/22/2020,27,112,282,1619,1731,2,33,0,4,0,0,29,5,0,0,1,25,113,259,1537,1650,10/26/2020
3/23/2020,14,126,169,1788,1914,15,48,1,5,0,0,43,9,3,0,1,16,129,164,1701,1830,10/26/2020
3/24/2020,20,146,242,2030,2176,7,55,0,5,0,0,50,10,4,0,1,19,148,233,1934,2082,10/26/2020
3/25/2020,26,172,182,2212,2384,5,60,1,6,0,0,54,11,3,0,1,28,176,170,2104,2280,10/26/2020
3/26/2020,35,207,181,2393,2600,10,70,5,11,0,0,59,14,5,0,1,41,217,173,2277,2494,10/26/2020
3/27/2020,27,234,214,2607,2841,9,79,1,12,1,1,66,17,6,2,3,31,248,200,2477,2725,10/26/2020
3/28/2020,59,293,260,2867,3160,13,92,3,15,2,3,74,15,6,1,4,64,312,240,2717,3029,10/26/2020
3/29/2020,100,393,350,3217,3610,8,100,4,19,1,4,77,18,8,2,6,105,417,312,3029,3446,10/26/2020
3/30/2020,62,455,222,3439,3894,20,120,5,24,0,4,92,20,11,3,9,78,495,184,3213,3708,10/26/2020
3/31/2020,71,526,369,3808,4334,11,131,7,31,1,5,95,22,13,2,11,73,568,294,3507,4075,10/26/2020
4/1/2020,99,625,698,4506,5131,18,149,7,38,0,5,106,30,15,1,12,100,668,637,4144,4812,10/26/2020
4/2/2020,52,677,477,4983,5660,22,171,6,44,2,7,120,36,21,4,16,62,730,433,4577,5307,10/26/2020
4/3/2020,108,785,774,5757,6542,23,194,7,51,0,7,136,43,25,3,19,100,830,703,5280,6110,10/26/2020
4/4/2020,143,928,660,6417,7345,22,216,4,55,5,12,149,41,30,9,28,138,968,614,5894,6862,10/26/2020
4/5/2020,187,1115,1156,7573,8688,20,236,9,64,1,13,159,44,36,2,30,181,1149,1055,6949,8098,10/26/2020
4/6/2020,218,1333,1706,9279,10612,26,262,7,71,0,13,178,48,40,7,37,207,1356,1540,8489,9845,10/26/2020
4/7/2020,284,1617,1629,10908,12525,20,282,5,76,2,15,191,50,42,5,42,261,1617,1469,9958,11575,10/26/2020
4/8/2020,290,1907,1720,12628,14535,19,301,7,83,6,21,197,50,38,10,52,271,1888,1540,11498,13386,10/26/2020
4/9/2020,283,2190,1516,14144,16334,32,333,9,92,4,25,216,53,40,7,59,277,2165,1348,12846,15011,10/26/2020
4/10/2020,419,2609,2574,16718,19327,29,362,16,108,5,30,224,59,41,11,70,401,2566,2349,15195,17761,10/26/2020
4/11/2020,297,2906,1905,18623,21529,29,391,11,119,2,32,240,61,48,12,82,281,2847,1709,16904,19751,10/26/2020
4/12/2020,314,3220,1670,20293,23513,35,426,13,132,5,37,257,59,49,9,91,285,3132,1418,18322,21454,10/26/2020
4/13/2020,161,3381,935,21228,24609,35,461,13,145,3,40,276,64,54,9,100,187,3319,834,19156,22475,10/26/2020
4/14/2020,289,3670,1787,23015,26685,27,488,17,162,5,45,281,72,53,8,108,262,3581,1519,20675,24256,10/26/2020
4/15/2020,351,4021,1799,24814,28835,31,519,20,182,3,48,289,72,54,17,125,306,3887,1538,22213,26100,10/26/2020
4/16/2020,447,4468,2494,27308,31776,36,555,25,207,6,54,294,72,53,14,139,387,4274,2064,24277,28551,10/26/2020
4/17/2020,304,4772,1821,29129,33901,32,587,20,227,7,61,299,66,45,21,160,290,4564,1435,25712,30276,10/26/2020
4/18/2020,321,5093,1725,30854,35947,26,613,18,245,4,65,303,63,49,15,175,284,4848,1314,27026,31874,10/26/2020
4/19/2020,381,5474,2047,32901,38375,23,636,26,271,1,66,299,65,55,11,186,337,5185,1728,28754,33939,10/26/2020
4/20/2020,394,5868,1907,34808,40676,46,682,29,300,2,68,314,75,56,10,196,376,5561,1561,30315,35876,10/26/2020
4/21/2020,444,6312,2110,36918,43230,45,727,33,333,5,73,321,72,56,18,214,385,5946,1689,32004,37950,10/26/2020
4/22/2020,418,6730,2390,39308,46038,41,768,32,365,5,78,325,73,58,18,232,379,6325,1899,33903,40228,10/26/2020
4/23/2020,479,7209,2469,41777,48986,32,800,28,393,5,83,324,76,62,15,247,412,6737,1841,35744,42481,10/26/2020
4/24/2020,491,7700,3284,45061,52761,35,835,26,419,4,87,329,85,63,15,262,407,7144,2605,38349,45493,10/26/2020
4/25/2020,393,8093,2206,47267,55360,34,869,17,436,5,92,341,85,62,14,276,300,7444,1750,40099,47543,10/26/2020
4/26/2020,316,8409,2309,49576,57985,33,902,15,451,3,95,356,86,59,14,290,274,7718,1859,41958,49676,10/26/2020
4/27/2020,249,8658,1620,51196,59854,29,931,21,472,4,99,360,86,61,10,300,206,7924,1153,43111,51035,10/26/2020
4/28/2020,410,9068,2263,53459,62527,44,975,24,496,3,102,377,88,59,22,322,332,8256,1742,44853,53109,10/26/2020
4/29/2020,476,9544,3343,56802,66346,36,1011,38,534,11,113,364,78,53,18,340,371,8627,2404,47257,55884,10/26/2020
4/30/2020,432,9976,2769,59571,69547,33,1044,38,572,6,119,353,83,57,24,364,350,8977,1896,49153,58130,10/26/2020
5/1/2020,454,10430,3086,62657,73087,51,1095,40,612,3,122,361,84,58,14,378,324,9301,2146,51299,60600,10/26/2020
5/2/2020,257,10687,1926,64583,75270,36,1131,37,649,5,127,355,91,62,24,402,192,9493,1258,52557,62050,10/26/2020
5/3/2020,283,10970,2160,66743,77713,31,1162,27,676,8,135,351,90,61,21,423,183,9676,1558,54115,63791,10/26/2020
5/4/2020,387,11357,2098,68841,80198,30,1192,31,707,5,140,345,88,57,18,441,290,9966,1549,55664,65630,10/26/2020
5/5/2020,433,11790,2873,71714,83504,29,1221,32,739,6,146,336,82,54,16,457,301,10267,1944,57608,67875,10/26/2020
5/6/2020,488,12278,2830,74544,86822,28,1249,44,783,9,155,311,79,54,21,478,340,10607,1904,59512,70119,10/26/2020
5/7/2020,425,12703,2969,77513,90216,36,1285,41,824,5,160,301,71,52,21,499,270,10877,1948,61460,72337,10/26/2020
5/8/2020,359,13062,2598,80111,93173,30,1315,29,853,5,165,297,71,53,22,521,229,11106,1729,63189,74295,10/26/2020
5/9/2020,467,13529,3346,83457,96986,22,1337,21,874,4,169,294,69,51,15,536,290,11396,2241,65430,76826,10/26/2020
5/10/2020,285,13814,2117,85574,99388,20,1357,23,897,6,175,285,70,49,14,550,189,11585,1512,66942,78527,10/26/2020
5/11/2020,257,14071,1857,87431,101502,31,1388,16,913,6,181,294,71,49,15,565,174,11759,1291,68233,79992,10/26/2020
5/12/2020,387,14458,2611,90042,104500,23,1411,18,931,4,185,295,69,48,22,587,224,11983,1692,69925,81908,10/26/2020
5/13/2020,351,14809,3630,93672,108481,23,1434,25,956,1,186,292,69,49,13,600,199,12182,1956,71881,84063,10/26/2020
5/14/2020,329,15138,3408,97080,112218,19,1453,27,983,3,189,281,64,45,15,615,231,12413,2006,73887,86300,10/26/2020
5/15/2020,381,15519,3458,100538,116057,24,1477,41,1024,5,194,259,62,45,14,629,232,12645,1796,75683,88328,10/26/2020
5/16/2020,449,15968,4156,104694,120662,25,1502,13,1037,5,199,266,61,46,15,644,247,12892,1941,77624,90516,10/26/2020
5/17/2020,240,16208,2768,107462,123670,17,1519,8,1045,5,204,270,59,45,10,654,126,13018,1530,79154,92172,10/26/2020
5/18/2020,250,16458,2001,109463,125921,19,1538,15,1060,5,209,269,57,40,18,672,135,13153,1364,80518,93671,10/26/2020
5/19/2020,415,16873,3168,112631,129504,23,1561,32,1092,5,214,255,56,38,11,683,215,13368,1913,82431,95799,10/26/2020
5/20/2020,326,17199,2771,115402,132601,19,1580,23,1115,7,221,244,52,33,22,705,183,13551,1509,83940,97491,10/26/2020
5/21/2020,374,17573,3757,119159,136732,26,1606,15,1130,3,224,252,53,29,20,725,168,13719,1926,85866,99585,10/26/2020
5/22/2020,351,17924,3161,122320,140244,20,1626,29,1159,5,229,238,52,29,11,736,206,13925,1600,87466,101391,10/26/2020
5/23/2020,253,18177,2742,125062,143239,19,1645,11,1170,3,232,243,52,32,13,749,109,14034,1264,88730,102764,10/26/2020
5/24/2020,163,18340,1370,126432,144772,13,1658,14,1184,2,234,240,53,36,8,757,83,14117,770,89500,103617,10/26/2020
5/25/2020,147,18487,1385,127817,146304,14,1672,14,1198,0,234,240,53,34,10,767,76,14193,760,90260,104453,10/26/2020
5/26/2020,285,18772,2620,130437,149209,24,1696,22,1220,5,239,237,48,33,15,782,158,14351,1776,92036,106387,10/26/2020
5/27/2020,276,19048,2057,132494,151542,20,1716,18,1238,3,242,236,50,33,10,792,132,14483,1128,93164,107647,10/26/2020
5/28/2020,348,19396,3359,135853,155249,17,1733,29,1267,4,246,220,47,32,8,800,130,14613,1112,94276,108889,10/26/2020
5/29/2020,410,19806,3915,139768,159574,19,1752,27,1294,6,252,206,43,31,12,812,174,14787,1568,95844,110631,10/26/2020
5/30/2020,225,20031,3915,143683,163714,16,1768,19,1313,4,256,199,41,29,12,824,109,14896,1813,97657,112553,10/26/2020
5/31/2020,155,20186,1689,145372,165558,11,1779,10,1323,1,257,199,44,26,3,827,78,14974,854,98511,113485,10/26/2020
6/1/2020,212,20398,2792,148164,168562,8,1787,14,1337,1,258,192,45,29,5,832,93,15067,1376,99887,114954,10/26/2020
6/2/2020,273,20671,3022,151186,171857,8,1795,9,1346,3,261,188,38,25,10,842,98,15165,1436,101323,116488,10/26/2020
6/3/2020,254,20925,3486,154672,175597,14,1809,18,1364,6,267,178,34,25,11,853,99,15264,1652,102975,118239,10/26/2020
6/4/2020,276,21201,4471,159143,180344,7,1816,25,1389,4,271,156,31,24,12,865,107,15371,2029,105004,120375,10/26/2020
6/5/2020,215,21416,3513,162656,184072,15,1831,13,1402,6,277,152,27,21,11,876,99,15470,1569,106573,122043,10/26/2020
6/6/2020,201,21617,2616,165272,186889,10,1841,7,1409,2,279,153,29,19,6,882,67,15537,1124,107697,123234,10/26/2020
6/7/2020,83,21700,1625,166897,188597,11,1852,7,1416,1,280,156,25,17,4,886,51,15588,780,108477,124065,10/26/2020
6/8/2020,119,21819,1849,168746,190565,15,1867,12,1428,2,282,157,27,18,4,890,45,15633,953,109430,125063,10/26/2020
6/9/2020,223,22042,2673,171419,193461,10,1877,18,1446,0,282,149,28,21,1,891,64,15697,1250,110680,126377,10/26/2020
6/10/2020,209,22251,2987,174406,196657,13,1890,12,1458,2,284,148,24,17,4,895,101,15798,1460,112140,127938,10/26/2020
6/11/2020,195,22446,3513,177919,200365,7,1897,15,1473,1,285,139,25,16,6,901,88,15886,1525,113665,129551,10/26/2020
6/12/2020,209,22655,4601,182520,205175,9,1906,15,1488,1,286,132,24,16,2,903,78,15964,2165,115830,131794,10/26/2020
6/13/2020,113,22768,3036,185556,208324,6,1912,5,1493,0,286,133,20,15,3,906,49,16013,1363,117193,133206,10/26/2020
6/14/2020,81,22849,2046,187602,210451,7,1919,8,1501,1,287,131,20,14,3,909,33,16046,963,118156,134202,10/26/2020
6/15/2020,188,23037,3108,190710,213747,14,1933,14,1515,0,287,131,20,16,5,914,75,16121,1779,119935,136056,10/26/2020
6/16/2020,110,23147,3017,193727,216874,11,1944,9,1524,1,288,132,22,16,8,922,50,16171,1541,121476,137647,10/26/2020
6/17/2020,127,23274,2835,196562,219836,15,1959,20,1544,4,292,123,18,14,6,928,50,16221,1313,122789,139010,10/26/2020
6/18/2020,149,23423,3048,199610,223033,9,1968,13,1557,1,293,118,19,16,7,935,70,16291,1309,124098,140389,10/26/2020
6/19/2020,141,23564,3769,203379,226943,12,1980,11,1568,1,294,118,20,17,3,938,59,16350,1358,125456,141806,10/26/2020
6/20/2020,84,23648,1891,205270,228918,9,1989,12,1580,0,294,115,20,18,4,942,36,16386,811,126267,142653,10/26/2020
6/21/2020,37,23685,1064,206334,230019,8,1997,5,1585,0,294,118,20,18,2,944,29,16415,688,126955,143370,10/26/2020
6/22/2020,138,23823,3730,210064,233887,12,2009,16,1601,0,294,114,19,18,2,946,65,16480,1699,128654,145134,10/26/2020
6/23/2020,163,23986,3831,213895,237881,3,2012,13,1614,3,297,101,18,18,7,953,81,16561,1772,130426,146987,10/26/2020
6/24/2020,120,24106,3502,217397,241503,9,2021,10,1624,1,298,99,18,18,5,958,44,16605,1677,132103,148708,10/26/2020
6/25/2020,103,24209,2883,220280,244489,6,2027,14,1638,1,299,90,17,17,1,959,50,16655,1499,133602,150257,10/26/2020
6/26/2020,94,24303,2488,222768,247071,2,2029,10,1648,0,299,82,18,18,1,960,60,16715,1322,134924,151639,10/26/2020
6/27/2020,84,24387,3216,225984,250371,5,2034,3,1651,1,300,83,17,17,5,965,37,16752,1216,136140,152892,10/26/2020
6/28/2020,39,24426,1469,227453,251879,4,2038,4,1655,4,304,79,15,14,6,971,17,16769,592,136732,153501,10/26/2020
6/29/2020,85,24511,3697,231150,255661,4,2042,5,1660,0,304,78,14,14,1,972,39,16808,1345,138077,154885,10/26/2020
6/30/2020,57,24568,1958,233108,257676,1,2043,5,1665,1,305,73,12,11,4,976,33,16841,993,139070,155911,10/26/2020
7/1/2020,144,24712,4098,237206,261918,8,2051,10,1675,0,305,71,11,11,1,977,79,16920,1922,140992,157912,10/26/2020
7/2/2020,103,24815,2803,240009,264824,5,2056,5,1680,1,306,70,10,10,3,980,59,16979,1080,142072,159051,10/26/2020
7/3/2020,50,24865,2078,242087,266952,9,2065,6,1686,0,306,73,9,9,3,983,25,17004,778,142850,159854,10/26/2020
7/4/2020,57,24922,2345,244432,269354,2,2067,4,1690,1,307,70,10,9,2,985,33,17037,1004,143854,160891,10/26/2020
7/5/2020,49,24971,2932,247364,272335,1,2068,2,1692,1,308,68,8,8,2,987,26,17063,1437,145291,162354,10/26/2020
7/6/2020,101,25072,2811,250175,275247,6,2074,6,1698,0,308,68,9,9,4,991,57,17120,1544,146835,163955,10/26/2020
7/7/2020,81,25153,3457,253632,278785,5,2079,7,1705,0,308,66,8,8,2,993,47,17167,1533,148368,165535,10/26/2020
7/8/2020,105,25258,3409,257041,282299,4,2083,2,1707,0,308,68,9,8,0,993,64,17231,1424,149792,167023,10/26/2020
7/9/2020,94,25352,3714,260755,286107,9,2092,3,1710,0,308,74,9,8,0,993,50,17281,1615,151407,168688,10/26/2020
7/10/2020,132,25484,4432,265187,290671,6,2098,3,1713,2,310,75,7,7,3,996,80,17361,2062,153469,170830,10/26/2020
7/11/2020,63,25547,2932,268119,293666,6,2104,3,1716,1,311,77,6,6,3,999,36,17397,1312,154781,172178,10/26/2020
7/12/2020,47,25594,1837,269956,295550,1,2105,3,1719,1,312,74,6,5,3,1002,34,17431,942,155723,173154,10/26/2020
7/13/2020,84,25678,3201,273157,298835,8,2113,10,1729,0,312,72,6,5,1,1003,61,17492,1501,157224,174716,10/26/2020
7/14/2020,73,25751,3293,276450,302201,7,2120,4,1733,0,312,75,5,5,1,1004,43,17535,1371,158595,176130,10/26/2020
7/15/2020,130,25881,4173,280623,306504,5,2125,7,1740,0,312,73,5,4,0,1004,99,17634,1745,160340,177974,10/26/2020
7/16/2020,102,25983,3734,284357,310340,6,2131,9,1749,0,312,70,6,5,1,1005,75,17709,1609,161949,179658,10/26/2020
7/17/2020,156,26139,4236,288593,314732,14,2145,3,1752,1,313,80,5,5,2,1007,79,17788,1841,163790,181578,10/26/2020
7/18/2020,85,26224,3269,291862,318086,5,2150,9,1761,1,314,75,5,4,4,1011,70,17858,1392,165182,183040,10/26/2020
7/19/2020,82,26306,2694,294556,320862,7,2157,3,1764,0,314,79,6,4,2,1013,57,17915,1146,166328,184243,10/26/2020
7/20/2020,71,26377,2664,297220,323597,9,2166,7,1771,0,314,81,7,5,2,1015,68,17983,1454,167782,185765,10/26/2020
7/21/2020,130,26507,4299,301519,328026,9,2175,11,1782,0,314,79,9,6,1,1016,109,18092,1911,169693,187785,10/26/2020
7/22/2020,130,26637,3927,305446,332083,11,2186,11,1793,1,315,78,7,6,1,1017,86,18178,1679,171372,189550,10/26/2020
7/23/2020,141,26778,4413,309859,336637,9,2195,6,1799,0,315,81,8,7,0,1017,115,18293,1975,173347,191640,10/26/2020
7/24/2020,172,26950,5961,315820,342770,14,2209,14,1813,0,315,81,9,7,0,1017,119,18412,2308,175655,194067,10/26/2020
7/25/2020,134,27084,4399,320219,347303,7,2216,7,1820,0,315,81,10,8,3,1020,108,18520,2089,177744,196264,10/26/2020
7/26/2020,62,27146,3027,323246,350392,8,2224,9,1829,0,315,80,11,7,1,1021,54,18574,1331,179075,197649,10/26/2020
7/27/2020,188,27334,4190,327436,354770,12,2236,7,1836,0,315,85,13,8,1,1022,138,18712,2336,181411,200123,10/26/2020
7/28/2020,105,27439,3834,331270,358709,5,2241,5,1841,0,315,85,14,7,1,1023,95,18807,1629,183040,201847,10/26/2020
7/29/2020,190,27629,5137,336407,364036,11,2252,12,1853,0,315,84,15,7,0,1023,154,18961,2308,185348,204309,10/26/2020
7/30/2020,121,27750,4344,340751,368501,6,2258,2,1855,1,316,87,15,6,1,1024,97,19058,1643,186991,206049,10/26/2020
7/31/2020,131,27881,5509,346260,374141,8,2266,10,1865,0,316,85,15,7,1,1025,89,19147,1844,188835,207982,10/26/2020
8/1/2020,108,27989,4292,350552,378541,7,2273,2,1867,0,316,90,14,7,1,1026,88,19235,1555,190390,209625,10/26/2020
8/2/2020,84,28073,2802,353354,381427,12,2285,12,1879,2,318,88,14,8,2,1028,62,19297,1268,191658,210955,10/26/2020
8/3/2020,186,28259,5238,358592,386851,13,2298,12,1891,0,318,89,16,7,1,1029,150,19447,2190,193848,213295,10/26/2020
8/4/2020,125,28384,3691,362283,390667,9,2307,6,1897,1,319,91,12,5,2,1031,99,19546,1767,195615,215161,10/26/2020
8/5/2020,147,28531,5934,368217,396748,12,2319,10,1907,1,320,92,10,5,2,1033,118,19664,2463,198078,217742,10/26/2020
8/6/2020,169,28700,5533,373750,402450,7,2326,9,1916,0,320,90,9,4,0,1033,120,19784,2397,200475,220259,10/26/2020
8/7/2020,121,28821,4847,378597,407418,13,2339,10,1926,1,321,92,9,3,2,1035,87,19871,2137,202612,222483,10/26/2020
8/8/2020,123,28944,4107,382704,411648,19,2358,6,1932,1,322,104,8,3,1,1036,92,19963,1774,204386,224349,10/26/2020
8/9/2020,42,28986,1722,384426,413412,8,2366,10,1942,0,322,102,9,4,0,1036,35,19998,1069,205455,225453,10/26/2020
8/10/2020,149,29135,4584,389010,418145,11,2377,12,1954,0,322,101,9,4,1,1037,113,20111,2017,207472,227583,10/26/2020
8/11/2020,105,29240,4329,393339,422579,6,2383,14,1968,0,322,93,10,4,3,1040,92,20203,2260,209732,229935,10/26/2020
8/12/2020,121,29361,5184,398523,427884,8,2391,11,1979,0,322,90,9,3,1,1041,101,20304,2621,212353,232657,10/26/2020
8/13/2020,135,29496,4192,402715,432211,13,2404,12,1991,0,322,91,11,3,0,1041,95,20399,1897,214250,234649,10/26/2020
8/14/2020,145,29641,5494,408209,437850,13,2417,11,2002,0,322,93,11,4,3,1044,99,20498,1970,216220,236718,10/26/2020
8/15/2020,105,29746,4533,412742,442488,9,2426,11,2013,1,323,90,11,5,0,1044,88,20586,1685,217905,238491,10/26/2020
8/16/2020,83,29829,2472,415214,445043,7,2433,6,2019,4,327,87,8,4,6,1050,70,20656,959,218864,239520,10/26/2020
8/17/2020,106,29935,4570,419784,449719,10,2443,7,2026,0,327,90,8,5,2,1052,87,20743,2386,221250,241993,10/26/2020
8/18/2020,128,30063,4904,424688,454751,11,2454,9,2035,1,328,91,8,4,5,1057,94,20837,2747,223997,244834,10/26/2020
8/19/2020,113,30176,5065,429753,459929,8,2462,9,2044,1,329,89,9,5,0,1057,90,20927,2637,226634,247561,10/26/2020
8/20/2020,173,30349,7405,437158,467507,12,2474,6,2050,2,331,93,10,5,3,1060,139,21066,3512,230146,251212,10/26/2020
8/21/2020,151,30500,6571,443729,474229,8,2482,5,2055,1,332,95,9,4,2,1062,125,21191,2942,233088,254279,10/26/2020
8/22/2020,96,30596,5547,449276,479872,10,2492,12,2067,0,332,93,11,4,1,1063,84,21275,2603,235691,256966,10/26/2020
8/23/2020,70,30666,4370,453646,484312,11,2503,6,2073,0,332,98,11,2,1,1064,56,21331,2469,238160,259491,10/26/2020
8/24/2020,105,30771,5776,459422,490193,7,2510,10,2083,1,333,94,13,4,1,1065,77,21408,3144,241304,262712,10/26/2020
8/25/2020,108,30879,4759,464181,495060,10,2520,4,2087,1,334,99,11,4,1,1066,92,21500,2287,243591,265091,10/26/2020
8/26/2020,170,31049,9477,473658,504707,4,2524,8,2095,0,334,95,9,5,1,1067,127,21627,3084,246675,268302,10/26/2020
8/27/2020,92,31141,8564,482222,513363,6,2530,13,2108,1,335,87,6,5,2,1069,70,21697,3162,249837,271534,10/26/2020
8/28/2020,112,31253,7991,490213,521466,14,2544,4,2112,0,335,97,9,7,2,1071,87,21784,2429,252266,274050,10/26/2020
8/29/2020,65,31318,5368,495581,526899,6,2550,8,2120,1,336,94,10,6,2,1073,51,21835,1910,254176,276011,10/26/2020
8/30/2020,66,31384,4320,499901,531285,7,2557,4,2124,0,336,97,8,5,2,1075,48,21883,1993,256169,278052,10/26/2020
8/31/2020,105,31489,4863,504764,536253,12,2569,15,2139,0,336,94,8,4,1,1076,81,21964,2185,258354,280318,10/26/2020
9/1/2020,97,31586,7109,511873,543459,6,2575,9,2148,1,337,90,7,4,2,1078,65,22029,2377,260731,282760,10/26/2020
9/2/2020,125,31711,10524,522397,554108,9,2584,10,2158,1,338,88,8,4,2,1080,104,22133,3051,263782,285915,10/26/2020
9/3/2020,90,31801,11065,533462,565263,8,2592,8,2166,0,338,88,9,4,3,1083,73,22206,2583,266365,288571,10/26/2020
9/4/2020,102,31903,8953,542415,574318,11,2603,4,2170,0,338,95,9,4,1,1084,83,22289,2364,268729,291018,10/26/2020
9/5/2020,52,31955,6301,548716,580671,6,2609,9,2179,0,338,92,8,3,1,1085,42,22331,1599,270328,292659,10/26/2020
9/6/2020,87,32042,4317,553033,585075,4,2613,8,2187,1,339,87,6,3,1,1086,64,22395,1946,272274,294669,10/26/2020
9/7/2020,35,32077,3001,556034,588111,11,2624,3,2190,0,339,95,5,3,1,1087,26,22421,645,272919,295340,10/26/2020
9/8/2020,74,32151,6375,562409,594560,6,2630,12,2202,1,340,88,6,3,2,1089,66,22487,1597,274516,297003,10/26/2020
9/9/2020,118,32269,8641,571050,603319,9,2639,5,2207,1,341,91,9,3,1,1090,102,22589,2145,276661,299250,10/26/2020
9/10/2020,164,32433,11327,582377,614810,9,2648,8,2215,0,341,92,10,3,1,1091,111,22700,2274,278935,301635,10/26/2020
9/11/2020,120,32553,9449,591826,624379,11,2659,11,2226,0,341,92,10,5,0,1091,98,22798,1965,280900,303698,10/26/2020
9/12/2020,109,32662,6160,597986,630648,8,2667,5,2231,2,343,93,9,5,3,1094,97,22895,1520,282420,305315,10/26/2020
9/13/2020,58,32720,2710,600696,633416,4,2671,3,2234,0,343,94,10,5,0,1094,54,22949,858,283278,306227,10/26/2020
9/14/2020,104,32824,6433,607129,639953,5,2676,3,2237,2,345,94,10,5,2,1096,95,23044,1732,285010,308054,10/26/2020
9/15/2020,122,32946,8462,615591,648537,7,2683,2,2239,1,346,98,10,5,2,1098,124,23168,2200,287210,310378,10/26/2020
9/16/2020,137,33083,9711,625302,658385,7,2690,7,2246,2,348,96,9,6,5,1103,118,23286,1973,289183,312469,10/26/2020
9/17/2020,124,33207,9233,634535,667742,7,2697,14,2260,0,348,89,8,4,0,1103,154,23440,1955,291138,314578,10/26/2020
9/18/2020,132,33339,10034,644569,677908,7,2704,7,2267,1,349,88,11,6,2,1105,132,23572,1933,293071,316643,10/26/2020
9/19/2020,115,33454,8296,652865,686319,7,2711,3,2270,0,349,92,10,6,4,1109,112,23684,1693,294764,318448,10/26/2020
9/20/2020,60,33514,3668,656533,690047,7,2718,6,2276,2,351,91,9,8,4,1113,48,23732,1323,296087,319819,10/26/2020
9/21/2020,102,33616,7015,663548,697164,12,2730,3,2279,2,353,98,8,6,2,1115,94,23826,2413,298500,322326,10/26/2020
9/22/2020,154,33770,9282,672830,706600,12,2742,3,2282,1,354,106,7,5,1,1116,124,23950,2209,300709,324659,10/26/2020
9/23/2020,136,33906,10638,683468,717374,12,2754,7,2289,0,354,111,6,5,0,1116,127,24077,2219,302928,327005,10/26/2020
9/24/2020,118,34024,12464,695932,729956,7,2761,9,2298,1,355,108,7,5,1,1117,120,24197,3168,306096,330293,10/26/2020
9/25/2020,149,34173,10541,706473,740646,9,2770,10,2308,0,355,107,6,5,1,1118,141,24338,3013,309109,333447,10/26/2020
9/26/2020,146,34319,10549,717022,751341,12,2782,9,2317,0,355,110,6,5,1,1119,118,24456,2426,311535,335991,10/26/2020
9/27/2020,43,34362,2761,719783,754145,7,2789,5,2322,0,355,112,9,5,0,1119,34,24490,846,312381,336871,10/26/2020
9/28/2020,151,34513,7299,727082,761595,7,2796,7,2329,2,357,110,7,5,2,1121,133,24623,2263,314644,339267,10/26/2020
9/29/2020,208,34721,11033,738115,772836,12,2808,18,2347,1,358,103,6,6,1,1122,190,24813,2830,317474,342287,10/26/2020
9/30/2020,221,34942,12217,750332,785274,6,2814,6,2353,0,358,103,6,6,1,1123,186,24999,2602,320076,345075,10/26/2020
10/1/2020,184,35126,12493,762825,797951,16,2830,13,2366,1,359,105,5,4,2,1125,165,25164,2433,322509,347673,10/26/2020
10/2/2020,209,35335,12134,774959,810294,13,2843,13,2379,1,360,104,6,4,2,1127,181,25345,2503,325012,350357,10/26/2020
10/3/2020,157,35492,9314,784273,819765,9,2852,9,2388,2,362,102,7,4,2,1129,133,25478,2032,327044,352522,10/26/2020
10/4/2020,81,35573,2365,786638,822211,11,2863,9,2397,1,363,103,6,4,2,1131,78,25556,960,328004,353560,10/26/2020
10/5/2020,174,35747,8960,795598,831345,30,2893,10,2407,2,365,121,8,5,4,1135,160,25716,3037,331041,356757,10/26/2020
10/6/2020,176,35923,11172,806770,842693,11,2904,4,2411,0,365,128,10,6,0,1135,186,25902,2909,333950,359852,10/26/2020
10/7/2020,228,36151,12420,819190,855341,13,2917,14,2425,2,367,125,8,6,2,1137,242,26144,3539,337489,363633,10/26/2020
10/8/2020,262,36413,15184,834374,870787,16,2933,12,2437,1,368,128,7,5,3,1140,274,26418,4202,341691,368109,10/26/2020
10/9/2020,216,36629,13729,848103,884732,20,2953,12,2449,0,368,136,10,7,3,1143,199,26617,4348,346039,372656,10/26/2020
10/10/2020,229,36858,13819,861922,898780,19,2972,10,2459,1,369,144,13,7,2,1145,197,26814,3827,349866,376680,10/26/2020
10/11/2020,94,36952,3251,865173,902125,12,2984,9,2468,1,370,146,14,5,6,1151,87,26901,1161,351027,377928,10/26/2020
10/12/2020,165,37117,6410,871583,908700,19,3003,15,2483,2,372,148,14,5,4,1155,159,27060,1748,352775,379835,10/26/2020
10/13/2020,210,37327,8491,880074,917401,14,3017,13,2496,4,376,145,13,5,7,1162,207,27267,2316,355091,382358,10/26/2020
10/14/2020,320,37647,15018,895092,932739,16,3033,7,2503,0,376,154,15,5,2,1164,307,27574,4067,359158,386732,10/26/2020
10/15/2020,261,37908,14579,909671,947579,11,3044,16,2519,1,377,148,13,5,2,1166,255,27829,3580,362738,390567,10/26/2020
10/16/2020,276,38184,14971,924642,962826,13,3057,18,2537,1,378,142,13,4,2,1168,273,28102,3408,366146,394248,10/26/2020
10/17/2020,348,38532,14021,938663,977195,18,3075,11,2548,1,379,148,17,4,2,1170,303,28405,3277,369423,397828,10/26/2020
10/18/2020,153,38685,3943,942606,981291,18,3093,11,2559,0,379,155,17,5,1,1171,126,28531,1286,370709,399240,10/26/2020
10/19/2020,380,39065,8357,950963,990028,19,3112,22,2581,2,381,150,15,5,1,1172,318,28849,2531,373240,402089,10/26/2020
10/20/2020,428,39493,12901,963864,1003357,21,3133,17,2598,0,381,154,13,7,2,1174,382,29231,2913,376153,405384,10/26/2020
10/21/2020,538,40031,17233,981097,1021128,21,3154,8,2606,2,383,165,15,9,3,1177,468,29699,3466,379619,409318,10/26/2020
10/22/2020,523,40554,14665,995762,1036316,23,3177,20,2626,3,386,165,14,9,3,1180,525,30224,3004,382623,412847,10/26/2020
10/23/2020,500,41054,16438,1012200,1053254,20,3197,21,2647,1,387,163,15,9,3,1183,359,30583,2869,385492,416075,10/26/2020
10/24/2020,326,41380,9637,1021837,1063217,11,3208,11,2658,0,387,163,14,8,0,1183,274,30857,2071,387563,418420,10/26/2020
10/25/2020,192,41572,3733,1025570,1067142,,,,,,,,,,1,1184,167,31024,1305,388868,419892,10/26/2020
2/27/2020,0,0,0,0,0,1,1,0,0,0,0,1,0,0,0,0,0,0,0,0,0,10/27/2020
2/28/2020,0,0,0,0,0,0,1,0,0,0,0,1,1,0,0,0,0,0,0,0,0,10/27/2020
2/29/2020,0,0,0,0,0,0,1,0,0,0,0,1,1,0,0,0,0,0,0,0,0,10/27/2020
3/1/2020,2,2,2,2,4,0,1,0,0,0,0,1,1,1,0,0,2,2,2,2,4,10/27/2020
3/2/2020,0,2,1,3,5,1,2,0,0,0,0,2,2,2,0,0,0,2,1,3,5,10/27/2020
3/3/2020,0,2,2,5,7,0,2,0,0,0,0,2,2,2,0,0,0,2,2,5,7,10/27/2020
3/4/2020,0,2,12,17,19,1,3,0,0,0,0,3,2,2,0,0,0,2,10,15,17,10/27/2020
3/5/2020,0,2,4,21,23,0,3,0,0,0,0,3,2,2,0,0,1,3,4,19,22,10/27/2020
3/6/2020,1,3,12,33,36,0,3,0,0,0,0,3,2,2,0,0,0,3,11,30,33,10/27/2020
3/7/2020,0,3,19,52,55,0,3,0,0,0,0,3,2,1,0,0,0,3,19,49,52,10/27/2020
3/8/2020,0,3,18,70,73,0,3,0,0,0,0,3,2,1,0,0,0,3,18,67,70,10/27/2020
3/9/2020,1,4,15,85,89,0,3,0,0,0,0,3,2,1,0,0,1,4,15,82,86,10/27/2020
3/10/2020,2,6,25,110,116,0,3,0,0,0,0,3,2,1,0,0,1,5,23,105,110,10/27/2020
3/11/2020,0,6,34,144,150,1,4,0,0,0,0,4,1,1,0,0,0,5,34,139,144,10/27/2020
3/12/2020,9,15,41,185,200,1,5,0,0,0,0,5,1,1,0,0,8,13,38,177,190,10/27/2020
3/13/2020,6,21,50,235,256,4,9,1,1,0,0,8,1,1,0,0,6,19,48,225,244,10/27/2020
3/14/2020,0,21,90,325,346,0,9,0,1,0,0,8,1,1,0,0,0,19,86,311,330,10/27/2020
3/15/2020,1,22,54,379,401,1,10,0,1,0,0,9,2,1,0,0,1,20,54,365,385,10/27/2020
3/16/2020,2,24,95,474,498,2,12,0,1,0,0,11,2,0,0,0,2,22,92,457,479,10/27/2020
3/17/2020,12,36,162,636,672,6,18,0,1,0,0,17,2,0,0,0,11,33,150,607,640,10/27/2020
3/18/2020,9,45,116,752,797,3,21,0,1,0,0,20,2,0,0,0,11,44,110,717,761,10/27/2020
3/19/2020,15,60,262,1014,1074,2,23,1,2,0,0,21,3,0,1,1,17,61,249,966,1027,10/27/2020
3/20/2020,13,73,197,1211,1284,5,28,0,2,0,0,26,4,0,0,1,13,74,190,1156,1230,10/27/2020
3/21/2020,12,85,126,1337,1422,3,31,2,4,0,0,27,5,0,0,1,14,88,122,1278,1366,10/27/2020
3/22/2020,27,112,282,1619,1731,2,33,0,4,0,0,29,5,0,0,1,25,113,259,1537,1650,10/27/2020
3/23/2020,14,126,169,1788,1914,15,48,1,5,0,0,43,9,3,0,1,16,129,164,1701,1830,10/27/2020
3/24/2020,20,146,242,2030,2176,7,55,0,5,0,0,50,10,4,0,1,19,148,233,1934,2082,10/27/2020
3/25/2020,26,172,182,2212,2384,5,60,1,6,0,0,54,11,3,0,1,28,176,170,2104,2280,10/27/2020
3/26/2020,35,207,181,2393,2600,10,70,5,11,0,0,59,14,5,0,1,41,217,173,2277,2494,10/27/2020
3/27/2020,27,234,214,2607,2841,9,79,1,12,1,1,66,17,6,2,3,31,248,200,2477,2725,10/27/2020
3/28/2020,59,293,260,2867,3160,13,92,3,15,2,3,74,15,6,1,4,64,312,240,2717,3029,10/27/2020
3/29/2020,100,393,350,3217,3610,8,100,4,19,1,4,77,18,8,2,6,105,417,312,3029,3446,10/27/2020
3/30/2020,62,455,222,3439,3894,20,120,5,24,0,4,92,20,11,3,9,78,495,184,3213,3708,10/27/2020
3/31/2020,71,526,369,3808,4334,11,131,7,31,1,5,95,22,13,2,11,73,568,294,3507,4075,10/27/2020
4/1/2020,99,625,698,4506,5131,18,149,7,38,0,5,106,30,15,1,12,100,668,637,4144,4812,10/27/2020
4/2/2020,52,677,477,4983,5660,22,171,6,44,2,7,120,36,21,4,16,62,730,433,4577,5307,10/27/2020
4/3/2020,108,785,774,5757,6542,23,194,7,51,0,7,136,43,25,3,19,100,830,703,5280,6110,10/27/2020
4/4/2020,143,928,660,6417,7345,22,216,4,55,5,12,149,41,30,9,28,138,968,614,5894,6862,10/27/2020
4/5/2020,187,1115,1156,7573,8688,20,236,9,64,1,13,159,44,36,2,30,181,1149,1055,6949,8098,10/27/2020
4/6/2020,218,1333,1706,9279,10612,26,262,7,71,0,13,178,48,40,7,37,207,1356,1538,8487,9843,10/27/2020
4/7/2020,284,1617,1629,10908,12525,20,282,5,76,2,15,191,50,42,5,42,261,1617,1469,9956,11573,10/27/2020
4/8/2020,290,1907,1720,12628,14535,19,301,7,83,6,21,197,50,38,10,52,271,1888,1540,11496,13384,10/27/2020
4/9/2020,283,2190,1516,14144,16334,32,333,9,92,4,25,216,53,40,7,59,277,2165,1348,12844,15009,10/27/2020
4/10/2020,419,2609,2574,16718,19327,29,362,16,108,5,30,224,59,41,11,70,401,2566,2347,15191,17757,10/27/2020
4/11/2020,297,2906,1905,18623,21529,29,391,11,119,2,32,240,61,48,12,82,281,2847,1708,16899,19746,10/27/2020
4/12/2020,314,3220,1670,20293,23513,35,426,13,132,5,37,257,59,49,9,91,285,3132,1418,18317,21449,10/27/2020
4/13/2020,161,3381,935,21228,24609,35,461,13,145,3,40,276,64,54,9,100,187,3319,834,19151,22470,10/27/2020
4/14/2020,289,3670,1787,23015,26685,27,488,17,162,5,45,281,72,53,8,108,262,3581,1519,20670,24251,10/27/2020
4/15/2020,351,4021,1799,24814,28835,31,519,20,182,3,48,289,72,54,17,125,306,3887,1534,22204,26091,10/27/2020
4/16/2020,447,4468,2494,27308,31776,36,555,25,207,6,54,294,72,53,14,139,387,4274,2064,24268,28542,10/27/2020
4/17/2020,304,4772,1821,29129,33901,32,587,20,227,7,61,299,66,45,21,160,290,4564,1432,25700,30264,10/27/2020
4/18/2020,321,5093,1725,30854,35947,26,613,18,245,4,65,303,63,49,15,175,284,4848,1314,27014,31862,10/27/2020
4/19/2020,381,5474,2047,32901,38375,23,636,26,271,1,66,299,65,55,11,186,337,5185,1726,28740,33925,10/27/2020
4/20/2020,394,5868,1907,34808,40676,46,682,29,300,2,68,314,75,56,10,196,376,5561,1561,30301,35862,10/27/2020
4/21/2020,444,6312,2110,36918,43230,45,727,33,333,5,73,321,72,56,18,214,383,5944,1689,31990,37934,10/27/2020
4/22/2020,418,6730,2390,39308,46038,41,768,32,365,5,78,325,73,58,18,232,379,6323,1896,33886,40209,10/27/2020
4/23/2020,479,7209,2469,41777,48986,32,800,28,393,5,83,324,76,62,15,247,412,6735,1840,35726,42461,10/27/2020
4/24/2020,491,7700,3284,45061,52761,35,835,26,419,4,87,329,85,63,15,262,407,7142,2604,38330,45472,10/27/2020
4/25/2020,393,8093,2206,47267,55360,34,869,17,436,5,92,341,85,62,14,276,300,7442,1748,40078,47520,10/27/2020
4/26/2020,316,8409,2309,49576,57985,33,902,15,451,3,95,356,86,59,14,290,274,7716,1859,41937,49653,10/27/2020
4/27/2020,249,8658,1620,51196,59854,29,931,21,472,4,99,360,86,61,10,300,206,7922,1152,43089,51011,10/27/2020
4/28/2020,410,9068,2263,53459,62527,44,975,24,496,3,102,377,88,59,22,322,332,8254,1740,44829,53083,10/27/2020
4/29/2020,476,9544,3343,56802,66346,36,1011,38,534,11,113,364,78,53,18,340,371,8625,2403,47232,55857,10/27/2020
4/30/2020,432,9976,2769,59571,69547,33,1044,38,572,6,119,353,83,57,24,364,350,8975,1895,49127,58102,10/27/2020
5/1/2020,454,10430,3086,62657,73087,51,1095,39,611,3,122,362,84,58,14,378,324,9299,2145,51272,60571,10/27/2020
5/2/2020,257,10687,1926,64583,75270,36,1131,38,649,5,127,355,91,62,24,402,192,9491,1258,52530,62021,10/27/2020
5/3/2020,283,10970,2160,66743,77713,31,1162,26,675,8,135,352,90,61,21,423,183,9674,1557,54087,63761,10/27/2020
5/4/2020,387,11357,2098,68841,80198,30,1192,31,706,6,141,345,88,57,18,441,290,9964,1547,55634,65598,10/27/2020
5/5/2020,433,11790,2873,71714,83504,29,1221,32,738,6,147,336,82,54,16,457,301,10265,1944,57578,67843,10/27/2020
5/6/2020,488,12278,2830,74544,86822,28,1249,44,782,9,156,311,79,54,21,478,340,10605,1904,59482,70087,10/27/2020
5/7/2020,425,12703,2969,77513,90216,36,1285,41,823,5,161,301,71,52,21,499,270,10875,1948,61430,72305,10/27/2020
5/8/2020,359,13062,2598,80111,93173,30,1315,29,852,5,166,297,71,53,22,521,229,11104,1729,63159,74263,10/27/2020
5/9/2020,467,13529,3346,83457,96986,22,1337,21,873,4,170,294,69,51,15,536,290,11394,2240,65399,76793,10/27/2020
5/10/2020,285,13814,2117,85574,99388,20,1357,23,896,6,176,285,70,49,14,550,189,11583,1512,66911,78494,10/27/2020
5/11/2020,257,14071,1857,87431,101502,31,1388,16,912,6,182,294,71,49,15,565,174,11757,1290,68201,79958,10/27/2020
5/12/2020,387,14458,2611,90042,104500,23,1411,18,930,4,186,295,69,48,22,587,224,11981,1692,69893,81874,10/27/2020
5/13/2020,351,14809,3630,93672,108481,23,1434,25,955,1,187,292,69,49,13,600,199,12180,1956,71849,84029,10/27/2020
5/14/2020,329,15138,3408,97080,112218,19,1453,27,982,3,190,281,64,45,15,615,232,12412,2005,73854,86266,10/27/2020
5/15/2020,381,15519,3458,100538,116057,24,1477,41,1023,5,195,259,62,45,14,629,232,12644,1794,75648,88292,10/27/2020
5/16/2020,449,15968,4156,104694,120662,25,1502,13,1036,5,200,266,61,46,15,644,247,12891,1941,77589,90480,10/27/2020
5/17/2020,240,16208,2768,107462,123670,17,1519,8,1044,5,205,270,59,45,10,654,126,13017,1530,79119,92136,10/27/2020
5/18/2020,250,16458,2001,109463,125921,19,1538,15,1059,5,210,269,57,40,18,672,135,13152,1362,80481,93633,10/27/2020
5/19/2020,415,16873,3168,112631,129504,23,1561,32,1091,5,215,255,56,38,11,683,215,13367,1913,82394,95761,10/27/2020
5/20/2020,326,17199,2771,115402,132601,19,1580,23,1114,7,222,244,52,33,22,705,183,13550,1509,83903,97453,10/27/2020
5/21/2020,374,17573,3757,119159,136732,26,1606,15,1129,3,225,252,53,29,20,725,168,13718,1926,85829,99547,10/27/2020
5/22/2020,351,17924,3161,122320,140244,20,1626,29,1158,5,230,238,52,29,11,736,206,13924,1600,87429,101353,10/27/2020
5/23/2020,253,18177,2742,125062,143239,19,1645,11,1169,3,233,243,52,32,13,749,109,14033,1264,88693,102726,10/27/2020
5/24/2020,163,18340,1370,126432,144772,13,1658,14,1183,2,235,240,53,36,8,757,83,14116,770,89463,103579,10/27/2020
5/25/2020,147,18487,1385,127817,146304,14,1672,14,1197,0,235,240,53,34,10,767,76,14192,760,90223,104415,10/27/2020
5/26/2020,285,18772,2620,130437,149209,24,1696,22,1219,5,240,237,48,33,15,782,158,14350,1776,91999,106349,10/27/2020
5/27/2020,276,19048,2057,132494,151542,20,1716,18,1237,3,243,236,50,33,10,792,132,14482,1127,93126,107608,10/27/2020
5/28/2020,348,19396,3359,135853,155249,17,1733,29,1266,4,247,220,47,32,8,800,130,14612,1112,94238,108850,10/27/2020
5/29/2020,410,19806,3915,139768,159574,19,1752,27,1293,6,253,206,43,31,12,812,174,14786,1568,95806,110592,10/27/2020
5/30/2020,225,20031,3915,143683,163714,16,1768,19,1312,4,257,199,41,29,12,824,109,14895,1812,97618,112513,10/27/2020
5/31/2020,155,20186,1689,145372,165558,11,1779,10,1322,1,258,199,44,26,3,827,78,14973,852,98470,113443,10/27/2020
6/1/2020,212,20398,2792,148164,168562,8,1787,14,1336,1,259,192,45,29,5,832,93,15066,1376,99846,114912,10/27/2020
6/2/2020,273,20671,3022,151186,171857,8,1795,9,1345,3,262,188,38,25,10,842,98,15164,1434,101280,116444,10/27/2020
6/3/2020,254,20925,3486,154672,175597,14,1809,18,1363,6,268,178,34,25,11,853,99,15263,1651,102931,118194,10/27/2020
6/4/2020,276,21201,4471,159143,180344,7,1816,25,1388,4,272,156,31,24,12,865,107,15370,2029,104960,120330,10/27/2020
6/5/2020,215,21416,3513,162656,184072,15,1831,13,1401,6,278,152,27,21,11,876,99,15469,1568,106528,121997,10/27/2020
6/6/2020,201,21617,2616,165272,186889,10,1841,7,1408,2,280,153,29,19,6,882,67,15536,1123,107651,123187,10/27/2020
6/7/2020,83,21700,1625,166897,188597,11,1852,7,1415,1,281,156,25,17,4,886,51,15587,780,108431,124018,10/27/2020
6/8/2020,119,21819,1849,168746,190565,15,1867,12,1427,2,283,157,27,18,4,890,45,15632,952,109383,125015,10/27/2020
6/9/2020,223,22042,2673,171419,193461,10,1877,18,1445,0,283,149,28,21,1,891,64,15696,1250,110633,126329,10/27/2020
6/10/2020,209,22251,2987,174406,196657,13,1890,12,1457,2,285,148,24,17,4,895,101,15797,1460,112093,127890,10/27/2020
6/11/2020,195,22446,3513,177919,200365,7,1897,15,1472,1,286,139,25,16,6,901,88,15885,1525,113618,129503,10/27/2020
6/12/2020,209,22655,4601,182520,205175,9,1906,15,1487,1,287,132,24,16,2,903,78,15963,2165,115783,131746,10/27/2020
6/13/2020,113,22768,3036,185556,208324,6,1912,5,1492,0,287,133,20,15,3,906,49,16012,1363,117146,133158,10/27/2020
6/14/2020,81,22849,2046,187602,210451,7,1919,8,1500,1,288,131,20,14,3,909,33,16045,963,118109,134154,10/27/2020
6/15/2020,188,23037,3108,190710,213747,14,1933,14,1514,0,288,131,20,16,5,914,75,16120,1778,119887,136007,10/27/2020
6/16/2020,110,23147,3017,193727,216874,11,1944,9,1523,1,289,132,22,16,8,922,50,16170,1541,121428,137598,10/27/2020
6/17/2020,127,23274,2835,196562,219836,15,1959,20,1543,4,293,123,18,14,6,928,51,16221,1313,122741,138962,10/27/2020
6/18/2020,149,23423,3048,199610,223033,9,1968,13,1556,1,294,118,19,16,7,935,70,16291,1309,124050,140341,10/27/2020
6/19/2020,141,23564,3769,203379,226943,12,1980,11,1567,1,295,118,20,17,3,938,59,16350,1358,125408,141758,10/27/2020
6/20/2020,84,23648,1891,205270,228918,9,1989,12,1579,0,295,115,20,18,4,942,36,16386,811,126219,142605,10/27/2020
6/21/2020,37,23685,1064,206334,230019,8,1997,5,1584,0,295,118,20,18,2,944,30,16416,688,126907,143323,10/27/2020
6/22/2020,138,23823,3730,210064,233887,12,2009,16,1600,0,295,114,19,18,2,946,65,16481,1699,128606,145087,10/27/2020
6/23/2020,163,23986,3831,213895,237881,3,2012,13,1613,3,298,101,18,18,7,953,81,16562,1772,130378,146940,10/27/2020
6/24/2020,120,24106,3502,217397,241503,9,2021,10,1623,1,299,99,18,18,5,958,44,16606,1677,132055,148661,10/27/2020
6/25/2020,103,24209,2883,220280,244489,6,2027,14,1637,1,300,90,17,17,1,959,50,16656,1499,133554,150210,10/27/2020
6/26/2020,94,24303,2488,222768,247071,2,2029,10,1647,0,300,82,18,18,1,960,60,16716,1320,134874,151590,10/27/2020
6/27/2020,84,24387,3216,225984,250371,5,2034,3,1650,1,301,83,17,17,5,965,37,16753,1216,136090,152843,10/27/2020
6/28/2020,39,24426,1469,227453,251879,4,2038,4,1654,4,305,79,15,14,6,971,17,16770,592,136682,153452,10/27/2020
6/29/2020,85,24511,3697,231150,255661,4,2042,5,1659,0,305,78,14,14,1,972,39,16809,1344,138026,154835,10/27/2020
6/30/2020,57,24568,1958,233108,257676,1,2043,5,1664,1,306,73,12,11,4,976,33,16842,993,139019,155861,10/27/2020
7/1/2020,144,24712,4098,237206,261918,8,2051,10,1674,0,306,71,11,11,1,977,79,16921,1920,140939,157860,10/27/2020
7/2/2020,103,24815,2803,240009,264824,5,2056,5,1679,1,307,70,10,10,3,980,59,16980,1080,142019,158999,10/27/2020
7/3/2020,50,24865,2078,242087,266952,9,2065,6,1685,0,307,73,9,9,3,983,25,17005,778,142797,159802,10/27/2020
7/4/2020,57,24922,2345,244432,269354,2,2067,4,1689,1,308,70,10,9,2,985,33,17038,1004,143801,160839,10/27/2020
7/5/2020,49,24971,2932,247364,272335,1,2068,2,1691,1,309,68,8,8,2,987,26,17064,1436,145237,162301,10/27/2020
7/6/2020,101,25072,2811,250175,275247,6,2074,6,1697,0,309,68,9,9,4,991,57,17121,1543,146780,163901,10/27/2020
7/7/2020,81,25153,3457,253632,278785,5,2079,7,1704,0,309,66,8,8,2,993,47,17168,1532,148312,165480,10/27/2020
7/8/2020,105,25258,3409,257041,282299,4,2083,2,1706,0,309,68,9,8,0,993,64,17232,1422,149734,166966,10/27/2020
7/9/2020,94,25352,3714,260755,286107,9,2092,3,1709,0,309,74,9,8,0,993,50,17282,1614,151348,168630,10/27/2020
7/10/2020,132,25484,4432,265187,290671,6,2098,3,1712,2,311,75,7,7,3,996,80,17362,2062,153410,170772,10/27/2020
7/11/2020,63,25547,2932,268119,293666,6,2104,3,1715,1,312,77,6,6,3,999,36,17398,1312,154722,172120,10/27/2020
7/12/2020,47,25594,1837,269956,295550,1,2105,3,1718,1,313,74,6,5,3,1002,34,17432,941,155663,173095,10/27/2020
7/13/2020,84,25678,3201,273157,298835,8,2113,10,1728,0,313,72,6,5,1,1003,61,17493,1500,157163,174656,10/27/2020
7/14/2020,73,25751,3293,276450,302201,7,2120,4,1732,0,313,75,5,5,1,1004,43,17536,1371,158534,176070,10/27/2020
7/15/2020,130,25881,4173,280623,306504,5,2125,7,1739,0,313,73,5,4,0,1004,99,17635,1744,160278,177913,10/27/2020
7/16/2020,102,25983,3734,284357,310340,6,2131,9,1748,0,313,70,6,5,1,1005,75,17710,1609,161887,179597,10/27/2020
7/17/2020,156,26139,4236,288593,314732,14,2145,3,1751,1,314,80,5,5,2,1007,79,17789,1841,163728,181517,10/27/2020
7/18/2020,85,26224,3269,291862,318086,5,2150,9,1760,1,315,75,5,4,4,1011,70,17859,1392,165120,182979,10/27/2020
7/19/2020,82,26306,2694,294556,320862,7,2157,3,1763,0,315,79,6,4,2,1013,57,17916,1146,166266,184182,10/27/2020
7/20/2020,71,26377,2664,297220,323597,9,2166,7,1770,0,315,81,7,5,2,1015,68,17984,1454,167720,185704,10/27/2020
7/21/2020,130,26507,4299,301519,328026,9,2175,11,1781,0,315,79,9,6,1,1016,109,18093,1911,169631,187724,10/27/2020
7/22/2020,130,26637,3927,305446,332083,11,2186,11,1792,1,316,78,7,6,1,1017,86,18179,1678,171309,189488,10/27/2020
7/23/2020,141,26778,4413,309859,336637,9,2195,6,1798,0,316,81,8,7,0,1017,115,18294,1975,173284,191578,10/27/2020
7/24/2020,172,26950,5961,315820,342770,14,2209,14,1812,0,316,81,9,7,0,1017,119,18413,2307,175591,194004,10/27/2020
7/25/2020,134,27084,4399,320219,347303,7,2216,7,1819,0,316,81,10,8,3,1020,108,18521,2088,177679,196200,10/27/2020
7/26/2020,62,27146,3027,323246,350392,8,2224,9,1828,0,316,80,11,7,1,1021,54,18575,1331,179010,197585,10/27/2020
7/27/2020,188,27334,4190,327436,354770,12,2236,7,1835,0,316,85,13,8,1,1022,138,18713,2336,181346,200059,10/27/2020
7/28/2020,105,27439,3834,331270,358709,5,2241,5,1840,0,316,85,14,7,1,1023,95,18808,1628,182974,201782,10/27/2020
7/29/2020,190,27629,5137,336407,364036,11,2252,12,1852,0,316,84,15,7,0,1023,154,18962,2308,185282,204244,10/27/2020
7/30/2020,121,27750,4344,340751,368501,6,2258,2,1854,1,317,87,15,6,1,1024,97,19059,1642,186924,205983,10/27/2020
7/31/2020,131,27881,5509,346260,374141,8,2266,10,1864,0,317,85,15,7,1,1025,89,19148,1844,188768,207916,10/27/2020
8/1/2020,108,27989,4292,350552,378541,7,2273,2,1866,0,317,90,14,7,1,1026,88,19236,1554,190322,209558,10/27/2020
8/2/2020,84,28073,2802,353354,381427,12,2285,12,1878,2,319,88,14,8,2,1028,62,19298,1268,191590,210888,10/27/2020
8/3/2020,186,28259,5238,358592,386851,13,2298,12,1890,0,319,89,16,7,1,1029,149,19447,2190,193780,213227,10/27/2020
8/4/2020,125,28384,3691,362283,390667,9,2307,6,1896,1,320,91,12,5,2,1031,99,19546,1767,195547,215093,10/27/2020
8/5/2020,147,28531,5934,368217,396748,12,2319,10,1906,1,321,92,10,5,2,1033,118,19664,2462,198009,217673,10/27/2020
8/6/2020,169,28700,5533,373750,402450,7,2326,9,1915,0,321,90,9,4,0,1033,121,19785,2396,200405,220190,10/27/2020
8/7/2020,121,28821,4847,378597,407418,13,2339,10,1925,1,322,92,9,3,2,1035,87,19872,2137,202542,222414,10/27/2020
8/8/2020,123,28944,4107,382704,411648,19,2358,6,1931,1,323,104,8,3,1,1036,91,19963,1774,204316,224279,10/27/2020
8/9/2020,42,28986,1722,384426,413412,8,2366,10,1941,0,323,102,9,4,0,1036,35,19998,1067,205383,225381,10/27/2020
8/10/2020,149,29135,4584,389010,418145,11,2377,12,1953,0,323,101,9,4,1,1037,113,20111,2016,207399,227510,10/27/2020
8/11/2020,105,29240,4329,393339,422579,6,2383,14,1967,0,323,93,10,4,3,1040,92,20203,2259,209658,229861,10/27/2020
8/12/2020,121,29361,5184,398523,427884,8,2391,11,1978,0,323,90,9,3,1,1041,101,20304,2620,212278,232582,10/27/2020
8/13/2020,135,29496,4192,402715,432211,13,2404,12,1990,0,323,91,11,3,0,1041,95,20399,1897,214175,234574,10/27/2020
8/14/2020,145,29641,5494,408209,437850,13,2417,11,2001,0,323,93,11,4,3,1044,99,20498,1970,216145,236643,10/27/2020
8/15/2020,105,29746,4533,412742,442488,9,2426,11,2012,1,324,90,11,5,0,1044,88,20586,1685,217830,238416,10/27/2020
8/16/2020,83,29829,2472,415214,445043,7,2433,6,2018,4,328,87,8,4,6,1050,70,20656,959,218789,239445,10/27/2020
8/17/2020,106,29935,4570,419784,449719,10,2443,7,2025,0,328,90,8,5,2,1052,87,20743,2385,221174,241917,10/27/2020
8/18/2020,128,30063,4904,424688,454751,11,2454,9,2034,1,329,91,8,4,5,1057,94,20837,2744,223918,244755,10/27/2020
8/19/2020,113,30176,5065,429753,459929,8,2462,9,2043,1,330,89,9,5,0,1057,90,20927,2636,226554,247481,10/27/2020
8/20/2020,173,30349,7405,437158,467507,12,2474,6,2049,2,332,93,10,5,3,1060,139,21066,3512,230066,251132,10/27/2020
8/21/2020,151,30500,6571,443729,474229,8,2482,5,2054,1,333,95,9,4,2,1062,125,21191,2941,233007,254198,10/27/2020
8/22/2020,96,30596,5547,449276,479872,10,2492,12,2066,0,333,93,11,4,1,1063,84,21275,2603,235610,256885,10/27/2020
8/23/2020,70,30666,4370,453646,484312,11,2503,6,2072,0,333,98,11,2,1,1064,56,21331,2468,238078,259409,10/27/2020
8/24/2020,105,30771,5776,459422,490193,7,2510,10,2082,1,334,94,13,4,1,1065,77,21408,3144,241222,262630,10/27/2020
8/25/2020,108,30879,4759,464181,495060,10,2520,4,2086,1,335,99,11,4,1,1066,92,21500,2287,243509,265009,10/27/2020
8/26/2020,170,31049,9477,473658,504707,4,2524,8,2094,0,335,95,9,5,1,1067,127,21627,3083,246592,268219,10/27/2020
8/27/2020,92,31141,8564,482222,513363,6,2530,13,2107,1,336,87,6,5,2,1069,70,21697,3161,249753,271450,10/27/2020
8/28/2020,112,31253,7991,490213,521466,14,2544,4,2111,0,336,97,9,7,2,1071,87,21784,2428,252181,273965,10/27/2020
8/29/2020,65,31318,5368,495581,526899,6,2550,8,2119,1,337,94,10,6,2,1073,51,21835,1909,254090,275925,10/27/2020
8/30/2020,66,31384,4320,499901,531285,7,2557,4,2123,0,337,97,8,5,2,1075,48,21883,1993,256083,277966,10/27/2020
8/31/2020,105,31489,4863,504764,536253,12,2569,15,2138,0,337,94,8,4,1,1076,81,21964,2185,258268,280232,10/27/2020
9/1/2020,97,31586,7109,511873,543459,6,2575,9,2147,1,338,90,7,4,2,1078,65,22029,2377,260645,282674,10/27/2020
9/2/2020,125,31711,10524,522397,554108,9,2584,10,2157,1,339,88,8,4,2,1080,104,22133,3050,263695,285828,10/27/2020
9/3/2020,90,31801,11065,533462,565263,8,2592,8,2165,0,339,88,9,4,3,1083,73,22206,2582,266277,288483,10/27/2020
9/4/2020,102,31903,8953,542415,574318,11,2603,4,2169,0,339,95,9,4,1,1084,83,22289,2363,268640,290929,10/27/2020
9/5/2020,52,31955,6301,548716,580671,6,2609,9,2178,0,339,92,8,3,1,1085,42,22331,1598,270238,292569,10/27/2020
9/6/2020,87,32042,4317,553033,585075,4,2613,8,2186,1,340,87,6,3,1,1086,64,22395,1946,272184,294579,10/27/2020
9/7/2020,35,32077,3001,556034,588111,11,2624,3,2189,0,340,95,5,3,1,1087,26,22421,645,272829,295250,10/27/2020
9/8/2020,74,32151,6375,562409,594560,6,2630,12,2201,1,341,88,6,3,2,1089,66,22487,1594,274423,296910,10/27/2020
9/9/2020,118,32269,8641,571050,603319,9,2639,5,2206,1,342,91,9,3,1,1090,102,22589,2144,276567,299156,10/27/2020
9/10/2020,164,32433,11327,582377,614810,9,2648,8,2214,0,342,92,10,3,1,1091,111,22700,2274,278841,301541,10/27/2020
9/11/2020,120,32553,9449,591826,624379,11,2659,11,2225,0,342,92,10,5,0,1091,99,22799,1965,280806,303605,10/27/2020
9/12/2020,109,32662,6160,597986,630648,8,2667,5,2230,2,344,93,9,5,3,1094,97,22896,1519,282325,305221,10/27/2020
9/13/2020,58,32720,2710,600696,633416,4,2671,3,2233,0,344,94,10,5,0,1094,54,22950,858,283183,306133,10/27/2020
9/14/2020,104,32824,6433,607129,639953,5,2676,3,2236,2,346,94,10,5,2,1096,95,23045,1731,284914,307959,10/27/2020
9/15/2020,122,32946,8462,615591,648537,7,2683,2,2238,1,347,98,10,5,2,1098,124,23169,2199,287113,310282,10/27/2020
9/16/2020,137,33083,9711,625302,658385,7,2690,7,2245,2,349,96,9,6,5,1103,118,23287,1973,289086,312373,10/27/2020
9/17/2020,124,33207,9233,634535,667742,7,2697,14,2259,0,349,89,8,4,0,1103,154,23441,1953,291039,314480,10/27/2020
9/18/2020,132,33339,10034,644569,677908,7,2704,7,2266,1,350,88,11,6,2,1105,132,23573,1931,292970,316543,10/27/2020
9/19/2020,115,33454,8296,652865,686319,7,2711,3,2269,0,350,92,10,6,4,1109,112,23685,1693,294663,318348,10/27/2020
9/20/2020,60,33514,3668,656533,690047,7,2718,6,2275,2,352,91,9,8,4,1113,49,23734,1322,295985,319719,10/27/2020
9/21/2020,102,33616,7015,663548,697164,12,2730,3,2278,2,354,98,8,6,2,1115,94,23828,2413,298398,322226,10/27/2020
9/22/2020,154,33770,9282,672830,706600,12,2742,3,2281,1,355,106,7,5,1,1116,124,23952,2209,300607,324559,10/27/2020
9/23/2020,136,33906,10638,683468,717374,12,2754,7,2288,0,355,111,6,5,0,1116,127,24079,2218,302825,326904,10/27/2020
9/24/2020,118,34024,12464,695932,729956,7,2761,9,2297,1,356,108,7,5,1,1117,120,24199,3168,305993,330192,10/27/2020
9/25/2020,149,34173,10541,706473,740646,9,2770,10,2307,0,356,107,6,5,1,1118,141,24340,3012,309005,333345,10/27/2020
9/26/2020,146,34319,10549,717022,751341,12,2782,9,2316,0,356,110,6,5,1,1119,118,24458,2425,311430,335888,10/27/2020
9/27/2020,43,34362,2761,719783,754145,7,2789,5,2321,0,356,112,9,5,0,1119,34,24492,846,312276,336768,10/27/2020
9/28/2020,151,34513,7299,727082,761595,7,2796,7,2328,2,358,110,7,5,2,1121,133,24625,2260,314536,339161,10/27/2020
9/29/2020,208,34721,11033,738115,772836,12,2808,18,2346,1,359,103,6,6,1,1122,190,24815,2830,317366,342181,10/27/2020
9/30/2020,221,34942,12217,750332,785274,6,2814,6,2352,0,359,103,6,6,1,1123,186,25001,2602,319968,344969,10/27/2020
10/1/2020,184,35126,12493,762825,797951,16,2830,13,2365,1,360,105,5,4,2,1125,166,25167,2431,322399,347566,10/27/2020
10/2/2020,209,35335,12134,774959,810294,13,2843,13,2378,1,361,104,6,4,2,1127,181,25348,2502,324901,350249,10/27/2020
10/3/2020,157,35492,9314,784273,819765,9,2852,9,2387,2,363,102,7,4,2,1129,132,25480,2032,326933,352413,10/27/2020
10/4/2020,81,35573,2365,786638,822211,11,2863,9,2396,1,364,103,6,4,2,1131,78,25558,960,327893,353451,10/27/2020
10/5/2020,174,35747,8960,795598,831345,30,2893,10,2406,2,366,121,8,5,4,1135,159,25717,3036,330929,356646,10/27/2020
10/6/2020,176,35923,11172,806770,842693,11,2904,4,2410,0,366,128,10,6,0,1135,186,25903,2909,333838,359741,10/27/2020
10/7/2020,228,36151,12420,819190,855341,13,2917,14,2424,2,368,125,8,6,2,1137,242,26145,3537,337375,363520,10/27/2020
10/8/2020,262,36413,15184,834374,870787,16,2933,12,2436,1,369,128,7,5,3,1140,274,26419,4202,341577,367996,10/27/2020
10/9/2020,216,36629,13729,848103,884732,20,2953,12,2448,0,369,136,10,7,3,1143,198,26617,4347,345924,372541,10/27/2020
10/10/2020,229,36858,13819,861922,898780,19,2972,10,2458,1,370,144,13,7,2,1145,196,26813,3827,349751,376564,10/27/2020
10/11/2020,94,36952,3251,865173,902125,12,2984,9,2467,1,371,146,14,5,6,1151,87,26900,1159,350910,377810,10/27/2020
10/12/2020,165,37117,6410,871583,908700,19,3003,15,2482,2,373,148,14,5,4,1155,159,27059,1748,352658,379717,10/27/2020
10/13/2020,210,37327,8491,880074,917401,14,3017,13,2495,4,377,145,13,5,7,1162,206,27265,2314,354972,382237,10/27/2020
10/14/2020,320,37647,15018,895092,932739,16,3033,7,2502,0,377,154,15,5,2,1164,305,27570,4066,359038,386608,10/27/2020
10/15/2020,261,37908,14579,909671,947579,11,3044,16,2518,1,378,148,13,5,2,1166,254,27824,3580,362618,390442,10/27/2020
10/16/2020,276,38184,14971,924642,962826,13,3057,18,2536,1,379,142,13,4,2,1168,273,28097,3405,366023,394120,10/27/2020
10/17/2020,348,38532,14021,938663,977195,18,3075,11,2547,1,380,148,17,4,2,1170,304,28401,3276,369299,397700,10/27/2020
10/18/2020,153,38685,3943,942606,981291,18,3093,11,2558,0,380,155,17,5,2,1172,127,28528,1285,370584,399112,10/27/2020
10/19/2020,380,39065,8357,950963,990028,19,3112,22,2580,2,382,150,15,5,1,1173,319,28847,2529,373113,401960,10/27/2020
10/20/2020,428,39493,12901,963864,1003357,22,3134,17,2597,0,382,155,13,7,3,1176,381,29228,2912,376025,405253,10/27/2020
10/21/2020,538,40031,17310,981174,1021205,21,3155,8,2605,2,384,166,15,9,3,1179,468,29696,3540,379565,409261,10/27/2020
10/22/2020,536,40567,15635,996809,1037376,24,3179,20,2625,3,387,167,14,9,3,1182,484,30180,3249,382814,412994,10/27/2020
10/23/2020,510,41077,16541,1013350,1054427,21,3200,21,2646,1,388,166,15,9,3,1185,452,30632,2919,385733,416365,10/27/2020
10/24/2020,355,41432,9966,1023316,1064748,14,3214,11,2657,0,388,169,14,8,1,1186,331,30963,2291,388024,418987,10/27/2020
10/25/2020,228,41660,4663,1027979,1069639,15,3229,15,2672,1,389,168,14,8,1,1187,194,31157,1495,389519,420676,10/27/2020
10/26/2020,334,41994,7697,1035676,1077670,,,,,,,,,,1,1188,288,31445,2505,392024,423469,10/27/2020
2/27/2020,0,0,0,0,0,1,1,0,0,0,0,1,0,0,0,0,0,0,0,0,0,10/28/2020
2/28/2020,0,0,0,0,0,0,1,0,0,0,0,1,1,0,0,0,0,0,0,0,0,10/28/2020
2/29/2020,0,0,0,0,0,0,1,0,0,0,0,1,1,0,0,0,0,0,0,0,0,10/28/2020
3/1/2020,2,2,2,2,4,0,1,0,0,0,0,1,1,1,0,0,2,2,2,2,4,10/28/2020
3/2/2020,0,2,1,3,5,1,2,0,0,0,0,2,2,2,0,0,0,2,1,3,5,10/28/2020
3/3/2020,0,2,2,5,7,0,2,0,0,0,0,2,2,2,0,0,0,2,2,5,7,10/28/2020
3/4/2020,0,2,12,17,19,1,3,0,0,0,0,3,2,2,0,0,0,2,10,15,17,10/28/2020
3/5/2020,0,2,4,21,23,0,3,0,0,0,0,3,2,2,0,0,1,3,4,19,22,10/28/2020
3/6/2020,1,3,12,33,36,0,3,0,0,0,0,3,2,2,0,0,0,3,11,30,33,10/28/2020
3/7/2020,0,3,19,52,55,0,3,0,0,0,0,3,2,1,0,0,0,3,19,49,52,10/28/2020
3/8/2020,0,3,18,70,73,0,3,0,0,0,0,3,2,1,0,0,0,3,18,67,70,10/28/2020
3/9/2020,1,4,15,85,89,0,3,0,0,0,0,3,2,1,0,0,1,4,15,82,86,10/28/2020
3/10/2020,2,6,25,110,116,0,3,0,0,0,0,3,2,1,0,0,1,5,23,105,110,10/28/2020
3/11/2020,0,6,34,144,150,1,4,0,0,0,0,4,1,1,0,0,0,5,34,139,144,10/28/2020
3/12/2020,9,15,41,185,200,1,5,0,0,0,0,5,1,1,0,0,8,13,38,177,190,10/28/2020
3/13/2020,6,21,50,235,256,4,9,1,1,0,0,8,1,1,0,0,6,19,48,225,244,10/28/2020
3/14/2020,0,21,90,325,346,0,9,0,1,0,0,8,1,1,0,0,0,19,86,311,330,10/28/2020
3/15/2020,1,22,54,379,401,1,10,0,1,0,0,9,2,1,0,0,1,20,54,365,385,10/28/2020
3/16/2020,2,24,95,474,498,2,12,0,1,0,0,11,2,0,0,0,2,22,92,457,479,10/28/2020
3/17/2020,12,36,162,636,672,6,18,0,1,0,0,17,2,0,0,0,11,33,150,607,640,10/28/2020
3/18/2020,9,45,116,752,797,3,21,0,1,0,0,20,2,0,0,0,11,44,110,717,761,10/28/2020
3/19/2020,15,60,262,1014,1074,2,23,1,2,0,0,21,3,0,1,1,17,61,249,966,1027,10/28/2020
3/20/2020,13,73,197,1211,1284,5,28,0,2,0,0,26,4,0,0,1,13,74,189,1155,1229,10/28/2020
3/21/2020,12,85,126,1337,1422,3,31,2,4,0,0,27,5,0,0,1,14,88,122,1277,1365,10/28/2020
3/22/2020,27,112,282,1619,1731,2,33,0,4,0,0,29,5,0,0,1,25,113,259,1536,1649,10/28/2020
3/23/2020,14,126,169,1788,1914,15,48,1,5,0,0,43,9,3,0,1,16,129,164,1700,1829,10/28/2020
3/24/2020,20,146,242,2030,2176,7,55,0,5,0,0,50,10,4,0,1,19,148,233,1933,2081,10/28/2020
3/25/2020,26,172,182,2212,2384,5,60,1,6,0,0,54,11,3,0,1,28,176,170,2103,2279,10/28/2020
3/26/2020,35,207,181,2393,2600,10,70,5,11,0,0,59,14,5,0,1,41,217,172,2275,2492,10/28/2020
3/27/2020,27,234,214,2607,2841,9,79,1,12,1,1,66,17,6,2,3,31,248,200,2475,2723,10/28/2020
3/28/2020,59,293,260,2867,3160,13,92,3,15,2,3,74,15,6,1,4,64,312,240,2715,3027,10/28/2020
3/29/2020,100,393,350,3217,3610,8,100,4,19,1,4,77,18,8,2,6,105,417,312,3027,3444,10/28/2020
3/30/2020,62,455,222,3439,3894,20,120,5,24,0,4,92,20,11,3,9,78,495,184,3211,3706,10/28/2020
3/31/2020,71,526,369,3808,4334,11,131,7,31,1,5,95,22,13,2,11,73,568,294,3505,4073,10/28/2020
4/1/2020,99,625,698,4506,5131,18,149,7,38,0,5,106,30,15,1,12,100,668,636,4141,4809,10/28/2020
4/2/2020,52,677,477,4983,5660,22,171,6,44,2,7,120,36,21,4,16,62,730,433,4574,5304,10/28/2020
4/3/2020,108,785,774,5757,6542,23,194,7,51,0,7,136,43,25,3,19,100,830,702,5276,6106,10/28/2020
4/4/2020,143,928,660,6417,7345,22,216,4,55,5,12,149,41,30,9,28,138,968,613,5889,6857,10/28/2020
4/5/2020,187,1115,1156,7573,8688,20,236,9,64,1,13,159,44,36,2,30,181,1149,1054,6943,8092,10/28/2020
4/6/2020,218,1333,1706,9279,10612,26,262,7,71,0,13,178,48,40,7,37,207,1356,1535,8478,9834,10/28/2020
4/7/2020,284,1617,1629,10908,12525,20,282,5,76,2,15,191,50,42,5,42,261,1617,1469,9947,11564,10/28/2020
4/8/2020,290,1907,1720,12628,14535,19,301,7,83,6,21,197,50,38,10,52,271,1888,1537,11484,13372,10/28/2020
4/9/2020,283,2190,1516,14144,16334,32,333,9,92,4,25,216,53,40,7,59,277,2165,1348,12832,14997,10/28/2020
4/10/2020,419,2609,2574,16718,19327,29,362,16,108,5,30,224,59,41,11,70,401,2566,2344,15176,17742,10/28/2020
4/11/2020,297,2906,1905,18623,21529,29,391,11,119,2,32,240,61,48,12,82,281,2847,1706,16882,19729,10/28/2020
4/12/2020,314,3220,1670,20293,23513,35,426,13,132,5,37,257,59,49,9,91,285,3132,1417,18299,21431,10/28/2020
4/13/2020,161,3381,935,21228,24609,35,461,13,145,3,40,276,64,54,9,100,187,3319,832,19131,22450,10/28/2020
4/14/2020,289,3670,1787,23015,26685,27,488,18,163,5,45,280,72,53,8,108,262,3581,1517,20648,24229,10/28/2020
4/15/2020,351,4021,1799,24814,28835,31,519,20,183,3,48,288,72,54,17,125,306,3887,1532,22180,26067,10/28/2020
4/16/2020,447,4468,2494,27308,31776,36,555,25,208,6,54,293,72,53,14,139,387,4274,2063,24243,28517,10/28/2020
4/17/2020,304,4772,1821,29129,33901,32,587,20,228,7,61,298,66,45,21,160,290,4564,1428,25671,30235,10/28/2020
4/18/2020,321,5093,1725,30854,35947,26,613,18,246,4,65,302,63,49,15,175,284,4848,1313,26984,31832,10/28/2020
4/19/2020,381,5474,2047,32901,38375,23,636,26,272,1,66,298,65,55,11,186,337,5185,1725,28709,33894,10/28/2020
4/20/2020,394,5868,1907,34808,40676,46,682,29,301,2,68,313,75,56,10,196,376,5561,1561,30270,35831,10/28/2020
4/21/2020,444,6312,2110,36918,43230,45,727,33,334,5,73,320,72,56,18,214,383,5944,1688,31958,37902,10/28/2020
4/22/2020,418,6730,2390,39308,46038,41,768,32,366,5,78,324,73,58,18,232,379,6323,1896,33854,40177,10/28/2020
4/23/2020,479,7209,2469,41777,48986,32,800,28,394,5,83,323,76,62,15,247,412,6735,1840,35694,42429,10/28/2020
4/24/2020,491,7700,3284,45061,52761,35,835,26,420,4,87,328,85,63,15,262,407,7142,2602,38296,45438,10/28/2020
4/25/2020,393,8093,2206,47267,55360,34,869,17,437,5,92,340,85,62,14,276,300,7442,1746,40042,47484,10/28/2020
4/26/2020,316,8409,2309,49576,57985,33,902,15,452,3,95,355,86,59,14,290,274,7716,1857,41899,49615,10/28/2020
4/27/2020,249,8658,1620,51196,59854,29,931,21,473,4,99,359,86,61,10,300,206,7922,1151,43050,50972,10/28/2020
4/28/2020,410,9068,2263,53459,62527,44,975,24,497,3,102,376,88,59,22,322,332,8254,1737,44787,53041,10/28/2020
4/29/2020,476,9544,3343,56802,66346,36,1011,38,535,11,113,363,78,53,18,340,371,8625,2402,47189,55814,10/28/2020
4/30/2020,432,9976,2769,59571,69547,33,1044,38,573,6,119,352,83,57,24,364,350,8975,1895,49084,58059,10/28/2020
5/1/2020,454,10430,3086,62657,73087,51,1095,39,612,3,122,361,84,58,14,378,324,9299,2145,51229,60528,10/28/2020
5/2/2020,257,10687,1926,64583,75270,36,1131,38,650,5,127,354,91,62,24,402,192,9491,1258,52487,61978,10/28/2020
5/3/2020,283,10970,2160,66743,77713,31,1162,26,676,8,135,351,90,61,21,423,183,9674,1556,54043,63717,10/28/2020
5/4/2020,387,11357,2098,68841,80198,30,1192,31,707,6,141,344,88,57,18,441,290,9964,1546,55589,65553,10/28/2020
5/5/2020,433,11790,2873,71714,83504,29,1221,32,739,6,147,335,82,54,16,457,301,10265,1943,57532,67797,10/28/2020
5/6/2020,488,12278,2830,74544,86822,28,1249,44,783,9,156,310,79,54,21,478,340,10605,1903,59435,70040,10/28/2020
5/7/2020,425,12703,2969,77513,90216,36,1285,43,826,5,161,298,71,52,21,499,270,10875,1947,61382,72257,10/28/2020
5/8/2020,359,13062,2598,80111,93173,30,1315,29,855,5,166,294,71,53,22,521,229,11104,1729,63111,74215,10/28/2020
5/9/2020,467,13529,3346,83457,96986,22,1337,21,876,4,170,291,69,51,15,536,290,11394,2234,65345,76739,10/28/2020
5/10/2020,285,13814,2117,85574,99388,20,1357,23,899,6,176,282,70,49,14,550,189,11583,1509,66854,78437,10/28/2020
5/11/2020,257,14071,1857,87431,101502,31,1388,16,915,6,182,291,71,49,15,565,174,11757,1289,68143,79900,10/28/2020
5/12/2020,387,14458,2611,90042,104500,23,1411,18,933,4,186,292,69,48,22,587,224,11981,1692,69835,81816,10/28/2020
5/13/2020,351,14809,3630,93672,108481,23,1434,25,958,1,187,289,69,49,13,600,199,12180,1954,71789,83969,10/28/2020
5/14/2020,329,15138,3408,97080,112218,19,1453,27,985,3,190,278,64,45,15,615,232,12412,2000,73789,86201,10/28/2020
5/15/2020,381,15519,3458,100538,116057,24,1477,41,1026,5,195,256,62,45,14,629,232,12644,1793,75582,88226,10/28/2020
5/16/2020,449,15968,4156,104694,120662,25,1502,15,1041,5,200,261,61,46,15,644,247,12891,1939,77521,90412,10/28/2020
5/17/2020,240,16208,2768,107462,123670,17,1519,9,1050,5,205,264,59,45,10,654,126,13017,1529,79050,92067,10/28/2020
5/18/2020,250,16458,2001,109463,125921,19,1538,16,1066,5,210,262,57,40,18,672,135,13152,1362,80412,93564,10/28/2020
5/19/2020,415,16873,3168,112631,129504,23,1561,33,1099,5,215,247,56,38,11,683,215,13367,1913,82325,95692,10/28/2020
5/20/2020,326,17199,2771,115402,132601,19,1580,23,1122,7,222,236,52,33,22,705,183,13550,1508,83833,97383,10/28/2020
5/21/2020,374,17573,3757,119159,136732,26,1606,15,1137,3,225,244,53,29,20,725,168,13718,1925,85758,99476,10/28/2020
5/22/2020,351,17924,3161,122320,140244,20,1626,29,1166,5,230,230,52,29,11,736,206,13924,1600,87358,101282,10/28/2020
5/23/2020,253,18177,2742,125062,143239,19,1645,11,1177,3,233,235,52,32,13,749,109,14033,1263,88621,102654,10/28/2020
5/24/2020,163,18340,1370,126432,144772,13,1658,14,1191,2,235,232,53,36,8,757,83,14116,770,89391,103507,10/28/2020
5/25/2020,147,18487,1385,127817,146304,14,1672,14,1205,0,235,232,53,34,10,767,76,14192,760,90151,104343,10/28/2020
5/26/2020,285,18772,2620,130437,149209,24,1696,22,1227,5,240,229,48,33,15,782,158,14350,1775,91926,106276,10/28/2020
5/27/2020,276,19048,2057,132494,151542,20,1716,18,1245,3,243,228,50,33,10,792,132,14482,1127,93053,107535,10/28/2020
5/28/2020,348,19396,3359,135853,155249,17,1733,29,1274,4,247,212,47,32,8,800,130,14612,1112,94165,108777,10/28/2020
5/29/2020,410,19806,3915,139768,159574,19,1752,27,1301,6,253,198,43,31,12,812,174,14786,1566,95731,110517,10/28/2020
5/30/2020,225,20031,3915,143683,163714,16,1768,19,1320,4,257,191,41,29,12,824,109,14895,1812,97543,112438,10/28/2020
5/31/2020,155,20186,1689,145372,165558,11,1779,10,1330,1,258,191,44,26,3,827,78,14973,851,98394,113367,10/28/2020
6/1/2020,212,20398,2792,148164,168562,8,1787,14,1344,1,259,184,45,29,5,832,93,15066,1376,99770,114836,10/28/2020
6/2/2020,273,20671,3022,151186,171857,8,1795,10,1354,3,262,179,38,25,10,842,98,15164,1433,101203,116367,10/28/2020
6/3/2020,254,20925,3486,154672,175597,14,1809,18,1372,6,268,169,34,25,11,853,99,15263,1650,102853,118116,10/28/2020
6/4/2020,276,21201,4471,159143,180344,7,1816,26,1398,4,272,146,31,24,12,865,107,15370,2029,104882,120252,10/28/2020
6/5/2020,215,21416,3513,162656,184072,15,1831,13,1411,6,278,142,27,21,11,876,99,15469,1568,106450,121919,10/28/2020
6/6/2020,201,21617,2616,165272,186889,10,1841,7,1418,2,280,143,29,19,6,882,67,15536,1119,107569,123105,10/28/2020
6/7/2020,83,21700,1625,166897,188597,11,1852,7,1425,1,281,146,25,17,4,886,51,15587,779,108348,123935,10/28/2020
6/8/2020,119,21819,1849,168746,190565,15,1867,12,1437,2,283,147,27,18,4,890,45,15632,952,109300,124932,10/28/2020
6/9/2020,223,22042,2673,171419,193461,10,1877,19,1456,0,283,138,28,21,1,891,64,15696,1249,110549,126245,10/28/2020
6/10/2020,209,22251,2987,174406,196657,13,1890,12,1468,2,285,137,24,17,4,895,101,15797,1460,112009,127806,10/28/2020
6/11/2020,195,22446,3513,177919,200365,7,1897,15,1483,1,286,128,25,16,6,901,88,15885,1525,113534,129419,10/28/2020
6/12/2020,209,22655,4601,182520,205175,9,1906,16,1499,1,287,120,24,16,2,903,78,15963,2165,115699,131662,10/28/2020
6/13/2020,113,22768,3036,185556,208324,6,1912,5,1504,0,287,121,20,15,3,906,49,16012,1363,117062,133074,10/28/2020
6/14/2020,81,22849,2046,187602,210451,7,1919,8,1512,1,288,119,20,14,3,909,33,16045,963,118025,134070,10/28/2020
6/15/2020,188,23037,3108,190710,213747,14,1933,19,1531,0,288,114,20,16,5,914,75,16120,1777,119802,135922,10/28/2020
6/16/2020,110,23147,3017,193727,216874,11,1944,9,1540,1,289,115,22,16,8,922,50,16170,1541,121343,137513,10/28/2020
6/17/2020,127,23274,2835,196562,219836,15,1959,22,1562,4,293,104,18,14,6,928,50,16220,1311,122654,138874,10/28/2020
6/18/2020,149,23423,3048,199610,223033,9,1968,15,1577,1,294,97,19,16,7,935,70,16290,1309,123963,140253,10/28/2020
6/19/2020,141,23564,3769,203379,226943,12,1980,12,1589,1,295,96,20,17,3,938,59,16349,1358,125321,141670,10/28/2020
6/20/2020,84,23648,1891,205270,228918,9,1989,12,1601,0,295,93,20,18,4,942,36,16385,810,126131,142516,10/28/2020
6/21/2020,37,23685,1064,206334,230019,8,1997,5,1606,0,295,96,20,18,2,944,30,16415,687,126818,143233,10/28/2020
6/22/2020,138,23823,3730,210064,233887,12,2009,16,1622,0,295,92,19,18,2,946,65,16480,1699,128517,144997,10/28/2020
6/23/2020,163,23986,3831,213895,237881,3,2012,13,1635,3,298,79,18,18,7,953,81,16561,1771,130288,146849,10/28/2020
6/24/2020,120,24106,3502,217397,241503,9,2021,11,1646,1,299,76,18,18,5,958,44,16605,1677,131965,148570,10/28/2020
6/25/2020,103,24209,2883,220280,244489,6,2027,14,1660,1,300,67,17,17,1,959,50,16655,1497,133462,150117,10/28/2020
6/26/2020,94,24303,2488,222768,247071,2,2029,10,1670,0,300,59,18,18,1,960,60,16715,1320,134782,151497,10/28/2020
6/27/2020,84,24387,3216,225984,250371,5,2034,3,1673,1,301,60,17,17,5,965,37,16752,1216,135998,152750,10/28/2020
6/28/2020,39,24426,1469,227453,251879,4,2038,4,1677,4,305,56,15,14,6,971,17,16769,592,136590,153359,10/28/2020
6/29/2020,85,24511,3697,231150,255661,4,2042,5,1682,0,305,55,14,14,1,972,39,16808,1344,137934,154742,10/28/2020
6/30/2020,57,24568,1958,233108,257676,1,2043,5,1687,1,306,50,12,11,4,976,33,16841,993,138927,155768,10/28/2020
7/1/2020,144,24712,4098,237206,261918,8,2051,10,1697,0,306,48,11,11,1,977,79,16920,1918,140845,157765,10/28/2020
7/2/2020,103,24815,2803,240009,264824,5,2056,5,1702,1,307,47,10,10,3,980,59,16979,1079,141924,158903,10/28/2020
7/3/2020,50,24865,2078,242087,266952,9,2065,6,1708,0,307,50,9,9,3,983,25,17004,778,142702,159706,10/28/2020
7/4/2020,57,24922,2345,244432,269354,2,2067,4,1712,1,308,47,10,9,2,985,33,17037,1004,143706,160743,10/28/2020
7/5/2020,49,24971,2932,247364,272335,1,2068,2,1714,1,309,45,8,8,2,987,26,17063,1436,145142,162205,10/28/2020
7/6/2020,101,25072,2811,250175,275247,6,2074,6,1720,0,309,45,9,9,4,991,57,17120,1541,146683,163803,10/28/2020
7/7/2020,81,25153,3457,253632,278785,5,2079,7,1727,0,309,43,8,8,2,993,47,17167,1532,148215,165382,10/28/2020
7/8/2020,105,25258,3409,257041,282299,4,2083,2,1729,0,309,45,9,8,0,993,64,17231,1422,149637,166868,10/28/2020
7/9/2020,94,25352,3714,260755,286107,9,2092,3,1732,0,309,51,9,8,0,993,50,17281,1612,151249,168530,10/28/2020
7/10/2020,132,25484,4432,265187,290671,6,2098,3,1735,2,311,52,7,7,3,996,80,17361,2062,153311,170672,10/28/2020
7/11/2020,63,25547,2932,268119,293666,6,2104,3,1738,1,312,54,6,6,3,999,36,17397,1311,154622,172019,10/28/2020
7/12/2020,47,25594,1837,269956,295550,1,2105,3,1741,1,313,51,6,5,3,1002,34,17431,941,155563,172994,10/28/2020
7/13/2020,84,25678,3201,273157,298835,8,2113,10,1751,0,313,49,6,5,1,1003,61,17492,1499,157062,174554,10/28/2020
7/14/2020,73,25751,3293,276450,302201,7,2120,4,1755,0,313,52,5,5,1,1004,43,17535,1371,158433,175968,10/28/2020
7/15/2020,130,25881,4173,280623,306504,5,2125,7,1762,0,313,50,5,4,0,1004,99,17634,1742,160175,177809,10/28/2020
7/16/2020,102,25983,3734,284357,310340,6,2131,9,1771,0,313,47,6,5,1,1005,75,17709,1608,161783,179492,10/28/2020
7/17/2020,156,26139,4236,288593,314732,14,2145,3,1774,1,314,57,5,5,2,1007,79,17788,1841,163624,181412,10/28/2020
7/18/2020,85,26224,3269,291862,318086,5,2150,9,1783,1,315,52,5,4,4,1011,70,17858,1392,165016,182874,10/28/2020
7/19/2020,82,26306,2694,294556,320862,7,2157,3,1786,0,315,56,6,4,2,1013,57,17915,1146,166162,184077,10/28/2020
7/20/2020,71,26377,2664,297220,323597,9,2166,7,1793,0,315,58,7,5,2,1015,68,17983,1454,167616,185599,10/28/2020
7/21/2020,130,26507,4299,301519,328026,9,2175,11,1804,0,315,56,9,6,1,1016,108,18091,1910,169526,187617,10/28/2020
7/22/2020,130,26637,3927,305446,332083,11,2186,11,1815,1,316,55,7,6,1,1017,86,18177,1676,171202,189379,10/28/2020
7/23/2020,141,26778,4413,309859,336637,9,2195,6,1821,0,316,58,8,7,0,1017,115,18292,1974,173176,191468,10/28/2020
7/24/2020,172,26950,5961,315820,342770,14,2209,14,1835,0,316,58,9,7,0,1017,119,18411,2306,175482,193893,10/28/2020
7/25/2020,134,27084,4399,320219,347303,7,2216,7,1842,0,316,58,10,8,3,1020,108,18519,2086,177568,196087,10/28/2020
7/26/2020,62,27146,3027,323246,350392,8,2224,9,1851,0,316,57,11,7,1,1021,54,18573,1329,178897,197470,10/28/2020
7/27/2020,188,27334,4190,327436,354770,12,2236,7,1858,0,316,62,13,8,1,1022,138,18711,2336,181233,199944,10/28/2020
7/28/2020,105,27439,3834,331270,358709,5,2241,5,1863,0,316,62,14,7,1,1023,95,18806,1627,182860,201666,10/28/2020
7/29/2020,190,27629,5137,336407,364036,11,2252,12,1875,0,316,61,15,7,0,1023,154,18960,2308,185168,204128,10/28/2020
7/30/2020,121,27750,4344,340751,368501,6,2258,2,1877,1,317,64,15,6,1,1024,97,19057,1642,186810,205867,10/28/2020
7/31/2020,131,27881,5509,346260,374141,8,2266,10,1887,0,317,62,15,7,1,1025,89,19146,1843,188653,207799,10/28/2020
8/1/2020,108,27989,4292,350552,378541,7,2273,2,1889,0,317,67,14,7,1,1026,88,19234,1554,190207,209441,10/28/2020
8/2/2020,84,28073,2802,353354,381427,12,2285,12,1901,2,319,65,14,8,2,1028,62,19296,1268,191475,210771,10/28/2020
8/3/2020,186,28259,5238,358592,386851,13,2298,12,1913,0,319,66,16,7,1,1029,149,19445,2189,193664,213109,10/28/2020
8/4/2020,125,28384,3691,362283,390667,9,2307,6,1919,1,320,68,12,5,2,1031,99,19544,1767,195431,214975,10/28/2020
8/5/2020,147,28531,5934,368217,396748,12,2319,10,1929,1,321,69,10,5,2,1033,118,19662,2461,197892,217554,10/28/2020
8/6/2020,169,28700,5533,373750,402450,7,2326,9,1938,0,321,67,9,4,0,1033,120,19782,2393,200285,220067,10/28/2020
8/7/2020,121,28821,4847,378597,407418,13,2339,10,1948,1,322,69,9,3,2,1035,87,19869,2135,202420,222289,10/28/2020
8/8/2020,123,28944,4107,382704,411648,19,2358,6,1954,1,323,81,8,3,1,1036,91,19960,1772,204192,224152,10/28/2020
8/9/2020,42,28986,1722,384426,413412,8,2366,10,1964,0,323,79,9,4,0,1036,35,19995,1067,205259,225254,10/28/2020
8/10/2020,149,29135,4584,389010,418145,11,2377,12,1976,0,323,78,9,4,1,1037,113,20108,2015,207274,227382,10/28/2020
8/11/2020,105,29240,4329,393339,422579,6,2383,14,1990,0,323,70,10,4,3,1040,92,20200,2256,209530,229730,10/28/2020
8/12/2020,121,29361,5186,398525,427886,8,2391,11,2001,0,323,67,9,3,1,1041,101,20301,2621,212151,232452,10/28/2020
8/13/2020,135,29496,4192,402717,432213,13,2404,12,2013,0,323,68,11,3,0,1041,95,20396,1896,214047,234443,10/28/2020
8/14/2020,145,29641,5494,408211,437852,13,2417,11,2024,0,323,70,11,4,3,1044,99,20495,1970,216017,236512,10/28/2020
8/15/2020,105,29746,4533,412744,442490,9,2426,11,2035,1,324,67,11,5,0,1044,88,20583,1685,217702,238285,10/28/2020
8/16/2020,83,29829,2472,415216,445045,7,2433,6,2041,4,328,64,8,4,6,1050,70,20653,958,218660,239313,10/28/2020
8/17/2020,106,29935,4570,419786,449721,10,2443,7,2048,0,328,67,8,5,2,1052,87,20740,2383,221043,241783,10/28/2020
8/18/2020,128,30063,4904,424690,454753,11,2454,9,2057,1,329,68,8,4,5,1057,94,20834,2743,223786,244620,10/28/2020
8/19/2020,113,30176,5065,429755,459931,8,2462,9,2066,1,330,66,9,5,0,1057,90,20924,2635,226421,247345,10/28/2020
8/20/2020,173,30349,7405,437160,467509,12,2474,6,2072,2,332,70,10,5,3,1060,139,21063,3512,229933,250996,10/28/2020
8/21/2020,151,30500,6572,443732,474232,8,2482,5,2077,1,333,72,9,4,2,1062,125,21188,2939,232872,254060,10/28/2020
8/22/2020,96,30596,5547,449279,479875,10,2492,12,2089,0,333,70,11,4,1,1063,84,21272,2602,235474,256746,10/28/2020
8/23/2020,70,30666,4371,453650,484316,11,2503,6,2095,0,333,75,11,2,1,1064,56,21328,2469,237943,259271,10/28/2020
8/24/2020,105,30771,5776,459426,490197,7,2510,10,2105,1,334,71,13,4,1,1065,77,21405,3143,241086,262491,10/28/2020
8/25/2020,108,30879,4759,464185,495064,10,2520,4,2109,1,335,76,11,4,1,1066,92,21497,2285,243371,264868,10/28/2020
8/26/2020,170,31049,9477,473662,504711,4,2524,8,2117,0,335,72,9,5,1,1067,127,21624,3083,246454,268078,10/28/2020
8/27/2020,92,31141,8564,482226,513367,6,2530,13,2130,1,336,64,6,5,2,1069,70,21694,3159,249613,271307,10/28/2020
8/28/2020,112,31253,7991,490217,521470,14,2544,4,2134,0,336,74,9,7,2,1071,87,21781,2427,252040,273821,10/28/2020
8/29/2020,65,31318,5368,495585,526903,6,2550,8,2142,1,337,71,10,6,2,1073,51,21832,1909,253949,275781,10/28/2020
8/30/2020,66,31384,4320,499905,531289,7,2557,4,2146,0,337,74,8,5,2,1075,48,21880,1993,255942,277822,10/28/2020
8/31/2020,105,31489,4863,504768,536257,12,2569,15,2161,0,337,71,8,4,1,1076,81,21961,2184,258126,280087,10/28/2020
9/1/2020,97,31586,7109,511877,543463,6,2575,9,2170,1,338,67,7,4,2,1078,65,22026,2377,260503,282529,10/28/2020
9/2/2020,125,31711,10524,522401,554112,9,2584,10,2180,1,339,65,8,4,2,1080,104,22130,3049,263552,285682,10/28/2020
9/3/2020,90,31801,11065,533466,565267,8,2592,8,2188,0,339,65,9,4,3,1083,73,22203,2581,266133,288336,10/28/2020
9/4/2020,102,31903,8953,542419,574322,11,2603,4,2192,0,339,72,9,4,1,1084,84,22287,2362,268495,290782,10/28/2020
9/5/2020,52,31955,6301,548720,580675,6,2609,9,2201,0,339,69,8,3,1,1085,42,22329,1598,270093,292422,10/28/2020
9/6/2020,87,32042,4317,553037,585079,4,2613,8,2209,1,340,64,6,3,1,1086,64,22393,1945,272038,294431,10/28/2020
9/7/2020,35,32077,3001,556038,588115,11,2624,3,2212,0,340,72,5,3,1,1087,26,22419,645,272683,295102,10/28/2020
9/8/2020,74,32151,6375,562413,594564,6,2630,12,2224,1,341,65,6,3,2,1089,66,22485,1592,274275,296760,10/28/2020
9/9/2020,118,32269,8641,571054,603323,9,2639,5,2229,1,342,68,9,3,1,1090,102,22587,2144,276419,299006,10/28/2020
9/10/2020,164,32433,11327,582381,614814,9,2648,8,2237,0,342,69,10,3,1,1091,111,22698,2274,278693,301391,10/28/2020
9/11/2020,120,32553,9449,591830,624383,11,2659,11,2248,0,342,69,10,5,0,1091,98,22796,1965,280658,303454,10/28/2020
9/12/2020,109,32662,6160,597990,630652,8,2667,5,2253,2,344,70,9,5,3,1094,97,22893,1519,282177,305070,10/28/2020
9/13/2020,58,32720,2710,600700,633420,4,2671,3,2256,0,344,71,10,5,0,1094,54,22947,858,283035,305982,10/28/2020
9/14/2020,104,32824,6433,607133,639957,5,2676,3,2259,2,346,71,10,5,2,1096,95,23042,1731,284766,307808,10/28/2020
9/15/2020,122,32946,8462,615595,648541,7,2683,2,2261,1,347,75,10,5,2,1098,124,23166,2199,286965,310131,10/28/2020
9/16/2020,137,33083,9711,625306,658389,7,2690,7,2268,2,349,73,9,6,5,1103,118,23284,1973,288938,312222,10/28/2020
9/17/2020,124,33207,9233,634539,667746,7,2697,14,2282,0,349,66,8,4,0,1103,154,23438,1953,290891,314329,10/28/2020
9/18/2020,132,33339,10034,644573,677912,7,2704,7,2289,1,350,65,11,6,2,1105,132,23570,1929,292820,316390,10/28/2020
9/19/2020,115,33454,8296,652869,686323,7,2711,3,2292,0,350,69,10,6,4,1109,112,23682,1693,294513,318195,10/28/2020
9/20/2020,60,33514,3671,656540,690054,7,2718,6,2298,2,352,68,9,8,4,1113,49,23731,1325,295838,319569,10/28/2020
9/21/2020,102,33616,7017,663557,697173,12,2730,3,2301,2,354,75,8,6,2,1115,94,23825,2414,298252,322077,10/28/2020
9/22/2020,154,33770,9283,672840,706610,12,2742,3,2304,1,355,83,7,5,1,1116,123,23948,2209,300461,324409,10/28/2020
9/23/2020,136,33906,10646,683486,717392,12,2754,7,2311,0,355,88,6,5,0,1116,127,24075,2218,302679,326754,10/28/2020
9/24/2020,118,34024,12473,695959,729983,7,2761,9,2320,1,356,85,7,5,1,1117,120,24195,3171,305850,330045,10/28/2020
9/25/2020,149,34173,10544,706503,740676,9,2770,10,2330,0,356,84,6,5,1,1118,142,24337,3012,308862,333199,10/28/2020
9/26/2020,146,34319,10552,717055,751374,12,2782,9,2339,0,356,87,6,5,1,1119,118,24455,2426,311288,335743,10/28/2020
9/27/2020,43,34362,2761,719816,754178,7,2789,5,2344,0,356,89,9,5,0,1119,34,24489,846,312134,336623,10/28/2020
9/28/2020,151,34513,7303,727119,761632,7,2796,7,2351,2,358,87,7,5,2,1121,132,24621,2263,314397,339018,10/28/2020
9/29/2020,208,34721,11038,738157,772878,12,2808,18,2369,1,359,80,6,6,1,1122,190,24811,2832,317229,342040,10/28/2020
9/30/2020,221,34942,12224,750381,785323,6,2814,6,2375,0,359,80,6,6,1,1123,186,24997,2602,319831,344828,10/28/2020
10/1/2020,184,35126,12497,762878,798004,16,2830,13,2388,1,360,82,5,4,2,1125,166,25163,2430,322261,347424,10/28/2020
10/2/2020,209,35335,12137,775015,810350,14,2844,13,2401,1,361,82,7,5,2,1127,181,25344,2502,324763,350107,10/28/2020
10/3/2020,157,35492,9317,784332,819824,9,2853,9,2410,2,363,80,8,4,2,1129,132,25476,2033,326796,352272,10/28/2020
10/4/2020,81,35573,2365,786697,822270,11,2864,9,2419,1,364,81,7,4,2,1131,78,25554,960,327756,353310,10/28/2020
10/5/2020,174,35747,8964,795661,831408,30,2894,11,2430,2,366,98,8,5,4,1135,159,25713,3038,330794,356507,10/28/2020
10/6/2020,176,35923,11175,806836,842759,11,2905,5,2435,0,366,104,10,6,0,1135,186,25899,2911,333705,359604,10/28/2020
10/7/2020,228,36151,12424,819260,855411,13,2918,14,2449,2,368,101,8,6,2,1137,242,26141,3540,337245,363386,10/28/2020
10/8/2020,262,36413,15187,834447,870860,16,2934,12,2461,1,369,104,7,5,3,1140,274,26415,4199,341444,367859,10/28/2020
10/9/2020,216,36629,13733,848180,884809,21,2955,12,2473,0,369,113,10,7,3,1143,198,26613,4348,345792,372405,10/28/2020
10/10/2020,229,36858,13820,862000,898858,19,2974,10,2483,1,370,121,13,7,2,1145,196,26809,3826,349618,376427,10/28/2020
10/11/2020,94,36952,3253,865253,902205,12,2986,9,2492,1,371,123,14,5,6,1151,87,26896,1161,350779,377675,10/28/2020
10/12/2020,165,37117,6411,871664,908781,19,3005,15,2507,2,373,125,14,5,4,1155,159,27055,1747,352526,379581,10/28/2020
10/13/2020,210,37327,8499,880163,917490,15,3020,15,2522,4,377,121,13,5,7,1162,204,27259,2313,354839,382098,10/28/2020
10/14/2020,320,37647,15020,895183,932830,17,3037,7,2529,0,377,131,15,5,2,1164,305,27564,4067,358906,386470,10/28/2020
10/15/2020,261,37908,14581,909764,947672,11,3048,16,2545,1,378,125,13,5,2,1166,256,27820,3577,362483,390303,10/28/2020
10/16/2020,276,38184,14972,924736,962920,13,3061,20,2565,1,379,117,13,4,2,1168,272,28092,3401,365884,393976,10/28/2020
10/17/2020,348,38532,14024,938760,977292,19,3080,11,2576,1,380,124,17,4,2,1170,304,28396,3271,369155,397551,10/28/2020
10/18/2020,153,38685,3944,942704,981389,18,3098,11,2587,0,380,131,17,5,2,1172,127,28523,1285,370440,398963,10/28/2020
10/19/2020,380,39065,8357,951061,990126,20,3118,23,2610,2,382,126,15,5,1,1173,319,28842,2529,372969,401811,10/28/2020
10/20/2020,428,39493,12912,963973,1003466,22,3140,17,2627,0,382,131,14,7,3,1176,380,29222,2913,375882,405104,10/28/2020
10/21/2020,538,40031,17321,981294,1021325,21,3161,9,2636,2,384,141,16,9,3,1179,470,29692,3540,379422,409114,10/28/2020
10/22/2020,536,40567,15634,996928,1037495,24,3185,21,2657,3,387,141,15,9,3,1182,485,30177,3245,382667,412844,10/28/2020
10/23/2020,510,41077,16543,1013471,1054548,22,3207,26,2683,1,388,136,16,9,3,1185,443,30620,2917,385584,416204,10/28/2020
10/24/2020,355,41432,9968,1023439,1064871,14,3221,11,2694,0,388,139,15,8,1,1186,330,30950,2292,387876,418826,10/28/2020
10/25/2020,230,41662,4669,1028108,1069770,15,3236,15,2709,1,389,138,16,8,1,1187,203,31153,1496,389372,420525,10/28/2020
10/26/2020,380,42042,8441,1036549,1078591,20,3256,20,2729,2,391,136,18,8,2,1189,366,31519,2803,392175,423694,10/28/2020
10/27/2020,493,42535,12904,1049453,1091988,,,,,,,,,,3,1192,425,31944,2236,394411,426355,10/28/2020
2/27/2020,0,0,0,0,0,1,1,0,0,0,0,1,0,0,0,0,0,0,0,0,0,10/29/2020
2/28/2020,0,0,0,0,0,0,1,0,0,0,0,1,1,0,0,0,0,0,0,0,0,10/29/2020
2/29/2020,0,0,0,0,0,0,1,0,0,0,0,1,1,0,0,0,0,0,0,0,0,10/29/2020
3/1/2020,2,2,2,2,4,0,1,0,0,0,0,1,1,1,0,0,2,2,2,2,4,10/29/2020
3/2/2020,0,2,1,3,5,1,2,0,0,0,0,2,2,2,0,0,0,2,1,3,5,10/29/2020
3/3/2020,0,2,2,5,7,0,2,0,0,0,0,2,2,2,0,0,0,2,2,5,7,10/29/2020
3/4/2020,0,2,12,17,19,1,3,0,0,0,0,3,2,2,0,0,0,2,10,15,17,10/29/2020
3/5/2020,0,2,4,21,23,0,3,0,0,0,0,3,2,2,0,0,1,3,4,19,22,10/29/2020
3/6/2020,1,3,12,33,36,0,3,0,0,0,0,3,2,2,0,0,0,3,11,30,33,10/29/2020
3/7/2020,0,3,19,52,55,0,3,0,0,0,0,3,2,1,0,0,0,3,19,49,52,10/29/2020
3/8/2020,0,3,18,70,73,0,3,0,0,0,0,3,2,1,0,0,0,3,18,67,70,10/29/2020
3/9/2020,1,4,15,85,89,0,3,0,0,0,0,3,2,1,0,0,1,4,15,82,86,10/29/2020
3/10/2020,2,6,25,110,116,0,3,0,0,0,0,3,2,1,0,0,1,5,23,105,110,10/29/2020
3/11/2020,0,6,34,144,150,1,4,0,0,0,0,4,1,1,0,0,0,5,34,139,144,10/29/2020
3/12/2020,9,15,41,185,200,1,5,0,0,0,0,5,1,1,0,0,8,13,38,177,190,10/29/2020
3/13/2020,6,21,50,235,256,4,9,1,1,0,0,8,1,1,0,0,6,19,48,225,244,10/29/2020
3/14/2020,0,21,90,325,346,0,9,0,1,0,0,8,1,1,0,0,0,19,86,311,330,10/29/2020
3/15/2020,1,22,54,379,401,1,10,0,1,0,0,9,2,1,0,0,1,20,54,365,385,10/29/2020
3/16/2020,2,24,95,474,498,2,12,0,1,0,0,11,2,0,0,0,2,22,92,457,479,10/29/2020
3/17/2020,12,36,162,636,672,6,18,0,1,0,0,17,2,0,0,0,11,33,150,607,640,10/29/2020
3/18/2020,9,45,116,752,797,3,21,0,1,0,0,20,2,0,0,0,11,44,110,717,761,10/29/2020
3/19/2020,15,60,262,1014,1074,2,23,1,2,0,0,21,3,0,1,1,17,61,249,966,1027,10/29/2020
3/20/2020,13,73,197,1211,1284,5,28,0,2,0,0,26,4,0,0,1,13,74,189,1155,1229,10/29/2020
3/21/2020,12,85,126,1337,1422,3,31,2,4,0,0,27,5,0,0,1,14,88,122,1277,1365,10/29/2020
3/22/2020,27,112,282,1619,1731,2,33,0,4,0,0,29,5,0,0,1,25,113,259,1536,1649,10/29/2020
3/23/2020,14,126,169,1788,1914,15,48,1,5,0,0,43,9,3,0,1,16,129,164,1700,1829,10/29/2020
3/24/2020,20,146,242,2030,2176,7,55,0,5,0,0,50,10,4,0,1,19,148,233,1933,2081,10/29/2020
3/25/2020,26,172,182,2212,2384,5,60,1,6,0,0,54,11,3,0,1,28,176,169,2102,2278,10/29/2020
3/26/2020,35,207,181,2393,2600,10,70,5,11,0,0,59,14,5,0,1,41,217,171,2273,2490,10/29/2020
3/27/2020,27,234,214,2607,2841,9,79,1,12,1,1,66,17,6,2,3,31,248,200,2473,2721,10/29/2020
3/28/2020,59,293,260,2867,3160,13,92,3,15,2,3,74,15,6,1,4,64,312,240,2713,3025,10/29/2020
3/29/2020,100,393,350,3217,3610,8,100,4,19,1,4,77,18,8,2,6,105,417,312,3025,3442,10/29/2020
3/30/2020,62,455,222,3439,3894,20,120,5,24,0,4,92,20,11,3,9,78,495,184,3209,3704,10/29/2020
3/31/2020,71,526,369,3808,4334,11,131,7,31,1,5,95,22,13,2,11,73,568,294,3503,4071,10/29/2020
4/1/2020,99,625,698,4506,5131,18,149,7,38,0,5,106,30,15,1,12,100,668,636,4139,4807,10/29/2020
4/2/2020,52,677,477,4983,5660,22,171,6,44,2,7,120,36,21,4,16,62,730,433,4572,5302,10/29/2020
4/3/2020,108,785,774,5757,6542,23,194,7,51,0,7,136,43,25,3,19,100,830,702,5274,6104,10/29/2020
4/4/2020,143,928,660,6417,7345,22,216,4,55,5,12,149,41,30,9,28,138,968,613,5887,6855,10/29/2020
4/5/2020,187,1115,1156,7573,8688,20,236,9,64,1,13,159,44,36,2,30,181,1149,1051,6938,8087,10/29/2020
4/6/2020,218,1333,1706,9279,10612,26,262,7,71,0,13,178,48,40,7,37,207,1356,1535,8473,9829,10/29/2020
4/7/2020,284,1617,1629,10908,12525,20,282,5,76,2,15,191,50,42,5,42,261,1617,1469,9942,11559,10/29/2020
4/8/2020,290,1907,1720,12628,14535,19,301,7,83,6,21,197,50,38,10,52,271,1888,1536,11478,13366,10/29/2020
4/9/2020,283,2190,1516,14144,16334,32,333,9,92,4,25,216,53,40,7,59,277,2165,1346,12824,14989,10/29/2020
4/10/2020,419,2609,2574,16718,19327,29,362,16,108,5,30,224,59,41,11,70,400,2565,2342,15166,17731,10/29/2020
4/11/2020,297,2906,1905,18623,21529,29,391,11,119,2,32,240,61,48,12,82,281,2846,1703,16869,19715,10/29/2020
4/12/2020,314,3220,1670,20293,23513,35,426,13,132,5,37,257,59,49,9,91,285,3131,1417,18286,21417,10/29/2020
4/13/2020,161,3381,935,21228,24609,35,461,13,145,3,40,276,64,54,9,100,187,3318,832,19118,22436,10/29/2020
4/14/2020,289,3670,1787,23015,26685,27,488,18,163,5,45,280,72,53,8,108,262,3580,1517,20635,24215,10/29/2020
4/15/2020,351,4021,1799,24814,28835,31,519,20,183,3,48,288,72,54,17,125,306,3886,1532,22167,26053,10/29/2020
4/16/2020,447,4468,2494,27308,31776,36,555,25,208,6,54,293,72,53,14,139,387,4273,2060,24227,28500,10/29/2020
4/17/2020,304,4772,1821,29129,33901,32,587,20,228,7,61,298,66,45,21,160,290,4563,1427,25654,30217,10/29/2020
4/18/2020,321,5093,1725,30854,35947,26,613,18,246,4,65,302,63,49,15,175,284,4847,1313,26967,31814,10/29/2020
4/19/2020,381,5474,2047,32901,38375,23,636,26,272,1,66,298,65,55,11,186,337,5184,1723,28690,33874,10/29/2020
4/20/2020,394,5868,1907,34808,40676,46,682,29,301,2,68,313,75,56,10,196,376,5560,1561,30251,35811,10/29/2020
4/21/2020,444,6312,2110,36918,43230,45,727,33,334,5,73,320,72,56,18,214,383,5943,1687,31938,37881,10/29/2020
4/22/2020,418,6730,2390,39308,46038,41,768,32,366,5,78,324,73,58,18,232,379,6322,1895,33833,40155,10/29/2020
4/23/2020,479,7209,2469,41777,48986,32,800,28,394,5,83,323,76,62,15,247,412,6734,1838,35671,42405,10/29/2020
4/24/2020,491,7700,3284,45061,52761,35,835,26,420,4,87,328,85,63,15,262,407,7141,2599,38270,45411,10/29/2020
4/25/2020,393,8093,2206,47267,55360,34,869,17,437,5,92,340,85,62,14,276,300,7441,1744,40014,47455,10/29/2020
4/26/2020,316,8409,2309,49576,57985,33,902,15,452,3,95,355,86,59,14,290,274,7715,1854,41868,49583,10/29/2020
4/27/2020,249,8658,1620,51196,59854,29,931,21,473,4,99,359,86,61,10,300,206,7921,1150,43018,50939,10/29/2020
4/28/2020,410,9068,2263,53459,62527,44,975,24,497,3,102,376,88,59,22,322,332,8253,1736,44754,53007,10/29/2020
4/29/2020,476,9544,3343,56802,66346,36,1011,38,535,11,113,363,78,53,18,340,371,8624,2402,47156,55780,10/29/2020
4/30/2020,432,9976,2769,59571,69547,33,1044,38,573,6,119,352,83,57,24,364,350,8974,1893,49049,58023,10/29/2020
5/1/2020,454,10430,3086,62657,73087,51,1095,40,613,3,122,360,84,58,14,378,323,9297,2144,51193,60490,10/29/2020
5/2/2020,257,10687,1926,64583,75270,36,1131,37,650,5,127,354,91,62,24,402,192,9489,1256,52449,61938,10/29/2020
5/3/2020,283,10970,2160,66743,77713,31,1162,27,677,8,135,350,90,61,21,423,183,9672,1554,54003,63675,10/29/2020
5/4/2020,387,11357,2098,68841,80198,30,1192,31,708,5,140,344,88,57,18,441,290,9962,1544,55547,65509,10/29/2020
5/5/2020,433,11790,2873,71714,83504,29,1221,32,740,6,146,335,82,54,16,457,301,10263,1942,57489,67752,10/29/2020
5/6/2020,488,12278,2830,74544,86822,28,1249,44,784,9,155,310,79,54,21,478,340,10603,1902,59391,69994,10/29/2020
5/7/2020,425,12703,2969,77513,90216,36,1285,43,827,5,160,298,71,52,21,499,270,10873,1947,61338,72211,10/29/2020
5/8/2020,359,13062,2598,80111,93173,30,1315,29,856,5,165,294,71,53,22,521,229,11102,1728,63066,74168,10/29/2020
5/9/2020,467,13529,3346,83457,96986,22,1337,21,877,4,169,291,69,51,15,536,290,11392,2229,65295,76687,10/29/2020
5/10/2020,285,13814,2117,85574,99388,20,1357,23,900,6,175,282,70,49,14,550,189,11581,1507,66802,78383,10/29/2020
5/11/2020,257,14071,1857,87431,101502,31,1388,16,916,6,181,291,71,49,15,565,174,11755,1288,68090,79845,10/29/2020
5/12/2020,387,14458,2611,90042,104500,23,1411,18,934,4,185,292,69,48,22,587,224,11979,1691,69781,81760,10/29/2020
5/13/2020,351,14809,3630,93672,108481,23,1434,25,959,1,186,289,69,49,13,600,199,12178,1954,71735,83913,10/29/2020
5/14/2020,329,15138,3408,97080,112218,19,1453,27,986,3,189,278,64,45,15,615,232,12410,2000,73735,86145,10/29/2020
5/15/2020,381,15519,3458,100538,116057,24,1477,41,1027,5,194,256,62,45,14,629,232,12642,1792,75527,88169,10/29/2020
5/16/2020,449,15968,4156,104694,120662,25,1502,15,1042,5,199,261,61,46,15,644,247,12889,1937,77464,90353,10/29/2020
5/17/2020,240,16208,2768,107462,123670,17,1519,9,1051,5,204,264,59,45,10,654,126,13015,1529,78993,92008,10/29/2020
5/18/2020,250,16458,2001,109463,125921,19,1538,16,1067,5,209,262,57,40,18,672,135,13150,1362,80355,93505,10/29/2020
5/19/2020,415,16873,3168,112631,129504,23,1561,33,1100,5,214,247,56,38,11,683,215,13365,1913,82268,95633,10/29/2020
5/20/2020,326,17199,2771,115402,132601,19,1580,23,1123,7,221,236,52,33,22,705,183,13548,1508,83776,97324,10/29/2020
5/21/2020,374,17573,3757,119159,136732,26,1606,15,1138,3,224,244,53,29,20,725,168,13716,1924,85700,99416,10/29/2020
5/22/2020,351,17924,3161,122320,140244,20,1626,29,1167,5,229,230,52,29,11,736,206,13922,1600,87300,101222,10/29/2020
5/23/2020,253,18177,2742,125062,143239,19,1645,11,1178,3,232,235,52,32,13,749,109,14031,1262,88562,102593,10/29/2020
5/24/2020,163,18340,1370,126432,144772,13,1658,14,1192,2,234,232,53,36,8,757,83,14114,770,89332,103446,10/29/2020
5/25/2020,147,18487,1385,127817,146304,14,1672,14,1206,0,234,232,53,34,10,767,76,14190,759,90091,104281,10/29/2020
5/26/2020,285,18772,2620,130437,149209,24,1696,22,1228,5,239,229,48,33,15,782,158,14348,1775,91866,106214,10/29/2020
5/27/2020,276,19048,2057,132494,151542,20,1716,18,1246,3,242,228,50,33,10,792,132,14480,1127,92993,107473,10/29/2020
5/28/2020,348,19396,3359,135853,155249,17,1733,29,1275,4,246,212,47,32,8,800,130,14610,1111,94104,108714,10/29/2020
5/29/2020,410,19806,3915,139768,159574,19,1752,27,1302,6,252,198,43,31,12,812,174,14784,1565,95669,110453,10/29/2020
5/30/2020,225,20031,3915,143683,163714,16,1768,19,1321,4,256,191,41,29,12,824,109,14893,1810,97479,112372,10/29/2020
5/31/2020,155,20186,1689,145372,165558,11,1779,10,1331,1,257,191,44,26,3,827,78,14971,851,98330,113301,10/29/2020
6/1/2020,212,20398,2792,148164,168562,8,1787,14,1345,1,258,184,45,29,5,832,93,15064,1376,99706,114770,10/29/2020
6/2/2020,273,20671,3022,151186,171857,8,1795,10,1355,3,261,179,38,25,10,842,98,15162,1433,101139,116301,10/29/2020
6/3/2020,254,20925,3486,154672,175597,14,1809,18,1373,6,267,169,34,25,11,853,99,15261,1649,102788,118049,10/29/2020
6/4/2020,276,21201,4471,159143,180344,7,1816,26,1399,4,271,146,31,24,12,865,107,15368,2027,104815,120183,10/29/2020
6/5/2020,215,21416,3513,162656,184072,15,1831,13,1412,6,277,142,27,21,11,876,99,15467,1567,106382,121849,10/29/2020
6/6/2020,201,21617,2616,165272,186889,10,1841,7,1419,2,279,143,29,19,6,882,67,15534,1119,107501,123035,10/29/2020
6/7/2020,83,21700,1625,166897,188597,11,1852,7,1426,1,280,146,25,17,4,886,51,15585,779,108280,123865,10/29/2020
6/8/2020,119,21819,1849,168746,190565,15,1867,12,1438,2,282,147,27,18,4,890,45,15630,952,109232,124862,10/29/2020
6/9/2020,223,22042,2673,171419,193461,10,1877,19,1457,0,282,138,28,21,1,891,64,15694,1249,110481,126175,10/29/2020
6/10/2020,209,22251,2987,174406,196657,13,1890,12,1469,2,284,137,24,17,4,895,101,15795,1458,111939,127734,10/29/2020
6/11/2020,195,22446,3513,177919,200365,7,1897,15,1484,1,285,128,25,16,6,901,88,15883,1524,113463,129346,10/29/2020
6/12/2020,209,22655,4601,182520,205175,9,1906,16,1500,1,286,120,24,16,2,903,78,15961,2165,115628,131589,10/29/2020
6/13/2020,113,22768,3036,185556,208324,6,1912,5,1505,0,286,121,20,15,3,906,49,16010,1363,116991,133001,10/29/2020
6/14/2020,81,22849,2046,187602,210451,7,1919,8,1513,1,287,119,20,14,3,909,33,16043,963,117954,133997,10/29/2020
6/15/2020,188,23037,3108,190710,213747,14,1933,19,1532,0,287,114,20,16,5,914,75,16118,1777,119731,135849,10/29/2020
6/16/2020,110,23147,3017,193727,216874,11,1944,9,1541,1,288,115,22,16,8,922,50,16168,1541,121272,137440,10/29/2020
6/17/2020,127,23274,2835,196562,219836,15,1959,22,1563,4,292,104,18,14,6,928,50,16218,1311,122583,138801,10/29/2020
6/18/2020,149,23423,3048,199610,223033,9,1968,15,1578,1,293,97,19,16,7,935,70,16288,1308,123891,140179,10/29/2020
6/19/2020,141,23564,3769,203379,226943,12,1980,12,1590,1,294,96,20,17,3,938,59,16347,1357,125248,141595,10/29/2020
6/20/2020,84,23648,1891,205270,228918,9,1989,12,1602,0,294,93,20,18,4,942,36,16383,810,126058,142441,10/29/2020
6/21/2020,37,23685,1064,206334,230019,8,1997,5,1607,0,294,96,20,18,2,944,30,16413,687,126745,143158,10/29/2020
6/22/2020,138,23823,3730,210064,233887,12,2009,16,1623,0,294,92,19,18,2,946,65,16478,1698,128443,144921,10/29/2020
6/23/2020,163,23986,3831,213895,237881,3,2012,13,1636,3,297,79,18,18,7,953,81,16559,1770,130213,146772,10/29/2020
6/24/2020,120,24106,3502,217397,241503,9,2021,11,1647,1,298,76,18,18,5,958,44,16603,1676,131889,148492,10/29/2020
6/25/2020,103,24209,2883,220280,244489,6,2027,14,1661,1,299,67,17,17,1,959,50,16653,1497,133386,150039,10/29/2020
6/26/2020,94,24303,2488,222768,247071,2,2029,10,1671,0,299,59,18,18,1,960,60,16713,1319,134705,151418,10/29/2020
6/27/2020,84,24387,3216,225984,250371,5,2034,3,1674,1,300,60,17,17,5,965,37,16750,1215,135920,152670,10/29/2020
6/28/2020,39,24426,1469,227453,251879,4,2038,4,1678,4,304,56,15,14,6,971,17,16767,592,136512,153279,10/29/2020
6/29/2020,85,24511,3697,231150,255661,4,2042,5,1683,0,304,55,14,14,1,972,39,16806,1344,137856,154662,10/29/2020
6/30/2020,57,24568,1958,233108,257676,1,2043,5,1688,1,305,50,12,11,4,976,33,16839,992,138848,155687,10/29/2020
7/1/2020,144,24712,4098,237206,261918,8,2051,10,1698,0,305,48,11,11,1,977,79,16918,1918,140766,157684,10/29/2020
7/2/2020,103,24815,2803,240009,264824,5,2056,5,1703,1,306,47,10,10,3,980,59,16977,1078,141844,158821,10/29/2020
7/3/2020,50,24865,2078,242087,266952,9,2065,6,1709,0,306,50,9,9,3,983,25,17002,777,142621,159623,10/29/2020
7/4/2020,57,24922,2345,244432,269354,2,2067,4,1713,1,307,47,10,9,2,985,33,17035,1003,143624,160659,10/29/2020
7/5/2020,49,24971,2932,247364,272335,1,2068,2,1715,1,308,45,8,8,2,987,26,17061,1436,145060,162121,10/29/2020
7/6/2020,101,25072,2811,250175,275247,6,2074,6,1721,0,308,45,9,9,4,991,57,17118,1540,146600,163718,10/29/2020
7/7/2020,81,25153,3457,253632,278785,5,2079,7,1728,0,308,43,8,8,2,993,47,17165,1532,148132,165297,10/29/2020
7/8/2020,105,25258,3409,257041,282299,4,2083,2,1730,0,308,45,9,8,0,993,64,17229,1421,149553,166782,10/29/2020
7/9/2020,94,25352,3714,260755,286107,9,2092,3,1733,0,308,51,9,8,0,993,50,17279,1612,151165,168444,10/29/2020
7/10/2020,132,25484,4432,265187,290671,6,2098,3,1736,2,310,52,7,7,3,996,80,17359,2061,153226,170585,10/29/2020
7/11/2020,63,25547,2932,268119,293666,6,2104,3,1739,1,311,54,6,6,3,999,36,17395,1310,154536,171931,10/29/2020
7/12/2020,47,25594,1837,269956,295550,1,2105,3,1742,1,312,51,6,5,3,1002,34,17429,941,155477,172906,10/29/2020
7/13/2020,84,25678,3201,273157,298835,8,2113,10,1752,0,312,49,6,5,1,1003,61,17490,1497,156974,174464,10/29/2020
7/14/2020,73,25751,3293,276450,302201,7,2120,4,1756,0,312,52,5,5,1,1004,43,17533,1371,158345,175878,10/29/2020
7/15/2020,130,25881,4173,280623,306504,5,2125,7,1763,0,312,50,5,4,0,1004,100,17633,1741,160086,177719,10/29/2020
7/16/2020,102,25983,3734,284357,310340,6,2131,9,1772,0,312,47,6,5,1,1005,75,17708,1607,161693,179401,10/29/2020
7/17/2020,156,26139,4236,288593,314732,14,2145,3,1775,1,313,57,5,5,2,1007,79,17787,1841,163534,181321,10/29/2020
7/18/2020,85,26224,3269,291862,318086,5,2150,9,1784,1,314,52,5,4,4,1011,70,17857,1392,164926,182783,10/29/2020
7/19/2020,82,26306,2694,294556,320862,7,2157,3,1787,0,314,56,6,4,2,1013,57,17914,1145,166071,183985,10/29/2020
7/20/2020,71,26377,2664,297220,323597,9,2166,7,1794,0,314,58,7,5,2,1015,68,17982,1454,167525,185507,10/29/2020
7/21/2020,130,26507,4299,301519,328026,9,2175,11,1805,0,314,56,9,6,1,1016,108,18090,1910,169435,187525,10/29/2020
7/22/2020,130,26637,3927,305446,332083,11,2186,11,1816,1,315,55,7,6,1,1017,86,18176,1674,171109,189285,10/29/2020
7/23/2020,141,26778,4413,309859,336637,9,2195,6,1822,0,315,58,8,7,0,1017,115,18291,1972,173081,191372,10/29/2020
7/24/2020,172,26950,5961,315820,342770,14,2209,14,1836,0,315,58,9,7,0,1017,119,18410,2306,175387,193797,10/29/2020
7/25/2020,134,27084,4399,320219,347303,7,2216,7,1843,0,315,58,10,8,3,1020,108,18518,2085,177472,195990,10/29/2020
7/26/2020,62,27146,3027,323246,350392,8,2224,9,1852,0,315,57,11,7,1,1021,54,18572,1328,178800,197372,10/29/2020
7/27/2020,188,27334,4190,327436,354770,12,2236,7,1859,0,315,62,13,8,1,1022,138,18710,2334,181134,199844,10/29/2020
7/28/2020,105,27439,3834,331270,358709,5,2241,5,1864,0,315,62,14,7,1,1023,95,18805,1627,182761,201566,10/29/2020
7/29/2020,190,27629,5137,336407,364036,11,2252,12,1876,0,315,61,15,7,0,1023,154,18959,2305,185066,204025,10/29/2020
7/30/2020,121,27750,4344,340751,368501,6,2258,2,1878,1,316,64,15,6,1,1024,97,19056,1642,186708,205764,10/29/2020
7/31/2020,131,27881,5509,346260,374141,8,2266,10,1888,0,316,62,15,7,1,1025,89,19145,1841,188549,207694,10/29/2020
8/1/2020,108,27989,4292,350552,378541,7,2273,2,1890,0,316,67,14,7,1,1026,88,19233,1552,190101,209334,10/29/2020
8/2/2020,84,28073,2802,353354,381427,12,2285,12,1902,2,318,65,14,8,2,1028,62,19295,1267,191368,210663,10/29/2020
8/3/2020,186,28259,5238,358592,386851,13,2298,12,1914,0,318,66,16,7,1,1029,149,19444,2187,193555,212999,10/29/2020
8/4/2020,125,28384,3691,362283,390667,9,2307,6,1920,1,319,68,12,5,2,1031,99,19543,1766,195321,214864,10/29/2020
8/5/2020,147,28531,5934,368217,396748,12,2319,10,1930,1,320,69,10,5,2,1033,118,19661,2460,197781,217442,10/29/2020
8/6/2020,169,28700,5533,373750,402450,7,2326,9,1939,0,320,67,9,4,0,1033,120,19781,2391,200172,219953,10/29/2020
8/7/2020,121,28821,4847,378597,407418,13,2339,10,1949,1,321,69,9,3,2,1035,87,19868,2135,202307,222175,10/29/2020
8/8/2020,123,28944,4107,382704,411648,19,2358,6,1955,1,322,81,8,3,1,1036,91,19959,1771,204078,224037,10/29/2020
8/9/2020,42,28986,1722,384426,413412,8,2366,10,1965,0,322,79,9,4,0,1036,35,19994,1067,205145,225139,10/29/2020
8/10/2020,149,29135,4584,389010,418145,11,2377,12,1977,0,322,78,9,4,1,1037,113,20107,2014,207159,227266,10/29/2020
8/11/2020,105,29240,4329,393339,422579,6,2383,14,1991,0,322,70,10,4,3,1040,92,20199,2255,209414,229613,10/29/2020
8/12/2020,121,29361,5186,398525,427886,8,2391,11,2002,0,322,67,9,3,1,1041,101,20300,2620,212034,232334,10/29/2020
8/13/2020,135,29496,4192,402717,432213,13,2404,12,2014,0,322,68,11,3,0,1041,95,20395,1896,213930,234325,10/29/2020
8/14/2020,145,29641,5494,408211,437852,13,2417,11,2025,0,322,70,11,4,3,1044,99,20494,1968,215898,236392,10/29/2020
8/15/2020,105,29746,4533,412744,442490,9,2426,11,2036,1,323,67,11,5,0,1044,88,20582,1683,217581,238163,10/29/2020
8/16/2020,83,29829,2472,415216,445045,7,2433,6,2042,4,327,64,8,4,6,1050,70,20652,958,218539,239191,10/29/2020
8/17/2020,106,29935,4570,419786,449721,10,2443,7,2049,0,327,67,8,5,2,1052,87,20739,2383,220922,241661,10/29/2020
8/18/2020,128,30063,4904,424690,454753,11,2454,9,2058,1,328,68,8,4,5,1057,94,20833,2741,223663,244496,10/29/2020
8/19/2020,113,30176,5065,429755,459931,8,2462,9,2067,1,329,66,9,5,0,1057,90,20923,2633,226296,247219,10/29/2020
8/20/2020,173,30349,7405,437160,467509,12,2474,6,2073,2,331,70,10,5,3,1060,139,21062,3512,229808,250870,10/29/2020
8/21/2020,151,30500,6572,443732,474232,8,2482,5,2078,1,332,72,9,4,2,1062,125,21187,2939,232747,253934,10/29/2020
8/22/2020,96,30596,5547,449279,479875,10,2492,12,2090,0,332,70,11,4,1,1063,84,21271,2600,235347,256618,10/29/2020
8/23/2020,70,30666,4371,453650,484316,11,2503,6,2096,0,332,75,11,2,1,1064,56,21327,2466,237813,259140,10/29/2020
8/24/2020,105,30771,5776,459426,490197,7,2510,10,2106,1,333,71,13,4,1,1065,77,21404,3142,240955,262359,10/29/2020
8/25/2020,108,30879,4759,464185,495064,10,2520,4,2110,1,334,76,11,4,1,1066,92,21496,2283,243238,264734,10/29/2020
8/26/2020,170,31049,9477,473662,504711,4,2524,8,2118,0,334,72,9,5,1,1067,127,21623,3080,246318,267941,10/29/2020
8/27/2020,92,31141,8564,482226,513367,6,2530,13,2131,1,335,64,6,5,2,1069,70,21693,3158,249476,271169,10/29/2020
8/28/2020,112,31253,7991,490217,521470,14,2544,4,2135,0,335,74,9,7,2,1071,87,21780,2425,251901,273681,10/29/2020
8/29/2020,65,31318,5368,495585,526903,6,2550,8,2143,1,336,71,10,6,2,1073,51,21831,1909,253810,275641,10/29/2020
8/30/2020,66,31384,4320,499905,531289,7,2557,4,2147,0,336,74,8,5,2,1075,48,21879,1993,255803,277682,10/29/2020
8/31/2020,105,31489,4863,504768,536257,12,2569,15,2162,0,336,71,8,4,1,1076,81,21960,2183,257986,279946,10/29/2020
9/1/2020,97,31586,7109,511877,543463,6,2575,9,2171,1,337,67,7,4,2,1078,65,22025,2376,260362,282387,10/29/2020
9/2/2020,125,31711,10524,522401,554112,9,2584,10,2181,1,338,65,8,4,2,1080,104,22129,3048,263410,285539,10/29/2020
9/3/2020,90,31801,11065,533466,565267,8,2592,8,2189,0,338,65,9,4,3,1083,73,22202,2580,265990,288192,10/29/2020
9/4/2020,102,31903,8953,542419,574322,11,2603,4,2193,0,338,72,9,4,1,1084,84,22286,2361,268351,290637,10/29/2020
9/5/2020,52,31955,6301,548720,580675,6,2609,9,2202,0,338,69,8,3,1,1085,42,22328,1596,269947,292275,10/29/2020
9/6/2020,87,32042,4317,553037,585079,4,2613,8,2210,1,339,64,6,3,1,1086,64,22392,1944,271891,294283,10/29/2020
9/7/2020,35,32077,3001,556038,588115,11,2624,3,2213,0,339,72,5,3,1,1087,26,22418,645,272536,294954,10/29/2020
9/8/2020,74,32151,6375,562413,594564,6,2630,12,2225,1,340,65,6,3,2,1089,66,22484,1591,274127,296611,10/29/2020
9/9/2020,118,32269,8641,571054,603323,9,2639,5,2230,1,341,68,9,3,1,1090,102,22586,2140,276267,298853,10/29/2020
9/10/2020,164,32433,11327,582381,614814,9,2648,8,2238,0,341,69,10,3,1,1091,111,22697,2274,278541,301238,10/29/2020
9/11/2020,120,32553,9449,591830,624383,11,2659,11,2249,0,341,69,10,5,0,1091,98,22795,1965,280506,303301,10/29/2020
9/12/2020,109,32662,6160,597990,630652,8,2667,5,2254,2,343,70,9,5,3,1094,97,22892,1517,282023,304915,10/29/2020
9/13/2020,58,32720,2710,600700,633420,4,2671,3,2257,0,343,71,10,5,0,1094,54,22946,858,282881,305827,10/29/2020
9/14/2020,104,32824,6433,607133,639957,5,2676,3,2260,2,345,71,10,5,2,1096,95,23041,1728,284609,307650,10/29/2020
9/15/2020,122,32946,8462,615595,648541,7,2683,2,2262,1,346,75,10,5,2,1098,124,23165,2198,286807,309972,10/29/2020
9/16/2020,137,33083,9711,625306,658389,7,2690,7,2269,2,348,73,9,6,5,1103,118,23283,1973,288780,312063,10/29/2020
9/17/2020,124,33207,9233,634539,667746,7,2697,14,2283,0,348,66,8,4,0,1103,154,23437,1951,290731,314168,10/29/2020
9/18/2020,132,33339,10034,644573,677912,7,2704,7,2290,1,349,65,11,6,2,1105,132,23569,1927,292658,316227,10/29/2020
9/19/2020,115,33454,8296,652869,686323,7,2711,3,2293,0,349,69,10,6,4,1109,112,23681,1692,294350,318031,10/29/2020
9/20/2020,60,33514,3671,656540,690054,7,2718,6,2299,2,351,68,9,8,4,1113,49,23730,1324,295674,319404,10/29/2020
9/21/2020,102,33616,7017,663557,697173,12,2730,3,2302,2,353,75,8,6,2,1115,94,23824,2412,298086,321910,10/29/2020
9/22/2020,154,33770,9283,672840,706610,12,2742,3,2305,1,354,83,7,5,1,1116,123,23947,2207,300293,324240,10/29/2020
9/23/2020,136,33906,10646,683486,717392,12,2754,7,2312,0,354,88,6,5,0,1116,127,24074,2218,302511,326585,10/29/2020
9/24/2020,118,34024,12473,695959,729983,7,2761,9,2321,1,355,85,7,5,1,1117,120,24194,3171,305682,329876,10/29/2020
9/25/2020,149,34173,10545,706504,740677,9,2770,10,2331,0,355,84,6,5,1,1118,142,24336,3011,308693,333029,10/29/2020
9/26/2020,146,34319,10552,717056,751375,12,2782,9,2340,0,355,87,6,5,1,1119,118,24454,2425,311118,335572,10/29/2020
9/27/2020,43,34362,2761,719817,754179,7,2789,5,2345,0,355,89,9,5,0,1119,34,24488,846,311964,336452,10/29/2020
9/28/2020,152,34514,7303,727120,761634,7,2796,7,2352,2,357,87,7,5,2,1121,133,24621,2262,314226,338847,10/29/2020
9/29/2020,208,34722,11041,738161,772883,12,2808,18,2370,1,358,80,6,6,1,1122,190,24811,2831,317057,341868,10/29/2020
9/30/2020,221,34943,12225,750386,785329,6,2814,6,2376,0,358,80,6,6,1,1123,186,24997,2601,319658,344655,10/29/2020
10/1/2020,184,35127,12497,762883,798010,16,2830,13,2389,1,359,82,5,4,2,1125,166,25163,2427,322085,347248,10/29/2020
10/2/2020,210,35337,12142,775025,810362,14,2844,13,2402,1,360,82,7,5,2,1127,181,25344,2500,324585,349929,10/29/2020
10/3/2020,157,35494,9312,784337,819831,9,2853,9,2411,2,362,80,8,4,2,1129,131,25475,2032,326617,352092,10/29/2020
10/4/2020,81,35575,2365,786702,822277,11,2864,9,2420,1,363,81,7,4,2,1131,78,25553,957,327574,353127,10/29/2020
10/5/2020,174,35749,8969,795671,831420,30,2894,11,2431,2,365,98,8,5,4,1135,160,25713,3038,330612,356325,10/29/2020
10/6/2020,176,35925,11172,806843,842768,11,2905,5,2436,0,365,104,10,6,0,1135,186,25899,2911,333523,359422,10/29/2020
10/7/2020,228,36153,12424,819267,855420,13,2918,14,2450,2,367,101,8,6,2,1137,242,26141,3540,337063,363204,10/29/2020
10/8/2020,262,36415,15187,834454,870869,16,2934,12,2462,1,368,104,7,5,3,1140,274,26415,4196,341259,367674,10/29/2020
10/9/2020,216,36631,13733,848187,884818,21,2955,12,2474,0,368,113,10,7,3,1143,198,26613,4345,345604,372217,10/29/2020
10/10/2020,229,36860,13820,862007,898867,19,2974,10,2484,1,369,121,13,7,2,1145,196,26809,3826,349430,376239,10/29/2020
10/11/2020,94,36954,3253,865260,902214,12,2986,9,2493,1,370,123,14,5,6,1151,87,26896,1161,350591,377487,10/29/2020
10/12/2020,165,37119,6412,871672,908791,19,3005,15,2508,2,372,125,14,5,4,1155,159,27055,1746,352337,379392,10/29/2020
10/13/2020,210,37329,8499,880171,917500,15,3020,15,2523,4,376,121,13,5,7,1162,204,27259,2311,354648,381907,10/29/2020
10/14/2020,320,37649,15021,895192,932841,17,3037,7,2530,0,376,131,15,5,2,1164,304,27563,4062,358710,386273,10/29/2020
10/15/2020,261,37910,14591,909783,947693,11,3048,16,2546,1,377,125,13,5,2,1166,255,27818,3577,362287,390105,10/29/2020
10/16/2020,276,38186,14970,924753,962939,13,3061,20,2566,1,378,117,13,4,2,1168,272,28090,3398,365685,393775,10/29/2020
10/17/2020,348,38534,14024,938777,977311,19,3080,11,2577,1,379,124,17,4,2,1170,304,28394,3269,368954,397348,10/29/2020
10/18/2020,153,38687,3944,942721,981408,18,3098,11,2588,0,379,131,17,5,2,1172,127,28521,1285,370239,398760,10/29/2020
10/19/2020,381,39068,8366,951087,990155,20,3118,23,2611,2,381,126,15,5,1,1173,321,28842,2528,372767,401609,10/29/2020
10/20/2020,429,39497,12914,964001,1003498,22,3140,17,2628,0,381,131,14,7,3,1176,380,29222,2910,375677,404899,10/29/2020
10/21/2020,537,40034,17328,981329,1021363,21,3161,9,2637,2,383,141,15,9,3,1179,471,29693,3538,379215,408908,10/29/2020
10/22/2020,537,40571,15634,996963,1037534,24,3185,21,2658,3,386,141,14,9,3,1182,486,30179,3245,382460,412639,10/29/2020
10/23/2020,510,41081,16546,1013509,1054590,22,3207,26,2684,1,387,136,15,9,3,1185,442,30621,2915,385375,415996,10/29/2020
10/24/2020,355,41436,9971,1023480,1064916,14,3221,11,2695,0,387,139,14,8,1,1186,327,30948,2292,387667,418615,10/29/2020
10/25/2020,231,41667,4672,1028152,1069819,15,3236,15,2710,1,388,138,15,8,1,1187,204,31152,1496,389163,420315,10/29/2020
10/26/2020,446,42113,8887,1037039,1079152,21,3257,20,2730,2,390,137,17,8,3,1190,368,31520,2990,392153,423673,10/29/2020
10/27/2020,516,42629,13583,1050622,1093251,15,3272,11,2741,2,392,139,16,9,4,1194,441,31961,2406,394559,426520,10/29/2020
10/28/2020,409,43038,12722,1063344,1106382,,,,,,,,,,1,1195,351,32312,2469,397028,429340,10/29/2020
2/27/2020,0,0,0,0,0,1,1,0,0,0,0,1,0,0,0,0,0,0,0,0,0,10/31/2020
2/28/2020,0,0,0,0,0,0,1,0,0,0,0,1,1,0,0,0,0,0,0,0,0,10/31/2020
2/29/2020,0,0,0,0,0,0,1,0,0,0,0,1,1,0,0,0,0,0,0,0,0,10/31/2020
3/1/2020,2,2,2,2,4,0,1,0,0,0,0,1,1,1,0,0,2,2,2,2,4,10/31/2020
3/2/2020,0,2,1,3,5,1,2,0,0,0,0,2,2,2,0,0,0,2,1,3,5,10/31/2020
3/3/2020,0,2,2,5,7,0,2,0,0,0,0,2,2,2,0,0,0,2,2,5,7,10/31/2020
3/4/2020,0,2,12,17,19,1,3,0,0,0,0,3,2,2,0,0,0,2,10,15,17,10/31/2020
3/5/2020,0,2,4,21,23,0,3,0,0,0,0,3,2,2,0,0,1,3,4,19,22,10/31/2020
3/6/2020,1,3,12,33,36,0,3,0,0,0,0,3,2,2,0,0,0,3,11,30,33,10/31/2020
3/7/2020,0,3,19,52,55,0,3,0,0,0,0,3,2,1,0,0,0,3,19,49,52,10/31/2020
3/8/2020,0,3,18,70,73,0,3,0,0,0,0,3,2,1,0,0,0,3,18,67,70,10/31/2020
3/9/2020,1,4,15,85,89,0,3,0,0,0,0,3,2,1,0,0,1,4,15,82,86,10/31/2020
3/10/2020,2,6,25,110,116,0,3,0,0,0,0,3,2,1,0,0,1,5,23,105,110,10/31/2020
3/11/2020,0,6,34,144,150,1,4,0,0,0,0,4,1,1,0,0,0,5,34,139,144,10/31/2020
3/12/2020,9,15,41,185,200,1,5,0,0,0,0,5,1,1,0,0,8,13,38,177,190,10/31/2020
3/13/2020,6,21,50,235,256,4,9,1,1,0,0,8,1,1,0,0,6,19,48,225,244,10/31/2020
3/14/2020,0,21,90,325,346,0,9,0,1,0,0,8,1,1,0,0,0,19,86,311,330,10/31/2020
3/15/2020,1,22,54,379,401,1,10,0,1,0,0,9,2,1,0,0,1,20,54,365,385,10/31/2020
3/16/2020,2,24,95,474,498,2,12,0,1,0,0,11,2,0,0,0,2,22,92,457,479,10/31/2020
3/17/2020,12,36,162,636,672,6,18,0,1,0,0,17,2,0,0,0,11,33,150,607,640,10/31/2020
3/18/2020,9,45,116,752,797,3,21,0,1,0,0,20,2,0,0,0,11,44,110,717,761,10/31/2020
3/19/2020,15,60,262,1014,1074,2,23,1,2,0,0,21,3,0,1,1,17,61,249,966,1027,10/31/2020
3/20/2020,13,73,197,1211,1284,5,28,0,2,0,0,26,4,0,0,1,13,74,189,1155,1229,10/31/2020
3/21/2020,12,85,126,1337,1422,3,31,2,4,0,0,27,5,0,0,1,14,88,122,1277,1365,10/31/2020
3/22/2020,27,112,282,1619,1731,2,33,0,4,0,0,29,5,0,0,1,25,113,259,1536,1649,10/31/2020
3/23/2020,14,126,169,1788,1914,15,48,1,5,0,0,43,9,3,0,1,16,129,164,1700,1829,10/31/2020
3/24/2020,20,146,242,2030,2176,7,55,0,5,0,0,50,10,4,0,1,19,148,233,1933,2081,10/31/2020
3/25/2020,26,172,182,2212,2384,5,60,1,6,0,0,54,11,3,0,1,28,176,169,2102,2278,10/31/2020
3/26/2020,35,207,181,2393,2600,10,70,5,11,0,0,59,14,5,0,1,41,217,171,2273,2490,10/31/2020
3/27/2020,27,234,214,2607,2841,9,79,1,12,1,1,66,17,6,2,3,31,248,200,2473,2721,10/31/2020
3/28/2020,59,293,260,2867,3160,13,92,3,15,2,3,74,15,6,1,4,64,312,240,2713,3025,10/31/2020
3/29/2020,100,393,350,3217,3610,8,100,4,19,1,4,77,18,8,2,6,105,417,312,3025,3442,10/31/2020
3/30/2020,62,455,222,3439,3894,20,120,5,24,0,4,92,20,11,3,9,78,495,184,3209,3704,10/31/2020
3/31/2020,71,526,369,3808,4334,11,131,7,31,1,5,95,22,13,2,11,73,568,294,3503,4071,10/31/2020
4/1/2020,99,625,698,4506,5131,18,149,7,38,0,5,106,30,15,1,12,100,668,636,4139,4807,10/31/2020
4/2/2020,52,677,477,4983,5660,22,171,6,44,2,7,120,36,21,4,16,62,730,433,4572,5302,10/31/2020
4/3/2020,108,785,774,5757,6542,23,194,7,51,0,7,136,43,25,3,19,100,830,702,5274,6104,10/31/2020
4/4/2020,143,928,660,6417,7345,22,216,4,55,5,12,149,41,30,9,28,138,968,612,5886,6854,10/31/2020
4/5/2020,187,1115,1156,7573,8688,20,236,9,64,1,13,159,44,36,2,30,181,1149,1050,6936,8085,10/31/2020
4/6/2020,218,1333,1706,9279,10612,26,262,7,71,0,13,178,48,40,7,37,207,1356,1534,8470,9826,10/31/2020
4/7/2020,284,1617,1629,10908,12525,20,282,5,76,2,15,191,50,42,5,42,261,1617,1467,9937,11554,10/31/2020
4/8/2020,290,1907,1720,12628,14535,19,301,7,83,6,21,197,50,38,10,52,271,1888,1535,11472,13360,10/31/2020
4/9/2020,283,2190,1516,14144,16334,32,333,9,92,4,25,216,53,40,7,59,277,2165,1346,12818,14983,10/31/2020
4/10/2020,419,2609,2574,16718,19327,29,362,16,108,5,30,224,59,41,11,70,400,2565,2340,15158,17723,10/31/2020
4/11/2020,297,2906,1905,18623,21529,29,391,11,119,2,32,240,61,48,12,82,281,2846,1703,16861,19707,10/31/2020
4/12/2020,314,3220,1670,20293,23513,35,426,13,132,5,37,257,59,49,9,91,285,3131,1416,18277,21408,10/31/2020
4/13/2020,161,3381,935,21228,24609,35,461,13,145,3,40,276,64,54,9,100,187,3318,832,19109,22427,10/31/2020
4/14/2020,289,3670,1787,23015,26685,27,488,18,163,5,45,280,72,53,8,108,262,3580,1514,20623,24203,10/31/2020
4/15/2020,351,4021,1799,24814,28835,31,519,20,183,3,48,288,72,54,17,125,306,3886,1530,22153,26039,10/31/2020
4/16/2020,447,4468,2494,27308,31776,36,555,25,208,6,54,293,72,53,14,139,387,4273,2060,24213,28486,10/31/2020
4/17/2020,304,4772,1821,29129,33901,32,587,20,228,7,61,298,66,45,21,160,290,4563,1426,25639,30202,10/31/2020
4/18/2020,321,5093,1725,30854,35947,26,613,18,246,4,65,302,63,49,15,175,284,4847,1311,26950,31797,10/31/2020
4/19/2020,381,5474,2047,32901,38375,23,636,26,272,1,66,298,65,55,11,186,337,5184,1723,28673,33857,10/31/2020
4/20/2020,394,5868,1907,34808,40676,46,682,29,301,2,68,313,75,56,10,196,376,5560,1560,30233,35793,10/31/2020
4/21/2020,444,6312,2110,36918,43230,45,727,33,334,5,73,320,72,56,18,214,383,5943,1684,31917,37860,10/31/2020
4/22/2020,418,6730,2390,39308,46038,41,768,32,366,5,78,324,73,58,18,232,379,6322,1893,33810,40132,10/31/2020
4/23/2020,479,7209,2469,41777,48986,32,800,28,394,5,83,323,76,62,15,247,412,6734,1837,35647,42381,10/31/2020
4/24/2020,491,7700,3284,45061,52761,35,835,26,420,4,87,328,85,63,15,262,407,7141,2596,38243,45384,10/31/2020
4/25/2020,393,8093,2206,47267,55360,34,869,17,437,5,92,340,85,62,14,276,300,7441,1743,39986,47427,10/31/2020
4/26/2020,316,8409,2309,49576,57985,33,902,15,452,3,95,355,86,59,14,290,274,7715,1852,41838,49553,10/31/2020
4/27/2020,249,8658,1620,51196,59854,29,931,21,473,4,99,359,86,61,10,300,206,7921,1150,42988,50909,10/31/2020
4/28/2020,410,9068,2263,53459,62527,44,975,24,497,3,102,376,88,59,22,322,332,8253,1735,44723,52976,10/31/2020
4/29/2020,476,9544,3343,56802,66346,36,1011,38,535,11,113,363,78,53,18,340,371,8624,2398,47121,55745,10/31/2020
4/30/2020,432,9976,2769,59571,69547,33,1044,38,573,6,119,352,83,57,24,364,350,8974,1892,49013,57987,10/31/2020
5/1/2020,454,10430,3086,62657,73087,51,1095,39,612,3,122,361,84,58,14,378,323,9297,2140,51153,60450,10/31/2020
5/2/2020,257,10687,1926,64583,75270,36,1131,38,650,5,127,354,91,62,24,402,192,9489,1255,52408,61897,10/31/2020
5/3/2020,283,10970,2160,66743,77713,31,1162,27,677,8,135,350,90,61,21,423,183,9672,1551,53959,63631,10/31/2020
5/4/2020,387,11357,2098,68841,80198,30,1192,31,708,5,140,344,88,57,18,441,290,9962,1540,55499,65461,10/31/2020
5/5/2020,433,11790,2873,71714,83504,29,1221,32,740,6,146,335,82,54,16,457,301,10263,1942,57441,67704,10/31/2020
5/6/2020,488,12278,2830,74544,86822,28,1249,44,784,9,155,310,79,54,21,478,340,10603,1902,59343,69946,10/31/2020
5/7/2020,425,12703,2969,77513,90216,36,1285,43,827,5,160,298,71,52,21,499,270,10873,1946,61289,72162,10/31/2020
5/8/2020,359,13062,2598,80111,93173,30,1315,29,856,5,165,294,71,53,22,521,229,11102,1725,63014,74116,10/31/2020
5/9/2020,467,13529,3346,83457,96986,22,1337,21,877,4,169,291,69,51,15,536,290,11392,2229,65243,76635,10/31/2020
5/10/2020,285,13814,2117,85574,99388,20,1357,23,900,6,175,282,70,49,14,550,189,11581,1507,66750,78331,10/31/2020
5/11/2020,257,14071,1857,87431,101502,31,1388,16,916,6,181,291,71,49,15,565,174,11755,1285,68035,79790,10/31/2020
5/12/2020,387,14458,2611,90042,104500,23,1411,18,934,4,185,292,69,48,22,587,224,11979,1691,69726,81705,10/31/2020
5/13/2020,351,14809,3630,93672,108481,23,1434,25,959,1,186,289,69,49,13,600,199,12178,1945,71671,83849,10/31/2020
5/14/2020,329,15138,3408,97080,112218,19,1453,27,986,3,189,278,64,45,15,615,232,12410,1997,73668,86078,10/31/2020
5/15/2020,381,15519,3458,100538,116057,24,1477,41,1027,5,194,256,62,45,14,629,232,12642,1789,75457,88099,10/31/2020
5/16/2020,449,15968,4156,104694,120662,25,1502,15,1042,5,199,261,61,46,15,644,247,12889,1935,77392,90281,10/31/2020
5/17/2020,240,16208,2768,107462,123670,17,1519,9,1051,5,204,264,59,45,10,654,126,13015,1527,78919,91934,10/31/2020
5/18/2020,250,16458,2001,109463,125921,19,1538,16,1067,5,209,262,57,40,18,672,135,13150,1360,80279,93429,10/31/2020
5/19/2020,415,16873,3168,112631,129504,23,1561,33,1100,5,214,247,56,38,11,683,215,13365,1911,82190,95555,10/31/2020
5/20/2020,326,17199,2771,115402,132601,19,1580,23,1123,7,221,236,52,33,22,705,183,13548,1507,83697,97245,10/31/2020
5/21/2020,374,17573,3757,119159,136732,26,1606,15,1138,3,224,244,53,29,20,725,168,13716,1921,85618,99334,10/31/2020
5/22/2020,351,17924,3161,122320,140244,20,1626,29,1167,5,229,230,52,29,11,736,206,13922,1600,87218,101140,10/31/2020
5/23/2020,253,18177,2742,125062,143239,19,1645,11,1178,3,232,235,52,32,13,749,109,14031,1262,88480,102511,10/31/2020
5/24/2020,163,18340,1370,126432,144772,13,1658,14,1192,2,234,232,53,36,8,757,83,14114,770,89250,103364,10/31/2020
5/25/2020,147,18487,1385,127817,146304,14,1672,14,1206,0,234,232,53,34,10,767,76,14190,759,90009,104199,10/31/2020
5/26/2020,285,18772,2620,130437,149209,24,1696,22,1228,5,239,229,48,33,15,782,158,14348,1772,91781,106129,10/31/2020
5/27/2020,276,19048,2057,132494,151542,20,1716,18,1246,3,242,228,50,33,10,792,132,14480,1126,92907,107387,10/31/2020
5/28/2020,348,19396,3359,135853,155249,17,1733,29,1275,4,246,212,47,32,8,800,130,14610,1111,94018,108628,10/31/2020
5/29/2020,410,19806,3915,139768,159574,19,1752,27,1302,6,252,198,43,31,12,812,174,14784,1565,95583,110367,10/31/2020
5/30/2020,225,20031,3915,143683,163714,16,1768,19,1321,4,256,191,41,29,12,824,109,14893,1809,97392,112285,10/31/2020
5/31/2020,155,20186,1689,145372,165558,11,1779,10,1331,1,257,191,44,26,3,827,78,14971,851,98243,113214,10/31/2020
6/1/2020,212,20398,2792,148164,168562,8,1787,14,1345,1,258,184,45,29,5,832,93,15064,1375,99618,114682,10/31/2020
6/2/2020,273,20671,3022,151186,171857,8,1795,10,1355,3,261,179,38,25,10,842,98,15162,1431,101049,116211,10/31/2020
6/3/2020,254,20925,3486,154672,175597,14,1809,18,1373,6,267,169,34,25,11,853,99,15261,1648,102697,117958,10/31/2020
6/4/2020,276,21201,4471,159143,180344,7,1816,26,1399,4,271,146,31,24,12,865,107,15368,2027,104724,120092,10/31/2020
6/5/2020,215,21416,3513,162656,184072,15,1831,13,1412,6,277,142,27,21,11,876,99,15467,1565,106289,121756,10/31/2020
6/6/2020,201,21617,2616,165272,186889,10,1841,7,1419,2,279,143,29,19,6,882,67,15534,1117,107406,122940,10/31/2020
6/7/2020,83,21700,1625,166897,188597,11,1852,7,1426,1,280,146,25,17,4,886,51,15585,779,108185,123770,10/31/2020
6/8/2020,119,21819,1849,168746,190565,15,1867,12,1438,2,282,147,27,18,4,890,45,15630,952,109137,124767,10/31/2020
6/9/2020,223,22042,2673,171419,193461,10,1877,19,1457,0,282,138,28,21,1,891,64,15694,1249,110386,126080,10/31/2020
6/10/2020,209,22251,2987,174406,196657,13,1890,12,1469,2,284,137,24,17,4,895,101,15795,1456,111842,127637,10/31/2020
6/11/2020,195,22446,3513,177919,200365,7,1897,15,1484,1,285,128,25,16,6,901,88,15883,1522,113364,129247,10/31/2020
6/12/2020,209,22655,4601,182520,205175,9,1906,16,1500,1,286,120,24,16,2,903,78,15961,2164,115528,131489,10/31/2020
6/13/2020,113,22768,3036,185556,208324,6,1912,5,1505,0,286,121,20,15,3,906,49,16010,1362,116890,132900,10/31/2020
6/14/2020,81,22849,2046,187602,210451,7,1919,8,1513,1,287,119,20,14,3,909,33,16043,963,117853,133896,10/31/2020
6/15/2020,188,23037,3108,190710,213747,14,1933,19,1532,0,287,114,20,16,5,914,75,16118,1777,119630,135748,10/31/2020
6/16/2020,110,23147,3017,193727,216874,11,1944,9,1541,1,288,115,22,16,8,922,50,16168,1527,121157,137325,10/31/2020
6/17/2020,127,23274,2835,196562,219836,15,1959,22,1563,4,292,104,18,14,6,928,50,16218,1310,122467,138685,10/31/2020
6/18/2020,149,23423,3048,199610,223033,9,1968,15,1578,1,293,97,19,16,7,935,70,16288,1308,123775,140063,10/31/2020
6/19/2020,141,23564,3769,203379,226943,12,1980,12,1590,1,294,96,20,17,3,938,59,16347,1355,125130,141477,10/31/2020
6/20/2020,84,23648,1891,205270,228918,9,1989,12,1602,0,294,93,20,18,4,942,36,16383,810,125940,142323,10/31/2020
6/21/2020,37,23685,1064,206334,230019,8,1997,5,1607,0,294,96,20,18,2,944,30,16413,687,126627,143040,10/31/2020
6/22/2020,138,23823,3730,210064,233887,12,2009,16,1623,0,294,92,19,18,2,946,65,16478,1697,128324,144802,10/31/2020
6/23/2020,163,23986,3831,213895,237881,3,2012,13,1636,3,297,79,18,18,7,953,81,16559,1770,130094,146653,10/31/2020
6/24/2020,120,24106,3502,217397,241503,9,2021,11,1647,1,298,76,18,18,5,958,44,16603,1675,131769,148372,10/31/2020
6/25/2020,103,24209,2883,220280,244489,6,2027,14,1661,1,299,67,17,17,1,959,50,16653,1497,133266,149919,10/31/2020
6/26/2020,94,24303,2488,222768,247071,2,2029,10,1671,0,299,59,18,18,1,960,60,16713,1319,134585,151298,10/31/2020
6/27/2020,84,24387,3216,225984,250371,5,2034,3,1674,1,300,60,17,17,5,965,37,16750,1214,135799,152549,10/31/2020
6/28/2020,39,24426,1469,227453,251879,4,2038,4,1678,4,304,56,15,14,6,971,17,16767,592,136391,153158,10/31/2020
6/29/2020,85,24511,3697,231150,255661,4,2042,5,1683,0,304,55,14,14,1,972,39,16806,1343,137734,154540,10/31/2020
6/30/2020,57,24568,1958,233108,257676,1,2043,5,1688,1,305,50,12,11,4,976,33,16839,992,138726,155565,10/31/2020
7/1/2020,144,24712,4098,237206,261918,8,2051,10,1698,0,305,48,11,11,1,977,79,16918,1917,140643,157561,10/31/2020
7/2/2020,103,24815,2803,240009,264824,5,2056,5,1703,1,306,47,10,10,3,980,59,16977,1078,141721,158698,10/31/2020
7/3/2020,50,24865,2078,242087,266952,9,2065,6,1709,0,306,50,9,9,3,983,25,17002,776,142497,159499,10/31/2020
7/4/2020,57,24922,2345,244432,269354,2,2067,4,1713,1,307,47,10,9,2,985,33,17035,1003,143500,160535,10/31/2020
7/5/2020,49,24971,2932,247364,272335,1,2068,2,1715,1,308,45,8,8,2,987,26,17061,1434,144934,161995,10/31/2020
7/6/2020,101,25072,2811,250175,275247,6,2074,6,1721,0,308,45,9,9,4,991,57,17118,1539,146473,163591,10/31/2020
7/7/2020,81,25153,3457,253632,278785,5,2079,7,1728,0,308,43,8,8,2,993,47,17165,1532,148005,165170,10/31/2020
7/8/2020,105,25258,3409,257041,282299,4,2083,2,1730,0,308,45,9,8,0,993,64,17229,1419,149424,166653,10/31/2020
7/9/2020,94,25352,3714,260755,286107,9,2092,3,1733,0,308,51,9,8,0,993,50,17279,1611,151035,168314,10/31/2020
7/10/2020,132,25484,4432,265187,290671,6,2098,3,1736,2,310,52,7,7,3,996,80,17359,2061,153096,170455,10/31/2020
7/11/2020,63,25547,2932,268119,293666,6,2104,3,1739,1,311,54,6,6,3,999,36,17395,1310,154406,171801,10/31/2020
7/12/2020,47,25594,1837,269956,295550,1,2105,3,1742,1,312,51,6,5,3,1002,34,17429,941,155347,172776,10/31/2020
7/13/2020,84,25678,3201,273157,298835,8,2113,10,1752,0,312,49,6,5,1,1003,61,17490,1497,156844,174334,10/31/2020
7/14/2020,73,25751,3293,276450,302201,7,2120,4,1756,0,312,52,5,5,1,1004,43,17533,1370,158214,175747,10/31/2020
7/15/2020,130,25881,4173,280623,306504,5,2125,7,1763,0,312,50,5,4,0,1004,100,17633,1739,159953,177586,10/31/2020
7/16/2020,102,25983,3734,284357,310340,6,2131,9,1772,0,312,47,6,5,1,1005,75,17708,1605,161558,179266,10/31/2020
7/17/2020,156,26139,4236,288593,314732,14,2145,3,1775,1,313,57,5,5,2,1007,79,17787,1841,163399,181186,10/31/2020
7/18/2020,85,26224,3269,291862,318086,5,2150,9,1784,1,314,52,5,4,4,1011,70,17857,1392,164791,182648,10/31/2020
7/19/2020,82,26306,2694,294556,320862,7,2157,3,1787,0,314,56,6,4,2,1013,57,17914,1145,165936,183850,10/31/2020
7/20/2020,71,26377,2664,297220,323597,9,2166,7,1794,0,314,58,7,5,2,1015,68,17982,1454,167390,185372,10/31/2020
7/21/2020,130,26507,4299,301519,328026,9,2175,11,1805,0,314,56,9,6,1,1016,108,18090,1909,169299,187389,10/31/2020
7/22/2020,130,26637,3927,305446,332083,11,2186,11,1816,1,315,55,7,6,1,1017,86,18176,1673,170972,189148,10/31/2020
7/23/2020,141,26778,4413,309859,336637,9,2195,6,1822,0,315,58,8,7,0,1017,115,18291,1971,172943,191234,10/31/2020
7/24/2020,172,26950,5961,315820,342770,14,2209,14,1836,0,315,58,9,7,0,1017,119,18410,2303,175246,193656,10/31/2020
7/25/2020,134,27084,4399,320219,347303,7,2216,7,1843,0,315,58,10,8,3,1020,108,18518,2085,177331,195849,10/31/2020
7/26/2020,62,27146,3027,323246,350392,8,2224,9,1852,0,315,57,11,7,1,1021,54,18572,1327,178658,197230,10/31/2020
7/27/2020,188,27334,4190,327436,354770,12,2236,7,1859,0,315,62,13,8,1,1022,138,18710,2334,180992,199702,10/31/2020
7/28/2020,105,27439,3834,331270,358709,5,2241,5,1864,0,315,62,14,7,1,1023,95,18805,1626,182618,201423,10/31/2020
7/29/2020,190,27629,5137,336407,364036,11,2252,12,1876,0,315,61,15,7,0,1023,154,18959,2303,184921,203880,10/31/2020
7/30/2020,121,27750,4344,340751,368501,6,2258,2,1878,1,316,64,15,6,1,1024,97,19056,1640,186561,205617,10/31/2020
7/31/2020,131,27881,5509,346260,374141,8,2266,10,1888,0,316,62,15,7,1,1025,89,19145,1841,188402,207547,10/31/2020
8/1/2020,108,27989,4292,350552,378541,7,2273,2,1890,0,316,67,14,7,1,1026,88,19233,1552,189954,209187,10/31/2020
8/2/2020,84,28073,2802,353354,381427,12,2285,12,1902,2,318,65,14,8,2,1028,62,19295,1265,191219,210514,10/31/2020
8/3/2020,186,28259,5238,358592,386851,13,2298,12,1914,0,318,66,16,7,1,1029,149,19444,2185,193404,212848,10/31/2020
8/4/2020,125,28384,3691,362283,390667,9,2307,6,1920,1,319,68,12,5,2,1031,99,19543,1765,195169,214712,10/31/2020
8/5/2020,147,28531,5934,368217,396748,12,2319,10,1930,1,320,69,10,5,2,1033,118,19661,2459,197628,217289,10/31/2020
8/6/2020,169,28700,5533,373750,402450,7,2326,9,1939,0,320,67,9,4,0,1033,120,19781,2390,200018,219799,10/31/2020
8/7/2020,121,28821,4847,378597,407418,13,2339,10,1949,1,321,69,9,3,2,1035,87,19868,2133,202151,222019,10/31/2020
8/8/2020,123,28944,4107,382704,411648,19,2358,6,1955,1,322,81,8,3,1,1036,91,19959,1769,203920,223879,10/31/2020
8/9/2020,42,28986,1722,384426,413412,8,2366,10,1965,0,322,79,9,4,0,1036,35,19994,1067,204987,224981,10/31/2020
8/10/2020,149,29135,4584,389010,418145,11,2377,12,1977,0,322,78,9,4,1,1037,113,20107,2014,207001,227108,10/31/2020
8/11/2020,105,29240,4329,393339,422579,6,2383,14,1991,0,322,70,10,4,3,1040,92,20199,2255,209256,229455,10/31/2020
8/12/2020,121,29361,5186,398525,427886,8,2391,11,2002,0,322,67,9,3,1,1041,101,20300,2618,211874,232174,10/31/2020
8/13/2020,135,29496,4192,402717,432213,13,2404,12,2014,0,322,68,11,3,0,1041,95,20395,1894,213768,234163,10/31/2020
8/14/2020,145,29641,5494,408211,437852,13,2417,11,2025,0,322,70,11,4,3,1044,99,20494,1968,215736,236230,10/31/2020
8/15/2020,105,29746,4533,412744,442490,9,2426,11,2036,1,323,67,11,5,0,1044,88,20582,1683,217419,238001,10/31/2020
8/16/2020,83,29829,2472,415216,445045,7,2433,6,2042,4,327,64,8,4,6,1050,70,20652,957,218376,239028,10/31/2020
8/17/2020,106,29935,4570,419786,449721,10,2443,7,2049,0,327,67,8,5,2,1052,87,20739,2382,220758,241497,10/31/2020
8/18/2020,128,30063,4904,424690,454753,11,2454,9,2058,1,328,68,8,4,5,1057,94,20833,2740,223498,244331,10/31/2020
8/19/2020,113,30176,5065,429755,459931,8,2462,9,2067,1,329,66,9,5,0,1057,90,20923,2630,226128,247051,10/31/2020
8/20/2020,173,30349,7405,437160,467509,12,2474,6,2073,2,331,70,10,5,3,1060,139,21062,3509,229637,250699,10/31/2020
8/21/2020,151,30500,6572,443732,474232,8,2482,5,2078,1,332,72,9,4,2,1062,125,21187,2939,232576,253763,10/31/2020
8/22/2020,96,30596,5547,449279,479875,10,2492,12,2090,0,332,70,11,4,1,1063,84,21271,2597,235173,256444,10/31/2020
8/23/2020,70,30666,4371,453650,484316,11,2503,6,2096,0,332,75,11,2,1,1064,56,21327,2465,237638,258965,10/31/2020
8/24/2020,105,30771,5776,459426,490197,7,2510,10,2106,1,333,71,13,4,1,1065,77,21404,3142,240780,262184,10/31/2020
8/25/2020,108,30879,4759,464185,495064,10,2520,4,2110,1,334,76,11,4,1,1066,92,21496,2282,243062,264558,10/31/2020
8/26/2020,170,31049,9477,473662,504711,4,2524,8,2118,0,334,72,9,5,1,1067,127,21623,3078,246140,267763,10/31/2020
8/27/2020,92,31141,8564,482226,513367,6,2530,13,2131,1,335,64,6,5,2,1069,70,21693,3157,249297,270990,10/31/2020
8/28/2020,112,31253,7991,490217,521470,14,2544,4,2135,0,335,74,9,7,2,1071,87,21780,2424,251721,273501,10/31/2020
8/29/2020,65,31318,5368,495585,526903,6,2550,8,2143,1,336,71,10,6,2,1073,51,21831,1908,253629,275460,10/31/2020
8/30/2020,66,31384,4320,499905,531289,7,2557,4,2147,0,336,74,8,5,2,1075,48,21879,1992,255621,277500,10/31/2020
8/31/2020,105,31489,4863,504768,536257,12,2569,15,2162,0,336,71,8,4,1,1076,81,21960,2183,257804,279764,10/31/2020
9/1/2020,97,31586,7109,511877,543463,6,2575,9,2171,1,337,67,7,4,2,1078,65,22025,2375,260179,282204,10/31/2020
9/2/2020,125,31711,10524,522401,554112,9,2584,10,2181,1,338,65,8,4,2,1080,104,22129,3048,263227,285356,10/31/2020
9/3/2020,90,31801,11065,533466,565267,8,2592,8,2189,0,338,65,9,4,3,1083,73,22202,2579,265806,288008,10/31/2020
9/4/2020,102,31903,8953,542419,574322,11,2603,4,2193,0,338,72,9,4,1,1084,84,22286,2361,268167,290453,10/31/2020
9/5/2020,52,31955,6303,548722,580677,6,2609,9,2202,0,338,69,8,3,1,1085,42,22328,1597,269764,292092,10/31/2020
9/6/2020,87,32042,4319,553041,585083,4,2613,8,2210,1,339,64,6,3,1,1086,64,22392,1944,271708,294100,10/31/2020
9/7/2020,35,32077,3002,556043,588120,11,2624,3,2213,0,339,72,5,3,1,1087,26,22418,645,272353,294771,10/31/2020
9/8/2020,74,32151,6376,562419,594570,6,2630,12,2225,1,340,65,6,3,2,1089,66,22484,1590,273943,296427,10/31/2020
9/9/2020,118,32269,8641,571060,603329,9,2639,5,2230,1,341,68,9,3,1,1090,102,22586,2139,276082,298668,10/31/2020
9/10/2020,164,32433,11327,582387,614820,9,2648,8,2238,0,341,69,10,3,1,1091,111,22697,2273,278355,301052,10/31/2020
9/11/2020,120,32553,9449,591836,624389,11,2659,11,2249,0,341,69,10,5,0,1091,98,22795,1964,280319,303114,10/31/2020
9/12/2020,109,32662,6165,598001,630663,8,2667,5,2254,2,343,70,9,5,3,1094,97,22892,1520,281839,304731,10/31/2020
9/13/2020,58,32720,2710,600711,633431,4,2671,3,2257,0,343,71,10,5,0,1094,54,22946,858,282697,305643,10/31/2020
9/14/2020,104,32824,6437,607148,639972,5,2676,3,2260,2,345,71,10,5,2,1096,95,23041,1731,284428,307469,10/31/2020
9/15/2020,122,32946,8462,615610,648556,7,2683,2,2262,1,346,75,10,5,2,1098,124,23165,2197,286625,309790,10/31/2020
9/16/2020,137,33083,9712,625322,658405,7,2690,7,2269,2,348,73,9,6,5,1103,118,23283,1972,288597,311880,10/31/2020
9/17/2020,124,33207,9234,634556,667763,7,2697,14,2283,0,348,66,8,4,0,1103,154,23437,1948,290545,313982,10/31/2020
9/18/2020,132,33339,10036,644592,677931,7,2704,7,2290,1,349,65,11,6,2,1105,132,23569,1926,292471,316040,10/31/2020
9/19/2020,115,33454,8298,652890,686344,7,2711,3,2293,0,349,69,10,6,4,1109,112,23681,1692,294163,317844,10/31/2020
9/20/2020,60,33514,3671,656561,690075,7,2718,6,2299,2,351,68,9,8,4,1113,49,23730,1324,295487,319217,10/31/2020
9/21/2020,102,33616,7017,663578,697194,12,2730,3,2302,2,353,75,8,6,2,1115,94,23824,2409,297896,321720,10/31/2020
9/22/2020,154,33770,9283,672861,706631,12,2742,3,2305,1,354,83,7,5,1,1116,123,23947,2204,300100,324047,10/31/2020
9/23/2020,136,33906,10646,683507,717413,12,2754,7,2312,0,354,88,6,5,0,1116,127,24074,2218,302318,326392,10/31/2020
9/24/2020,118,34024,12473,695980,730004,7,2761,9,2321,1,355,85,7,5,1,1117,120,24194,3169,305487,329681,10/31/2020
9/25/2020,149,34173,10545,706525,740698,9,2770,10,2331,0,355,84,6,5,1,1118,142,24336,3010,308497,332833,10/31/2020
9/26/2020,146,34319,10553,717078,751397,12,2782,9,2340,0,355,87,6,5,1,1119,119,24455,2424,310921,335376,10/31/2020
9/27/2020,43,34362,2761,719839,754201,7,2789,5,2345,0,355,89,9,5,0,1119,34,24489,846,311767,336256,10/31/2020
9/28/2020,152,34514,7303,727142,761656,7,2796,7,2352,2,357,87,7,5,2,1121,133,24622,2262,314029,338651,10/31/2020
9/29/2020,208,34722,11042,738184,772906,12,2808,18,2370,1,358,80,6,6,1,1122,190,24812,2830,316859,341671,10/31/2020
9/30/2020,221,34943,12225,750409,785352,6,2814,6,2376,0,358,80,6,6,1,1123,187,24999,2600,319459,344458,10/31/2020
10/1/2020,184,35127,12497,762906,798033,17,2831,13,2389,1,359,83,6,4,2,1125,166,25165,2425,321884,347049,10/31/2020
10/2/2020,210,35337,12143,775049,810386,14,2845,13,2402,1,360,83,8,5,2,1127,181,25346,2498,324382,349728,10/31/2020
10/3/2020,157,35494,9312,784361,819855,9,2854,9,2411,2,362,81,9,4,2,1129,131,25477,2031,326413,351890,10/31/2020
10/4/2020,81,35575,2367,786728,822303,11,2865,9,2420,1,363,82,8,5,2,1131,78,25555,958,327371,352926,10/31/2020
10/5/2020,174,35749,8969,795697,831446,30,2895,11,2431,2,365,99,9,6,4,1135,160,25715,3037,330408,356123,10/31/2020
10/6/2020,176,35925,11173,806870,842795,11,2906,5,2436,0,365,105,11,7,0,1135,186,25901,2910,333318,359219,10/31/2020
10/7/2020,228,36153,12426,819296,855449,13,2919,14,2450,2,367,102,9,7,2,1137,242,26143,3540,336858,363001,10/31/2020
10/8/2020,262,36415,15211,834507,870922,17,2936,13,2463,2,369,104,7,5,3,1140,275,26418,4216,341074,367492,10/31/2020
10/9/2020,216,36631,13735,848242,884873,21,2957,12,2475,0,369,113,10,7,3,1143,198,26616,4343,345417,372033,10/31/2020
10/10/2020,229,36860,13826,862068,898928,19,2976,10,2485,1,370,121,13,7,2,1145,195,26811,3825,349242,376053,10/31/2020
10/11/2020,94,36954,3253,865321,902275,12,2988,9,2494,1,371,123,14,5,6,1151,87,26898,1160,350402,377300,10/31/2020
10/12/2020,165,37119,6414,871735,908854,19,3007,15,2509,2,373,125,14,5,4,1155,158,27056,1745,352147,379203,10/31/2020
10/13/2020,210,37329,8499,880234,917563,15,3022,15,2524,4,377,121,13,5,7,1162,204,27260,2308,354455,381715,10/31/2020
10/14/2020,320,37649,15025,895259,932908,17,3039,7,2531,0,377,131,15,5,2,1164,304,27564,4056,358511,386075,10/31/2020
10/15/2020,261,37910,14622,909881,947791,11,3050,16,2547,1,378,125,13,5,2,1166,254,27818,3590,362101,389919,10/31/2020
10/16/2020,276,38186,14971,924852,963038,13,3063,20,2567,1,379,117,13,4,2,1168,272,28090,3397,365498,393588,10/31/2020
10/17/2020,348,38534,14024,938876,977410,19,3082,11,2578,1,380,124,17,4,2,1170,304,28394,3266,368764,397158,10/31/2020
10/18/2020,153,38687,3991,942867,981554,18,3100,11,2589,0,380,131,17,5,2,1172,127,28521,1310,370074,398595,10/31/2020
10/19/2020,381,39068,8416,951283,990351,21,3121,23,2612,2,382,127,15,5,1,1173,321,28842,2550,372624,401466,10/31/2020
10/20/2020,429,39497,13137,964420,1003917,22,3143,17,2629,0,382,132,14,7,3,1176,380,29222,2970,375594,404816,10/31/2020
10/21/2020,537,40034,17408,981828,1021862,21,3164,9,2638,2,384,142,15,9,3,1179,471,29693,3536,379130,408823,10/31/2020
10/22/2020,537,40571,15850,997678,1038249,24,3188,21,2659,3,387,142,14,9,3,1182,486,30179,3225,382355,412534,10/31/2020
10/23/2020,510,41081,16620,1014298,1055379,22,3210,26,2685,1,388,137,15,9,3,1185,445,30624,2911,385266,415890,10/31/2020
10/24/2020,355,41436,10063,1024361,1065797,15,3225,11,2696,0,388,141,14,8,1,1186,328,30952,2289,387555,418507,10/31/2020
10/25/2020,231,41667,4761,1029122,1070789,15,3240,15,2711,1,389,140,15,8,1,1187,205,31157,1493,389048,420205,10/31/2020
10/26/2020,446,42113,9142,1038264,1080377,22,3262,20,2731,2,391,140,17,8,3,1190,385,31542,2990,392038,423580,10/31/2020
10/27/2020,516,42629,13582,1051846,1094475,27,3289,11,2742,2,393,154,16,9,4,1194,447,31989,2403,394441,426430,10/31/2020
10/28/2020,468,43097,14802,1066648,1109745,20,3309,21,2763,1,394,152,15,9,3,1197,403,32392,2723,397164,429556,10/31/2020
10/29/2020,551,43648,14011,1080659,1124307,,,,,,,,,,4,1201,482,32874,2838,400002,432876,10/31/2020
2/27/2020,0,0,0,0,0,1,1,0,0,0,0,1,0,0,0,0,0,0,0,0,0,11/3/2020
2/28/2020,0,0,0,0,0,0,1,0,0,0,0,1,1,0,0,0,0,0,0,0,0,11/3/2020
2/29/2020,0,0,0,0,0,0,1,0,0,0,0,1,1,0,0,0,0,0,0,0,0,11/3/2020
3/1/2020,2,2,2,2,4,0,1,0,0,0,0,1,1,1,0,0,2,2,2,2,4,11/3/2020
3/2/2020,0,2,1,3,5,1,2,0,0,0,0,2,2,2,0,0,0,2,1,3,5,11/3/2020
3/3/2020,0,2,2,5,7,0,2,0,0,0,0,2,2,2,0,0,0,2,2,5,7,11/3/2020
3/4/2020,0,2,12,17,19,1,3,0,0,0,0,3,2,2,0,0,0,2,10,15,17,11/3/2020
3/5/2020,0,2,4,21,23,0,3,0,0,0,0,3,2,2,0,0,1,3,4,19,22,11/3/2020
3/6/2020,1,3,12,33,36,0,3,0,0,0,0,3,2,2,0,0,0,3,11,30,33,11/3/2020
3/7/2020,0,3,19,52,55,0,3,0,0,0,0,3,2,1,0,0,0,3,19,49,52,11/3/2020
3/8/2020,0,3,18,70,73,0,3,0,0,0,0,3,2,1,0,0,0,3,18,67,70,11/3/2020
3/9/2020,1,4,15,85,89,0,3,0,0,0,0,3,2,1,0,0,1,4,15,82,86,11/3/2020
3/10/2020,2,6,25,110,116,0,3,0,0,0,0,3,2,1,0,0,1,5,23,105,110,11/3/2020
3/11/2020,0,6,34,144,150,1,4,0,0,0,0,4,1,1,0,0,0,5,34,139,144,11/3/2020
3/12/2020,9,15,41,185,200,1,5,0,0,0,0,5,1,1,0,0,8,13,38,177,190,11/3/2020
3/13/2020,6,21,50,235,256,4,9,1,1,0,0,8,1,1,0,0,6,19,48,225,244,11/3/2020
3/14/2020,0,21,90,325,346,0,9,0,1,0,0,8,1,1,0,0,0,19,86,311,330,11/3/2020
3/15/2020,1,22,54,379,401,1,10,0,1,0,0,9,2,1,0,0,1,20,54,365,385,11/3/2020
3/16/2020,2,24,95,474,498,2,12,0,1,0,0,11,2,0,0,0,2,22,92,457,479,11/3/2020
3/17/2020,12,36,162,636,672,6,18,0,1,0,0,17,2,0,0,0,11,33,150,607,640,11/3/2020
3/18/2020,9,45,116,752,797,3,21,0,1,0,0,20,2,0,0,0,11,44,110,717,761,11/3/2020
3/19/2020,15,60,262,1014,1074,2,23,1,2,0,0,21,3,0,1,1,17,61,248,965,1026,11/3/2020
3/20/2020,13,73,197,1211,1284,5,28,0,2,0,0,26,4,0,0,1,13,74,189,1154,1228,11/3/2020
3/21/2020,12,85,126,1337,1422,3,31,2,4,0,0,27,5,0,0,1,14,88,122,1276,1364,11/3/2020
3/22/2020,27,112,282,1619,1731,2,33,0,4,0,0,29,5,0,0,1,25,113,259,1535,1648,11/3/2020
3/23/2020,14,126,169,1788,1914,15,48,1,5,0,0,43,9,3,0,1,16,129,162,1697,1826,11/3/2020
3/24/2020,20,146,242,2030,2176,7,55,0,5,0,0,50,10,4,0,1,19,148,232,1929,2077,11/3/2020
3/25/2020,26,172,182,2212,2384,5,60,1,6,0,0,54,11,3,0,1,28,176,168,2097,2273,11/3/2020
3/26/2020,35,207,181,2393,2600,10,70,5,11,0,0,59,14,5,0,1,41,217,171,2268,2485,11/3/2020
3/27/2020,27,234,214,2607,2841,9,79,1,12,1,1,66,17,6,2,3,31,248,199,2467,2715,11/3/2020
3/28/2020,59,293,260,2867,3160,13,92,3,15,2,3,74,15,6,1,4,64,312,240,2707,3019,11/3/2020
3/29/2020,100,393,350,3217,3610,8,100,4,19,1,4,77,18,8,2,6,105,417,311,3018,3435,11/3/2020
3/30/2020,62,455,222,3439,3894,20,120,5,24,0,4,92,20,11,3,9,78,495,183,3201,3696,11/3/2020
3/31/2020,71,526,369,3808,4334,11,131,7,31,1,5,95,22,13,2,11,73,568,294,3495,4063,11/3/2020
4/1/2020,99,625,698,4506,5131,18,149,7,38,0,5,106,30,15,1,12,100,668,633,4128,4796,11/3/2020
4/2/2020,52,677,477,4983,5660,22,171,6,44,2,7,120,36,21,4,16,62,730,432,4560,5290,11/3/2020
4/3/2020,108,785,774,5757,6542,23,194,7,51,0,7,136,43,25,3,19,100,830,701,5261,6091,11/3/2020
4/4/2020,143,928,660,6417,7345,22,216,4,55,5,12,149,41,30,9,28,138,968,610,5871,6839,11/3/2020
4/5/2020,187,1115,1156,7573,8688,20,236,9,64,1,13,159,44,36,2,30,181,1149,1048,6919,8068,11/3/2020
4/6/2020,218,1333,1706,9279,10612,26,262,7,71,0,13,178,48,40,7,37,207,1356,1529,8448,9804,11/3/2020
4/7/2020,284,1617,1629,10908,12525,20,282,4,75,2,15,192,50,42,5,42,261,1617,1466,9914,11531,11/3/2020
4/8/2020,290,1907,1720,12628,14535,19,301,7,82,6,21,198,50,38,10,52,271,1888,1530,11444,13332,11/3/2020
4/9/2020,283,2190,1516,14144,16334,32,333,9,91,4,25,217,53,40,7,59,277,2165,1343,12787,14952,11/3/2020
4/10/2020,419,2609,2574,16718,19327,29,362,17,108,5,30,224,59,41,11,70,400,2565,2337,15124,17689,11/3/2020
4/11/2020,297,2906,1905,18623,21529,29,391,11,119,2,32,240,61,48,12,82,281,2846,1700,16824,19670,11/3/2020
4/12/2020,314,3220,1670,20293,23513,35,426,13,132,5,37,257,59,49,9,91,285,3131,1412,18236,21367,11/3/2020
4/13/2020,161,3381,935,21228,24609,35,461,13,145,3,40,276,64,54,9,100,187,3318,830,19066,22384,11/3/2020
4/14/2020,289,3670,1787,23015,26685,27,488,18,163,5,45,280,72,53,8,108,262,3580,1509,20575,24155,11/3/2020
4/15/2020,351,4021,1799,24814,28835,31,519,20,183,3,48,288,72,54,17,125,306,3886,1528,22103,25989,11/3/2020
4/16/2020,447,4468,2494,27308,31776,36,555,25,208,6,54,293,72,53,14,139,387,4273,2056,24159,28432,11/3/2020
4/17/2020,304,4772,1821,29129,33901,32,587,20,228,7,61,298,66,45,21,160,290,4563,1424,25583,30146,11/3/2020
4/18/2020,321,5093,1725,30854,35947,26,613,18,246,4,65,302,63,49,15,175,284,4847,1307,26890,31737,11/3/2020
4/19/2020,381,5474,2047,32901,38375,23,636,26,272,1,66,298,65,55,11,186,337,5184,1720,28610,33794,11/3/2020
4/20/2020,394,5868,1907,34808,40676,46,682,29,301,2,68,313,75,56,10,196,376,5560,1558,30168,35728,11/3/2020
4/21/2020,444,6312,2110,36918,43230,45,727,33,334,5,73,320,72,56,18,214,383,5943,1681,31849,37792,11/3/2020
4/22/2020,418,6730,2390,39308,46038,41,768,32,366,5,78,324,73,58,18,232,379,6322,1889,33738,40060,11/3/2020
4/23/2020,479,7209,2469,41777,48986,32,800,28,394,5,83,323,76,62,15,247,412,6734,1835,35573,42307,11/3/2020
4/24/2020,491,7700,3284,45061,52761,35,835,26,420,4,87,328,85,63,15,262,407,7141,2590,38163,45304,11/3/2020
4/25/2020,393,8093,2206,47267,55360,34,869,17,437,5,92,340,85,62,14,276,300,7441,1740,39903,47344,11/3/2020
4/26/2020,316,8409,2309,49576,57985,33,902,15,452,3,95,355,86,59,14,290,274,7715,1852,41755,49470,11/3/2020
4/27/2020,249,8658,1620,51196,59854,29,931,21,473,4,99,359,86,61,10,300,206,7921,1146,42901,50822,11/3/2020
4/28/2020,410,9068,2263,53459,62527,44,975,24,497,3,102,376,88,59,22,322,332,8253,1720,44621,52874,11/3/2020
4/29/2020,476,9544,3343,56802,66346,36,1011,38,535,11,113,363,78,53,18,340,371,8624,2392,47013,55637,11/3/2020
4/30/2020,432,9976,2769,59571,69547,33,1044,38,573,6,119,352,83,57,24,364,350,8974,1883,48896,57870,11/3/2020
5/1/2020,454,10430,3086,62657,73087,51,1095,39,612,3,122,361,84,58,14,378,323,9297,2137,51033,60330,11/3/2020
5/2/2020,257,10687,1926,64583,75270,36,1131,38,650,5,127,354,91,62,24,402,192,9489,1253,52286,61775,11/3/2020
5/3/2020,283,10970,2160,66743,77713,31,1162,27,677,8,135,350,90,61,21,423,183,9672,1550,53836,63508,11/3/2020
5/4/2020,387,11357,2098,68841,80198,30,1192,31,708,5,140,344,88,57,18,441,290,9962,1536,55372,65334,11/3/2020
5/5/2020,433,11790,2873,71714,83504,29,1221,32,740,6,146,335,82,54,16,457,301,10263,1936,57308,67571,11/3/2020
5/6/2020,488,12278,2830,74544,86822,28,1249,44,784,9,155,310,79,54,21,478,340,10603,1896,59204,69807,11/3/2020
5/7/2020,425,12703,2969,77513,90216,36,1285,43,827,5,160,298,71,52,21,499,270,10873,1941,61145,72018,11/3/2020
5/8/2020,359,13062,2598,80111,93173,30,1315,29,856,5,165,294,71,53,22,521,229,11102,1721,62866,73968,11/3/2020
5/9/2020,467,13529,3346,83457,96986,22,1337,21,877,4,169,291,69,51,15,536,290,11392,2217,65083,76475,11/3/2020
5/10/2020,285,13814,2117,85574,99388,20,1357,23,900,6,175,282,70,49,14,550,189,11581,1501,66584,78165,11/3/2020
5/11/2020,257,14071,1857,87431,101502,31,1388,16,916,6,181,291,71,49,15,565,174,11755,1281,67865,79620,11/3/2020
5/12/2020,387,14458,2611,90042,104500,23,1411,18,934,4,185,292,69,48,22,587,224,11979,1686,69551,81530,11/3/2020
5/13/2020,351,14809,3630,93672,108481,23,1434,25,959,1,186,289,69,49,13,600,199,12178,1940,71491,83669,11/3/2020
5/14/2020,329,15138,3408,97080,112218,19,1453,27,986,3,189,278,64,45,15,615,232,12410,1995,73486,85896,11/3/2020
5/15/2020,381,15519,3458,100538,116057,24,1477,41,1027,5,194,256,62,45,14,629,232,12642,1785,75271,87913,11/3/2020
5/16/2020,449,15968,4156,104694,120662,25,1502,15,1042,5,199,261,61,46,15,644,247,12889,1928,77199,90088,11/3/2020
5/17/2020,240,16208,2768,107462,123670,17,1519,9,1051,5,204,264,59,45,10,654,126,13015,1526,78725,91740,11/3/2020
5/18/2020,250,16458,2001,109463,125921,19,1538,16,1067,5,209,262,57,40,18,672,135,13150,1359,80084,93234,11/3/2020
5/19/2020,415,16873,3168,112631,129504,23,1561,33,1100,5,214,247,56,38,11,683,215,13365,1908,81992,95357,11/3/2020
5/20/2020,326,17199,2771,115402,132601,19,1580,23,1123,7,221,236,52,33,22,705,183,13548,1506,83498,97046,11/3/2020
5/21/2020,374,17573,3757,119159,136732,26,1606,15,1138,3,224,244,53,29,20,725,168,13716,1919,85417,99133,11/3/2020
5/22/2020,351,17924,3161,122320,140244,20,1626,29,1167,5,229,230,52,29,11,736,206,13922,1598,87015,100937,11/3/2020
5/23/2020,253,18177,2742,125062,143239,19,1645,11,1178,3,232,235,52,32,13,749,109,14031,1259,88274,102305,11/3/2020
5/24/2020,163,18340,1370,126432,144772,13,1658,14,1192,2,234,232,53,36,8,757,83,14114,768,89042,103156,11/3/2020
5/25/2020,147,18487,1385,127817,146304,14,1672,14,1206,0,234,232,53,34,10,767,76,14190,757,89799,103989,11/3/2020
5/26/2020,285,18772,2620,130437,149209,24,1696,22,1228,5,239,229,48,33,15,782,158,14348,1769,91568,105916,11/3/2020
5/27/2020,276,19048,2057,132494,151542,20,1716,18,1246,3,242,228,50,33,10,792,132,14480,1124,92692,107172,11/3/2020
5/28/2020,348,19396,3359,135853,155249,17,1733,29,1275,4,246,212,47,32,8,800,130,14610,1109,93801,108411,11/3/2020
5/29/2020,410,19806,3915,139768,159574,19,1752,27,1302,6,252,198,43,31,12,812,174,14784,1563,95364,110148,11/3/2020
5/30/2020,225,20031,3915,143683,163714,16,1768,19,1321,4,256,191,41,29,12,824,109,14893,1807,97171,112064,11/3/2020
5/31/2020,155,20186,1690,145373,165559,11,1779,10,1331,1,257,191,44,26,3,827,78,14971,849,98020,112991,11/3/2020
6/1/2020,212,20398,2792,148165,168563,8,1787,14,1345,1,258,184,45,29,5,832,93,15064,1374,99394,114458,11/3/2020
6/2/2020,273,20671,3022,151187,171858,8,1795,10,1355,3,261,179,38,25,10,842,98,15162,1426,100820,115982,11/3/2020
6/3/2020,254,20925,3486,154673,175598,14,1809,18,1373,6,267,169,34,25,11,853,99,15261,1646,102466,117727,11/3/2020
6/4/2020,276,21201,4471,159144,180345,7,1816,26,1399,4,271,146,31,24,12,865,107,15368,2021,104487,119855,11/3/2020
6/5/2020,215,21416,3513,162657,184073,15,1831,13,1412,6,277,142,27,21,11,876,99,15467,1561,106048,121515,11/3/2020
6/6/2020,201,21617,2616,165273,186890,10,1841,7,1419,2,279,143,29,19,6,882,67,15534,1115,107163,122697,11/3/2020
6/7/2020,83,21700,1625,166898,188598,11,1852,7,1426,1,280,146,25,17,4,886,51,15585,779,107942,123527,11/3/2020
6/8/2020,119,21819,1849,168747,190566,15,1867,12,1438,2,282,147,27,18,4,890,45,15630,950,108892,124522,11/3/2020
6/9/2020,223,22042,2673,171420,193462,10,1877,19,1457,0,282,138,28,21,1,891,64,15694,1247,110139,125833,11/3/2020
6/10/2020,209,22251,2987,174407,196658,13,1890,12,1469,2,284,137,24,17,4,895,101,15795,1456,111595,127390,11/3/2020
6/11/2020,195,22446,3513,177920,200366,7,1897,15,1484,1,285,128,25,16,6,901,88,15883,1519,113114,128997,11/3/2020
6/12/2020,209,22655,4601,182521,205176,9,1906,16,1500,1,286,120,24,16,2,903,78,15961,2163,115277,131238,11/3/2020
6/13/2020,113,22768,3036,185557,208325,6,1912,5,1505,0,286,121,20,15,3,906,49,16010,1360,116637,132647,11/3/2020
6/14/2020,81,22849,2046,187603,210452,7,1919,8,1513,1,287,119,20,14,3,909,33,16043,962,117599,133642,11/3/2020
6/15/2020,188,23037,3108,190711,213748,14,1933,19,1532,0,287,114,20,16,5,914,75,16118,1776,119375,135493,11/3/2020
6/16/2020,110,23147,3017,193728,216875,11,1944,9,1541,1,288,115,22,16,8,922,50,16168,1525,120900,137068,11/3/2020
6/17/2020,127,23274,2835,196563,219837,15,1959,22,1563,4,292,104,18,14,6,928,50,16218,1304,122204,138422,11/3/2020
6/18/2020,149,23423,3048,199611,223034,9,1968,15,1578,1,293,97,19,16,7,935,70,16288,1307,123511,139799,11/3/2020
6/19/2020,141,23564,3769,203380,226944,12,1980,12,1590,1,294,96,20,17,3,938,59,16347,1353,124864,141211,11/3/2020
6/20/2020,84,23648,1891,205271,228919,9,1989,12,1602,0,294,93,20,18,4,942,36,16383,809,125673,142056,11/3/2020
6/21/2020,37,23685,1064,206335,230020,8,1997,5,1607,0,294,96,20,18,2,944,30,16413,686,126359,142772,11/3/2020
6/22/2020,138,23823,3730,210065,233888,12,2009,16,1623,0,294,92,19,18,2,946,65,16478,1694,128053,144531,11/3/2020
6/23/2020,163,23986,3831,213896,237882,3,2012,13,1636,3,297,79,18,18,7,953,81,16559,1765,129818,146377,11/3/2020
6/24/2020,120,24106,3502,217398,241504,9,2021,11,1647,1,298,76,18,18,5,958,44,16603,1671,131489,148092,11/3/2020
6/25/2020,103,24209,2883,220281,244490,6,2027,14,1661,1,299,67,17,17,1,959,50,16653,1494,132983,149636,11/3/2020
6/26/2020,94,24303,2488,222769,247072,2,2029,10,1671,0,299,59,18,18,1,960,60,16713,1319,134302,151015,11/3/2020
6/27/2020,84,24387,3216,225985,250372,5,2034,3,1674,1,300,60,17,17,5,965,37,16750,1213,135515,152265,11/3/2020
6/28/2020,39,24426,1469,227454,251880,4,2038,4,1678,4,304,56,15,14,6,971,17,16767,592,136107,152874,11/3/2020
6/29/2020,85,24511,3697,231151,255662,4,2042,5,1683,0,304,55,14,14,1,972,39,16806,1342,137449,154255,11/3/2020
6/30/2020,57,24568,1958,233109,257677,1,2043,5,1688,1,305,50,12,11,4,976,33,16839,992,138441,155280,11/3/2020
7/1/2020,144,24712,4098,237207,261919,8,2051,10,1698,0,305,48,11,11,1,977,79,16918,1914,140355,157273,11/3/2020
7/2/2020,103,24815,2803,240010,264825,5,2056,5,1703,1,306,47,10,10,3,980,59,16977,1075,141430,158407,11/3/2020
7/3/2020,50,24865,2079,242089,266954,9,2065,6,1709,0,306,50,9,9,3,983,25,17002,777,142207,159209,11/3/2020
7/4/2020,57,24922,2345,244434,269356,2,2067,4,1713,1,307,47,10,9,2,985,33,17035,1000,143207,160242,11/3/2020
7/5/2020,49,24971,2932,247366,272337,1,2068,2,1715,1,308,45,8,8,2,987,26,17061,1431,144638,161699,11/3/2020
7/6/2020,101,25072,2814,250180,275252,6,2074,6,1721,0,308,45,9,9,4,991,57,17118,1537,146175,163293,11/3/2020
7/7/2020,81,25153,3457,253637,278790,5,2079,7,1728,0,308,43,8,8,2,993,47,17165,1532,147707,164872,11/3/2020
7/8/2020,105,25258,3409,257046,282304,4,2083,2,1730,0,308,45,9,8,0,993,64,17229,1417,149124,166353,11/3/2020
7/9/2020,94,25352,3714,260760,286112,9,2092,3,1733,0,308,51,9,8,0,993,50,17279,1608,150732,168011,11/3/2020
7/10/2020,132,25484,4437,265197,290681,6,2098,3,1736,2,310,52,7,7,3,996,80,17359,2065,152797,170156,11/3/2020
7/11/2020,63,25547,2938,268135,293682,6,2104,3,1739,1,311,54,6,6,3,999,36,17395,1312,154109,171504,11/3/2020
7/12/2020,47,25594,1838,269973,295567,1,2105,3,1742,1,312,51,6,5,3,1002,34,17429,941,155050,172479,11/3/2020
7/13/2020,84,25678,3209,273182,298860,8,2113,10,1752,0,312,49,6,5,1,1003,61,17490,1500,156550,174040,11/3/2020
7/14/2020,74,25752,3298,276480,302232,7,2120,4,1756,0,312,52,5,5,1,1004,44,17534,1373,157923,175457,11/3/2020
7/15/2020,130,25882,4181,280661,306543,5,2125,7,1763,0,312,50,5,4,0,1004,100,17634,1743,159666,177300,11/3/2020
7/16/2020,103,25985,3740,284401,310386,6,2131,9,1772,0,312,47,6,5,1,1005,76,17710,1611,161277,178987,11/3/2020
7/17/2020,156,26141,4238,288639,314780,14,2145,3,1775,1,313,57,5,5,2,1007,79,17789,1843,163120,180909,11/3/2020
7/18/2020,85,26226,3272,291911,318137,5,2150,9,1784,1,314,52,5,4,4,1011,70,17859,1392,164512,182371,11/3/2020
7/19/2020,82,26308,2696,294607,320915,7,2157,3,1787,0,314,56,6,4,2,1013,57,17916,1146,165658,183574,11/3/2020
7/20/2020,71,26379,2666,297273,323652,9,2166,7,1794,0,314,58,7,5,2,1015,68,17984,1449,167107,185091,11/3/2020
7/21/2020,130,26509,4304,301577,328086,9,2175,11,1805,0,314,56,9,6,1,1016,108,18092,1911,169018,187110,11/3/2020
7/22/2020,130,26639,3928,305505,332144,11,2186,11,1816,1,315,55,7,6,1,1017,86,18178,1672,170690,188868,11/3/2020
7/23/2020,141,26780,4415,309920,336700,9,2195,6,1822,0,315,58,8,7,0,1017,115,18293,1968,172658,190951,11/3/2020
7/24/2020,172,26952,5966,315886,342838,14,2209,14,1836,0,315,58,9,7,0,1017,119,18412,2305,174963,193375,11/3/2020
7/25/2020,134,27086,4398,320284,347370,7,2216,7,1843,0,315,58,10,8,3,1020,108,18520,2080,177043,195563,11/3/2020
7/26/2020,62,27148,3033,323317,350465,8,2224,9,1852,0,315,57,11,7,1,1021,54,18574,1329,178372,196946,11/3/2020
7/27/2020,188,27336,4191,327508,354844,12,2236,7,1859,0,315,62,13,8,1,1022,138,18712,2335,180707,199419,11/3/2020
7/28/2020,105,27441,3840,331348,358789,5,2241,5,1864,0,315,62,14,7,1,1023,95,18807,1627,182334,201141,11/3/2020
7/29/2020,190,27631,5139,336487,364118,11,2252,12,1876,0,315,61,15,7,0,1023,154,18961,2297,184631,203592,11/3/2020
7/30/2020,121,27752,4345,340832,368584,6,2258,2,1878,1,316,64,15,6,1,1024,97,19058,1639,186270,205328,11/3/2020
7/31/2020,131,27883,5512,346344,374227,8,2266,10,1888,0,316,62,15,7,1,1025,89,19147,1840,188110,207257,11/3/2020
8/1/2020,109,27992,4294,350638,378630,7,2273,2,1890,0,316,67,14,7,1,1026,89,19236,1554,189664,208900,11/3/2020
8/2/2020,84,28076,2804,353442,381518,12,2285,12,1902,2,318,65,14,8,2,1028,62,19298,1266,190930,210228,11/3/2020
8/3/2020,188,28264,5248,358690,386954,13,2298,12,1914,0,318,66,16,7,1,1029,150,19448,2194,193124,212572,11/3/2020
8/4/2020,125,28389,3691,362381,390770,9,2307,6,1920,1,319,68,12,5,2,1031,99,19547,1760,194884,214431,11/3/2020
8/5/2020,147,28536,5935,368316,396852,12,2319,10,1930,1,320,69,10,5,2,1033,119,19666,2454,197338,217004,11/3/2020
8/6/2020,169,28705,5546,373862,402567,7,2326,9,1939,0,320,67,9,4,0,1033,120,19786,2397,199735,219521,11/3/2020
8/7/2020,123,28828,4851,378713,407541,13,2339,10,1949,1,321,69,9,3,2,1035,87,19873,2134,201869,221742,11/3/2020
8/8/2020,123,28951,4112,382825,411776,19,2358,6,1955,1,322,81,8,3,1,1036,91,19964,1770,203639,223603,11/3/2020
8/9/2020,42,28993,1727,384552,413545,8,2366,10,1965,0,322,79,9,4,0,1036,35,19999,1067,204706,224705,11/3/2020
8/10/2020,149,29142,4587,389139,418281,11,2377,12,1977,0,322,78,9,4,1,1037,113,20112,2013,206719,226831,11/3/2020
8/11/2020,106,29248,4334,393473,422721,6,2383,14,1991,0,322,70,10,4,3,1040,92,20204,2256,208975,229179,11/3/2020
8/12/2020,121,29369,5188,398661,428030,8,2391,11,2002,0,322,67,9,3,1,1041,101,20305,2617,211592,231897,11/3/2020
8/13/2020,135,29504,4196,402857,432361,13,2404,12,2014,0,322,68,11,3,0,1041,95,20400,1896,213488,233888,11/3/2020
8/14/2020,145,29649,5498,408355,438004,13,2417,11,2025,0,322,70,11,4,3,1044,98,20498,1968,215456,235954,11/3/2020
8/15/2020,106,29755,4534,412889,442644,9,2426,11,2036,1,323,67,11,5,0,1044,88,20586,1684,217140,237726,11/3/2020
8/16/2020,83,29838,2477,415366,445204,7,2433,6,2042,4,327,64,8,4,6,1050,70,20656,958,218098,238754,11/3/2020
8/17/2020,106,29944,4575,419941,449885,10,2443,7,2049,0,327,67,8,5,2,1052,87,20743,2381,220479,241222,11/3/2020
8/18/2020,128,30072,4911,424852,454924,11,2454,9,2058,1,328,68,8,4,5,1057,94,20837,2742,223221,244058,11/3/2020
8/19/2020,113,30185,5077,429929,460114,8,2462,9,2067,1,329,66,9,5,0,1057,90,20927,2635,225856,246783,11/3/2020
8/20/2020,173,30358,7411,437340,467698,12,2474,6,2073,2,331,70,10,5,3,1060,139,21066,3502,229358,250424,11/3/2020
8/21/2020,151,30509,6577,443917,474426,8,2482,5,2078,1,332,72,9,4,2,1062,125,21191,2931,232289,253480,11/3/2020
8/22/2020,96,30605,5550,449467,480072,11,2493,12,2090,0,332,71,11,4,1,1063,84,21275,2595,234884,256159,11/3/2020
8/23/2020,71,30676,4375,453842,484518,11,2504,6,2096,0,332,76,12,2,1,1064,56,21331,2466,237350,258681,11/3/2020
8/24/2020,105,30781,5784,459626,490407,7,2511,10,2106,1,333,72,14,4,1,1065,77,21408,3144,240494,261902,11/3/2020
8/25/2020,108,30889,4764,464390,495279,11,2522,4,2110,1,334,78,12,4,1,1066,92,21500,2281,242775,264275,11/3/2020
8/26/2020,170,31059,9482,473872,504931,4,2526,8,2118,0,334,74,10,5,1,1067,127,21627,3079,245854,267481,11/3/2020
8/27/2020,92,31151,8565,482437,513588,6,2532,13,2131,1,335,66,7,5,2,1069,70,21697,3147,249001,270698,11/3/2020
8/28/2020,113,31264,7994,490431,521695,14,2546,4,2135,0,335,76,10,7,2,1071,87,21784,2423,251424,273208,11/3/2020
8/29/2020,65,31329,5374,495805,527134,6,2552,8,2143,1,336,73,11,6,2,1073,51,21835,1909,253333,275168,11/3/2020
8/30/2020,66,31395,4323,500128,531523,7,2559,4,2147,0,336,76,9,5,2,1075,48,21883,1993,255326,277209,11/3/2020
8/31/2020,105,31500,4863,504991,536491,12,2571,16,2163,0,336,72,8,4,1,1076,81,21964,2180,257506,279470,11/3/2020
9/1/2020,98,31598,7109,512100,543698,6,2577,9,2172,1,337,68,7,4,2,1078,66,22030,2373,259879,281909,11/3/2020
9/2/2020,125,31723,10529,522629,554352,9,2586,10,2182,1,338,66,8,4,2,1080,104,22134,3044,262923,285057,11/3/2020
9/3/2020,90,31813,11079,533708,565521,8,2594,8,2190,0,338,66,9,4,3,1083,73,22207,2583,265506,287713,11/3/2020
9/4/2020,103,31916,8963,542671,574587,11,2605,4,2194,0,338,73,9,4,1,1084,83,22290,2365,267871,290161,11/3/2020
9/5/2020,52,31968,6309,548980,580948,6,2611,9,2203,0,338,70,8,3,1,1085,42,22332,1598,269469,291801,11/3/2020
9/6/2020,88,32056,4325,553305,585361,4,2615,8,2211,1,339,65,6,3,1,1086,65,22397,1946,271415,293812,11/3/2020
9/7/2020,35,32091,3002,556307,588398,11,2626,3,2214,0,339,73,5,3,1,1087,26,22423,643,272058,294481,11/3/2020
9/8/2020,74,32165,6381,562688,594853,6,2632,12,2226,1,340,66,6,3,2,1089,66,22489,1589,273647,296136,11/3/2020
9/9/2020,118,32283,8650,571338,603621,9,2641,5,2231,1,341,69,9,3,1,1090,102,22591,2143,275790,298381,11/3/2020
9/10/2020,164,32447,11334,582672,615119,9,2650,8,2239,0,341,70,10,3,1,1091,111,22702,2273,278063,300765,11/3/2020
9/11/2020,120,32567,9454,592126,624693,11,2661,11,2250,0,341,70,10,5,0,1091,97,22799,1966,280029,302828,11/3/2020
9/12/2020,110,32677,6173,598299,630976,8,2669,5,2255,2,343,71,9,5,3,1094,97,22896,1523,281552,304448,11/3/2020
9/13/2020,58,32735,2716,601015,633750,4,2673,3,2258,0,343,72,10,5,0,1094,54,22950,861,282413,305363,11/3/2020
9/14/2020,104,32839,6446,607461,640300,5,2678,3,2261,2,345,72,10,5,2,1096,95,23045,1734,284147,307192,11/3/2020
9/15/2020,122,32961,8466,615927,648888,7,2685,2,2263,1,346,76,10,5,2,1098,124,23169,2192,286339,309508,11/3/2020
9/16/2020,137,33098,9715,625642,658740,7,2692,7,2270,2,348,74,9,6,5,1103,118,23287,1972,288311,311598,11/3/2020
9/17/2020,125,33223,9239,634881,668104,7,2699,14,2284,0,348,67,8,4,0,1103,154,23441,1947,290258,313699,11/3/2020
9/18/2020,132,33355,10045,644926,678281,7,2706,7,2291,1,349,66,11,6,2,1105,132,23573,1929,292187,315760,11/3/2020
9/19/2020,115,33470,8297,653223,686693,7,2713,3,2294,0,349,70,10,6,4,1109,112,23685,1692,293879,317564,11/3/2020
9/20/2020,60,33530,3676,656899,690429,7,2720,6,2300,2,351,69,9,8,4,1113,49,23734,1326,295205,318939,11/3/2020
9/21/2020,102,33632,7018,663917,697549,12,2732,3,2303,2,353,76,8,6,2,1115,94,23828,2405,297610,321438,11/3/2020
9/22/2020,154,33786,9287,673204,706990,12,2744,3,2306,1,354,84,7,5,1,1116,123,23951,2204,299814,323765,11/3/2020
9/23/2020,136,33922,10650,683854,717776,12,2756,7,2313,0,354,89,6,5,0,1116,127,24078,2217,302031,326109,11/3/2020
9/24/2020,120,34042,12479,696333,730375,7,2763,9,2322,1,355,86,7,5,1,1117,121,24199,3170,305201,329400,11/3/2020
9/25/2020,149,34191,10553,706886,741077,9,2772,10,2332,0,355,85,6,5,1,1118,142,24341,3006,308207,332548,11/3/2020
9/26/2020,146,34337,10559,717445,751782,12,2784,9,2341,0,355,88,6,5,1,1119,119,24460,2423,310630,335090,11/3/2020
9/27/2020,43,34380,2764,720209,754589,7,2791,5,2346,0,355,90,9,5,0,1119,34,24494,846,311476,335970,11/3/2020
9/28/2020,152,34532,7308,727517,762049,7,2798,7,2353,2,357,88,7,5,2,1121,134,24628,2262,313738,338366,11/3/2020
9/29/2020,208,34740,11046,738563,773303,12,2810,18,2371,1,358,81,6,6,1,1122,190,24818,2830,316568,341386,11/3/2020
9/30/2020,221,34961,12230,750793,785754,6,2816,6,2377,0,358,81,6,6,1,1123,187,25005,2600,319168,344173,11/3/2020
10/1/2020,185,35146,12503,763296,798442,17,2833,13,2390,1,359,84,6,4,2,1125,166,25171,2425,321593,346764,11/3/2020
10/2/2020,210,35356,12152,775448,810804,14,2847,13,2403,1,360,84,8,5,2,1127,182,25353,2503,324096,349449,11/3/2020
10/3/2020,157,35513,9312,784760,820273,9,2856,9,2412,2,362,82,9,4,2,1129,131,25484,2028,326124,351608,11/3/2020
10/4/2020,81,35594,2369,787129,822723,11,2867,9,2421,1,363,83,8,5,2,1131,78,25562,956,327080,352642,11/3/2020
10/5/2020,174,35768,8980,796109,831877,30,2897,11,2432,2,365,100,9,6,4,1135,160,25722,3037,330117,355839,11/3/2020
10/6/2020,177,35945,11183,807292,843237,11,2908,5,2437,0,365,106,11,7,0,1135,186,25908,2910,333027,358935,11/3/2020
10/7/2020,231,36176,12440,819732,855908,13,2921,14,2451,2,367,103,9,7,2,1137,243,26151,3548,336575,362726,11/3/2020
10/8/2020,262,36438,15231,834963,871401,17,2938,13,2464,2,369,105,7,5,3,1140,274,26425,4225,340800,367225,11/3/2020
10/9/2020,217,36655,13747,848710,885365,21,2959,12,2476,0,369,114,10,7,3,1143,199,26624,4345,345145,371769,11/3/2020
10/10/2020,229,36884,13834,862544,899428,19,2978,10,2486,1,370,122,13,7,2,1145,194,26818,3825,348970,375788,11/3/2020
10/11/2020,97,36981,3264,865808,902789,12,2990,9,2495,1,371,124,14,5,6,1151,88,26906,1168,350138,377044,11/3/2020
10/12/2020,169,37150,6439,872247,909397,19,3009,15,2510,2,373,126,14,5,4,1155,161,27067,1755,351893,378960,11/3/2020
10/13/2020,213,37363,8520,880767,918130,15,3024,15,2525,4,377,122,13,5,7,1162,206,27273,2315,354208,381481,11/3/2020
10/14/2020,322,37685,15038,895805,933490,17,3041,7,2532,0,377,132,15,5,2,1164,304,27577,4058,358266,385843,11/3/2020
10/15/2020,262,37947,14641,910446,948393,11,3052,16,2548,1,378,126,13,5,2,1166,255,27832,3596,361862,389694,11/3/2020
10/16/2020,279,38226,15008,925454,963680,13,3065,20,2568,1,379,118,13,4,2,1168,275,28107,3409,365271,393378,11/3/2020
10/17/2020,354,38580,14064,939518,978098,19,3084,11,2579,1,380,125,17,4,2,1170,310,28417,3286,368557,396974,11/3/2020
10/18/2020,155,38735,4039,943557,982292,18,3102,11,2590,0,380,132,17,5,2,1172,128,28545,1336,369893,398438,11/3/2020
10/19/2020,388,39123,8488,952045,991168,21,3123,23,2613,2,382,128,15,5,1,1173,325,28870,2587,372480,401350,11/3/2020
10/20/2020,439,39562,13238,965283,1004845,22,3145,17,2630,0,382,133,14,7,3,1176,387,29257,3022,375502,404759,11/3/2020
10/21/2020,544,40106,17468,982751,1022857,21,3166,9,2639,2,384,143,15,9,3,1179,472,29729,3554,379056,408785,11/3/2020
10/22/2020,538,40644,15859,998610,1039254,24,3190,21,2660,3,387,143,14,9,3,1182,487,30216,3224,382280,412496,11/3/2020
10/23/2020,513,41157,16627,1015237,1056394,22,3212,26,2686,1,388,138,15,9,3,1185,447,30663,2906,385186,415849,11/3/2020
10/24/2020,359,41516,10243,1025480,1066996,17,3229,11,2697,0,388,144,14,8,1,1186,329,30992,2276,387462,418454,11/3/2020
10/25/2020,233,41749,4763,1030243,1071992,15,3244,15,2712,1,389,143,15,8,1,1187,206,31198,1484,388946,420144,11/3/2020
10/26/2020,453,42202,9179,1039422,1081624,25,3269,20,2732,2,391,146,18,8,3,1190,392,31590,2999,391945,423535,11/3/2020
10/27/2020,516,42718,13992,1053414,1096132,28,3297,11,2743,2,393,161,17,9,4,1194,445,32035,2409,394354,426389,11/3/2020
10/28/2020,468,43186,15229,1068643,1111829,22,3319,23,2766,1,394,159,16,9,3,1197,403,32438,2724,397078,429516,11/3/2020
10/29/2020,603,43789,16202,1084845,1128634,20,3339,18,2784,3,397,158,19,11,4,1201,525,32963,3121,400199,433162,11/3/2020
10/30/2020,533,44322,14129,1098974,1143296,21,3360,19,2803,5,402,155,19,9,4,1205,463,33426,2844,403043,436469,11/3/2020
10/31/2020,572,44894,11760,1110734,1155628,29,3389,9,2812,1,403,174,22,9,3,1208,506,33932,2318,405361,439293,11/3/2020
11/1/2020,308,45202,4888,1115622,1160824,17,3406,13,2825,1,404,177,24,12,3,1211,267,34199,1149,406510,440709,11/3/2020
11/2/2020,405,45607,8830,1124452,1170059,,,,,,,,,,1,1212,344,34543,2471,408981,443524,11/3/2020
2/27/2020,0,0,0,0,0,1,1,0,0,0,0,1,0,0,0,0,0,0,0,0,0,11/4/2020
2/28/2020,0,0,0,0,0,0,1,0,0,0,0,1,1,0,0,0,0,0,0,0,0,11/4/2020
2/29/2020,0,0,0,0,0,0,1,0,0,0,0,1,1,0,0,0,0,0,0,0,0,11/4/2020
3/1/2020,2,2,2,2,4,0,1,0,0,0,0,1,1,1,0,0,2,2,2,2,4,11/4/2020
3/2/2020,0,2,1,3,5,1,2,0,0,0,0,2,2,2,0,0,0,2,1,3,5,11/4/2020
3/3/2020,0,2,2,5,7,0,2,0,0,0,0,2,2,2,0,0,0,2,2,5,7,11/4/2020
3/4/2020,0,2,12,17,19,1,3,0,0,0,0,3,2,2,0,0,0,2,10,15,17,11/4/2020
3/5/2020,0,2,4,21,23,0,3,0,0,0,0,3,2,2,0,0,1,3,4,19,22,11/4/2020
3/6/2020,1,3,12,33,36,0,3,0,0,0,0,3,2,2,0,0,0,3,11,30,33,11/4/2020
3/7/2020,0,3,19,52,55,0,3,0,0,0,0,3,2,1,0,0,0,3,19,49,52,11/4/2020
3/8/2020,0,3,18,70,73,0,3,0,0,0,0,3,2,1,0,0,0,3,18,67,70,11/4/2020
3/9/2020,1,4,15,85,89,0,3,0,0,0,0,3,2,1,0,0,1,4,15,82,86,11/4/2020
3/10/2020,2,6,25,110,116,0,3,0,0,0,0,3,2,1,0,0,1,5,23,105,110,11/4/2020
3/11/2020,0,6,34,144,150,1,4,0,0,0,0,4,1,1,0,0,0,5,34,139,144,11/4/2020
3/12/2020,9,15,41,185,200,1,5,0,0,0,0,5,1,1,0,0,8,13,38,177,190,11/4/2020
3/13/2020,6,21,50,235,256,4,9,1,1,0,0,8,1,1,0,0,6,19,48,225,244,11/4/2020
3/14/2020,0,21,90,325,346,0,9,0,1,0,0,8,1,1,0,0,0,19,86,311,330,11/4/2020
3/15/2020,1,22,54,379,401,1,10,0,1,0,0,9,2,1,0,0,1,20,54,365,385,11/4/2020
3/16/2020,2,24,95,474,498,2,12,0,1,0,0,11,2,0,0,0,2,22,92,457,479,11/4/2020
3/17/2020,12,36,162,636,672,6,18,0,1,0,0,17,2,0,0,0,11,33,149,606,639,11/4/2020
3/18/2020,9,45,116,752,797,3,21,0,1,0,0,20,2,0,0,0,11,44,110,716,760,11/4/2020
3/19/2020,15,60,262,1014,1074,2,23,1,2,0,0,21,3,0,1,1,17,61,248,964,1025,11/4/2020
3/20/2020,13,73,197,1211,1284,5,28,0,2,0,0,26,4,0,0,1,13,74,188,1152,1226,11/4/2020
3/21/2020,12,85,126,1337,1422,3,31,2,4,0,0,27,5,0,0,1,14,88,122,1274,1362,11/4/2020
3/22/2020,27,112,282,1619,1731,2,33,0,4,0,0,29,5,0,0,1,25,113,259,1533,1646,11/4/2020
3/23/2020,14,126,169,1788,1914,15,48,1,5,0,0,43,9,3,0,1,16,129,162,1695,1824,11/4/2020
3/24/2020,20,146,242,2030,2176,7,55,0,5,0,0,50,10,4,0,1,19,148,232,1927,2075,11/4/2020
3/25/2020,26,172,182,2212,2384,5,60,1,6,0,0,54,11,3,0,1,28,176,168,2095,2271,11/4/2020
3/26/2020,35,207,181,2393,2600,10,70,5,11,0,0,59,14,5,0,1,41,217,170,2265,2482,11/4/2020
3/27/2020,27,234,214,2607,2841,9,79,1,12,1,1,66,17,6,2,3,31,248,199,2464,2712,11/4/2020
3/28/2020,59,293,260,2867,3160,13,92,3,15,2,3,74,15,6,1,4,64,312,240,2704,3016,11/4/2020
3/29/2020,100,393,350,3217,3610,8,100,4,19,1,4,77,18,8,2,6,105,417,310,3014,3431,11/4/2020
3/30/2020,62,455,222,3439,3894,20,120,5,24,0,4,92,20,11,3,9,78,495,183,3197,3692,11/4/2020
3/31/2020,71,526,369,3808,4334,11,131,7,31,1,5,95,22,13,2,11,73,568,294,3491,4059,11/4/2020
4/1/2020,99,625,698,4506,5131,18,149,7,38,0,5,106,30,15,1,12,100,668,633,4124,4792,11/4/2020
4/2/2020,52,677,477,4983,5660,22,171,6,44,2,7,120,36,21,4,16,62,730,431,4555,5285,11/4/2020
4/3/2020,108,785,774,5757,6542,23,194,7,51,0,7,136,43,25,3,19,100,830,699,5254,6084,11/4/2020
4/4/2020,143,928,660,6417,7345,22,216,4,55,5,12,149,41,30,9,28,138,968,610,5864,6832,11/4/2020
4/5/2020,187,1115,1156,7573,8688,20,236,9,64,1,13,159,44,36,2,30,181,1149,1048,6912,8061,11/4/2020
4/6/2020,218,1333,1706,9279,10612,26,262,7,71,0,13,178,48,40,7,37,207,1356,1527,8439,9795,11/4/2020
4/7/2020,284,1617,1629,10908,12525,20,282,4,75,2,15,192,50,42,5,42,261,1617,1466,9905,11522,11/4/2020
4/8/2020,290,1907,1720,12628,14535,19,301,7,82,6,21,198,50,38,10,52,271,1888,1529,11434,13322,11/4/2020
4/9/2020,283,2190,1516,14144,16334,32,333,9,91,4,25,217,53,40,7,59,277,2165,1342,12776,14941,11/4/2020
4/10/2020,419,2609,2574,16718,19327,29,362,17,108,5,30,224,59,41,11,70,400,2565,2336,15112,17677,11/4/2020
4/11/2020,297,2906,1905,18623,21529,29,391,11,119,2,32,240,61,48,12,82,281,2846,1700,16812,19658,11/4/2020
4/12/2020,314,3220,1670,20293,23513,35,426,13,132,5,37,257,59,49,9,91,285,3131,1412,18224,21355,11/4/2020
4/13/2020,161,3381,935,21228,24609,35,461,13,145,3,40,276,64,54,9,100,187,3318,830,19054,22372,11/4/2020
4/14/2020,289,3670,1787,23015,26685,27,488,18,163,5,45,280,72,53,8,108,262,3580,1508,20562,24142,11/4/2020
4/15/2020,351,4021,1799,24814,28835,31,519,20,183,3,48,288,72,54,17,125,306,3886,1528,22090,25976,11/4/2020
4/16/2020,447,4468,2494,27308,31776,36,555,25,208,6,54,293,72,53,14,139,387,4273,2054,24144,28417,11/4/2020
4/17/2020,304,4772,1821,29129,33901,32,587,20,228,7,61,298,66,45,21,160,290,4563,1421,25565,30128,11/4/2020
4/18/2020,321,5093,1725,30854,35947,26,613,18,246,4,65,302,63,49,15,175,284,4847,1305,26870,31717,11/4/2020
4/19/2020,381,5474,2047,32901,38375,23,636,26,272,1,66,298,65,55,11,186,337,5184,1718,28588,33772,11/4/2020
4/20/2020,394,5868,1907,34808,40676,46,682,29,301,2,68,313,75,56,10,196,376,5560,1557,30145,35705,11/4/2020
4/21/2020,444,6312,2110,36918,43230,45,727,33,334,5,73,320,72,56,18,214,383,5943,1677,31822,37765,11/4/2020
4/22/2020,418,6730,2390,39308,46038,41,768,32,366,5,78,324,73,58,18,232,379,6322,1888,33710,40032,11/4/2020
4/23/2020,479,7209,2469,41777,48986,32,800,28,394,5,83,323,76,62,15,247,412,6734,1835,35545,42279,11/4/2020
4/24/2020,491,7700,3284,45061,52761,35,835,26,420,4,87,328,85,63,15,262,407,7141,2588,38133,45274,11/4/2020
4/25/2020,393,8093,2206,47267,55360,34,869,17,437,5,92,340,85,62,14,276,300,7441,1737,39870,47311,11/4/2020
4/26/2020,316,8409,2309,49576,57985,33,902,15,452,3,95,355,86,59,14,290,274,7715,1852,41722,49437,11/4/2020
4/27/2020,249,8658,1620,51196,59854,29,931,21,473,4,99,359,86,61,10,300,206,7921,1143,42865,50786,11/4/2020
4/28/2020,410,9068,2263,53459,62527,44,975,24,497,3,102,376,88,59,22,322,332,8253,1714,44579,52832,11/4/2020
4/29/2020,476,9544,3343,56802,66346,36,1011,38,535,11,113,363,78,53,18,340,371,8624,2389,46968,55592,11/4/2020
4/30/2020,432,9976,2769,59571,69547,33,1044,38,573,6,119,352,83,57,24,364,350,8974,1879,48847,57821,11/4/2020
5/1/2020,454,10430,3086,62657,73087,51,1095,39,612,3,122,361,84,58,14,378,323,9297,2136,50983,60280,11/4/2020
5/2/2020,257,10687,1926,64583,75270,36,1131,38,650,5,127,354,91,62,24,402,192,9489,1252,52235,61724,11/4/2020
5/3/2020,283,10970,2160,66743,77713,31,1162,27,677,8,135,350,90,61,21,423,183,9672,1550,53785,63457,11/4/2020
5/4/2020,387,11357,2098,68841,80198,30,1192,31,708,5,140,344,88,57,18,441,290,9962,1536,55321,65283,11/4/2020
5/5/2020,433,11790,2873,71714,83504,29,1221,32,740,6,146,335,82,54,16,457,301,10263,1934,57255,67518,11/4/2020
5/6/2020,488,12278,2830,74544,86822,28,1249,44,784,9,155,310,79,54,21,478,340,10603,1894,59149,69752,11/4/2020
5/7/2020,425,12703,2969,77513,90216,36,1285,43,827,5,160,298,71,52,21,499,270,10873,1939,61088,71961,11/4/2020
5/8/2020,359,13062,2598,80111,93173,30,1315,29,856,5,165,294,71,53,22,521,229,11102,1716,62804,73906,11/4/2020
5/9/2020,467,13529,3346,83457,96986,22,1337,21,877,4,169,291,69,51,15,536,290,11392,2213,65017,76409,11/4/2020
5/10/2020,285,13814,2117,85574,99388,20,1357,23,900,6,175,282,70,49,14,550,189,11581,1500,66517,78098,11/4/2020
5/11/2020,257,14071,1857,87431,101502,31,1388,16,916,6,181,291,71,49,15,565,174,11755,1280,67797,79552,11/4/2020
5/12/2020,387,14458,2611,90042,104500,23,1411,18,934,4,185,292,69,48,22,587,224,11979,1684,69481,81460,11/4/2020
5/13/2020,351,14809,3630,93672,108481,23,1434,25,959,1,186,289,69,49,13,600,199,12178,1937,71418,83596,11/4/2020
5/14/2020,329,15138,3408,97080,112218,19,1453,27,986,3,189,278,64,45,15,615,232,12410,1993,73411,85821,11/4/2020
5/15/2020,381,15519,3458,100538,116057,24,1477,41,1027,5,194,256,62,45,14,629,232,12642,1784,75195,87837,11/4/2020
5/16/2020,449,15968,4156,104694,120662,25,1502,15,1042,5,199,261,61,46,15,644,247,12889,1927,77122,90011,11/4/2020
5/17/2020,240,16208,2768,107462,123670,17,1519,9,1051,5,204,264,59,45,10,654,126,13015,1526,78648,91663,11/4/2020
5/18/2020,250,16458,2001,109463,125921,19,1538,16,1067,5,209,262,57,40,18,672,135,13150,1357,80005,93155,11/4/2020
5/19/2020,415,16873,3168,112631,129504,23,1561,33,1100,5,214,247,56,38,11,683,215,13365,1908,81913,95278,11/4/2020
5/20/2020,326,17199,2771,115402,132601,19,1580,23,1123,7,221,236,52,33,22,705,183,13548,1506,83419,96967,11/4/2020
5/21/2020,374,17573,3757,119159,136732,26,1606,15,1138,3,224,244,53,29,20,725,168,13716,1917,85336,99052,11/4/2020
5/22/2020,351,17924,3161,122320,140244,20,1626,29,1167,5,229,230,52,29,11,736,206,13922,1593,86929,100851,11/4/2020
5/23/2020,253,18177,2742,125062,143239,19,1645,11,1178,3,232,235,52,32,13,749,109,14031,1259,88188,102219,11/4/2020
5/24/2020,163,18340,1370,126432,144772,13,1658,14,1192,2,234,232,53,36,8,757,83,14114,768,88956,103070,11/4/2020
5/25/2020,147,18487,1385,127817,146304,14,1672,14,1206,0,234,232,53,34,10,767,76,14190,757,89713,103903,11/4/2020
5/26/2020,285,18772,2620,130437,149209,24,1696,22,1228,5,239,229,48,33,15,782,158,14348,1769,91482,105830,11/4/2020
5/27/2020,276,19048,2057,132494,151542,20,1716,18,1246,3,242,228,50,33,10,792,132,14480,1124,92606,107086,11/4/2020
5/28/2020,348,19396,3359,135853,155249,17,1733,29,1275,4,246,212,47,32,8,800,130,14610,1108,93714,108324,11/4/2020
5/29/2020,410,19806,3915,139768,159574,19,1752,27,1302,6,252,198,43,31,12,812,174,14784,1562,95276,110060,11/4/2020
5/30/2020,225,20031,3915,143683,163714,16,1768,19,1321,4,256,191,41,29,12,824,109,14893,1804,97080,111973,11/4/2020
5/31/2020,155,20186,1690,145373,165559,11,1779,10,1331,1,257,191,44,26,3,827,78,14971,849,97929,112900,11/4/2020
6/1/2020,212,20398,2792,148165,168563,8,1787,14,1345,1,258,184,45,29,5,832,93,15064,1373,99302,114366,11/4/2020
6/2/2020,273,20671,3022,151187,171858,8,1795,10,1355,3,261,179,38,25,10,842,98,15162,1426,100728,115890,11/4/2020
6/3/2020,254,20925,3486,154673,175598,14,1809,18,1373,6,267,169,34,25,11,853,99,15261,1646,102374,117635,11/4/2020
6/4/2020,276,21201,4471,159144,180345,7,1816,26,1399,4,271,146,31,24,12,865,107,15368,2021,104395,119763,11/4/2020
6/5/2020,215,21416,3513,162657,184073,15,1831,13,1412,6,277,142,27,21,11,876,99,15467,1559,105954,121421,11/4/2020
6/6/2020,201,21617,2616,165273,186890,10,1841,7,1419,2,279,143,29,19,6,882,67,15534,1113,107067,122601,11/4/2020
6/7/2020,83,21700,1625,166898,188598,11,1852,7,1426,1,280,146,25,17,4,886,51,15585,779,107846,123431,11/4/2020
6/8/2020,119,21819,1849,168747,190566,15,1867,12,1438,2,282,147,27,18,4,890,45,15630,950,108796,124426,11/4/2020
6/9/2020,223,22042,2673,171420,193462,10,1877,19,1457,0,282,138,28,21,1,891,64,15694,1247,110043,125737,11/4/2020
6/10/2020,209,22251,2987,174407,196658,13,1890,12,1469,2,284,137,24,17,4,895,101,15795,1456,111499,127294,11/4/2020
6/11/2020,195,22446,3513,177920,200366,7,1897,15,1484,1,285,128,25,16,6,901,88,15883,1518,113017,128900,11/4/2020
6/12/2020,209,22655,4601,182521,205176,9,1906,16,1500,1,286,120,24,16,2,903,78,15961,2163,115180,131141,11/4/2020
6/13/2020,113,22768,3036,185557,208325,6,1912,5,1505,0,286,121,20,15,3,906,49,16010,1360,116540,132550,11/4/2020
6/14/2020,81,22849,2046,187603,210452,7,1919,8,1513,1,287,119,20,14,3,909,33,16043,962,117502,133545,11/4/2020
6/15/2020,188,23037,3108,190711,213748,14,1933,19,1532,0,287,114,20,16,5,914,75,16118,1775,119277,135395,11/4/2020
6/16/2020,110,23147,3017,193728,216875,11,1944,9,1541,1,288,115,22,16,8,922,50,16168,1525,120802,136970,11/4/2020
6/17/2020,127,23274,2835,196563,219837,15,1959,22,1563,4,292,104,18,14,6,928,50,16218,1303,122105,138323,11/4/2020
6/18/2020,149,23423,3048,199611,223034,9,1968,15,1578,1,293,97,19,16,7,935,70,16288,1307,123412,139700,11/4/2020
6/19/2020,141,23564,3769,203380,226944,12,1980,12,1590,1,294,96,20,17,3,938,59,16347,1353,124765,141112,11/4/2020
6/20/2020,84,23648,1891,205271,228919,9,1989,12,1602,0,294,93,20,18,4,942,36,16383,809,125574,141957,11/4/2020
6/21/2020,37,23685,1064,206335,230020,8,1997,5,1607,0,294,96,20,18,2,944,30,16413,685,126259,142672,11/4/2020
6/22/2020,138,23823,3730,210065,233888,12,2009,16,1623,0,294,92,19,18,2,946,65,16478,1694,127953,144431,11/4/2020
6/23/2020,163,23986,3831,213896,237882,3,2012,13,1636,3,297,79,18,18,7,953,81,16559,1765,129718,146277,11/4/2020
6/24/2020,120,24106,3502,217398,241504,9,2021,11,1647,1,298,76,18,18,5,958,44,16603,1671,131389,147992,11/4/2020
6/25/2020,103,24209,2883,220281,244490,6,2027,14,1661,1,299,67,17,17,1,959,50,16653,1493,132882,149535,11/4/2020
6/26/2020,94,24303,2488,222769,247072,2,2029,10,1671,0,299,59,18,18,1,960,60,16713,1318,134200,150913,11/4/2020
6/27/2020,84,24387,3216,225985,250372,5,2034,3,1674,1,300,60,17,17,5,965,37,16750,1211,135411,152161,11/4/2020
6/28/2020,39,24426,1469,227454,251880,4,2038,4,1678,4,304,56,15,14,6,971,17,16767,591,136002,152769,11/4/2020
6/29/2020,85,24511,3697,231151,255662,4,2042,5,1683,0,304,55,14,14,1,972,39,16806,1341,137343,154149,11/4/2020
6/30/2020,57,24568,1958,233109,257677,1,2043,5,1688,1,305,50,12,11,4,976,33,16839,992,138335,155174,11/4/2020
7/1/2020,144,24712,4098,237207,261919,8,2051,10,1698,0,305,48,11,11,1,977,79,16918,1913,140248,157166,11/4/2020
7/2/2020,103,24815,2803,240010,264825,5,2056,5,1703,1,306,47,10,10,3,980,59,16977,1075,141323,158300,11/4/2020
7/3/2020,50,24865,2079,242089,266954,9,2065,6,1709,0,306,50,9,9,3,983,25,17002,777,142100,159102,11/4/2020
7/4/2020,57,24922,2345,244434,269356,2,2067,4,1713,1,307,47,10,9,2,985,33,17035,1000,143100,160135,11/4/2020
7/5/2020,49,24971,2932,247366,272337,1,2068,2,1715,1,308,45,8,8,2,987,26,17061,1430,144530,161591,11/4/2020
7/6/2020,101,25072,2814,250180,275252,6,2074,6,1721,0,308,45,9,9,4,991,57,17118,1536,146066,163184,11/4/2020
7/7/2020,81,25153,3457,253637,278790,5,2079,7,1728,0,308,43,8,8,2,993,47,17165,1530,147596,164761,11/4/2020
7/8/2020,105,25258,3409,257046,282304,4,2083,2,1730,0,308,45,9,8,0,993,64,17229,1417,149013,166242,11/4/2020
7/9/2020,94,25352,3714,260760,286112,9,2092,3,1733,0,308,51,9,8,0,993,50,17279,1608,150621,167900,11/4/2020
7/10/2020,132,25484,4437,265197,290681,6,2098,3,1736,2,310,52,7,7,3,996,80,17359,2064,152685,170044,11/4/2020
7/11/2020,63,25547,2938,268135,293682,6,2104,3,1739,1,311,54,6,6,3,999,36,17395,1310,153995,171390,11/4/2020
7/12/2020,47,25594,1838,269973,295567,1,2105,3,1742,1,312,51,6,5,3,1002,34,17429,939,154934,172363,11/4/2020
7/13/2020,84,25678,3209,273182,298860,8,2113,10,1752,0,312,49,6,5,1,1003,61,17490,1499,156433,173923,11/4/2020
7/14/2020,74,25752,3298,276480,302232,7,2120,4,1756,0,312,52,5,5,1,1004,44,17534,1372,157805,175339,11/4/2020
7/15/2020,130,25882,4181,280661,306543,5,2125,7,1763,0,312,50,5,4,0,1004,100,17634,1742,159547,177181,11/4/2020
7/16/2020,103,25985,3740,284401,310386,6,2131,9,1772,0,312,47,6,5,1,1005,76,17710,1608,161155,178865,11/4/2020
7/17/2020,156,26141,4239,288640,314781,14,2145,3,1775,1,313,57,5,5,2,1007,80,17790,1840,162995,180785,11/4/2020
7/18/2020,85,26226,3272,291912,318138,5,2150,9,1784,1,314,52,5,4,4,1011,70,17860,1390,164385,182245,11/4/2020
7/19/2020,82,26308,2696,294608,320916,7,2157,3,1787,0,314,56,6,4,2,1013,57,17917,1146,165531,183448,11/4/2020
7/20/2020,71,26379,2666,297274,323653,9,2166,7,1794,0,314,58,7,5,2,1015,68,17985,1449,166980,184965,11/4/2020
7/21/2020,130,26509,4304,301578,328087,9,2175,11,1805,0,314,56,9,6,1,1016,108,18093,1909,168889,186982,11/4/2020
7/22/2020,130,26639,3928,305506,332145,11,2186,11,1816,1,315,55,7,6,1,1017,86,18179,1671,170560,188739,11/4/2020
7/23/2020,141,26780,4415,309921,336701,9,2195,6,1822,0,315,58,8,7,0,1017,115,18294,1966,172526,190820,11/4/2020
7/24/2020,172,26952,5966,315887,342839,14,2209,14,1836,0,315,58,9,7,0,1017,119,18413,2305,174831,193244,11/4/2020
7/25/2020,134,27086,4398,320285,347371,7,2216,7,1843,0,315,58,10,8,3,1020,108,18521,2080,176911,195432,11/4/2020
7/26/2020,62,27148,3033,323318,350466,8,2224,9,1852,0,315,57,11,7,1,1021,54,18575,1329,178240,196815,11/4/2020
7/27/2020,188,27336,4191,327509,354845,12,2236,7,1859,0,315,62,13,8,1,1022,138,18713,2335,180575,199288,11/4/2020
7/28/2020,105,27441,3840,331349,358790,5,2241,5,1864,0,315,62,14,7,1,1023,95,18808,1627,182202,201010,11/4/2020
7/29/2020,190,27631,5139,336488,364119,11,2252,12,1876,0,315,61,15,7,0,1023,154,18962,2295,184497,203459,11/4/2020
7/30/2020,121,27752,4345,340833,368585,6,2258,2,1878,1,316,64,15,6,1,1024,97,19059,1639,186136,205195,11/4/2020
7/31/2020,131,27883,5512,346345,374228,8,2266,10,1888,0,316,62,15,7,1,1025,89,19148,1837,187973,207121,11/4/2020
8/1/2020,109,27992,4294,350639,378631,7,2273,2,1890,0,316,67,14,7,1,1026,89,19237,1552,189525,208762,11/4/2020
8/2/2020,84,28076,2804,353443,381519,12,2285,12,1902,2,318,65,14,8,2,1028,62,19299,1266,190791,210090,11/4/2020
8/3/2020,188,28264,5248,358691,386955,13,2298,12,1914,0,318,66,16,7,1,1029,150,19449,2193,192984,212433,11/4/2020
8/4/2020,125,28389,3691,362382,390771,9,2307,6,1920,1,319,68,12,5,2,1031,99,19548,1759,194743,214291,11/4/2020
8/5/2020,147,28536,5935,368317,396853,12,2319,10,1930,1,320,69,10,5,2,1033,119,19667,2452,197195,216862,11/4/2020
8/6/2020,169,28705,5546,373863,402568,7,2326,9,1939,0,320,67,9,4,0,1033,120,19787,2394,199589,219376,11/4/2020
8/7/2020,123,28828,4851,378714,407542,13,2339,10,1949,1,321,69,9,3,2,1035,87,19874,2132,201721,221595,11/4/2020
8/8/2020,123,28951,4112,382826,411777,19,2358,6,1955,1,322,81,8,3,1,1036,91,19965,1770,203491,223456,11/4/2020
8/9/2020,42,28993,1727,384553,413546,8,2366,10,1965,0,322,79,9,4,0,1036,35,20000,1065,204556,224556,11/4/2020
8/10/2020,149,29142,4587,389140,418282,11,2377,12,1977,0,322,78,9,4,1,1037,113,20113,2013,206569,226682,11/4/2020
8/11/2020,106,29248,4334,393474,422722,6,2383,14,1991,0,322,70,10,4,3,1040,92,20205,2256,208825,229030,11/4/2020
8/12/2020,121,29369,5188,398662,428031,8,2391,11,2002,0,322,67,9,3,1,1041,101,20306,2614,211439,231745,11/4/2020
8/13/2020,135,29504,4196,402858,432362,13,2404,12,2014,0,322,68,11,3,0,1041,95,20401,1894,213333,233734,11/4/2020
8/14/2020,145,29649,5498,408356,438005,13,2417,11,2025,0,322,70,11,4,3,1044,98,20499,1968,215301,235800,11/4/2020
8/15/2020,106,29755,4534,412890,442645,9,2426,11,2036,1,323,67,11,5,0,1044,88,20587,1680,216981,237568,11/4/2020
8/16/2020,83,29838,2477,415367,445205,7,2433,6,2042,4,327,64,8,4,6,1050,70,20657,958,217939,238596,11/4/2020
8/17/2020,106,29944,4575,419942,449886,10,2443,7,2049,0,327,67,8,5,2,1052,87,20744,2380,220319,241063,11/4/2020
8/18/2020,128,30072,4911,424853,454925,11,2454,9,2058,1,328,68,8,4,5,1057,94,20838,2741,223060,243898,11/4/2020
8/19/2020,113,30185,5077,429930,460115,8,2462,9,2067,1,329,66,9,5,0,1057,90,20928,2635,225695,246623,11/4/2020
8/20/2020,173,30358,7411,437341,467699,12,2474,6,2073,2,331,70,10,5,3,1060,139,21067,3499,229194,250261,11/4/2020
8/21/2020,151,30509,6577,443918,474427,8,2482,5,2078,1,332,72,9,4,2,1062,125,21192,2930,232124,253316,11/4/2020
8/22/2020,96,30605,5550,449468,480073,11,2493,12,2090,0,332,71,11,4,1,1063,84,21276,2592,234716,255992,11/4/2020
8/23/2020,71,30676,4375,453843,484519,11,2504,6,2096,0,332,76,12,2,1,1064,56,21332,2466,237182,258514,11/4/2020
8/24/2020,105,30781,5784,459627,490408,7,2511,10,2106,1,333,72,14,4,1,1065,77,21409,3141,240323,261732,11/4/2020
8/25/2020,108,30889,4764,464391,495280,11,2522,4,2110,1,334,78,12,4,1,1066,92,21501,2279,242602,264103,11/4/2020
8/26/2020,170,31059,9482,473873,504932,4,2526,8,2118,0,334,74,10,5,1,1067,127,21628,3077,245679,267307,11/4/2020
8/27/2020,92,31151,8565,482438,513589,6,2532,13,2131,1,335,66,7,5,2,1069,70,21698,3146,248825,270523,11/4/2020
8/28/2020,113,31264,7994,490432,521696,14,2546,4,2135,0,335,76,10,7,2,1071,87,21785,2423,251248,273033,11/4/2020
8/29/2020,65,31329,5374,495806,527135,6,2552,8,2143,1,336,73,11,6,2,1073,51,21836,1907,253155,274991,11/4/2020
8/30/2020,66,31395,4323,500129,531524,7,2559,4,2147,0,336,76,9,5,2,1075,48,21884,1991,255146,277030,11/4/2020
8/31/2020,105,31500,4863,504992,536492,12,2571,16,2163,0,336,72,8,4,1,1076,81,21965,2180,257326,279291,11/4/2020
9/1/2020,98,31598,7109,512101,543699,6,2577,9,2172,1,337,68,7,4,2,1078,66,22031,2371,259697,281728,11/4/2020
9/2/2020,125,31723,10529,522630,554353,9,2586,10,2182,1,338,66,8,4,2,1080,104,22135,3043,262740,284875,11/4/2020
9/3/2020,90,31813,11079,533709,565522,8,2594,8,2190,0,338,66,9,4,3,1083,73,22208,2580,265320,287528,11/4/2020
9/4/2020,103,31916,8963,542672,574588,11,2605,4,2194,0,338,73,9,4,1,1084,83,22291,2365,267685,289976,11/4/2020
9/5/2020,52,31968,6309,548981,580949,6,2611,9,2203,0,338,70,8,3,1,1085,42,22333,1598,269283,291616,11/4/2020
9/6/2020,88,32056,4325,553306,585362,4,2615,8,2211,1,339,65,6,3,1,1086,65,22398,1945,271228,293626,11/4/2020
9/7/2020,35,32091,3002,556308,588399,11,2626,3,2214,0,339,73,5,3,1,1087,26,22424,643,271871,294295,11/4/2020
9/8/2020,74,32165,6381,562689,594854,6,2632,12,2226,1,340,66,6,3,2,1089,66,22490,1589,273460,295950,11/4/2020
9/9/2020,118,32283,8650,571339,603622,9,2641,5,2231,1,341,69,9,3,1,1090,102,22592,2143,275603,298195,11/4/2020
9/10/2020,164,32447,11334,582673,615120,9,2650,8,2239,0,341,70,10,3,1,1091,111,22703,2270,277873,300576,11/4/2020
9/11/2020,120,32567,9454,592127,624694,11,2661,11,2250,0,341,70,10,5,0,1091,97,22800,1966,279839,302639,11/4/2020
9/12/2020,110,32677,6173,598300,630977,8,2669,5,2255,2,343,71,9,5,3,1094,97,22897,1522,281361,304258,11/4/2020
9/13/2020,58,32735,2716,601016,633751,4,2673,3,2258,0,343,72,10,5,0,1094,54,22951,861,282222,305173,11/4/2020
9/14/2020,104,32839,6446,607462,640301,6,2679,3,2261,2,345,73,10,5,2,1096,95,23046,1734,283956,307002,11/4/2020
9/15/2020,122,32961,8466,615928,648889,7,2686,2,2263,1,346,77,10,5,2,1098,124,23170,2192,286148,309318,11/4/2020
9/16/2020,137,33098,9715,625643,658741,7,2693,7,2270,2,348,75,9,6,5,1103,118,23288,1971,288119,311407,11/4/2020
9/17/2020,125,33223,9239,634882,668105,7,2700,14,2284,0,348,68,8,4,0,1103,154,23442,1945,290064,313506,11/4/2020
9/18/2020,132,33355,10045,644927,678282,7,2707,7,2291,1,349,67,11,6,2,1105,132,23574,1929,291993,315567,11/4/2020
9/19/2020,115,33470,8297,653224,686694,7,2714,3,2294,0,349,71,10,6,4,1109,112,23686,1691,293684,317370,11/4/2020
9/20/2020,60,33530,3676,656900,690430,7,2721,6,2300,2,351,70,9,8,4,1113,49,23735,1325,295009,318744,11/4/2020
9/21/2020,102,33632,7018,663918,697550,12,2733,3,2303,2,353,77,8,6,2,1115,94,23829,2405,297414,321243,11/4/2020
9/22/2020,154,33786,9287,673205,706991,12,2745,3,2306,1,354,85,7,5,1,1116,123,23952,2201,299615,323567,11/4/2020
9/23/2020,136,33922,10650,683855,717777,12,2757,7,2313,0,354,90,6,5,0,1116,127,24079,2215,301830,325909,11/4/2020
9/24/2020,120,34042,12479,696334,730376,7,2764,9,2322,1,355,87,7,5,1,1117,121,24200,3169,304999,329199,11/4/2020
9/25/2020,149,34191,10553,706887,741078,9,2773,10,2332,0,355,86,6,5,1,1118,142,24342,3006,308005,332347,11/4/2020
9/26/2020,146,34337,10559,717446,751783,12,2785,9,2341,0,355,89,6,5,1,1119,119,24461,2423,310428,334889,11/4/2020
9/27/2020,43,34380,2764,720210,754590,7,2792,5,2346,0,355,91,9,5,0,1119,34,24495,846,311274,335769,11/4/2020
9/28/2020,152,34532,7308,727518,762050,7,2799,7,2353,2,357,89,7,5,2,1121,134,24629,2261,313535,338164,11/4/2020
9/29/2020,208,34740,11046,738564,773304,12,2811,18,2371,1,358,82,6,6,1,1122,190,24819,2827,316362,341181,11/4/2020
9/30/2020,221,34961,12230,750794,785755,6,2817,6,2377,0,358,82,6,6,1,1123,187,25006,2599,318961,343967,11/4/2020
10/1/2020,185,35146,12503,763297,798443,17,2834,13,2390,1,359,85,6,4,2,1125,166,25172,2424,321385,346557,11/4/2020
10/2/2020,210,35356,12152,775449,810805,14,2848,13,2403,1,360,85,8,5,2,1127,182,25354,2503,323888,349242,11/4/2020
10/3/2020,157,35513,9312,784761,820274,9,2857,9,2412,2,362,83,9,4,2,1129,131,25485,2028,325916,351401,11/4/2020
10/4/2020,81,35594,2369,787130,822724,11,2868,9,2421,1,363,84,8,5,2,1131,78,25563,956,326872,352435,11/4/2020
10/5/2020,174,35768,8980,796110,831878,30,2898,11,2432,2,365,101,9,6,4,1135,160,25723,3035,329907,355630,11/4/2020
10/6/2020,177,35945,11183,807293,843238,11,2909,5,2437,0,365,107,11,7,0,1135,186,25909,2909,332816,358725,11/4/2020
10/7/2020,231,36176,12440,819733,855909,13,2922,14,2451,2,367,104,9,7,2,1137,243,26152,3546,336362,362514,11/4/2020
10/8/2020,262,36438,15231,834964,871402,17,2939,13,2464,2,369,106,7,5,3,1140,274,26426,4224,340586,367012,11/4/2020
10/9/2020,217,36655,13747,848711,885366,21,2960,12,2476,0,369,115,10,7,3,1143,199,26625,4345,344931,371556,11/4/2020
10/10/2020,229,36884,13834,862545,899429,19,2979,10,2486,1,370,123,13,7,2,1145,194,26819,3824,348755,375574,11/4/2020
10/11/2020,97,36981,3264,865809,902790,12,2991,9,2495,1,371,125,14,5,6,1151,88,26907,1168,349923,376830,11/4/2020
10/12/2020,169,37150,6439,872248,909398,19,3010,15,2510,2,373,127,14,5,4,1155,160,27067,1754,351677,378744,11/4/2020
10/13/2020,213,37363,8520,880768,918131,15,3025,15,2525,4,377,123,13,5,7,1162,206,27273,2311,353988,381261,11/4/2020
10/14/2020,322,37685,15038,895806,933491,17,3042,7,2532,0,377,133,15,5,2,1164,304,27577,4057,358045,385622,11/4/2020
10/15/2020,262,37947,14641,910447,948394,11,3053,16,2548,1,378,127,13,5,2,1166,255,27832,3596,361641,389473,11/4/2020
10/16/2020,279,38226,15008,925455,963681,13,3066,20,2568,1,379,119,13,4,2,1168,275,28107,3407,365048,393155,11/4/2020
10/17/2020,354,38580,14064,939519,978099,19,3085,11,2579,1,380,126,17,4,2,1170,309,28416,3283,368331,396747,11/4/2020
10/18/2020,155,38735,4039,943558,982293,18,3103,11,2590,0,380,133,17,5,2,1172,128,28544,1336,369667,398211,11/4/2020
10/19/2020,388,39123,8488,952046,991169,21,3124,23,2613,2,382,129,15,5,1,1173,325,28869,2586,372253,401122,11/4/2020
10/20/2020,439,39562,13238,965284,1004846,22,3146,17,2630,0,382,134,14,7,3,1176,388,29257,3020,375273,404530,11/4/2020
10/21/2020,544,40106,17470,982754,1022860,21,3167,9,2639,2,384,144,15,9,3,1179,472,29729,3553,378826,408555,11/4/2020
10/22/2020,538,40644,15859,998613,1039257,24,3191,21,2660,3,387,144,14,9,3,1182,487,30216,3221,382047,412263,11/4/2020
10/23/2020,514,41158,16626,1015239,1056397,22,3213,26,2686,1,388,139,15,9,3,1185,449,30665,2902,384949,415614,11/4/2020
10/24/2020,359,41517,10246,1025485,1067002,17,3230,11,2697,0,388,145,14,8,1,1186,329,30994,2275,387224,418218,11/4/2020
10/25/2020,233,41750,4760,1030245,1071995,15,3245,15,2712,1,389,144,15,8,1,1187,206,31200,1483,388707,419907,11/4/2020
10/26/2020,454,42204,9179,1039424,1081628,25,3270,20,2732,2,391,147,18,8,3,1190,393,31593,2996,391703,423296,11/4/2020
10/27/2020,516,42720,13992,1053416,1096136,28,3298,11,2743,2,393,162,17,9,4,1194,444,32037,2408,394111,426148,11/4/2020
10/28/2020,468,43188,15231,1068647,1111835,22,3320,23,2766,1,394,160,16,9,3,1197,403,32440,2721,396832,429272,11/4/2020
10/29/2020,610,43798,16233,1084880,1128678,20,3340,18,2784,3,397,159,19,11,4,1201,529,32969,3148,399980,432949,11/4/2020
10/30/2020,543,44341,14265,1099145,1143486,21,3361,20,2804,5,402,155,19,9,4,1205,467,33436,2973,402953,436389,11/4/2020
10/31/2020,586,44927,11898,1111043,1155970,29,3390,12,2816,1,403,171,22,9,3,1208,507,33943,2441,405394,439337,11/4/2020
11/1/2020,324,45251,5006,1116049,1161300,17,3407,14,2830,1,404,173,24,12,4,1212,272,34215,1238,406632,440847,11/4/2020
11/2/2020,509,45760,9658,1125707,1171467,25,3432,26,2856,3,407,169,21,11,2,1214,441,34656,2891,409523,444179,11/4/2020
11/3/2020,544,46304,12348,1138055,1184359,,,,,,,,,,0,1214,466,35122,2376,411899,447021,11/4/2020
2/27/2020,0,0,0,0,0,1,1,0,0,0,0,1,0,0,0,0,0,0,0,0,0,11/5/2020
2/28/2020,0,0,0,0,0,0,1,0,0,0,0,1,1,0,0,0,0,0,0,0,0,11/5/2020
2/29/2020,0,0,0,0,0,0,1,0,0,0,0,1,1,0,0,0,0,0,0,0,0,11/5/2020
3/1/2020,2,2,2,2,4,0,1,0,0,0,0,1,1,1,0,0,2,2,2,2,4,11/5/2020
3/2/2020,0,2,1,3,5,1,2,0,0,0,0,2,2,2,0,0,0,2,1,3,5,11/5/2020
3/3/2020,0,2,2,5,7,0,2,0,0,0,0,2,2,2,0,0,0,2,2,5,7,11/5/2020
3/4/2020,0,2,12,17,19,1,3,0,0,0,0,3,2,2,0,0,0,2,10,15,17,11/5/2020
3/5/2020,0,2,4,21,23,0,3,0,0,0,0,3,2,2,0,0,1,3,4,19,22,11/5/2020
3/6/2020,1,3,12,33,36,0,3,0,0,0,0,3,2,2,0,0,0,3,11,30,33,11/5/2020
3/7/2020,0,3,19,52,55,0,3,0,0,0,0,3,2,1,0,0,0,3,19,49,52,11/5/2020
3/8/2020,0,3,18,70,73,0,3,0,0,0,0,3,2,1,0,0,0,3,18,67,70,11/5/2020
3/9/2020,1,4,15,85,89,0,3,0,0,0,0,3,2,1,0,0,1,4,15,82,86,11/5/2020
3/10/2020,2,6,25,110,116,0,3,0,0,0,0,3,2,1,0,0,1,5,23,105,110,11/5/2020
3/11/2020,0,6,34,144,150,1,4,0,0,0,0,4,1,1,0,0,0,5,34,139,144,11/5/2020
3/12/2020,9,15,41,185,200,1,5,0,0,0,0,5,1,1,0,0,8,13,38,177,190,11/5/2020
3/13/2020,6,21,50,235,256,4,9,1,1,0,0,8,1,1,0,0,6,19,48,225,244,11/5/2020
3/14/2020,0,21,90,325,346,0,9,0,1,0,0,8,1,1,0,0,0,19,86,311,330,11/5/2020
3/15/2020,1,22,54,379,401,1,10,0,1,0,0,9,2,1,0,0,1,20,54,365,385,11/5/2020
3/16/2020,2,24,95,474,498,2,12,0,1,0,0,11,2,0,0,0,2,22,92,457,479,11/5/2020
3/17/2020,12,36,162,636,672,6,18,0,1,0,0,17,2,0,0,0,11,33,149,606,639,11/5/2020
3/18/2020,9,45,116,752,797,3,21,0,1,0,0,20,2,0,0,0,11,44,110,716,760,11/5/2020
3/19/2020,15,60,262,1014,1074,2,23,1,2,0,0,21,3,0,1,1,17,61,248,964,1025,11/5/2020
3/20/2020,13,73,197,1211,1284,5,28,0,2,0,0,26,4,0,0,1,13,74,188,1152,1226,11/5/2020
3/21/2020,12,85,126,1337,1422,3,31,2,4,0,0,27,5,0,0,1,14,88,122,1274,1362,11/5/2020
3/22/2020,27,112,282,1619,1731,2,33,0,4,0,0,29,5,0,0,1,25,113,259,1533,1646,11/5/2020
3/23/2020,14,126,169,1788,1914,15,48,1,5,0,0,43,9,3,0,1,16,129,162,1695,1824,11/5/2020
3/24/2020,20,146,242,2030,2176,7,55,0,5,0,0,50,10,4,0,1,19,148,232,1927,2075,11/5/2020
3/25/2020,26,172,182,2212,2384,5,60,1,6,0,0,54,11,3,0,1,28,176,168,2095,2271,11/5/2020
3/26/2020,35,207,181,2393,2600,10,70,5,11,0,0,59,14,5,0,1,41,217,170,2265,2482,11/5/2020
3/27/2020,27,234,214,2607,2841,9,79,1,12,1,1,66,17,6,2,3,31,248,199,2464,2712,11/5/2020
3/28/2020,59,293,260,2867,3160,13,92,3,15,2,3,74,15,6,1,4,64,312,240,2704,3016,11/5/2020
3/29/2020,100,393,350,3217,3610,8,100,4,19,1,4,77,18,8,2,6,105,417,310,3014,3431,11/5/2020
3/30/2020,62,455,222,3439,3894,20,120,5,24,0,4,92,20,11,3,9,78,495,183,3197,3692,11/5/2020
3/31/2020,71,526,369,3808,4334,11,131,7,31,1,5,95,22,13,2,11,73,568,294,3491,4059,11/5/2020
4/1/2020,99,625,698,4506,5131,18,149,7,38,0,5,106,30,15,1,12,100,668,632,4123,4791,11/5/2020
4/2/2020,52,677,477,4983,5660,22,171,6,44,2,7,120,36,21,4,16,62,730,431,4554,5284,11/5/2020
4/3/2020,108,785,774,5757,6542,23,194,7,51,0,7,136,43,25,3,19,100,830,699,5253,6083,11/5/2020
4/4/2020,143,928,660,6417,7345,22,216,4,55,5,12,149,41,30,9,28,138,968,610,5863,6831,11/5/2020
4/5/2020,187,1115,1156,7573,8688,20,236,9,64,1,13,159,44,36,2,30,181,1149,1047,6910,8059,11/5/2020
4/6/2020,218,1333,1706,9279,10612,26,262,7,71,0,13,178,48,40,7,37,207,1356,1526,8436,9792,11/5/2020
4/7/2020,284,1617,1629,10908,12525,20,282,4,75,2,15,192,50,42,5,42,261,1617,1466,9902,11519,11/5/2020
4/8/2020,290,1907,1720,12628,14535,19,301,7,82,6,21,198,50,38,10,52,271,1888,1528,11430,13318,11/5/2020
4/9/2020,283,2190,1516,14144,16334,32,333,9,91,4,25,217,53,40,7,59,277,2165,1342,12772,14937,11/5/2020
4/10/2020,419,2609,2574,16718,19327,29,362,17,108,5,30,224,59,41,11,70,400,2565,2335,15107,17672,11/5/2020
4/11/2020,297,2906,1905,18623,21529,29,391,11,119,2,32,240,61,48,12,82,281,2846,1698,16805,19651,11/5/2020
4/12/2020,314,3220,1670,20293,23513,35,426,13,132,5,37,257,59,49,9,91,285,3131,1411,18216,21347,11/5/2020
4/13/2020,161,3381,935,21228,24609,35,461,13,145,3,40,276,64,54,9,100,187,3318,830,19046,22364,11/5/2020
4/14/2020,289,3670,1787,23015,26685,27,488,18,163,5,45,280,72,53,8,108,262,3580,1506,20552,24132,11/5/2020
4/15/2020,351,4021,1799,24814,28835,31,519,20,183,3,48,288,72,54,17,125,306,3886,1526,22078,25964,11/5/2020
4/16/2020,447,4468,2494,27308,31776,36,555,25,208,6,54,293,72,53,14,139,387,4273,2051,24129,28402,11/5/2020
4/17/2020,304,4772,1821,29129,33901,32,587,20,228,7,61,298,66,45,21,160,290,4563,1421,25550,30113,11/5/2020
4/18/2020,321,5093,1725,30854,35947,26,613,18,246,4,65,302,63,49,15,175,284,4847,1303,26853,31700,11/5/2020
4/19/2020,381,5474,2047,32901,38375,23,636,26,272,1,66,298,65,55,11,186,337,5184,1716,28569,33753,11/5/2020
4/20/2020,394,5868,1907,34808,40676,46,682,29,301,2,68,313,75,56,10,196,376,5560,1554,30123,35683,11/5/2020
4/21/2020,444,6312,2110,36918,43230,45,727,33,334,5,73,320,72,56,18,214,383,5943,1677,31800,37743,11/5/2020
4/22/2020,418,6730,2390,39308,46038,41,768,32,366,5,78,324,73,58,18,232,379,6322,1886,33686,40008,11/5/2020
4/23/2020,479,7209,2469,41777,48986,32,800,28,394,5,83,323,76,62,15,247,412,6734,1834,35520,42254,11/5/2020
4/24/2020,491,7700,3284,45061,52761,35,835,26,420,4,87,328,85,63,15,262,407,7141,2586,38106,45247,11/5/2020
4/25/2020,393,8093,2206,47267,55360,34,869,17,437,5,92,340,85,62,14,276,300,7441,1736,39842,47283,11/5/2020
4/26/2020,316,8409,2309,49576,57985,33,902,15,452,3,95,355,86,59,14,290,274,7715,1850,41692,49407,11/5/2020
4/27/2020,249,8658,1620,51196,59854,29,931,21,473,4,99,359,86,61,10,300,206,7921,1142,42834,50755,11/5/2020
4/28/2020,410,9068,2263,53459,62527,44,975,24,497,3,102,376,88,59,22,322,332,8253,1709,44543,52796,11/5/2020
4/29/2020,476,9544,3343,56802,66346,36,1011,38,535,11,113,363,78,53,18,340,371,8624,2387,46930,55554,11/5/2020
4/30/2020,432,9976,2769,59571,69547,33,1044,38,573,6,119,352,83,57,24,364,350,8974,1875,48805,57779,11/5/2020
5/1/2020,454,10430,3086,62657,73087,51,1095,39,612,3,122,361,84,58,14,378,323,9297,2131,50936,60233,11/5/2020
5/2/2020,257,10687,1926,64583,75270,36,1131,38,650,5,127,354,91,62,24,402,192,9489,1252,52188,61677,11/5/2020
5/3/2020,283,10970,2160,66743,77713,31,1162,26,676,8,135,351,90,61,21,423,183,9672,1549,53737,63409,11/5/2020
5/4/2020,387,11357,2098,68841,80198,30,1192,31,707,6,141,344,88,57,18,441,290,9962,1535,55272,65234,11/5/2020
5/5/2020,433,11790,2873,71714,83504,29,1221,32,739,6,147,335,82,54,16,457,301,10263,1933,57205,67468,11/5/2020
5/6/2020,488,12278,2830,74544,86822,28,1249,44,783,9,156,310,79,54,21,478,340,10603,1893,59098,69701,11/5/2020
5/7/2020,425,12703,2969,77513,90216,36,1285,43,826,5,161,298,71,52,21,499,270,10873,1936,61034,71907,11/5/2020
5/8/2020,359,13062,2598,80111,93173,30,1315,29,855,5,166,294,71,53,22,521,229,11102,1714,62748,73850,11/5/2020
5/9/2020,467,13529,3346,83457,96986,22,1337,21,876,4,170,291,69,51,15,536,290,11392,2213,64961,76353,11/5/2020
5/10/2020,285,13814,2117,85574,99388,20,1357,23,899,6,176,282,70,49,14,550,189,11581,1497,66458,78039,11/5/2020
5/11/2020,257,14071,1857,87431,101502,31,1388,16,915,6,182,291,71,49,15,565,174,11755,1280,67738,79493,11/5/2020
5/12/2020,387,14458,2611,90042,104500,23,1411,18,933,4,186,292,69,48,22,587,224,11979,1678,69416,81395,11/5/2020
5/13/2020,351,14809,3630,93672,108481,23,1434,25,958,1,187,289,69,49,13,600,199,12178,1933,71349,83527,11/5/2020
5/14/2020,329,15138,3408,97080,112218,19,1453,27,985,3,190,278,64,45,15,615,232,12410,1991,73340,85750,11/5/2020
5/15/2020,381,15519,3458,100538,116057,24,1477,41,1026,5,195,256,62,45,14,629,232,12642,1783,75123,87765,11/5/2020
5/16/2020,449,15968,4156,104694,120662,25,1502,15,1041,5,200,261,61,46,15,644,247,12889,1926,77049,89938,11/5/2020
5/17/2020,240,16208,2768,107462,123670,17,1519,9,1050,5,205,264,59,45,10,654,126,13015,1525,78574,91589,11/5/2020
5/18/2020,250,16458,2001,109463,125921,19,1538,16,1066,5,210,262,57,40,18,672,135,13150,1357,79931,93081,11/5/2020
5/19/2020,415,16873,3168,112631,129504,23,1561,33,1099,5,215,247,56,38,11,683,215,13365,1908,81839,95204,11/5/2020
5/20/2020,326,17199,2771,115402,132601,19,1580,23,1122,7,222,236,52,33,22,705,183,13548,1505,83344,96892,11/5/2020
5/21/2020,374,17573,3757,119159,136732,26,1606,15,1137,3,225,244,53,29,20,725,168,13716,1917,85261,98977,11/5/2020
5/22/2020,351,17924,3161,122320,140244,20,1626,29,1166,5,230,230,52,29,11,736,206,13922,1591,86852,100774,11/5/2020
5/23/2020,253,18177,2742,125062,143239,19,1645,11,1177,3,233,235,52,32,13,749,109,14031,1259,88111,102142,11/5/2020
5/24/2020,163,18340,1370,126432,144772,13,1658,14,1191,2,235,232,53,36,8,757,83,14114,768,88879,102993,11/5/2020
5/25/2020,147,18487,1385,127817,146304,14,1672,14,1205,0,235,232,53,34,10,767,76,14190,757,89636,103826,11/5/2020
5/26/2020,285,18772,2620,130437,149209,24,1696,22,1227,5,240,229,48,33,15,782,158,14348,1765,91401,105749,11/5/2020
5/27/2020,276,19048,2057,132494,151542,20,1716,18,1245,3,243,228,50,33,10,792,132,14480,1124,92525,107005,11/5/2020
5/28/2020,348,19396,3359,135853,155249,17,1733,29,1274,4,247,212,47,32,8,800,130,14610,1107,93632,108242,11/5/2020
5/29/2020,410,19806,3915,139768,159574,19,1752,27,1301,6,253,198,43,31,12,812,174,14784,1561,95193,109977,11/5/2020
5/30/2020,225,20031,3915,143683,163714,16,1768,19,1320,4,257,191,41,29,12,824,109,14893,1801,96994,111887,11/5/2020
5/31/2020,155,20186,1690,145373,165559,11,1779,10,1330,1,258,191,44,26,3,827,78,14971,849,97843,112814,11/5/2020
6/1/2020,212,20398,2792,148165,168563,8,1787,14,1344,1,259,184,45,29,5,832,93,15064,1373,99216,114280,11/5/2020
6/2/2020,273,20671,3022,151187,171858,8,1795,10,1354,3,262,179,38,25,10,842,98,15162,1425,100641,115803,11/5/2020
6/3/2020,254,20925,3486,154673,175598,14,1809,18,1372,6,268,169,34,25,11,853,99,15261,1643,102284,117545,11/5/2020
6/4/2020,276,21201,4471,159144,180345,7,1816,26,1398,4,272,146,31,24,12,865,107,15368,2016,104300,119668,11/5/2020
6/5/2020,215,21416,3513,162657,184073,15,1831,13,1411,6,278,142,27,21,11,876,99,15467,1559,105859,121326,11/5/2020
6/6/2020,201,21617,2616,165273,186890,10,1841,7,1418,2,280,143,29,19,6,882,67,15534,1112,106971,122505,11/5/2020
6/7/2020,83,21700,1625,166898,188598,11,1852,7,1425,1,281,146,25,17,4,886,51,15585,779,107750,123335,11/5/2020
6/8/2020,119,21819,1849,168747,190566,15,1867,12,1437,2,283,147,27,18,4,890,45,15630,950,108700,124330,11/5/2020
6/9/2020,223,22042,2673,171420,193462,10,1877,19,1456,0,283,138,28,21,1,891,64,15694,1247,109947,125641,11/5/2020
6/10/2020,209,22251,2987,174407,196658,13,1890,12,1468,2,285,137,24,17,4,895,101,15795,1454,111401,127196,11/5/2020
6/11/2020,195,22446,3513,177920,200366,7,1897,15,1483,1,286,128,25,16,6,901,88,15883,1517,112918,128801,11/5/2020
6/12/2020,209,22655,4601,182521,205176,9,1906,16,1499,1,287,120,24,16,2,903,78,15961,2161,115079,131040,11/5/2020
6/13/2020,113,22768,3036,185557,208325,6,1912,5,1504,0,287,121,20,15,3,906,49,16010,1360,116439,132449,11/5/2020
6/14/2020,81,22849,2046,187603,210452,7,1919,8,1512,1,288,119,20,14,3,909,33,16043,961,117400,133443,11/5/2020
6/15/2020,188,23037,3108,190711,213748,14,1933,19,1531,0,288,114,20,16,5,914,75,16118,1773,119173,135291,11/5/2020
6/16/2020,110,23147,3017,193728,216875,11,1944,9,1540,1,289,115,22,16,8,922,50,16168,1525,120698,136866,11/5/2020
6/17/2020,127,23274,2835,196563,219837,15,1959,22,1562,4,293,104,18,14,6,928,50,16218,1302,122000,138218,11/5/2020
6/18/2020,149,23423,3048,199611,223034,9,1968,15,1577,1,294,97,19,16,7,935,70,16288,1307,123307,139595,11/5/2020
6/19/2020,141,23564,3769,203380,226944,12,1980,12,1589,1,295,96,20,17,3,938,59,16347,1351,124658,141005,11/5/2020
6/20/2020,84,23648,1891,205271,228919,9,1989,12,1601,0,295,93,20,18,4,942,36,16383,809,125467,141850,11/5/2020
6/21/2020,37,23685,1064,206335,230020,8,1997,5,1606,0,295,96,20,18,2,944,30,16413,685,126152,142565,11/5/2020
6/22/2020,138,23823,3730,210065,233888,12,2009,16,1622,0,295,92,19,18,2,946,65,16478,1694,127846,144324,11/5/2020
6/23/2020,163,23986,3831,213896,237882,3,2012,13,1635,3,298,79,18,18,7,953,82,16560,1765,129611,146171,11/5/2020
6/24/2020,120,24106,3502,217398,241504,9,2021,11,1646,1,299,76,18,18,5,958,44,16604,1671,131282,147886,11/5/2020
6/25/2020,103,24209,2883,220281,244490,6,2027,14,1660,1,300,67,17,17,1,959,50,16654,1492,132774,149428,11/5/2020
6/26/2020,94,24303,2488,222769,247072,2,2029,10,1670,0,300,59,18,18,1,960,60,16714,1316,134090,150804,11/5/2020
6/27/2020,84,24387,3216,225985,250372,5,2034,3,1673,1,301,60,17,17,5,965,37,16751,1209,135299,152050,11/5/2020
6/28/2020,39,24426,1469,227454,251880,4,2038,4,1677,4,305,56,15,14,6,971,17,16768,590,135889,152657,11/5/2020
6/29/2020,85,24511,3697,231151,255662,4,2042,5,1682,0,305,55,14,14,1,972,39,16807,1341,137230,154037,11/5/2020
6/30/2020,57,24568,1958,233109,257677,1,2043,5,1687,1,306,50,12,11,4,976,33,16840,991,138221,155061,11/5/2020
7/1/2020,144,24712,4098,237207,261919,8,2051,10,1697,0,306,48,11,11,1,977,79,16919,1913,140134,157053,11/5/2020
7/2/2020,103,24815,2803,240010,264825,5,2056,5,1702,1,307,47,10,10,3,980,59,16978,1074,141208,158186,11/5/2020
7/3/2020,50,24865,2079,242089,266954,9,2065,6,1708,0,307,50,9,9,3,983,25,17003,777,141985,158988,11/5/2020
7/4/2020,57,24922,2345,244434,269356,2,2067,4,1712,1,308,47,10,9,2,985,33,17036,1000,142985,160021,11/5/2020
7/5/2020,49,24971,2932,247366,272337,1,2068,2,1714,1,309,45,8,8,2,987,26,17062,1429,144414,161476,11/5/2020
7/6/2020,101,25072,2814,250180,275252,6,2074,6,1720,0,309,45,9,9,4,991,57,17119,1535,145949,163068,11/5/2020
7/7/2020,81,25153,3457,253637,278790,5,2079,7,1727,0,309,43,8,8,2,993,47,17166,1530,147479,164645,11/5/2020
7/8/2020,105,25258,3409,257046,282304,4,2083,2,1729,0,309,45,9,8,0,993,64,17230,1417,148896,166126,11/5/2020
7/9/2020,94,25352,3714,260760,286112,9,2092,3,1732,0,309,51,9,8,0,993,50,17280,1608,150504,167784,11/5/2020
7/10/2020,132,25484,4437,265197,290681,6,2098,3,1735,2,311,52,7,7,3,996,80,17360,2062,152566,169926,11/5/2020
7/11/2020,63,25547,2938,268135,293682,6,2104,3,1738,1,312,54,6,6,3,999,36,17396,1310,153876,171272,11/5/2020
7/12/2020,47,25594,1838,269973,295567,1,2105,3,1741,1,313,51,6,5,3,1002,34,17430,938,154814,172244,11/5/2020
7/13/2020,84,25678,3209,273182,298860,8,2113,10,1751,0,313,49,6,5,1,1003,61,17491,1497,156311,173802,11/5/2020
7/14/2020,74,25752,3298,276480,302232,7,2120,4,1755,0,313,52,5,5,1,1004,44,17535,1372,157683,175218,11/5/2020
7/15/2020,130,25882,4181,280661,306543,5,2125,7,1762,0,313,50,5,4,0,1004,100,17635,1742,159425,177060,11/5/2020
7/16/2020,103,25985,3740,284401,310386,6,2131,9,1771,0,313,47,6,5,1,1005,76,17711,1607,161032,178743,11/5/2020
7/17/2020,156,26141,4239,288640,314781,14,2145,3,1774,1,314,57,5,5,2,1007,79,17790,1840,162872,180662,11/5/2020
7/18/2020,85,26226,3272,291912,318138,5,2150,9,1783,1,315,52,5,4,4,1011,70,17860,1389,164261,182121,11/5/2020
7/19/2020,82,26308,2696,294608,320916,7,2157,3,1786,0,315,56,6,4,2,1013,57,17917,1144,165405,183322,11/5/2020
7/20/2020,71,26379,2666,297274,323653,9,2166,7,1793,0,315,58,7,5,2,1015,68,17985,1446,166851,184836,11/5/2020
7/21/2020,130,26509,4304,301578,328087,9,2175,11,1804,0,315,56,9,6,1,1016,108,18093,1907,168758,186851,11/5/2020
7/22/2020,130,26639,3928,305506,332145,11,2186,11,1815,1,316,55,7,6,1,1017,86,18179,1671,170429,188608,11/5/2020
7/23/2020,141,26780,4415,309921,336701,9,2195,6,1821,0,316,58,8,7,0,1017,115,18294,1963,172392,190686,11/5/2020
7/24/2020,172,26952,5966,315887,342839,14,2209,14,1835,0,316,58,9,7,0,1017,119,18413,2303,174695,193108,11/5/2020
7/25/2020,134,27086,4398,320285,347371,7,2216,7,1842,0,316,58,10,8,3,1020,108,18521,2080,176775,195296,11/5/2020
7/26/2020,62,27148,3033,323318,350466,8,2224,9,1851,0,316,57,11,7,1,1021,54,18575,1328,178103,196678,11/5/2020
7/27/2020,188,27336,4191,327509,354845,12,2236,7,1858,0,316,62,13,8,1,1022,138,18713,2333,180436,199149,11/5/2020
7/28/2020,105,27441,3840,331349,358790,5,2241,5,1863,0,316,62,14,7,1,1023,95,18808,1627,182063,200871,11/5/2020
7/29/2020,190,27631,5139,336488,364119,11,2252,12,1875,0,316,61,15,7,0,1023,154,18962,2294,184357,203319,11/5/2020
7/30/2020,121,27752,4345,340833,368585,6,2258,2,1877,1,317,64,15,6,1,1024,97,19059,1638,185995,205054,11/5/2020
7/31/2020,131,27883,5512,346345,374228,8,2266,10,1887,0,317,62,15,7,1,1025,89,19148,1835,187830,206978,11/5/2020
8/1/2020,109,27992,4294,350639,378631,7,2273,2,1889,0,317,67,14,7,1,1026,89,19237,1551,189381,208618,11/5/2020
8/2/2020,84,28076,2804,353443,381519,12,2285,12,1901,2,319,65,14,8,2,1028,62,19299,1266,190647,209946,11/5/2020
8/3/2020,188,28264,5248,358691,386955,13,2298,12,1913,0,319,66,16,7,1,1029,150,19449,2191,192838,212287,11/5/2020
8/4/2020,125,28389,3691,362382,390771,9,2307,6,1919,1,320,68,12,5,2,1031,99,19548,1759,194597,214145,11/5/2020
8/5/2020,147,28536,5935,368317,396853,12,2319,10,1929,1,321,69,10,5,2,1033,119,19667,2451,197048,216715,11/5/2020
8/6/2020,169,28705,5546,373863,402568,7,2326,9,1938,0,321,67,9,4,0,1033,120,19787,2389,199437,219224,11/5/2020
8/7/2020,123,28828,4851,378714,407542,13,2339,10,1948,1,322,69,9,3,2,1035,87,19874,2130,201567,221441,11/5/2020
8/8/2020,123,28951,4112,382826,411777,19,2358,6,1954,1,323,81,8,3,1,1036,91,19965,1770,203337,223302,11/5/2020
8/9/2020,42,28993,1727,384553,413546,8,2366,10,1964,0,323,79,9,4,0,1036,35,20000,1064,204401,224401,11/5/2020
8/10/2020,149,29142,4587,389140,418282,11,2377,12,1976,0,323,78,9,4,1,1037,113,20113,2011,206412,226525,11/5/2020
8/11/2020,106,29248,4334,393474,422722,6,2383,14,1990,0,323,70,10,4,3,1040,92,20205,2256,208668,228873,11/5/2020
8/12/2020,121,29369,5188,398662,428031,8,2391,11,2001,0,323,67,9,3,1,1041,101,20306,2611,211279,231585,11/5/2020
8/13/2020,135,29504,4196,402858,432362,13,2404,12,2013,0,323,68,11,3,0,1041,95,20401,1893,213172,233573,11/5/2020
8/14/2020,145,29649,5498,408356,438005,13,2417,11,2024,0,323,70,11,4,3,1044,98,20499,1965,215137,235636,11/5/2020
8/15/2020,106,29755,4534,412890,442645,9,2426,11,2035,1,324,67,11,5,0,1044,88,20587,1678,216815,237402,11/5/2020
8/16/2020,83,29838,2477,415367,445205,7,2433,6,2041,4,328,64,8,4,6,1050,70,20657,958,217773,238430,11/5/2020
8/17/2020,106,29944,4575,419942,449886,10,2443,7,2048,0,328,67,8,5,2,1052,87,20744,2377,220150,240894,11/5/2020
8/18/2020,128,30072,4911,424853,454925,11,2454,9,2057,1,329,68,8,4,5,1057,94,20838,2740,222890,243728,11/5/2020
8/19/2020,113,30185,5077,429930,460115,8,2462,9,2066,1,330,66,9,5,0,1057,90,20928,2633,225523,246451,11/5/2020
8/20/2020,173,30358,7411,437341,467699,12,2474,6,2072,2,332,70,10,5,3,1060,139,21067,3498,229021,250088,11/5/2020
8/21/2020,151,30509,6577,443918,474427,8,2482,5,2077,1,333,72,9,4,2,1062,125,21192,2929,231950,253142,11/5/2020
8/22/2020,96,30605,5550,449468,480073,11,2493,12,2089,0,333,71,11,4,1,1063,84,21276,2590,234540,255816,11/5/2020
8/23/2020,71,30676,4375,453843,484519,11,2504,6,2095,0,333,76,12,2,1,1064,56,21332,2466,237006,258338,11/5/2020
8/24/2020,105,30781,5784,459627,490408,7,2511,10,2105,1,334,72,14,4,1,1065,77,21409,3141,240147,261556,11/5/2020
8/25/2020,108,30889,4764,464391,495280,11,2522,4,2109,1,335,78,12,4,1,1066,92,21501,2276,242423,263924,11/5/2020
8/26/2020,170,31059,9482,473873,504932,4,2526,8,2117,0,335,74,10,5,1,1067,127,21628,3075,245498,267126,11/5/2020
8/27/2020,92,31151,8565,482438,513589,6,2532,13,2130,1,336,66,7,5,2,1069,70,21698,3145,248643,270341,11/5/2020
8/28/2020,113,31264,7994,490432,521696,14,2546,4,2134,0,336,76,10,7,2,1071,87,21785,2423,251066,272851,11/5/2020
8/29/2020,65,31329,5374,495806,527135,6,2552,8,2142,1,337,73,11,6,2,1073,51,21836,1907,252973,274809,11/5/2020
8/30/2020,66,31395,4323,500129,531524,7,2559,4,2146,0,337,76,9,5,2,1075,48,21884,1990,254963,276847,11/5/2020
8/31/2020,105,31500,4863,504992,536492,12,2571,16,2162,0,337,72,8,4,1,1076,81,21965,2180,257143,279108,11/5/2020
9/1/2020,98,31598,7109,512101,543699,6,2577,9,2171,1,338,68,7,4,2,1078,66,22031,2369,259512,281543,11/5/2020
9/2/2020,125,31723,10529,522630,554353,9,2586,10,2181,1,339,66,8,4,2,1080,104,22135,3042,262554,284689,11/5/2020
9/3/2020,90,31813,11079,533709,565522,8,2594,8,2189,0,339,66,9,4,3,1083,73,22208,2579,265133,287341,11/5/2020
9/4/2020,103,31916,8963,542672,574588,11,2605,4,2193,0,339,73,9,4,1,1084,83,22291,2365,267498,289789,11/5/2020
9/5/2020,52,31968,6309,548981,580949,6,2611,9,2202,0,339,70,8,3,1,1085,42,22333,1598,269096,291429,11/5/2020
9/6/2020,88,32056,4325,553306,585362,4,2615,8,2210,1,340,65,6,3,1,1086,65,22398,1944,271040,293438,11/5/2020
9/7/2020,35,32091,3002,556308,588399,11,2626,3,2213,0,340,73,5,3,1,1087,26,22424,643,271683,294107,11/5/2020
9/8/2020,74,32165,6381,562689,594854,6,2632,12,2225,1,341,66,6,3,2,1089,66,22490,1589,273272,295762,11/5/2020
9/9/2020,118,32283,8650,571339,603622,9,2641,5,2230,1,342,69,9,3,1,1090,102,22592,2141,275413,298005,11/5/2020
9/10/2020,164,32447,11334,582673,615120,9,2650,8,2238,0,342,70,10,3,1,1091,111,22703,2270,277683,300386,11/5/2020
9/11/2020,120,32567,9454,592127,624694,11,2661,11,2249,0,342,70,10,5,0,1091,97,22800,1966,279649,302449,11/5/2020
9/12/2020,110,32677,6173,598300,630977,8,2669,5,2254,2,344,71,9,5,3,1094,97,22897,1519,281168,304065,11/5/2020
9/13/2020,58,32735,2716,601016,633751,4,2673,3,2257,0,344,72,10,5,0,1094,54,22951,861,282029,304980,11/5/2020
9/14/2020,104,32839,6446,607462,640301,6,2679,3,2260,2,346,73,10,5,2,1096,95,23046,1733,283762,306808,11/5/2020
9/15/2020,122,32961,8466,615928,648889,7,2686,2,2262,1,347,77,10,5,2,1098,124,23170,2191,285953,309123,11/5/2020
9/16/2020,137,33098,9715,625643,658741,7,2693,7,2269,2,349,75,9,6,5,1103,118,23288,1970,287923,311211,11/5/2020
9/17/2020,125,33223,9239,634882,668105,7,2700,14,2283,0,349,68,8,4,0,1103,154,23442,1944,289867,313309,11/5/2020
9/18/2020,132,33355,10045,644927,678282,7,2707,7,2290,1,350,67,11,6,2,1105,132,23574,1927,291794,315368,11/5/2020
9/19/2020,115,33470,8297,653224,686694,7,2714,3,2293,0,350,71,10,6,4,1109,112,23686,1690,293484,317170,11/5/2020
9/20/2020,60,33530,3676,656900,690430,7,2721,6,2299,2,352,70,9,8,4,1113,49,23735,1323,294807,318542,11/5/2020
9/21/2020,102,33632,7018,663918,697550,12,2733,3,2302,2,354,77,8,6,2,1115,94,23829,2405,297212,321041,11/5/2020
9/22/2020,154,33786,9287,673205,706991,12,2745,3,2305,1,355,85,7,5,1,1116,123,23952,2201,299413,323365,11/5/2020
9/23/2020,136,33922,10650,683855,717777,12,2757,7,2312,0,355,90,6,5,0,1116,127,24079,2212,301625,325704,11/5/2020
9/24/2020,120,34042,12479,696334,730376,7,2764,9,2321,1,356,87,7,5,1,1117,121,24200,3168,304793,328993,11/5/2020
9/25/2020,149,34191,10553,706887,741078,9,2773,10,2331,0,356,86,6,5,1,1118,142,24342,3004,307797,332139,11/5/2020
9/26/2020,146,34337,10559,717446,751783,12,2785,9,2340,0,356,89,6,5,1,1119,119,24461,2422,310219,334680,11/5/2020
9/27/2020,43,34380,2764,720210,754590,7,2792,5,2345,0,356,91,9,5,0,1119,34,24495,846,311065,335560,11/5/2020
9/28/2020,152,34532,7308,727518,762050,7,2799,7,2352,2,358,89,7,5,2,1121,134,24629,2261,313326,337955,11/5/2020
9/29/2020,208,34740,11046,738564,773304,12,2811,18,2370,1,359,82,6,6,1,1122,190,24819,2827,316153,340972,11/5/2020
9/30/2020,221,34961,12230,750794,785755,6,2817,6,2376,0,359,82,6,6,1,1123,187,25006,2596,318749,343755,11/5/2020
10/1/2020,185,35146,12503,763297,798443,17,2834,13,2389,1,360,85,6,4,2,1125,166,25172,2421,321170,346342,11/5/2020
10/2/2020,210,35356,12153,775450,810806,14,2848,13,2402,1,361,85,8,5,2,1127,182,25354,2504,323674,349028,11/5/2020
10/3/2020,157,35513,9312,784762,820275,9,2857,9,2411,2,363,83,9,4,2,1129,131,25485,2027,325701,351186,11/5/2020
10/4/2020,81,35594,2369,787131,822725,11,2868,9,2420,1,364,84,8,5,2,1131,78,25563,955,326656,352219,11/5/2020
10/5/2020,174,35768,8982,796113,831881,30,2898,11,2431,2,366,101,9,6,4,1135,160,25723,3036,329692,355415,11/5/2020
10/6/2020,177,35945,11185,807298,843243,11,2909,5,2436,0,366,107,11,7,0,1135,186,25909,2910,332602,358511,11/5/2020
10/7/2020,231,36176,12440,819738,855914,13,2922,14,2450,2,368,104,9,7,2,1137,243,26152,3546,336148,362300,11/5/2020
10/8/2020,262,36438,15233,834971,871409,17,2939,13,2463,2,370,106,7,5,4,1141,274,26426,4222,340370,366796,11/5/2020
10/9/2020,217,36655,13745,848716,885371,21,2960,12,2475,0,370,115,10,7,3,1144,199,26625,4340,344710,371335,11/5/2020
10/10/2020,229,36884,13832,862548,899432,19,2979,10,2485,1,371,123,13,7,2,1146,194,26819,3821,348531,375350,11/5/2020
10/11/2020,97,36981,3263,865811,902792,12,2991,9,2494,1,372,125,14,5,6,1152,88,26907,1167,349698,376605,11/5/2020
10/12/2020,169,37150,6439,872250,909400,19,3010,15,2509,2,374,127,14,5,4,1156,160,27067,1753,351451,378518,11/5/2020
10/13/2020,213,37363,8521,880771,918134,15,3025,15,2524,4,378,123,13,5,7,1163,207,27274,2311,353762,381036,11/5/2020
10/14/2020,322,37685,15038,895809,933494,17,3042,7,2531,0,378,133,15,5,2,1165,304,27578,4057,357819,385397,11/5/2020
10/15/2020,262,37947,14640,910449,948396,11,3053,16,2547,1,379,127,13,5,2,1167,254,27832,3595,361414,389246,11/5/2020
10/16/2020,279,38226,15011,925460,963686,13,3066,20,2567,1,380,119,13,4,2,1169,275,28107,3405,364819,392926,11/5/2020
10/17/2020,354,38580,14068,939528,978108,19,3085,11,2578,1,381,126,17,4,2,1171,309,28416,3283,368102,396518,11/5/2020
10/18/2020,155,38735,4039,943567,982302,18,3103,11,2589,0,381,133,17,5,2,1173,128,28544,1336,369438,397982,11/5/2020
10/19/2020,388,39123,8487,952054,991177,21,3124,23,2612,2,383,129,15,5,1,1174,325,28869,2580,372018,400887,11/5/2020
10/20/2020,439,39562,13241,965295,1004857,22,3146,17,2629,0,383,134,14,7,3,1177,388,29257,3021,375039,404296,11/5/2020
10/21/2020,544,40106,17462,982757,1022863,21,3167,9,2638,2,385,144,15,9,3,1180,471,29728,3546,378585,408313,11/5/2020
10/22/2020,538,40644,15863,998620,1039264,24,3191,21,2659,3,388,144,14,9,3,1183,487,30215,3219,381804,412019,11/5/2020
10/23/2020,514,41158,16631,1015251,1056409,22,3213,26,2685,1,389,139,15,9,3,1186,449,30664,2904,384708,415372,11/5/2020
10/24/2020,359,41517,10248,1025499,1067016,17,3230,11,2696,0,389,145,14,8,1,1187,331,30995,2275,386983,417978,11/5/2020
10/25/2020,233,41750,4762,1030261,1072011,15,3245,15,2711,1,390,144,15,8,2,1189,206,31201,1481,388464,419665,11/5/2020
10/26/2020,454,42204,9172,1039433,1081637,25,3270,20,2731,2,392,147,18,8,3,1192,393,31594,2986,391450,423044,11/5/2020
10/27/2020,517,42721,13992,1053425,1096146,28,3298,11,2742,2,394,162,17,9,4,1196,445,32039,2406,393856,425895,11/5/2020
10/28/2020,468,43189,15229,1068654,1111843,22,3320,23,2765,1,395,160,16,9,3,1199,403,32442,2719,396575,429017,11/5/2020
10/29/2020,609,43798,16235,1084889,1128687,20,3340,18,2783,3,398,159,19,11,4,1203,528,32970,3148,399723,432693,11/5/2020
10/30/2020,544,44342,14317,1099206,1143548,21,3361,20,2803,5,403,155,19,9,4,1207,466,33436,2976,402699,436135,11/5/2020
10/31/2020,585,44927,11844,1111050,1155977,31,3392,12,2815,1,404,173,22,9,3,1210,504,33940,2427,405126,439066,11/5/2020
11/1/2020,328,45255,5073,1116123,1161378,18,3410,15,2830,1,405,175,24,12,4,1214,275,34215,1265,406391,440606,11/5/2020
11/2/2020,520,45775,9769,1125892,1171667,34,3444,27,2857,3,408,179,21,11,5,1219,452,34667,2951,409342,444009,11/5/2020
11/3/2020,600,46375,12699,1138591,1184966,28,3472,24,2881,1,409,182,20,11,1,1220,517,35184,2533,411875,447059,11/5/2020
11/4/2020,646,47021,15139,1153730,1200751,,,,,,,,,,2,1222,566,35750,2803,414678,450428,11/5/2020
2/27/2020,0,0,0,0,0,1,1,0,0,0,0,1,0,0,0,0,0,0,0,0,0,11/6/2020
2/28/2020,0,0,0,0,0,0,1,0,0,0,0,1,1,0,0,0,0,0,0,0,0,11/6/2020
2/29/2020,0,0,0,0,0,0,1,0,0,0,0,1,1,0,0,0,0,0,0,0,0,11/6/2020
3/1/2020,2,2,2,2,4,0,1,0,0,0,0,1,1,1,0,0,2,2,2,2,4,11/6/2020
3/2/2020,0,2,1,3,5,1,2,0,0,0,0,2,2,2,0,0,0,2,1,3,5,11/6/2020
3/3/2020,0,2,2,5,7,0,2,0,0,0,0,2,2,2,0,0,0,2,2,5,7,11/6/2020
3/4/2020,0,2,12,17,19,1,3,0,0,0,0,3,2,2,0,0,0,2,10,15,17,11/6/2020
3/5/2020,0,2,4,21,23,0,3,0,0,0,0,3,2,2,0,0,1,3,4,19,22,11/6/2020
3/6/2020,1,3,12,33,36,0,3,0,0,0,0,3,2,2,0,0,0,3,11,30,33,11/6/2020
3/7/2020,0,3,19,52,55,0,3,0,0,0,0,3,2,1,0,0,0,3,19,49,52,11/6/2020
3/8/2020,0,3,18,70,73,0,3,0,0,0,0,3,2,1,0,0,0,3,18,67,70,11/6/2020
3/9/2020,1,4,15,85,89,0,3,0,0,0,0,3,2,1,0,0,1,4,15,82,86,11/6/2020
3/10/2020,2,6,25,110,116,0,3,0,0,0,0,3,2,1,0,0,1,5,23,105,110,11/6/2020
3/11/2020,0,6,34,144,150,1,4,0,0,0,0,4,1,1,0,0,0,5,34,139,144,11/6/2020
3/12/2020,9,15,41,185,200,1,5,0,0,0,0,5,1,1,0,0,8,13,38,177,190,11/6/2020
3/13/2020,6,21,50,235,256,4,9,1,1,0,0,8,1,1,0,0,6,19,48,225,244,11/6/2020
3/14/2020,0,21,90,325,346,0,9,0,1,0,0,8,1,1,0,0,0,19,86,311,330,11/6/2020
3/15/2020,1,22,54,379,401,1,10,0,1,0,0,9,2,1,0,0,1,20,53,364,384,11/6/2020
3/16/2020,2,24,95,474,498,2,12,0,1,0,0,11,2,0,0,0,2,22,92,456,478,11/6/2020
3/17/2020,12,36,162,636,672,6,18,0,1,0,0,17,2,0,0,0,11,33,149,605,638,11/6/2020
3/18/2020,9,45,116,752,797,3,21,0,1,0,0,20,2,0,0,0,11,44,110,715,759,11/6/2020
3/19/2020,15,60,262,1014,1074,2,23,1,2,0,0,21,3,0,1,1,17,61,247,962,1023,11/6/2020
3/20/2020,13,73,197,1211,1284,5,28,0,2,0,0,26,4,0,0,1,13,74,188,1150,1224,11/6/2020
3/21/2020,12,85,126,1337,1422,3,31,2,4,0,0,27,5,0,0,1,14,88,122,1272,1360,11/6/2020
3/22/2020,27,112,282,1619,1731,2,33,0,4,0,0,29,5,0,0,1,25,113,258,1530,1643,11/6/2020
3/23/2020,14,126,169,1788,1914,15,48,1,5,0,0,43,9,3,0,1,16,129,162,1692,1821,11/6/2020
3/24/2020,20,146,242,2030,2176,8,56,0,5,0,0,51,10,5,0,1,19,148,232,1924,2072,11/6/2020
3/25/2020,26,172,182,2212,2384,5,61,2,7,0,0,54,11,3,0,1,28,176,168,2092,2268,11/6/2020
3/26/2020,35,207,181,2393,2600,9,70,5,12,0,0,58,14,5,0,1,41,217,170,2262,2479,11/6/2020
3/27/2020,27,234,214,2607,2841,9,79,1,13,1,1,65,17,6,2,3,31,248,198,2460,2708,11/6/2020
3/28/2020,59,293,260,2867,3160,11,90,2,15,1,2,73,15,6,1,4,64,312,240,2700,3012,11/6/2020
3/29/2020,100,393,350,3217,3610,8,98,4,19,1,3,76,17,8,2,6,105,417,310,3010,3427,11/6/2020
3/30/2020,62,455,222,3439,3894,19,117,5,24,0,3,90,18,10,3,9,78,495,183,3193,3688,11/6/2020
3/31/2020,71,526,369,3808,4334,11,128,7,31,1,4,93,20,12,2,11,73,568,294,3487,4055,11/6/2020
4/1/2020,99,625,698,4506,5131,18,146,7,38,0,4,104,28,15,1,12,100,668,630,4117,4785,11/6/2020
4/2/2020,52,677,477,4983,5660,22,168,6,44,2,6,118,34,21,4,16,62,730,430,4547,5277,11/6/2020
4/3/2020,108,785,774,5757,6542,23,191,7,51,0,6,134,41,25,3,19,100,830,699,5246,6076,11/6/2020
4/4/2020,143,928,660,6417,7345,22,213,4,55,5,11,147,40,29,9,28,138,968,608,5854,6822,11/6/2020
4/5/2020,187,1115,1156,7573,8688,20,233,9,64,1,12,157,43,35,2,30,181,1149,1046,6900,8049,11/6/2020
4/6/2020,218,1333,1706,9279,10612,26,259,6,70,0,12,177,47,39,7,37,207,1356,1525,8425,9781,11/6/2020
4/7/2020,284,1617,1629,10908,12525,20,279,4,74,2,14,191,49,41,5,42,261,1617,1465,9890,11507,11/6/2020
4/8/2020,290,1907,1720,12628,14535,19,298,7,81,6,20,197,49,37,10,52,271,1888,1526,11416,13304,11/6/2020
4/9/2020,283,2190,1516,14144,16334,32,330,8,89,4,24,217,53,40,7,59,277,2165,1341,12757,14922,11/6/2020
4/10/2020,419,2609,2574,16718,19327,29,359,17,106,5,29,224,59,41,11,70,400,2565,2332,15089,17654,11/6/2020
4/11/2020,297,2906,1905,18623,21529,29,388,11,117,2,31,240,61,48,12,82,281,2846,1694,16783,19629,11/6/2020
4/12/2020,314,3220,1670,20293,23513,35,423,13,130,5,36,257,59,49,9,91,285,3131,1409,18192,21323,11/6/2020
4/13/2020,161,3381,935,21228,24609,35,458,13,143,3,39,276,64,54,9,100,187,3318,830,19022,22340,11/6/2020
4/14/2020,289,3670,1787,23015,26685,27,485,18,161,5,44,280,72,53,8,108,262,3580,1502,20524,24104,11/6/2020
4/15/2020,351,4021,1799,24814,28835,31,516,20,181,3,47,288,72,54,17,125,306,3886,1525,22049,25935,11/6/2020
4/16/2020,447,4468,2494,27308,31776,36,552,25,206,6,53,293,72,53,14,139,387,4273,2051,24100,28373,11/6/2020
4/17/2020,304,4772,1821,29129,33901,32,584,20,226,7,60,298,66,45,21,160,290,4563,1420,25520,30083,11/6/2020
4/18/2020,321,5093,1725,30854,35947,26,610,18,244,4,64,302,63,49,15,175,284,4847,1302,26822,31669,11/6/2020
4/19/2020,381,5474,2047,32901,38375,23,633,26,270,1,65,298,65,55,11,186,337,5184,1713,28535,33719,11/6/2020
4/20/2020,394,5868,1907,34808,40676,46,679,29,299,2,67,313,75,56,10,196,376,5560,1553,30088,35648,11/6/2020
4/21/2020,444,6312,2110,36918,43230,45,724,32,331,5,72,321,72,56,18,214,383,5943,1675,31763,37706,11/6/2020
4/22/2020,418,6730,2390,39308,46038,41,765,32,363,5,77,325,73,58,18,232,379,6322,1885,33648,39970,11/6/2020
4/23/2020,479,7209,2469,41777,48986,32,797,28,391,5,82,324,76,62,15,247,412,6734,1833,35481,42215,11/6/2020
4/24/2020,491,7700,3284,45061,52761,35,832,26,417,4,86,329,85,63,15,262,407,7141,2582,38063,45204,11/6/2020
4/25/2020,393,8093,2206,47267,55360,34,866,17,434,5,91,341,85,62,14,276,300,7441,1734,39797,47238,11/6/2020
4/26/2020,316,8409,2309,49576,57985,33,899,15,449,3,94,356,86,59,14,290,274,7715,1847,41644,49359,11/6/2020
4/27/2020,249,8658,1620,51196,59854,29,928,21,470,4,98,360,86,61,10,300,206,7921,1142,42786,50707,11/6/2020
4/28/2020,410,9068,2263,53459,62527,44,972,24,494,3,101,377,88,59,22,322,332,8253,1708,44494,52747,11/6/2020
4/29/2020,476,9544,3343,56802,66346,36,1008,38,532,11,112,364,78,53,18,340,371,8624,2367,46861,55485,11/6/2020
4/30/2020,432,9976,2769,59571,69547,33,1041,38,570,6,118,353,83,57,24,364,350,8974,1873,48734,57708,11/6/2020
5/1/2020,454,10430,3086,62657,73087,51,1092,38,608,3,121,363,84,58,14,378,323,9297,2129,50863,60160,11/6/2020
5/2/2020,257,10687,1926,64583,75270,36,1128,39,647,5,126,355,93,63,24,402,192,9489,1250,52113,61602,11/6/2020
5/3/2020,283,10970,2160,66743,77713,31,1159,26,673,8,134,352,91,61,21,423,183,9672,1545,53658,63330,11/6/2020
5/4/2020,387,11357,2098,68841,80198,30,1189,31,704,6,140,345,89,58,18,441,290,9962,1535,55193,65155,11/6/2020
5/5/2020,433,11790,2873,71714,83504,29,1218,32,736,6,146,336,83,55,16,457,301,10263,1932,57125,67388,11/6/2020
5/6/2020,488,12278,2830,74544,86822,28,1246,44,780,9,155,311,80,55,21,478,340,10603,1893,59018,69621,11/6/2020
5/7/2020,425,12703,2969,77513,90216,36,1282,43,823,5,160,299,72,53,21,499,270,10873,1935,60953,71826,11/6/2020
5/8/2020,359,13062,2598,80111,93173,30,1312,29,852,5,165,295,72,54,22,521,229,11102,1713,62666,73768,11/6/2020
5/9/2020,467,13529,3346,83457,96986,22,1334,21,873,4,169,292,70,52,15,536,290,11392,2211,64877,76269,11/6/2020
5/10/2020,285,13814,2117,85574,99388,20,1354,23,896,6,175,283,71,50,14,550,189,11581,1495,66372,77953,11/6/2020
5/11/2020,257,14071,1857,87431,101502,31,1385,16,912,6,181,292,72,50,15,565,174,11755,1279,67651,79406,11/6/2020
5/12/2020,387,14458,2611,90042,104500,23,1408,18,930,4,185,293,70,49,22,587,224,11979,1653,69304,81283,11/6/2020
5/13/2020,351,14809,3630,93672,108481,23,1431,25,955,1,186,290,70,50,13,600,199,12178,1931,71235,83413,11/6/2020
5/14/2020,329,15138,3408,97080,112218,19,1450,27,982,3,189,279,65,46,15,615,232,12410,1982,73217,85627,11/6/2020
5/15/2020,381,15519,3458,100538,116057,24,1474,41,1023,5,194,257,63,46,14,629,232,12642,1778,74995,87637,11/6/2020
5/16/2020,449,15968,4156,104694,120662,25,1499,15,1038,5,199,262,62,47,15,644,247,12889,1923,76918,89807,11/6/2020
5/17/2020,240,16208,2768,107462,123670,17,1516,9,1047,5,204,265,60,46,10,654,126,13015,1524,78442,91457,11/6/2020
5/18/2020,250,16458,2001,109463,125921,19,1535,16,1063,5,209,263,58,41,18,672,135,13150,1355,79797,92947,11/6/2020
5/19/2020,415,16873,3168,112631,129504,23,1558,33,1096,5,214,248,57,39,11,683,215,13365,1906,81703,95068,11/6/2020
5/20/2020,326,17199,2771,115402,132601,19,1577,23,1119,7,221,237,53,34,22,705,183,13548,1504,83207,96755,11/6/2020
5/21/2020,374,17573,3757,119159,136732,26,1603,15,1134,3,224,245,54,30,20,725,168,13716,1916,85123,98839,11/6/2020
5/22/2020,351,17924,3161,122320,140244,20,1623,29,1163,5,229,231,53,30,11,736,206,13922,1587,86710,100632,11/6/2020
5/23/2020,253,18177,2742,125062,143239,19,1642,11,1174,3,232,236,53,33,13,749,109,14031,1257,87967,101998,11/6/2020
5/24/2020,163,18340,1370,126432,144772,13,1655,14,1188,2,234,233,54,36,8,757,83,14114,766,88733,102847,11/6/2020
5/25/2020,147,18487,1385,127817,146304,14,1669,14,1202,0,234,233,54,34,10,767,76,14190,757,89490,103680,11/6/2020
5/26/2020,285,18772,2620,130437,149209,24,1693,22,1224,5,239,230,49,33,15,782,158,14348,1763,91253,105601,11/6/2020
5/27/2020,276,19048,2057,132494,151542,20,1713,18,1242,3,242,229,51,33,10,792,132,14480,1123,92376,106856,11/6/2020
5/28/2020,348,19396,3359,135853,155249,17,1730,29,1271,4,246,213,47,32,8,800,130,14610,1107,93483,108093,11/6/2020
5/29/2020,410,19806,3915,139768,159574,19,1749,27,1298,6,252,199,43,31,12,812,174,14784,1560,95043,109827,11/6/2020
5/30/2020,225,20031,3915,143683,163714,16,1765,19,1317,4,256,192,41,29,12,824,109,14893,1800,96843,111736,11/6/2020
5/31/2020,155,20186,1690,145373,165559,11,1776,10,1327,1,257,192,44,26,3,827,78,14971,849,97692,112663,11/6/2020
6/1/2020,212,20398,2792,148165,168563,8,1784,14,1341,1,258,185,45,29,5,832,93,15064,1372,99064,114128,11/6/2020
6/2/2020,273,20671,3022,151187,171858,8,1792,10,1351,3,261,180,38,25,10,842,98,15162,1424,100488,115650,11/6/2020
6/3/2020,254,20925,3486,154673,175598,14,1806,18,1369,6,267,170,34,25,11,853,99,15261,1643,102131,117392,11/6/2020
6/4/2020,276,21201,4471,159144,180345,7,1813,26,1395,4,271,147,31,24,12,865,107,15368,2016,104147,119515,11/6/2020
6/5/2020,215,21416,3513,162657,184073,15,1828,13,1408,6,277,143,27,21,11,876,99,15467,1556,105703,121170,11/6/2020
6/6/2020,201,21617,2616,165273,186890,10,1838,7,1415,2,279,144,29,19,6,882,67,15534,1110,106813,122347,11/6/2020
6/7/2020,83,21700,1625,166898,188598,11,1849,7,1422,1,280,147,25,17,4,886,51,15585,778,107591,123176,11/6/2020
6/8/2020,119,21819,1849,168747,190566,15,1864,13,1435,2,282,147,27,18,4,890,45,15630,950,108541,124171,11/6/2020
6/9/2020,223,22042,2673,171420,193462,10,1874,19,1454,0,282,138,28,21,1,891,64,15694,1246,109787,125481,11/6/2020
6/10/2020,209,22251,2987,174407,196658,13,1887,12,1466,2,284,137,24,17,4,895,101,15795,1453,111240,127035,11/6/2020
6/11/2020,195,22446,3513,177920,200366,7,1894,15,1481,1,285,128,25,16,6,901,88,15883,1517,112757,128640,11/6/2020
6/12/2020,209,22655,4601,182521,205176,9,1903,16,1497,1,286,120,24,16,2,903,78,15961,2161,114918,130879,11/6/2020
6/13/2020,113,22768,3036,185557,208325,6,1909,5,1502,0,286,121,20,15,3,906,49,16010,1359,116277,132287,11/6/2020
6/14/2020,81,22849,2046,187603,210452,7,1916,8,1510,1,287,119,20,14,3,909,33,16043,961,117238,133281,11/6/2020
6/15/2020,188,23037,3108,190711,213748,14,1930,19,1529,0,287,114,20,16,5,914,75,16118,1773,119011,135129,11/6/2020
6/16/2020,110,23147,3017,193728,216875,11,1941,9,1538,1,288,115,22,16,8,922,50,16168,1524,120535,136703,11/6/2020
6/17/2020,127,23274,2835,196563,219837,15,1956,21,1559,4,292,105,18,14,6,928,50,16218,1302,121837,138055,11/6/2020
6/18/2020,149,23423,3048,199611,223034,9,1965,15,1574,1,293,98,19,16,7,935,70,16288,1307,123144,139432,11/6/2020
6/19/2020,141,23564,3769,203380,226944,12,1977,12,1586,1,294,97,20,17,3,938,59,16347,1350,124494,140841,11/6/2020
6/20/2020,84,23648,1891,205271,228919,9,1986,12,1598,0,294,94,20,18,4,942,36,16383,809,125303,141686,11/6/2020
6/21/2020,37,23685,1064,206335,230020,8,1994,5,1603,0,294,97,20,18,2,944,30,16413,685,125988,142401,11/6/2020
6/22/2020,138,23823,3730,210065,233888,12,2006,17,1620,0,294,92,19,18,2,946,65,16478,1694,127682,144160,11/6/2020
6/23/2020,163,23986,3831,213896,237882,3,2009,13,1633,3,297,79,18,18,7,953,82,16560,1765,129447,146007,11/6/2020
6/24/2020,120,24106,3502,217398,241504,9,2018,11,1644,1,298,76,18,18,5,958,44,16604,1671,131118,147722,11/6/2020
6/25/2020,103,24209,2883,220281,244490,6,2024,14,1658,1,299,67,17,17,1,959,50,16654,1491,132609,149263,11/6/2020
6/26/2020,94,24303,2488,222769,247072,2,2026,10,1668,0,299,59,18,18,1,960,60,16714,1316,133925,150639,11/6/2020
6/27/2020,84,24387,3216,225985,250372,5,2031,3,1671,1,300,60,17,17,5,965,37,16751,1206,135131,151882,11/6/2020
6/28/2020,39,24426,1469,227454,251880,4,2035,4,1675,4,304,56,15,14,6,971,17,16768,590,135721,152489,11/6/2020
6/29/2020,85,24511,3697,231151,255662,4,2039,5,1680,0,304,55,14,14,1,972,39,16807,1340,137061,153868,11/6/2020
6/30/2020,57,24568,1958,233109,257677,1,2040,5,1685,1,305,50,12,11,4,976,33,16840,988,138049,154889,11/6/2020
7/1/2020,144,24712,4098,237207,261919,8,2048,10,1695,0,305,48,11,11,1,977,79,16919,1913,139962,156881,11/6/2020
7/2/2020,103,24815,2803,240010,264825,5,2053,5,1700,1,306,47,10,10,3,980,59,16978,1074,141036,158014,11/6/2020
7/3/2020,50,24865,2079,242089,266954,9,2062,6,1706,0,306,50,9,9,3,983,25,17003,777,141813,158816,11/6/2020
7/4/2020,57,24922,2345,244434,269356,2,2064,4,1710,1,307,47,10,9,2,985,33,17036,998,142811,159847,11/6/2020
7/5/2020,49,24971,2932,247366,272337,1,2065,2,1712,1,308,45,8,8,2,987,26,17062,1425,144236,161298,11/6/2020
7/6/2020,101,25072,2814,250180,275252,6,2071,6,1718,0,308,45,9,9,4,991,57,17119,1534,145770,162889,11/6/2020
7/7/2020,81,25153,3457,253637,278790,5,2076,7,1725,0,308,43,8,8,2,993,47,17166,1530,147300,164466,11/6/2020
7/8/2020,105,25258,3409,257046,282304,4,2080,2,1727,0,308,45,9,8,0,993,64,17230,1414,148714,165944,11/6/2020
7/9/2020,94,25352,3714,260760,286112,9,2089,3,1730,0,308,51,9,8,0,993,50,17280,1608,150322,167602,11/6/2020
7/10/2020,132,25484,4437,265197,290681,6,2095,3,1733,2,310,52,7,7,3,996,80,17360,2061,152383,169743,11/6/2020
7/11/2020,63,25547,2938,268135,293682,6,2101,3,1736,1,311,54,6,6,3,999,36,17396,1309,153692,171088,11/6/2020
7/12/2020,47,25594,1838,269973,295567,1,2102,3,1739,1,312,51,6,5,3,1002,34,17430,936,154628,172058,11/6/2020
7/13/2020,84,25678,3209,273182,298860,8,2110,10,1749,0,312,49,6,5,1,1003,61,17491,1495,156123,173614,11/6/2020
7/14/2020,74,25752,3298,276480,302232,7,2117,4,1753,0,312,52,5,5,1,1004,44,17535,1370,157493,175028,11/6/2020
7/15/2020,130,25882,4181,280661,306543,5,2122,7,1760,0,312,50,5,4,0,1004,100,17635,1741,159234,176869,11/6/2020
7/16/2020,103,25985,3740,284401,310386,6,2128,9,1769,0,312,47,6,5,1,1005,76,17711,1607,160841,178552,11/6/2020
7/17/2020,156,26141,4239,288640,314781,14,2142,3,1772,1,313,57,5,5,2,1007,79,17790,1838,162679,180469,11/6/2020
7/18/2020,85,26226,3272,291912,318138,5,2147,9,1781,1,314,52,5,4,4,1011,70,17860,1389,164068,181928,11/6/2020
7/19/2020,82,26308,2696,294608,320916,7,2154,3,1784,0,314,56,6,4,2,1013,57,17917,1144,165212,183129,11/6/2020
7/20/2020,71,26379,2666,297274,323653,9,2163,7,1791,0,314,58,7,5,2,1015,68,17985,1446,166658,184643,11/6/2020
7/21/2020,130,26509,4304,301578,328087,9,2172,11,1802,0,314,56,9,6,1,1016,108,18093,1905,168563,186656,11/6/2020
7/22/2020,130,26639,3928,305506,332145,10,2182,11,1813,1,315,54,7,6,1,1017,86,18179,1670,170233,188412,11/6/2020
7/23/2020,141,26780,4415,309921,336701,8,2190,6,1819,0,315,56,8,7,0,1017,115,18294,1960,172193,190487,11/6/2020
7/24/2020,172,26952,5966,315887,342839,14,2204,12,1831,0,315,58,9,7,0,1017,119,18413,2303,174496,192909,11/6/2020
7/25/2020,134,27086,4398,320285,347371,7,2211,7,1838,0,315,58,10,8,3,1020,108,18521,2079,176575,195096,11/6/2020
7/26/2020,62,27148,3033,323318,350466,8,2219,9,1847,0,315,57,11,7,1,1021,54,18575,1328,177903,196478,11/6/2020
7/27/2020,188,27336,4191,327509,354845,12,2231,7,1854,0,315,62,13,8,1,1022,138,18713,2332,180235,198948,11/6/2020
7/28/2020,105,27441,3840,331349,358790,5,2236,5,1859,0,315,62,14,7,1,1023,95,18808,1626,181861,200669,11/6/2020
7/29/2020,190,27631,5139,336488,364119,11,2247,12,1871,0,315,61,15,7,0,1023,154,18962,2292,184153,203115,11/6/2020
7/30/2020,121,27752,4345,340833,368585,6,2253,2,1873,1,316,64,15,6,1,1024,97,19059,1638,185791,204850,11/6/2020
7/31/2020,131,27883,5512,346345,374228,7,2260,9,1882,0,316,62,15,7,1,1025,89,19148,1835,187626,206774,11/6/2020
8/1/2020,109,27992,4294,350639,378631,7,2267,2,1884,0,316,67,14,7,1,1026,89,19237,1549,189175,208412,11/6/2020
8/2/2020,84,28076,2804,353443,381519,12,2279,12,1896,2,318,65,14,8,2,1028,62,19299,1266,190441,209740,11/6/2020
8/3/2020,188,28264,5248,358691,386955,12,2291,11,1907,0,318,66,16,7,1,1029,150,19449,2190,192631,212080,11/6/2020
8/4/2020,125,28389,3691,362382,390771,9,2300,6,1913,1,319,68,12,5,2,1031,99,19548,1757,194388,213936,11/6/2020
8/5/2020,147,28536,5935,368317,396853,12,2312,10,1923,1,320,69,10,5,2,1033,119,19667,2450,196838,216505,11/6/2020
8/6/2020,169,28705,5546,373863,402568,7,2319,9,1932,0,320,67,9,4,0,1033,120,19787,2387,199225,219012,11/6/2020
8/7/2020,123,28828,4851,378714,407542,13,2332,10,1942,1,321,69,9,3,2,1035,87,19874,2128,201353,221227,11/6/2020
8/8/2020,123,28951,4112,382826,411777,19,2351,6,1948,1,322,81,8,3,1,1036,91,19965,1769,203122,223087,11/6/2020
8/9/2020,42,28993,1727,384553,413546,6,2357,8,1956,0,322,79,9,4,0,1036,35,20000,1064,204186,224186,11/6/2020
8/10/2020,149,29142,4587,389140,418282,9,2366,10,1966,0,322,78,9,4,1,1037,113,20113,2011,206197,226310,11/6/2020
8/11/2020,106,29248,4334,393474,422722,5,2371,13,1979,0,322,70,10,4,3,1040,92,20205,2254,208451,228656,11/6/2020
8/12/2020,121,29369,5188,398662,428031,8,2379,11,1990,0,322,67,9,3,1,1041,101,20306,2611,211062,231368,11/6/2020
8/13/2020,135,29504,4196,402858,432362,13,2392,12,2002,0,322,68,11,3,0,1041,95,20401,1892,212954,233355,11/6/2020
8/14/2020,145,29649,5498,408356,438005,13,2405,11,2013,0,322,70,11,4,3,1044,98,20499,1964,214918,235417,11/6/2020
8/15/2020,106,29755,4534,412890,442645,9,2414,11,2024,1,323,67,11,5,0,1044,88,20587,1677,216595,237182,11/6/2020
8/16/2020,83,29838,2477,415367,445205,6,2420,5,2029,4,327,64,8,4,6,1050,70,20657,957,217552,238209,11/6/2020
8/17/2020,106,29944,4575,419942,449886,8,2428,6,2035,0,327,66,8,5,2,1052,87,20744,2377,219929,240673,11/6/2020
8/18/2020,128,30072,4911,424853,454925,11,2439,8,2043,1,328,68,8,4,5,1057,94,20838,2739,222668,243506,11/6/2020
8/19/2020,113,30185,5077,429930,460115,8,2447,9,2052,1,329,66,9,5,0,1057,90,20928,2630,225298,246226,11/6/2020
8/20/2020,173,30358,7411,437341,467699,12,2459,6,2058,2,331,70,10,5,3,1060,139,21067,3496,228794,249861,11/6/2020
8/21/2020,151,30509,6577,443918,474427,8,2467,5,2063,1,332,72,9,4,2,1062,125,21192,2929,231723,252915,11/6/2020
8/22/2020,96,30605,5550,449468,480073,11,2478,12,2075,0,332,71,11,4,1,1063,84,21276,2587,234310,255586,11/6/2020
8/23/2020,71,30676,4375,453843,484519,11,2489,6,2081,0,332,76,12,2,1,1064,56,21332,2466,236776,258108,11/6/2020
8/24/2020,105,30781,5784,459627,490408,7,2496,10,2091,1,333,72,14,4,1,1065,77,21409,3140,239916,261325,11/6/2020
8/25/2020,108,30889,4764,464391,495280,11,2507,4,2095,1,334,78,12,4,1,1066,92,21501,2276,242192,263693,11/6/2020
8/26/2020,170,31059,9482,473873,504932,4,2511,8,2103,0,334,74,10,5,1,1067,127,21628,3073,245265,266893,11/6/2020
8/27/2020,92,31151,8565,482438,513589,6,2517,13,2116,1,335,66,7,5,2,1069,70,21698,3143,248408,270106,11/6/2020
8/28/2020,113,31264,7994,490432,521696,14,2531,4,2120,0,335,76,10,7,2,1071,87,21785,2421,250829,272614,11/6/2020
8/29/2020,65,31329,5374,495806,527135,6,2537,8,2128,1,336,73,11,6,2,1073,51,21836,1906,252735,274571,11/6/2020
8/30/2020,66,31395,4323,500129,531524,7,2544,4,2132,0,336,76,9,5,2,1075,48,21884,1988,254723,276607,11/6/2020
8/31/2020,105,31500,4863,504992,536492,12,2556,16,2148,0,336,72,8,4,1,1076,81,21965,2178,256901,278866,11/6/2020
9/1/2020,98,31598,7109,512101,543699,6,2562,9,2157,1,337,68,7,4,2,1078,66,22031,2368,259269,281300,11/6/2020
9/2/2020,125,31723,10529,522630,554353,9,2571,10,2167,1,338,66,8,4,2,1080,104,22135,3041,262310,284445,11/6/2020
9/3/2020,90,31813,11079,533709,565522,8,2579,8,2175,0,338,66,9,4,3,1083,73,22208,2576,264886,287094,11/6/2020
9/4/2020,103,31916,8963,542672,574588,11,2590,4,2179,0,338,73,9,4,1,1084,83,22291,2365,267251,289542,11/6/2020
9/5/2020,52,31968,6309,548981,580949,6,2596,9,2188,0,338,70,8,3,1,1085,42,22333,1596,268847,291180,11/6/2020
9/6/2020,88,32056,4325,553306,585362,4,2600,8,2196,1,339,65,6,3,1,1086,65,22398,1944,270791,293189,11/6/2020
9/7/2020,35,32091,3002,556308,588399,11,2611,3,2199,0,339,73,5,3,1,1087,26,22424,641,271432,293856,11/6/2020
9/8/2020,74,32165,6381,562689,594854,6,2617,12,2211,1,340,66,6,3,2,1089,66,22490,1585,273017,295507,11/6/2020
9/9/2020,118,32283,8650,571339,603622,10,2627,5,2216,1,341,70,9,3,1,1090,102,22592,2140,275157,297749,11/6/2020
9/10/2020,164,32447,11334,582673,615120,9,2636,8,2224,0,341,71,10,3,1,1091,111,22703,2269,277426,300129,11/6/2020
9/11/2020,120,32567,9454,592127,624694,11,2647,11,2235,0,341,71,10,5,0,1091,97,22800,1966,279392,302192,11/6/2020
9/12/2020,110,32677,6173,598300,630977,8,2655,5,2240,2,343,72,9,5,3,1094,97,22897,1518,280910,303807,11/6/2020
9/13/2020,58,32735,2716,601016,633751,4,2659,3,2243,0,343,73,10,5,0,1094,54,22951,861,281771,304722,11/6/2020
9/14/2020,104,32839,6446,607462,640301,6,2665,3,2246,2,345,74,10,5,2,1096,95,23046,1731,283502,306548,11/6/2020
9/15/2020,122,32961,8466,615928,648889,7,2672,2,2248,1,346,78,10,5,2,1098,124,23170,2191,285693,308863,11/6/2020
9/16/2020,137,33098,9715,625643,658741,7,2679,7,2255,2,348,76,9,6,5,1103,118,23288,1970,287663,310951,11/6/2020
9/17/2020,125,33223,9239,634882,668105,7,2686,15,2270,0,348,68,8,4,0,1103,154,23442,1943,289606,313048,11/6/2020
9/18/2020,132,33355,10045,644927,678282,7,2693,7,2277,1,349,67,11,6,2,1105,132,23574,1924,291530,315104,11/6/2020
9/19/2020,115,33470,8297,653224,686694,7,2700,3,2280,0,349,71,10,6,4,1109,112,23686,1690,293220,316906,11/6/2020
9/20/2020,60,33530,3676,656900,690430,7,2707,6,2286,2,351,70,9,8,4,1113,49,23735,1323,294543,318278,11/6/2020
9/21/2020,102,33632,7018,663918,697550,12,2719,3,2289,2,353,77,8,6,2,1115,94,23829,2404,296947,320776,11/6/2020
9/22/2020,154,33786,9287,673205,706991,12,2731,3,2292,1,354,85,7,5,1,1116,123,23952,2199,299146,323098,11/6/2020
9/23/2020,136,33922,10650,683855,717777,12,2743,7,2299,0,354,90,6,5,0,1116,127,24079,2211,301357,325436,11/6/2020
9/24/2020,120,34042,12479,696334,730376,7,2750,9,2308,1,355,87,7,5,1,1117,121,24200,3167,304524,328724,11/6/2020
9/25/2020,149,34191,10553,706887,741078,9,2759,10,2318,0,355,86,6,5,1,1118,142,24342,3002,307526,331868,11/6/2020
9/26/2020,146,34337,10559,717446,751783,12,2771,9,2327,0,355,89,6,5,1,1119,119,24461,2420,309946,334407,11/6/2020
9/27/2020,43,34380,2764,720210,754590,7,2778,5,2332,0,355,91,9,5,0,1119,34,24495,846,310792,335287,11/6/2020
9/28/2020,152,34532,7308,727518,762050,7,2785,7,2339,2,357,89,7,5,2,1121,134,24629,2261,313053,337682,11/6/2020
9/29/2020,208,34740,11046,738564,773304,12,2797,18,2357,1,358,82,6,6,1,1122,190,24819,2827,315880,340699,11/6/2020
9/30/2020,221,34961,12230,750794,785755,6,2803,6,2363,0,358,82,6,6,1,1123,187,25006,2596,318476,343482,11/6/2020
10/1/2020,185,35146,12503,763297,798443,17,2820,13,2376,1,359,85,6,4,2,1125,166,25172,2419,320895,346067,11/6/2020
10/2/2020,210,35356,12153,775450,810806,14,2834,13,2389,1,360,85,8,5,2,1127,182,25354,2501,323396,348750,11/6/2020
10/3/2020,157,35513,9312,784762,820275,9,2843,9,2398,2,362,83,9,4,2,1129,131,25485,2027,325423,350908,11/6/2020
10/4/2020,81,35594,2369,787131,822725,11,2854,9,2407,1,363,84,8,5,2,1131,78,25563,955,326378,351941,11/6/2020
10/5/2020,174,35768,8982,796113,831881,30,2884,11,2418,2,365,101,9,6,4,1135,160,25723,3034,329412,355135,11/6/2020
10/6/2020,177,35945,11185,807298,843243,11,2895,5,2423,0,365,107,11,7,0,1135,186,25909,2910,332322,358231,11/6/2020
10/7/2020,231,36176,12440,819738,855914,13,2908,14,2437,2,367,104,9,7,2,1137,243,26152,3542,335864,362016,11/6/2020
10/8/2020,262,36438,15233,834971,871409,17,2925,13,2450,2,369,106,7,5,4,1141,274,26426,4216,340080,366506,11/6/2020
10/9/2020,217,36655,13745,848716,885371,21,2946,12,2462,0,369,115,10,7,3,1144,199,26625,4340,344420,371045,11/6/2020
10/10/2020,229,36884,13832,862548,899432,19,2965,10,2472,1,370,123,13,7,2,1146,194,26819,3819,348239,375058,11/6/2020
10/11/2020,97,36981,3263,865811,902792,12,2977,9,2481,1,371,125,14,5,6,1152,88,26907,1167,349406,376313,11/6/2020
10/12/2020,169,37150,6439,872250,909400,19,2996,15,2496,2,373,127,14,5,4,1156,160,27067,1749,351155,378222,11/6/2020
10/13/2020,213,37363,8521,880771,918134,15,3011,15,2511,4,377,123,13,5,7,1163,207,27274,2310,353465,380739,11/6/2020
10/14/2020,322,37685,15038,895809,933494,17,3028,7,2518,0,377,133,15,5,2,1165,304,27578,4054,357519,385097,11/6/2020
10/15/2020,262,37947,14640,910449,948396,11,3039,16,2534,1,378,127,13,5,2,1167,254,27832,3593,361112,388944,11/6/2020
10/16/2020,279,38226,15011,925460,963686,13,3052,20,2554,1,379,119,13,4,2,1169,275,28107,3401,364513,392620,11/6/2020
10/17/2020,354,38580,14068,939528,978108,19,3071,11,2565,1,380,126,17,4,2,1171,309,28416,3283,367796,396212,11/6/2020
10/18/2020,155,38735,4039,943567,982302,18,3089,11,2576,0,380,133,17,6,2,1173,128,28544,1334,369130,397674,11/6/2020
10/19/2020,388,39123,8489,952056,991179,21,3110,23,2599,2,382,129,15,6,1,1174,325,28869,2576,371706,400575,11/6/2020
10/20/2020,439,39562,13241,965297,1004859,22,3132,17,2616,0,382,134,14,8,3,1177,388,29257,3020,374726,403983,11/6/2020
10/21/2020,544,40106,17462,982759,1022865,21,3153,9,2625,2,384,144,15,9,3,1180,471,29728,3543,378269,407997,11/6/2020
10/22/2020,538,40644,15863,998622,1039266,24,3177,21,2646,3,387,144,14,9,3,1183,487,30215,3215,381484,411699,11/6/2020
10/23/2020,514,41158,16631,1015253,1056411,22,3199,26,2672,1,388,139,15,9,3,1186,449,30664,2901,384385,415049,11/6/2020
10/24/2020,359,41517,10248,1025501,1067018,17,3216,11,2683,0,388,145,14,8,1,1187,331,30995,2274,386659,417654,11/6/2020
10/25/2020,233,41750,4762,1030263,1072013,15,3231,15,2698,1,389,144,15,8,2,1189,206,31201,1480,388139,419340,11/6/2020
10/26/2020,454,42204,9174,1039437,1081641,25,3256,20,2718,2,391,147,18,8,3,1192,393,31594,2985,391124,422718,11/6/2020
10/27/2020,517,42721,13992,1053429,1096150,28,3284,11,2729,2,393,162,17,9,4,1196,445,32039,2404,393528,425567,11/6/2020
10/28/2020,468,43189,15229,1068658,1111847,22,3306,23,2752,1,394,160,16,9,3,1199,403,32442,2718,396246,428688,11/6/2020
10/29/2020,609,43798,16234,1084892,1128690,20,3326,18,2770,3,397,159,19,11,4,1203,528,32970,3147,399393,432363,11/6/2020
10/30/2020,544,44342,14317,1099209,1143551,21,3347,20,2790,5,402,155,19,9,4,1207,466,33436,2974,402367,435803,11/6/2020
10/31/2020,585,44927,11844,1111053,1155980,31,3378,12,2802,1,403,173,22,9,3,1210,504,33940,2425,404792,438732,11/6/2020
11/1/2020,328,45255,5073,1116126,1161381,18,3396,15,2817,1,404,175,25,12,4,1214,275,34215,1263,406055,440270,11/6/2020
11/2/2020,520,45775,9769,1125895,1171670,34,3430,27,2844,3,407,179,22,11,5,1219,452,34667,2950,409005,443672,11/6/2020
11/3/2020,602,46377,12720,1138615,1184992,30,3460,24,2868,1,408,184,21,11,1,1220,517,35184,2538,411543,446727,11/6/2020
11/4/2020,678,47055,15810,1154425,1201480,28,3488,23,2891,2,410,187,21,12,3,1223,566,35750,2952,414495,450245,11/6/2020
11/5/2020,720,47775,15716,1170141,1217916,,,,,,,,,,1,1224,630,36380,2772,417267,453647,11/6/2020
2/27/2020,0,0,0,0,0,1,1,0,0,0,0,1,0,0,0,0,0,0,0,0,0,11/9/2020
2/28/2020,0,0,0,0,0,0,1,0,0,0,0,1,1,0,0,0,0,0,0,0,0,11/9/2020
2/29/2020,0,0,0,0,0,0,1,0,0,0,0,1,1,0,0,0,0,0,0,0,0,11/9/2020
3/1/2020,2,2,2,2,4,0,1,0,0,0,0,1,1,1,0,0,2,2,2,2,4,11/9/2020
3/2/2020,0,2,1,3,5,1,2,0,0,0,0,2,2,2,0,0,0,2,0,2,4,11/9/2020
3/3/2020,0,2,2,5,7,0,2,0,0,0,0,2,2,2,0,0,0,2,1,3,5,11/9/2020
3/4/2020,0,2,12,17,19,1,3,0,0,0,0,3,2,2,0,0,0,2,10,13,15,11/9/2020
3/5/2020,0,2,4,21,23,0,3,0,0,0,0,3,2,2,0,0,1,3,4,17,20,11/9/2020
3/6/2020,1,3,12,33,36,0,3,0,0,0,0,3,2,2,0,0,0,3,11,28,31,11/9/2020
3/7/2020,0,3,19,52,55,0,3,0,0,0,0,3,2,1,0,0,0,3,19,47,50,11/9/2020
3/8/2020,0,3,18,70,73,0,3,0,0,0,0,3,2,1,0,0,0,3,18,65,68,11/9/2020
3/9/2020,1,4,15,85,89,0,3,0,0,0,0,3,2,1,0,0,1,4,14,79,83,11/9/2020
3/10/2020,2,6,25,110,116,0,3,0,0,0,0,3,2,1,0,0,1,5,23,102,107,11/9/2020
3/11/2020,0,6,34,144,150,1,4,0,0,0,0,4,1,1,0,0,0,5,34,136,141,11/9/2020
3/12/2020,9,15,41,185,200,1,5,0,0,0,0,5,1,1,0,0,8,13,38,174,187,11/9/2020
3/13/2020,6,21,50,235,256,4,9,1,1,0,0,8,1,1,0,0,6,19,47,221,240,11/9/2020
3/14/2020,0,21,90,325,346,0,9,0,1,0,0,8,1,1,0,0,0,19,83,304,323,11/9/2020
3/15/2020,1,22,54,379,401,1,10,0,1,0,0,9,2,1,0,0,1,20,53,357,377,11/9/2020
3/16/2020,2,24,95,474,498,2,12,0,1,0,0,11,2,0,0,0,2,22,91,448,470,11/9/2020
3/17/2020,12,36,162,636,672,6,18,0,1,0,0,17,2,0,0,0,11,33,149,597,630,11/9/2020
3/18/2020,9,45,116,752,797,3,21,0,1,0,0,20,2,0,0,0,11,44,110,707,751,11/9/2020
3/19/2020,15,60,262,1014,1074,2,23,1,2,0,0,21,3,0,1,1,17,61,247,954,1015,11/9/2020
3/20/2020,13,73,197,1211,1284,5,28,0,2,0,0,26,4,0,0,1,13,74,188,1142,1216,11/9/2020
3/21/2020,12,85,126,1337,1422,3,31,2,4,0,0,27,5,0,0,1,14,88,122,1264,1352,11/9/2020
3/22/2020,27,112,282,1619,1731,2,33,0,4,0,0,29,5,0,0,1,25,113,258,1522,1635,11/9/2020
3/23/2020,14,126,169,1788,1914,15,48,1,5,0,0,43,9,3,0,1,16,129,162,1684,1813,11/9/2020
3/24/2020,20,146,242,2030,2176,8,56,0,5,0,0,51,10,5,0,1,19,148,230,1914,2062,11/9/2020
3/25/2020,26,172,182,2212,2384,5,61,2,7,0,0,54,11,3,0,1,28,176,167,2081,2257,11/9/2020
3/26/2020,35,207,181,2393,2600,9,70,5,12,0,0,58,14,5,0,1,41,217,170,2251,2468,11/9/2020
3/27/2020,27,234,214,2607,2841,9,79,1,13,1,1,65,16,6,2,3,31,248,198,2449,2697,11/9/2020
3/28/2020,59,293,260,2867,3160,10,89,2,15,1,2,72,15,6,1,4,64,312,240,2689,3001,11/9/2020
3/29/2020,100,393,350,3217,3610,8,97,3,18,1,3,76,17,8,2,6,105,417,310,2999,3416,11/9/2020
3/30/2020,62,455,222,3439,3894,19,116,5,23,0,3,90,18,10,3,9,78,495,181,3180,3675,11/9/2020
3/31/2020,71,526,369,3808,4334,11,127,7,30,1,4,93,20,12,2,11,73,568,294,3474,4042,11/9/2020
4/1/2020,99,625,698,4506,5131,18,145,7,37,0,4,104,28,15,1,12,100,668,629,4103,4771,11/9/2020
4/2/2020,52,677,477,4983,5660,22,167,6,43,2,6,118,34,21,4,16,62,730,427,4530,5260,11/9/2020
4/3/2020,108,785,774,5757,6542,23,190,7,50,0,6,134,41,25,3,19,100,830,699,5229,6059,11/9/2020
4/4/2020,143,928,660,6417,7345,22,212,4,54,5,11,147,40,29,9,28,138,968,606,5835,6803,11/9/2020
4/5/2020,187,1115,1156,7573,8688,20,232,9,63,1,12,157,43,35,2,30,181,1149,1043,6878,8027,11/9/2020
4/6/2020,218,1333,1706,9279,10612,26,258,6,69,0,12,177,47,39,7,37,207,1356,1521,8399,9755,11/9/2020
4/7/2020,284,1617,1629,10908,12525,20,278,4,73,2,14,191,49,41,5,42,261,1617,1459,9858,11475,11/9/2020
4/8/2020,290,1907,1720,12628,14535,19,297,7,80,6,20,197,49,37,10,52,271,1888,1524,11382,13270,11/9/2020
4/9/2020,283,2190,1516,14144,16334,32,329,8,88,4,24,217,53,40,7,59,277,2165,1338,12720,14885,11/9/2020
4/10/2020,419,2609,2574,16718,19327,29,358,17,105,5,29,224,59,41,11,70,400,2565,2329,15049,17614,11/9/2020
4/11/2020,297,2906,1905,18623,21529,29,387,11,116,2,31,240,61,48,12,82,281,2846,1691,16740,19586,11/9/2020
4/12/2020,314,3220,1670,20293,23513,35,422,13,129,5,36,257,59,49,9,91,285,3131,1403,18143,21274,11/9/2020
4/13/2020,161,3381,935,21228,24609,35,457,13,142,3,39,276,64,54,9,100,187,3318,828,18971,22289,11/9/2020
4/14/2020,289,3670,1787,23015,26685,27,484,18,160,5,44,280,72,53,8,108,262,3580,1498,20469,24049,11/9/2020
4/15/2020,351,4021,1799,24814,28835,31,515,20,180,3,47,288,72,54,17,125,306,3886,1521,21990,25876,11/9/2020
4/16/2020,447,4468,2494,27308,31776,36,551,25,205,6,53,293,72,53,14,139,387,4273,2043,24033,28306,11/9/2020
4/17/2020,304,4772,1821,29129,33901,32,583,20,225,7,60,298,66,45,21,160,290,4563,1418,25451,30014,11/9/2020
4/18/2020,321,5093,1725,30854,35947,26,609,18,243,4,64,302,63,49,15,175,284,4847,1300,26751,31598,11/9/2020
4/19/2020,381,5474,2047,32901,38375,23,632,26,269,1,65,298,65,55,11,186,337,5184,1707,28458,33642,11/9/2020
4/20/2020,394,5868,1907,34808,40676,46,678,29,298,2,67,313,75,56,10,196,376,5560,1550,30008,35568,11/9/2020
4/21/2020,444,6312,2110,36918,43230,45,723,32,330,5,72,321,72,56,18,214,383,5943,1672,31680,37623,11/9/2020
4/22/2020,418,6730,2390,39308,46038,41,764,32,362,5,77,325,73,58,18,232,379,6322,1880,33560,39882,11/9/2020
4/23/2020,479,7209,2469,41777,48986,32,796,28,390,5,82,324,76,62,15,247,412,6734,1829,35389,42123,11/9/2020
4/24/2020,491,7700,3284,45061,52761,35,831,26,416,4,86,329,85,63,15,262,407,7141,2571,37960,45101,11/9/2020
4/25/2020,393,8093,2206,47267,55360,34,865,17,433,5,91,341,85,62,14,276,299,7440,1731,39691,47131,11/9/2020
4/26/2020,316,8409,2309,49576,57985,33,898,15,448,3,94,356,86,59,14,290,274,7714,1845,41536,49250,11/9/2020
4/27/2020,249,8658,1620,51196,59854,29,927,21,469,4,98,360,86,61,10,300,206,7920,1140,42676,50596,11/9/2020
4/28/2020,410,9068,2263,53459,62527,44,971,24,493,3,101,377,88,59,22,322,332,8252,1699,44375,52627,11/9/2020
4/29/2020,476,9544,3343,56802,66346,36,1007,38,531,11,112,364,78,53,18,340,371,8623,2363,46738,55361,11/9/2020
4/30/2020,432,9976,2769,59571,69547,33,1040,38,569,6,118,353,83,57,24,364,350,8973,1861,48599,57572,11/9/2020
5/1/2020,454,10430,3086,62657,73087,51,1091,39,608,3,121,362,84,58,14,378,323,9296,2121,50720,60016,11/9/2020
5/2/2020,257,10687,1926,64583,75270,36,1127,38,646,5,126,355,93,63,24,402,192,9488,1247,51967,61455,11/9/2020
5/3/2020,283,10970,2160,66743,77713,31,1158,26,672,8,134,352,91,61,21,423,183,9671,1542,53509,63180,11/9/2020
5/4/2020,387,11357,2098,68841,80198,30,1188,31,703,6,140,345,89,58,18,441,290,9961,1532,55041,65002,11/9/2020
5/5/2020,433,11790,2873,71714,83504,29,1217,32,735,6,146,336,83,55,16,457,300,10261,1927,56968,67229,11/9/2020
5/6/2020,488,12278,2830,74544,86822,28,1245,44,779,9,155,311,80,55,21,478,340,10601,1892,58860,69461,11/9/2020
5/7/2020,425,12703,2969,77513,90216,36,1281,43,822,5,160,299,72,53,21,499,269,10870,1932,60792,71662,11/9/2020
5/8/2020,359,13062,2598,80111,93173,30,1311,29,851,5,165,295,72,54,22,521,229,11099,1712,62504,73603,11/9/2020
5/9/2020,467,13529,3346,83457,96986,22,1333,21,872,4,169,292,70,52,15,536,290,11389,2206,64710,76099,11/9/2020
5/10/2020,285,13814,2117,85574,99388,20,1353,23,895,6,175,283,71,50,14,550,189,11578,1490,66200,77778,11/9/2020
5/11/2020,257,14071,1857,87431,101502,31,1384,16,911,6,181,292,72,50,15,565,174,11752,1277,67477,79229,11/9/2020
5/12/2020,387,14458,2611,90042,104500,23,1407,18,929,4,185,293,70,49,22,587,224,11976,1640,69117,81093,11/9/2020
5/13/2020,351,14809,3630,93672,108481,23,1430,25,954,1,186,290,70,50,13,600,199,12175,1927,71044,83219,11/9/2020
5/14/2020,329,15138,3408,97080,112218,19,1449,27,981,3,189,279,65,46,15,615,232,12407,1970,73014,85421,11/9/2020
5/15/2020,381,15519,3458,100538,116057,24,1473,41,1022,5,194,257,63,46,14,629,232,12639,1772,74786,87425,11/9/2020
5/16/2020,449,15968,4156,104694,120662,25,1498,15,1037,5,199,262,62,47,15,644,247,12886,1913,76699,89585,11/9/2020
5/17/2020,240,16208,2768,107462,123670,17,1515,9,1046,5,204,265,60,46,10,654,126,13012,1520,78219,91231,11/9/2020
5/18/2020,250,16458,2001,109463,125921,19,1534,16,1062,5,209,263,58,41,18,672,135,13147,1354,79573,92720,11/9/2020
5/19/2020,415,16873,3168,112631,129504,23,1557,33,1095,5,214,248,57,39,11,683,215,13362,1900,81473,94835,11/9/2020
5/20/2020,326,17199,2771,115402,132601,19,1576,23,1118,7,221,237,53,34,22,705,184,13546,1499,82972,96518,11/9/2020
5/21/2020,374,17573,3757,119159,136732,25,1601,15,1133,3,224,244,54,30,20,725,168,13714,1915,84887,98601,11/9/2020
5/22/2020,351,17924,3161,122320,140244,20,1621,28,1161,5,229,231,53,30,11,736,206,13920,1583,86470,100390,11/9/2020
5/23/2020,253,18177,2742,125062,143239,19,1640,11,1172,3,232,236,53,33,13,749,109,14029,1250,87720,101749,11/9/2020
5/24/2020,163,18340,1370,126432,144772,13,1653,14,1186,2,234,233,54,36,8,757,83,14112,765,88485,102597,11/9/2020
5/25/2020,147,18487,1385,127817,146304,14,1667,14,1200,0,234,233,54,34,10,767,76,14188,755,89240,103428,11/9/2020
5/26/2020,285,18772,2620,130437,149209,24,1691,21,1221,5,239,231,49,33,15,782,158,14346,1758,90998,105344,11/9/2020
5/27/2020,276,19048,2057,132494,151542,20,1711,18,1239,3,242,230,51,33,10,792,132,14478,1120,92118,106596,11/9/2020
5/28/2020,348,19396,3359,135853,155249,17,1728,29,1268,4,246,214,47,32,8,800,130,14608,1106,93224,107832,11/9/2020
5/29/2020,410,19806,3915,139768,159574,19,1747,26,1294,7,253,200,43,31,12,812,174,14782,1555,94779,109561,11/9/2020
5/30/2020,225,20031,3915,143683,163714,16,1763,19,1313,4,257,193,41,29,12,824,109,14891,1796,96575,111466,11/9/2020
5/31/2020,155,20186,1690,145373,165559,11,1774,11,1324,1,258,192,44,26,3,827,78,14969,849,97424,112393,11/9/2020
6/1/2020,212,20398,2792,148165,168563,8,1782,14,1338,1,259,185,45,29,5,832,93,15062,1369,98793,113855,11/9/2020
6/2/2020,273,20671,3022,151187,171858,8,1790,10,1348,3,262,180,38,25,10,842,98,15160,1419,100212,115372,11/9/2020
6/3/2020,254,20925,3486,154673,175598,14,1804,18,1366,6,268,170,34,25,11,853,99,15259,1640,101852,117111,11/9/2020
6/4/2020,276,21201,4471,159144,180345,7,1811,26,1392,4,272,147,31,24,12,865,107,15366,2014,103866,119232,11/9/2020
6/5/2020,215,21416,3513,162657,184073,15,1826,13,1405,6,278,143,27,21,11,876,99,15465,1550,105416,120881,11/9/2020
6/6/2020,201,21617,2616,165273,186890,10,1836,7,1412,2,280,144,29,19,6,882,67,15532,1108,106524,122056,11/9/2020
6/7/2020,83,21700,1625,166898,188598,11,1847,7,1419,1,281,147,25,17,4,886,51,15583,777,107301,122884,11/9/2020
6/8/2020,119,21819,1849,168747,190566,15,1862,13,1432,2,283,147,27,18,4,890,45,15628,949,108250,123878,11/9/2020
6/9/2020,223,22042,2673,171420,193462,10,1872,19,1451,0,283,138,28,21,1,891,64,15692,1243,109493,125185,11/9/2020
6/10/2020,209,22251,2987,174407,196658,13,1885,12,1463,2,285,137,24,17,4,895,101,15793,1450,110943,126736,11/9/2020
6/11/2020,195,22446,3513,177920,200366,7,1892,15,1478,1,286,128,25,16,6,901,88,15881,1515,112458,128339,11/9/2020
6/12/2020,209,22655,4601,182521,205176,9,1901,16,1494,1,287,120,24,16,2,903,78,15959,2160,114618,130577,11/9/2020
6/13/2020,113,22768,3036,185557,208325,6,1907,5,1499,0,287,121,20,15,3,906,49,16008,1359,115977,131985,11/9/2020
6/14/2020,81,22849,2046,187603,210452,7,1914,8,1507,1,288,119,20,14,3,909,33,16041,960,116937,132978,11/9/2020
6/15/2020,188,23037,3108,190711,213748,14,1928,19,1526,0,288,114,20,16,5,914,75,16116,1771,118708,134824,11/9/2020
6/16/2020,110,23147,3017,193728,216875,11,1939,9,1535,1,289,115,22,16,8,922,50,16166,1520,120228,136394,11/9/2020
6/17/2020,127,23274,2835,196563,219837,15,1954,21,1556,4,293,105,18,14,6,928,50,16216,1299,121527,137743,11/9/2020
6/18/2020,149,23423,3048,199611,223034,9,1963,15,1571,1,294,98,19,16,7,935,70,16286,1306,122833,139119,11/9/2020
6/19/2020,141,23564,3769,203380,226944,12,1975,12,1583,1,295,97,20,17,3,938,59,16345,1348,124181,140526,11/9/2020
6/20/2020,84,23648,1891,205271,228919,9,1984,12,1595,0,295,94,20,18,4,942,36,16381,809,124990,141371,11/9/2020
6/21/2020,37,23685,1064,206335,230020,8,1992,5,1600,0,295,97,20,18,2,944,30,16411,685,125675,142086,11/9/2020
6/22/2020,138,23823,3730,210065,233888,12,2004,17,1617,0,295,92,19,18,2,946,65,16476,1692,127367,143843,11/9/2020
6/23/2020,163,23986,3831,213896,237882,3,2007,13,1630,3,298,79,18,18,7,953,82,16558,1763,129130,145688,11/9/2020
6/24/2020,120,24106,3502,217398,241504,9,2016,11,1641,1,299,76,18,18,5,958,44,16602,1667,130797,147399,11/9/2020
6/25/2020,103,24209,2883,220281,244490,6,2022,14,1655,1,300,67,17,17,1,959,50,16652,1489,132286,148938,11/9/2020
6/26/2020,94,24303,2488,222769,247072,2,2024,10,1665,0,300,59,18,18,1,960,60,16712,1316,133602,150314,11/9/2020
6/27/2020,84,24387,3216,225985,250372,5,2029,3,1668,1,301,60,17,17,5,965,37,16749,1202,134804,151553,11/9/2020
6/28/2020,39,24426,1469,227454,251880,4,2033,4,1672,4,305,56,15,14,6,971,17,16766,590,135394,152160,11/9/2020
6/29/2020,85,24511,3697,231151,255662,4,2037,5,1677,0,305,55,14,14,1,972,39,16805,1338,136732,153537,11/9/2020
6/30/2020,57,24568,1958,233109,257677,1,2038,5,1682,1,306,50,12,11,4,976,33,16838,988,137720,154558,11/9/2020
7/1/2020,144,24712,4098,237207,261919,8,2046,10,1692,0,306,48,11,11,1,977,79,16917,1909,139629,156546,11/9/2020
7/2/2020,103,24815,2803,240010,264825,5,2051,5,1697,1,307,47,10,10,3,980,59,16976,1074,140703,157679,11/9/2020
7/3/2020,50,24865,2079,242089,266954,9,2060,6,1703,0,307,50,9,9,3,983,25,17001,776,141479,158480,11/9/2020
7/4/2020,57,24922,2345,244434,269356,2,2062,4,1707,1,308,47,10,9,2,985,33,17034,994,142473,159507,11/9/2020
7/5/2020,49,24971,2932,247366,272337,1,2063,2,1709,1,309,45,8,8,2,987,26,17060,1425,143898,160958,11/9/2020
7/6/2020,101,25072,2814,250180,275252,6,2069,6,1715,0,309,45,9,9,4,991,57,17117,1534,145432,162549,11/9/2020
7/7/2020,81,25153,3457,253637,278790,5,2074,7,1722,0,309,43,8,8,2,993,47,17164,1529,146961,164125,11/9/2020
7/8/2020,105,25258,3409,257046,282304,4,2078,2,1724,0,309,45,9,8,0,993,64,17228,1411,148372,165600,11/9/2020
7/9/2020,94,25352,3714,260760,286112,9,2087,3,1727,0,309,51,9,8,0,993,50,17278,1604,149976,167254,11/9/2020
7/10/2020,132,25484,4437,265197,290681,6,2093,3,1730,2,311,52,7,7,3,996,80,17358,2058,152034,169392,11/9/2020
7/11/2020,63,25547,2938,268135,293682,6,2099,3,1733,1,312,54,6,6,3,999,36,17394,1308,153342,170736,11/9/2020
7/12/2020,47,25594,1838,269973,295567,1,2100,3,1736,1,313,51,6,5,3,1002,34,17428,936,154278,171706,11/9/2020
7/13/2020,84,25678,3209,273182,298860,8,2108,10,1746,0,313,49,6,5,1,1003,61,17489,1492,155770,173259,11/9/2020
7/14/2020,74,25752,3298,276480,302232,7,2115,4,1750,0,313,52,5,5,1,1004,44,17533,1366,157136,174669,11/9/2020
7/15/2020,130,25882,4181,280661,306543,5,2120,7,1757,0,313,50,5,4,0,1004,100,17633,1739,158875,176508,11/9/2020
7/16/2020,103,25985,3740,284401,310386,6,2126,9,1766,0,313,47,6,5,1,1005,76,17709,1606,160481,178190,11/9/2020
7/17/2020,156,26141,4239,288640,314781,14,2140,3,1769,1,314,57,5,5,2,1007,79,17788,1836,162317,180105,11/9/2020
7/18/2020,85,26226,3272,291912,318138,5,2145,9,1778,1,315,52,5,4,4,1011,70,17858,1386,163703,181561,11/9/2020
7/19/2020,82,26308,2696,294608,320916,7,2152,3,1781,0,315,56,6,4,2,1013,57,17915,1142,164845,182760,11/9/2020
7/20/2020,71,26379,2666,297274,323653,9,2161,7,1788,0,315,58,7,5,2,1015,68,17983,1444,166289,184272,11/9/2020
7/21/2020,130,26509,4304,301578,328087,9,2170,11,1799,0,315,56,9,6,1,1016,108,18091,1903,168192,186283,11/9/2020
7/22/2020,130,26639,3928,305506,332145,7,2177,8,1807,1,316,54,7,6,1,1017,86,18177,1666,169858,188035,11/9/2020
7/23/2020,141,26780,4415,309921,336701,8,2185,6,1813,0,316,56,8,7,0,1017,115,18292,1957,171815,190107,11/9/2020
7/24/2020,172,26952,5966,315887,342839,14,2199,12,1825,0,316,58,9,7,0,1017,119,18411,2300,174115,192526,11/9/2020
7/25/2020,134,27086,4398,320285,347371,7,2206,7,1832,0,316,58,10,8,3,1020,108,18519,2077,176192,194711,11/9/2020
7/26/2020,62,27148,3033,323318,350466,8,2214,9,1841,0,316,57,11,7,1,1021,54,18573,1327,177519,196092,11/9/2020
7/27/2020,188,27336,4191,327509,354845,12,2226,7,1848,0,316,62,13,8,1,1022,138,18711,2328,179847,198558,11/9/2020
7/28/2020,105,27441,3840,331349,358790,5,2231,5,1853,0,316,62,14,7,1,1023,95,18806,1624,181471,200277,11/9/2020
7/29/2020,190,27631,5139,336488,364119,9,2240,10,1863,0,316,61,15,7,0,1023,154,18960,2289,183760,202720,11/9/2020
7/30/2020,121,27752,4345,340833,368585,6,2246,2,1865,1,317,64,15,6,1,1024,97,19057,1634,185394,204451,11/9/2020
7/31/2020,131,27883,5512,346345,374228,7,2253,9,1874,0,317,62,15,7,1,1025,89,19146,1829,187223,206369,11/9/2020
8/1/2020,109,27992,4294,350639,378631,7,2260,2,1876,0,317,67,14,7,1,1026,89,19235,1549,188772,208007,11/9/2020
8/2/2020,84,28076,2804,353443,381519,12,2272,12,1888,2,319,65,14,8,2,1028,62,19297,1261,190033,209330,11/9/2020
8/3/2020,188,28264,5248,358691,386955,11,2283,10,1898,0,319,66,16,7,1,1029,150,19447,2186,192219,211666,11/9/2020
8/4/2020,125,28389,3691,362382,390771,8,2291,5,1903,1,320,68,12,5,2,1031,99,19546,1755,193974,213520,11/9/2020
8/5/2020,147,28536,5935,368317,396853,11,2302,9,1912,1,321,69,10,5,2,1033,119,19665,2448,196422,216087,11/9/2020
8/6/2020,169,28705,5546,373863,402568,7,2309,9,1921,0,321,67,9,4,0,1033,120,19785,2384,198806,218591,11/9/2020
8/7/2020,123,28828,4851,378714,407542,12,2321,9,1930,1,322,69,9,3,2,1035,87,19872,2124,200930,220802,11/9/2020
8/8/2020,123,28951,4112,382826,411777,19,2340,6,1936,1,323,81,8,3,1,1036,91,19963,1768,202698,222661,11/9/2020
8/9/2020,42,28993,1727,384553,413546,6,2346,8,1944,0,323,79,9,4,0,1036,35,19998,1062,203760,223758,11/9/2020
8/10/2020,149,29142,4587,389140,418282,8,2354,9,1953,0,323,78,9,4,1,1037,113,20111,2007,205767,225878,11/9/2020
8/11/2020,106,29248,4334,393474,422722,5,2359,13,1966,0,323,70,10,4,3,1040,92,20203,2253,208020,228223,11/9/2020
8/12/2020,121,29369,5188,398662,428031,8,2367,11,1977,0,323,67,9,3,1,1041,101,20304,2606,210626,230930,11/9/2020
8/13/2020,135,29504,4196,402858,432362,13,2380,12,1989,0,323,68,11,3,0,1041,95,20399,1889,212515,232914,11/9/2020
8/14/2020,145,29649,5498,408356,438005,13,2393,11,2000,0,323,70,11,4,3,1044,98,20497,1964,214479,234976,11/9/2020
8/15/2020,106,29755,4534,412890,442645,9,2402,11,2011,1,324,67,11,5,0,1044,88,20585,1674,216153,236738,11/9/2020
8/16/2020,83,29838,2477,415367,445205,6,2408,5,2016,4,328,64,8,4,6,1050,70,20655,954,217107,237762,11/9/2020
8/17/2020,106,29944,4575,419942,449886,8,2416,6,2022,0,328,66,8,5,2,1052,87,20742,2370,219477,240219,11/9/2020
8/18/2020,128,30072,4911,424853,454925,11,2427,8,2030,1,329,68,8,4,5,1057,94,20836,2737,222214,243050,11/9/2020
8/19/2020,113,30185,5077,429930,460115,8,2435,9,2039,1,330,66,9,5,0,1057,90,20926,2627,224841,245767,11/9/2020
8/20/2020,173,30358,7411,437341,467699,12,2447,6,2045,2,332,70,10,5,3,1060,139,21065,3491,228332,249397,11/9/2020
8/21/2020,151,30509,6577,443918,474427,8,2455,5,2050,1,333,72,9,4,2,1062,125,21190,2928,231260,252450,11/9/2020
8/22/2020,96,30605,5550,449468,480073,11,2466,12,2062,0,333,71,11,4,1,1063,84,21274,2582,233842,255116,11/9/2020
8/23/2020,71,30676,4375,453843,484519,11,2477,6,2068,0,333,76,12,2,1,1064,56,21330,2464,236306,257636,11/9/2020
8/24/2020,105,30781,5784,459627,490408,7,2484,10,2078,1,334,72,14,4,1,1065,77,21407,3137,239443,260850,11/9/2020
8/25/2020,108,30889,4764,464391,495280,10,2494,4,2082,1,335,77,12,4,1,1066,92,21499,2274,241717,263216,11/9/2020
8/26/2020,170,31059,9482,473873,504932,4,2498,8,2090,0,335,73,10,5,1,1067,127,21626,3070,244787,266413,11/9/2020
8/27/2020,92,31151,8565,482438,513589,6,2504,13,2103,1,336,65,7,5,2,1069,70,21696,3136,247923,269619,11/9/2020
8/28/2020,113,31264,7994,490432,521696,14,2518,4,2107,0,336,75,10,7,2,1071,87,21783,2421,250344,272127,11/9/2020
8/29/2020,65,31329,5374,495806,527135,6,2524,8,2115,1,337,72,11,6,2,1073,51,21834,1904,252248,274082,11/9/2020
8/30/2020,66,31395,4323,500129,531524,7,2531,4,2119,0,337,75,9,5,2,1075,48,21882,1986,254234,276116,11/9/2020
8/31/2020,105,31500,4863,504992,536492,12,2543,16,2135,0,337,71,8,4,1,1076,81,21963,2174,256408,278371,11/9/2020
9/1/2020,98,31598,7109,512101,543699,6,2549,9,2144,1,338,67,7,4,2,1078,66,22029,2365,258773,280802,11/9/2020
9/2/2020,125,31723,10529,522630,554353,9,2558,10,2154,1,339,65,8,4,2,1080,104,22133,3034,261807,283940,11/9/2020
9/3/2020,90,31813,11079,533709,565522,8,2566,8,2162,0,339,65,9,4,3,1083,73,22206,2573,264380,286586,11/9/2020
9/4/2020,103,31916,8963,542672,574588,11,2577,4,2166,0,339,72,9,4,1,1084,83,22289,2363,266743,289032,11/9/2020
9/5/2020,52,31968,6309,548981,580949,6,2583,9,2175,0,339,69,8,3,1,1085,42,22331,1593,268336,290667,11/9/2020
9/6/2020,88,32056,4325,553306,585362,4,2587,8,2183,1,340,64,6,3,1,1086,65,22396,1942,270278,292674,11/9/2020
9/7/2020,35,32091,3002,556308,588399,11,2598,3,2186,0,340,72,5,3,1,1087,26,22422,641,270919,293341,11/9/2020
9/8/2020,74,32165,6381,562689,594854,6,2604,12,2198,1,341,65,6,3,2,1089,66,22488,1582,272501,294989,11/9/2020
9/9/2020,118,32283,8650,571339,603622,10,2614,5,2203,1,342,69,9,3,1,1090,102,22590,2138,274639,297229,11/9/2020
9/10/2020,164,32447,11334,582673,615120,9,2623,8,2211,0,342,70,10,3,1,1091,111,22701,2264,276903,299604,11/9/2020
9/11/2020,120,32567,9454,592127,624694,11,2634,11,2222,0,342,70,10,5,0,1091,97,22798,1964,278867,301665,11/9/2020
9/12/2020,110,32677,6173,598300,630977,8,2642,5,2227,2,344,71,9,5,3,1094,97,22895,1516,280383,303278,11/9/2020
9/13/2020,58,32735,2716,601016,633751,4,2646,3,2230,0,344,72,10,5,0,1094,54,22949,861,281244,304193,11/9/2020
9/14/2020,104,32839,6446,607462,640301,6,2652,3,2233,2,346,73,10,5,2,1096,95,23044,1728,282972,306016,11/9/2020
9/15/2020,122,32961,8466,615928,648889,7,2659,2,2235,1,347,77,10,5,2,1098,124,23168,2188,285160,308328,11/9/2020
9/16/2020,137,33098,9715,625643,658741,7,2666,7,2242,2,349,75,9,6,5,1103,118,23286,1965,287125,310411,11/9/2020
9/17/2020,125,33223,9239,634882,668105,7,2673,15,2257,0,349,67,8,4,0,1103,154,23440,1942,289067,312507,11/9/2020
9/18/2020,132,33355,10045,644927,678282,7,2680,7,2264,1,350,66,11,6,2,1105,132,23572,1922,290989,314561,11/9/2020
9/19/2020,115,33470,8297,653224,686694,7,2687,3,2267,0,350,70,10,6,4,1109,112,23684,1688,292677,316361,11/9/2020
9/20/2020,60,33530,3676,656900,690430,7,2694,6,2273,2,352,69,9,8,4,1113,49,23733,1322,293999,317732,11/9/2020
9/21/2020,102,33632,7018,663918,697550,12,2706,3,2276,2,354,76,8,6,2,1115,94,23827,2401,296400,320227,11/9/2020
9/22/2020,154,33786,9287,673205,706991,12,2718,3,2279,1,355,84,7,5,1,1116,123,23950,2199,298599,322549,11/9/2020
9/23/2020,136,33922,10650,683855,717777,12,2730,7,2286,0,355,89,6,5,0,1116,127,24077,2211,300810,324887,11/9/2020
9/24/2020,120,34042,12479,696334,730376,7,2737,9,2295,1,356,86,7,5,1,1117,121,24198,3162,303972,328170,11/9/2020
9/25/2020,149,34191,10553,706887,741078,9,2746,10,2305,0,356,85,6,5,1,1118,142,24340,3000,306972,331312,11/9/2020
9/26/2020,146,34337,10559,717446,751783,12,2758,9,2314,0,356,88,6,5,1,1119,119,24459,2417,309389,333848,11/9/2020
9/27/2020,43,34380,2764,720210,754590,7,2765,5,2319,0,356,90,9,5,0,1119,34,24493,845,310234,334727,11/9/2020
9/28/2020,152,34532,7308,727518,762050,7,2772,7,2326,2,358,88,7,5,2,1121,134,24627,2259,312493,337120,11/9/2020
9/29/2020,208,34740,11046,738564,773304,12,2784,18,2344,1,359,81,6,6,1,1122,190,24817,2823,315316,340133,11/9/2020
9/30/2020,221,34961,12230,750794,785755,6,2790,6,2350,0,359,81,6,6,1,1123,187,25004,2593,317909,342913,11/9/2020
10/1/2020,185,35146,12503,763297,798443,17,2807,13,2363,1,360,84,6,4,2,1125,166,25170,2412,320321,345491,11/9/2020
10/2/2020,210,35356,12153,775450,810806,14,2821,13,2376,1,361,84,8,5,2,1127,182,25352,2499,322820,348172,11/9/2020
10/3/2020,157,35513,9312,784762,820275,9,2830,9,2385,2,363,82,9,4,2,1129,131,25483,2023,324843,350326,11/9/2020
10/4/2020,81,35594,2369,787131,822725,11,2841,9,2394,1,364,83,8,5,2,1131,78,25561,954,325797,351358,11/9/2020
10/5/2020,174,35768,8982,796113,831881,30,2871,11,2405,2,366,100,9,6,4,1135,160,25721,3033,328830,354551,11/9/2020
10/6/2020,177,35945,11185,807298,843243,11,2882,5,2410,0,366,106,11,7,0,1135,186,25907,2904,331734,357641,11/9/2020
10/7/2020,231,36176,12440,819738,855914,13,2895,14,2424,2,368,103,9,7,2,1137,244,26151,3541,335275,361426,11/9/2020
10/8/2020,262,36438,15233,834971,871409,17,2912,13,2437,2,370,105,7,5,4,1141,274,26425,4212,339487,365912,11/9/2020
10/9/2020,217,36655,13745,848716,885371,21,2933,12,2449,0,370,114,10,7,3,1144,199,26624,4333,343820,370444,11/9/2020
10/10/2020,229,36884,13832,862548,899432,19,2952,10,2459,1,371,122,13,7,2,1146,194,26818,3810,347630,374448,11/9/2020
10/11/2020,97,36981,3263,865811,902792,12,2964,9,2468,1,372,124,14,5,6,1152,88,26906,1166,348796,375702,11/9/2020
10/12/2020,169,37150,6439,872250,909400,19,2983,15,2483,2,374,126,14,5,4,1156,159,27065,1747,350543,377608,11/9/2020
10/13/2020,213,37363,8521,880771,918134,15,2998,15,2498,4,378,122,13,5,7,1163,208,27273,2310,352853,380126,11/9/2020
10/14/2020,322,37685,15038,895809,933494,17,3015,7,2505,0,378,132,15,5,2,1165,304,27577,4045,356898,384475,11/9/2020
10/15/2020,262,37947,14640,910449,948396,11,3026,16,2521,1,379,126,13,5,2,1167,254,27831,3590,360488,388319,11/9/2020
10/16/2020,279,38226,15011,925460,963686,13,3039,20,2541,1,380,118,13,4,2,1169,275,28106,3396,363884,391990,11/9/2020
10/17/2020,354,38580,14068,939528,978108,19,3058,11,2552,1,381,125,17,4,2,1171,310,28416,3274,367158,395574,11/9/2020
10/18/2020,155,38735,4039,943567,982302,18,3076,11,2563,0,381,132,17,6,2,1173,129,28545,1329,368487,397032,11/9/2020
10/19/2020,388,39123,8489,952056,991179,21,3097,23,2586,2,383,128,15,6,1,1174,325,28870,2573,371060,399930,11/9/2020
10/20/2020,439,39562,13241,965297,1004859,22,3119,17,2603,0,383,133,14,8,3,1177,387,29257,3018,374078,403335,11/9/2020
10/21/2020,544,40106,17462,982759,1022865,21,3140,9,2612,2,385,143,15,9,3,1180,470,29727,3533,377611,407338,11/9/2020
10/22/2020,538,40644,15863,998622,1039266,24,3164,21,2633,3,388,143,14,9,3,1183,487,30214,3209,380820,411034,11/9/2020
10/23/2020,514,41158,16631,1015253,1056411,22,3186,26,2659,1,389,138,15,9,3,1186,453,30667,2897,383717,414384,11/9/2020
10/24/2020,359,41517,10248,1025501,1067018,17,3203,11,2670,0,389,144,14,8,1,1187,330,30997,2272,385989,416986,11/9/2020
10/25/2020,233,41750,4762,1030263,1072013,16,3219,15,2685,1,390,144,15,8,2,1189,205,31202,1476,387465,418667,11/9/2020
10/26/2020,454,42204,9174,1039437,1081641,25,3244,20,2705,2,392,147,18,8,3,1192,396,31598,2981,390446,422044,11/9/2020
10/27/2020,517,42721,13992,1053429,1096150,28,3272,11,2716,2,394,162,17,9,4,1196,452,32050,2402,392848,424898,11/9/2020
10/28/2020,468,43189,15229,1068658,1111847,22,3294,23,2739,1,395,160,16,9,3,1199,404,32454,2715,395563,428017,11/9/2020
10/29/2020,609,43798,16234,1084892,1128690,20,3314,18,2757,3,398,159,19,11,4,1203,529,32983,3147,398710,431693,11/9/2020
10/30/2020,544,44342,14318,1099210,1143552,21,3335,20,2777,5,403,155,19,9,4,1207,464,33447,2964,401674,435121,11/9/2020
10/31/2020,585,44927,11843,1111053,1155980,31,3366,12,2789,1,404,173,22,9,3,1210,488,33935,2421,404095,438030,11/9/2020
11/1/2020,328,45255,5073,1116126,1161381,19,3385,15,2804,1,405,176,25,12,4,1214,271,34206,1261,405356,439562,11/9/2020
11/2/2020,520,45775,9914,1126040,1171815,34,3419,27,2831,3,408,180,22,11,5,1219,453,34659,2944,408300,442959,11/9/2020
11/3/2020,603,46378,13058,1139098,1185476,30,3449,24,2855,1,409,185,21,11,1,1220,528,35187,2541,410841,446028,11/9/2020
11/4/2020,679,47057,16119,1155217,1202274,32,3481,23,2878,2,411,192,21,11,3,1223,632,35819,2950,413791,449610,11/9/2020
11/5/2020,757,47814,18879,1174096,1221910,44,3525,32,2910,1,412,203,20,13,3,1226,669,36488,5184,418975,455463,11/9/2020
11/6/2020,774,48588,17140,1191236,1239824,33,3558,25,2935,1,413,210,25,16,5,1231,687,37175,4365,423340,460515,11/9/2020
11/7/2020,604,49192,13236,1204472,1253664,26,3584,23,2958,1,414,212,27,17,1,1232,568,37743,2501,425841,463584,11/9/2020
11/8/2020,304,49496,3671,1208143,1257639,,,,,,,,,,1,1233,266,38009,1181,427022,465031,11/9/2020
2/27/2020,0,0,0,0,0,1,1,0,0,0,0,1,0,0,0,0,0,0,0,0,0,11/10/2020
2/28/2020,0,0,0,0,0,0,1,0,0,0,0,1,1,0,0,0,0,0,0,0,0,11/10/2020
2/29/2020,0,0,0,0,0,0,1,0,0,0,0,1,1,0,0,0,0,0,0,0,0,11/10/2020
3/1/2020,2,2,2,2,4,0,1,0,0,0,0,1,1,1,0,0,2,2,2,2,4,11/10/2020
3/2/2020,0,2,1,3,5,1,2,0,0,0,0,2,2,2,0,0,0,2,0,2,4,11/10/2020
3/3/2020,0,2,2,5,7,0,2,0,0,0,0,2,2,2,0,0,0,2,1,3,5,11/10/2020
3/4/2020,0,2,12,17,19,1,3,0,0,0,0,3,2,2,0,0,0,2,10,13,15,11/10/2020
3/5/2020,0,2,4,21,23,0,3,0,0,0,0,3,2,2,0,0,1,3,4,17,20,11/10/2020
3/6/2020,1,3,12,33,36,0,3,0,0,0,0,3,2,2,0,0,0,3,11,28,31,11/10/2020
3/7/2020,0,3,19,52,55,0,3,0,0,0,0,3,2,1,0,0,0,3,19,47,50,11/10/2020
3/8/2020,0,3,18,70,73,0,3,0,0,0,0,3,2,1,0,0,0,3,18,65,68,11/10/2020
3/9/2020,1,4,15,85,89,0,3,0,0,0,0,3,2,1,0,0,1,4,14,79,83,11/10/2020
3/10/2020,2,6,25,110,116,0,3,0,0,0,0,3,2,1,0,0,1,5,23,102,107,11/10/2020
3/11/2020,0,6,34,144,150,1,4,0,0,0,0,4,1,1,0,0,0,5,34,136,141,11/10/2020
3/12/2020,9,15,41,185,200,1,5,0,0,0,0,5,1,1,0,0,8,13,38,174,187,11/10/2020
3/13/2020,6,21,50,235,256,4,9,1,1,0,0,8,1,1,0,0,6,19,47,221,240,11/10/2020
3/14/2020,0,21,90,325,346,0,9,0,1,0,0,8,1,1,0,0,0,19,83,304,323,11/10/2020
3/15/2020,1,22,54,379,401,1,10,0,1,0,0,9,2,1,0,0,1,20,53,357,377,11/10/2020
3/16/2020,2,24,95,474,498,2,12,0,1,0,0,11,2,0,0,0,2,22,91,448,470,11/10/2020
3/17/2020,12,36,162,636,672,6,18,0,1,0,0,17,2,0,0,0,11,33,149,597,630,11/10/2020
3/18/2020,9,45,116,752,797,3,21,0,1,0,0,20,2,0,0,0,11,44,110,707,751,11/10/2020
3/19/2020,15,60,262,1014,1074,2,23,1,2,0,0,21,3,0,1,1,17,61,247,954,1015,11/10/2020
3/20/2020,13,73,197,1211,1284,5,28,0,2,0,0,26,4,0,0,1,13,74,187,1141,1215,11/10/2020
3/21/2020,12,85,126,1337,1422,3,31,2,4,0,0,27,5,0,0,1,14,88,122,1263,1351,11/10/2020
3/22/2020,27,112,282,1619,1731,2,33,0,4,0,0,29,5,0,0,1,25,113,258,1521,1634,11/10/2020
3/23/2020,14,126,169,1788,1914,15,48,1,5,0,0,43,9,3,0,1,16,129,162,1683,1812,11/10/2020
3/24/2020,20,146,242,2030,2176,8,56,0,5,0,0,51,10,5,0,1,19,148,230,1913,2061,11/10/2020
3/25/2020,26,172,182,2212,2384,5,61,2,7,0,0,54,11,3,0,1,28,176,166,2079,2255,11/10/2020
3/26/2020,35,207,181,2393,2600,9,70,5,12,0,0,58,14,5,0,1,41,217,170,2249,2466,11/10/2020
3/27/2020,27,234,214,2607,2841,9,79,1,13,1,1,65,16,6,2,3,31,248,198,2447,2695,11/10/2020
3/28/2020,59,293,260,2867,3160,11,90,2,15,1,2,73,15,6,1,4,64,312,240,2687,2999,11/10/2020
3/29/2020,100,393,350,3217,3610,8,98,3,18,1,3,77,18,8,2,6,105,417,310,2997,3414,11/10/2020
3/30/2020,62,455,222,3439,3894,19,117,5,23,0,3,91,19,11,3,9,78,495,181,3178,3673,11/10/2020
3/31/2020,71,526,369,3808,4334,11,128,7,30,1,4,94,21,13,2,11,73,568,294,3472,4040,11/10/2020
4/1/2020,99,625,698,4506,5131,18,146,7,37,0,4,105,29,15,1,12,100,668,628,4100,4768,11/10/2020
4/2/2020,52,677,477,4983,5660,22,168,6,43,2,6,119,35,21,4,16,62,730,426,4526,5256,11/10/2020
4/3/2020,108,785,774,5757,6542,23,191,7,50,0,6,135,42,25,3,19,100,830,697,5223,6053,11/10/2020
4/4/2020,143,928,660,6417,7345,22,213,4,54,5,11,148,40,29,9,28,138,968,606,5829,6797,11/10/2020
4/5/2020,187,1115,1156,7573,8688,20,233,9,63,1,12,158,43,35,2,30,181,1149,1043,6872,8021,11/10/2020
4/6/2020,218,1333,1706,9279,10612,26,259,7,70,0,12,177,47,39,7,37,207,1356,1521,8393,9749,11/10/2020
4/7/2020,284,1617,1629,10908,12525,20,279,4,74,2,14,191,49,41,5,42,261,1617,1459,9852,11469,11/10/2020
4/8/2020,290,1907,1720,12628,14535,19,298,7,81,6,20,197,49,37,10,52,271,1888,1524,11376,13264,11/10/2020
4/9/2020,283,2190,1516,14144,16334,32,330,8,89,4,24,217,53,40,7,59,277,2165,1335,12711,14876,11/10/2020
4/10/2020,419,2609,2574,16718,19327,29,359,17,106,5,29,224,59,41,11,70,400,2565,2329,15040,17605,11/10/2020
4/11/2020,297,2906,1905,18623,21529,29,388,11,117,2,31,240,61,48,12,82,281,2846,1690,16730,19576,11/10/2020
4/12/2020,314,3220,1670,20293,23513,35,423,13,130,5,36,257,59,49,9,91,285,3131,1403,18133,21264,11/10/2020
4/13/2020,161,3381,935,21228,24609,35,458,13,143,3,39,276,64,54,9,100,187,3318,828,18961,22279,11/10/2020
4/14/2020,289,3670,1787,23015,26685,27,485,18,161,5,44,280,72,53,8,108,262,3580,1497,20458,24038,11/10/2020
4/15/2020,351,4021,1799,24814,28835,31,516,20,181,3,47,288,72,54,17,125,306,3886,1520,21978,25864,11/10/2020
4/16/2020,447,4468,2494,27308,31776,36,552,25,206,6,53,293,72,53,14,139,387,4273,2042,24020,28293,11/10/2020
4/17/2020,304,4772,1821,29129,33901,32,584,20,226,7,60,298,66,45,21,160,290,4563,1417,25437,30000,11/10/2020
4/18/2020,321,5093,1725,30854,35947,26,610,18,244,4,64,302,63,49,15,175,284,4847,1300,26737,31584,11/10/2020
4/19/2020,381,5474,2047,32901,38375,23,633,26,270,1,65,298,65,55,11,186,337,5184,1703,28440,33624,11/10/2020
4/20/2020,394,5868,1907,34808,40676,46,679,29,299,2,67,313,75,56,10,196,376,5560,1548,29988,35548,11/10/2020
4/21/2020,444,6312,2110,36918,43230,45,724,32,331,5,72,321,72,56,18,214,383,5943,1671,31659,37602,11/10/2020
4/22/2020,418,6730,2390,39308,46038,41,765,32,363,5,77,325,73,58,18,232,379,6322,1879,33538,39860,11/10/2020
4/23/2020,479,7209,2469,41777,48986,32,797,28,391,5,82,324,76,62,15,247,412,6734,1829,35367,42101,11/10/2020
4/24/2020,491,7700,3284,45061,52761,35,832,26,417,4,86,329,85,63,15,262,407,7141,2570,37937,45078,11/10/2020
4/25/2020,393,8093,2206,47267,55360,34,866,17,434,5,91,341,85,62,14,276,299,7440,1731,39668,47108,11/10/2020
4/26/2020,316,8409,2309,49576,57985,33,899,15,449,3,94,356,86,59,14,290,274,7714,1842,41510,49224,11/10/2020
4/27/2020,249,8658,1620,51196,59854,29,928,21,470,4,98,360,86,61,10,300,206,7920,1139,42649,50569,11/10/2020
4/28/2020,410,9068,2263,53459,62527,44,972,24,494,3,101,377,88,59,22,322,332,8252,1695,44344,52596,11/10/2020
4/29/2020,476,9544,3343,56802,66346,36,1008,38,532,11,112,364,78,53,18,340,370,8622,2347,46691,55313,11/10/2020
4/30/2020,432,9976,2769,59571,69547,33,1041,38,570,6,118,353,83,57,24,364,349,8971,1856,48547,57518,11/10/2020
5/1/2020,454,10430,3086,62657,73087,51,1092,39,609,3,121,362,84,58,14,378,323,9294,2117,50664,59958,11/10/2020
5/2/2020,257,10687,1926,64583,75270,36,1128,38,647,5,126,355,93,63,24,402,192,9486,1247,51911,61397,11/10/2020
5/3/2020,283,10970,2160,66743,77713,31,1159,27,674,8,134,351,91,61,21,423,183,9669,1540,53451,63120,11/10/2020
5/4/2020,387,11357,2098,68841,80198,30,1189,31,705,5,139,345,89,58,18,441,290,9959,1531,54982,64941,11/10/2020
5/5/2020,433,11790,2873,71714,83504,29,1218,32,737,6,145,336,83,55,16,457,300,10259,1927,56909,67168,11/10/2020
5/6/2020,488,12278,2830,74544,86822,28,1246,44,781,9,154,311,80,55,21,478,340,10599,1891,58800,69399,11/10/2020
5/7/2020,425,12703,2969,77513,90216,36,1282,43,824,5,159,299,72,53,21,499,269,10868,1931,60731,71599,11/10/2020
5/8/2020,359,13062,2598,80111,93173,30,1312,29,853,5,164,295,72,54,22,521,229,11097,1710,62441,73538,11/10/2020
5/9/2020,467,13529,3346,83457,96986,22,1334,21,874,4,168,292,70,52,15,536,290,11387,2204,64645,76032,11/10/2020
5/10/2020,285,13814,2117,85574,99388,20,1354,23,897,6,174,283,71,50,14,550,189,11576,1490,66135,77711,11/10/2020
5/11/2020,257,14071,1857,87431,101502,31,1385,16,913,6,180,292,72,50,15,565,174,11750,1276,67411,79161,11/10/2020
5/12/2020,387,14458,2611,90042,104500,23,1408,18,931,4,184,293,70,49,22,587,224,11974,1640,69051,81025,11/10/2020
5/13/2020,351,14809,3630,93672,108481,23,1431,25,956,1,185,290,70,50,13,600,199,12173,1926,70977,83150,11/10/2020
5/14/2020,329,15138,3408,97080,112218,19,1450,27,983,3,188,279,65,46,15,615,232,12405,1968,72945,85350,11/10/2020
5/15/2020,381,15519,3458,100538,116057,24,1474,41,1024,5,193,257,63,46,14,629,232,12637,1772,74717,87354,11/10/2020
5/16/2020,449,15968,4156,104694,120662,25,1499,15,1039,5,198,262,62,47,15,644,247,12884,1911,76628,89512,11/10/2020
5/17/2020,240,16208,2768,107462,123670,17,1516,9,1048,5,203,265,60,46,10,654,126,13010,1518,78146,91156,11/10/2020
5/18/2020,250,16458,2001,109463,125921,19,1535,16,1064,5,208,263,58,41,18,672,135,13145,1352,79498,92643,11/10/2020
5/19/2020,415,16873,3168,112631,129504,23,1558,33,1097,5,213,248,57,39,11,683,215,13360,1897,81395,94755,11/10/2020
5/20/2020,326,17199,2771,115402,132601,19,1577,23,1120,7,220,237,53,34,22,705,184,13544,1499,82894,96438,11/10/2020
5/21/2020,374,17573,3757,119159,136732,25,1602,15,1135,3,223,244,54,30,20,725,168,13712,1913,84807,98519,11/10/2020
5/22/2020,351,17924,3161,122320,140244,20,1622,28,1163,5,228,231,53,30,11,736,206,13918,1579,86386,100304,11/10/2020
5/23/2020,253,18177,2742,125062,143239,19,1641,11,1174,3,231,236,53,33,13,749,109,14027,1250,87636,101663,11/10/2020
5/24/2020,163,18340,1370,126432,144772,13,1654,14,1188,2,233,233,54,36,8,757,83,14110,765,88401,102511,11/10/2020
5/25/2020,147,18487,1385,127817,146304,14,1668,14,1202,0,233,233,54,34,10,767,76,14186,754,89155,103341,11/10/2020
5/26/2020,285,18772,2620,130437,149209,24,1692,21,1223,5,238,231,49,33,15,782,158,14344,1756,90911,105255,11/10/2020
5/27/2020,276,19048,2057,132494,151542,20,1712,18,1241,3,241,230,51,33,10,792,132,14476,1119,92030,106506,11/10/2020
5/28/2020,348,19396,3359,135853,155249,17,1729,29,1270,4,245,214,47,32,8,800,130,14606,1106,93136,107742,11/10/2020
5/29/2020,410,19806,3915,139768,159574,19,1748,26,1296,7,252,200,43,31,12,812,174,14780,1554,94690,109470,11/10/2020
5/30/2020,225,20031,3915,143683,163714,16,1764,19,1315,4,256,193,41,29,12,824,109,14889,1793,96483,111372,11/10/2020
5/31/2020,155,20186,1690,145373,165559,11,1775,11,1326,1,257,192,44,26,3,827,78,14967,848,97331,112298,11/10/2020
6/1/2020,212,20398,2792,148165,168563,8,1783,14,1340,1,258,185,45,29,5,832,93,15060,1368,98699,113759,11/10/2020
6/2/2020,273,20671,3022,151187,171858,8,1791,10,1350,3,261,180,38,25,10,842,98,15158,1418,100117,115275,11/10/2020
6/3/2020,254,20925,3486,154673,175598,14,1805,18,1368,6,267,170,34,25,11,853,99,15257,1640,101757,117014,11/10/2020
6/4/2020,276,21201,4471,159144,180345,7,1812,26,1394,4,271,147,31,24,12,865,107,15364,2012,103769,119133,11/10/2020
6/5/2020,215,21416,3513,162657,184073,15,1827,13,1407,6,277,143,27,21,11,876,99,15463,1548,105317,120780,11/10/2020
6/6/2020,201,21617,2616,165273,186890,10,1837,7,1414,2,279,144,29,19,6,882,67,15530,1108,106425,121955,11/10/2020
6/7/2020,83,21700,1625,166898,188598,11,1848,7,1421,1,280,147,25,17,4,886,51,15581,777,107202,122783,11/10/2020
6/8/2020,119,21819,1849,168747,190566,15,1863,13,1434,2,282,147,27,18,4,890,45,15626,949,108151,123777,11/10/2020
6/9/2020,223,22042,2673,171420,193462,10,1873,19,1453,0,282,138,28,21,1,891,64,15690,1241,109392,125082,11/10/2020
6/10/2020,209,22251,2987,174407,196658,13,1886,12,1465,2,284,137,24,17,4,895,101,15791,1448,110840,126631,11/10/2020
6/11/2020,195,22446,3513,177920,200366,7,1893,15,1480,1,285,128,25,16,6,901,88,15879,1514,112354,128233,11/10/2020
6/12/2020,209,22655,4601,182521,205176,9,1902,16,1496,1,286,120,24,16,2,903,78,15957,2157,114511,130468,11/10/2020
6/13/2020,113,22768,3036,185557,208325,6,1908,5,1501,0,286,121,20,15,3,906,49,16006,1359,115870,131876,11/10/2020
6/14/2020,81,22849,2046,187603,210452,7,1915,8,1509,1,287,119,20,14,3,909,33,16039,960,116830,132869,11/10/2020
6/15/2020,188,23037,3108,190711,213748,14,1929,19,1528,0,287,114,20,16,5,914,75,16114,1766,118596,134710,11/10/2020
6/16/2020,110,23147,3017,193728,216875,11,1940,9,1537,1,288,115,22,16,8,922,50,16164,1520,120116,136280,11/10/2020
6/17/2020,127,23274,2835,196563,219837,15,1955,21,1558,4,292,105,18,14,6,928,50,16214,1295,121411,137625,11/10/2020
6/18/2020,149,23423,3048,199611,223034,9,1964,15,1573,1,293,98,19,16,7,935,70,16284,1305,122716,139000,11/10/2020
6/19/2020,141,23564,3769,203380,226944,12,1976,12,1585,1,294,97,20,17,3,938,59,16343,1345,124061,140404,11/10/2020
6/20/2020,84,23648,1891,205271,228919,9,1985,12,1597,0,294,94,20,18,4,942,36,16379,808,124869,141248,11/10/2020
6/21/2020,37,23685,1064,206335,230020,8,1993,5,1602,0,294,97,20,18,2,944,30,16409,685,125554,141963,11/10/2020
6/22/2020,138,23823,3730,210065,233888,12,2005,17,1619,0,294,92,19,18,2,946,65,16474,1690,127244,143718,11/10/2020
6/23/2020,163,23986,3831,213896,237882,3,2008,13,1632,3,297,79,18,18,7,953,81,16555,1763,129007,145562,11/10/2020
6/24/2020,120,24106,3502,217398,241504,9,2017,11,1643,1,298,76,18,18,5,958,44,16599,1666,130673,147272,11/10/2020
6/25/2020,103,24209,2883,220281,244490,6,2023,14,1657,1,299,67,17,17,1,959,50,16649,1487,132160,148809,11/10/2020
6/26/2020,94,24303,2488,222769,247072,2,2025,10,1667,0,299,59,18,18,1,960,60,16709,1313,133473,150182,11/10/2020
6/27/2020,84,24387,3216,225985,250372,5,2030,3,1670,1,300,60,17,17,5,965,37,16746,1200,134673,151419,11/10/2020
6/28/2020,39,24426,1469,227454,251880,4,2034,4,1674,4,304,56,15,14,6,971,17,16763,589,135262,152025,11/10/2020
6/29/2020,85,24511,3697,231151,255662,4,2038,5,1679,0,304,55,14,14,1,972,39,16802,1337,136599,153401,11/10/2020
6/30/2020,57,24568,1958,233109,257677,1,2039,5,1684,1,305,50,12,11,4,976,33,16835,988,137587,154422,11/10/2020
7/1/2020,144,24712,4098,237207,261919,8,2047,10,1694,0,305,48,11,11,1,977,79,16914,1908,139495,156409,11/10/2020
7/2/2020,103,24815,2803,240010,264825,5,2052,5,1699,1,306,47,10,10,3,980,59,16973,1074,140569,157542,11/10/2020
7/3/2020,50,24865,2079,242089,266954,9,2061,6,1705,0,306,50,9,9,3,983,25,16998,776,141345,158343,11/10/2020
7/4/2020,57,24922,2345,244434,269356,2,2063,4,1709,1,307,47,10,9,2,985,33,17031,992,142337,159368,11/10/2020
7/5/2020,49,24971,2932,247366,272337,1,2064,2,1711,1,308,45,8,8,2,987,26,17057,1425,143762,160819,11/10/2020
7/6/2020,101,25072,2814,250180,275252,6,2070,6,1717,0,308,45,9,9,4,991,57,17114,1534,145296,162410,11/10/2020
7/7/2020,81,25153,3457,253637,278790,5,2075,7,1724,0,308,43,8,8,2,993,47,17161,1527,146823,163984,11/10/2020
7/8/2020,105,25258,3409,257046,282304,4,2079,2,1726,0,308,45,9,8,0,993,64,17225,1404,148227,165452,11/10/2020
7/9/2020,94,25352,3714,260760,286112,9,2088,3,1729,0,308,51,9,8,0,993,50,17275,1603,149830,167105,11/10/2020
7/10/2020,132,25484,4437,265197,290681,6,2094,3,1732,2,310,52,7,7,3,996,80,17355,2056,151886,169241,11/10/2020
7/11/2020,63,25547,2938,268135,293682,6,2100,3,1735,1,311,54,6,6,3,999,36,17391,1307,153193,170584,11/10/2020
7/12/2020,47,25594,1838,269973,295567,1,2101,3,1738,1,312,51,6,5,3,1002,34,17425,935,154128,171553,11/10/2020
7/13/2020,84,25678,3209,273182,298860,8,2109,10,1748,0,312,49,6,5,1,1003,61,17486,1492,155620,173106,11/10/2020
7/14/2020,74,25752,3298,276480,302232,7,2116,4,1752,0,312,52,5,5,1,1004,44,17530,1365,156985,174515,11/10/2020
7/15/2020,130,25882,4181,280661,306543,5,2121,7,1759,0,312,50,5,4,0,1004,100,17630,1737,158722,176352,11/10/2020
7/16/2020,103,25985,3740,284401,310386,6,2127,9,1768,0,312,47,6,5,1,1005,76,17706,1606,160328,178034,11/10/2020
7/17/2020,156,26141,4239,288640,314781,14,2141,3,1771,1,313,57,5,5,2,1007,79,17785,1834,162162,179947,11/10/2020
7/18/2020,85,26226,3272,291912,318138,5,2146,9,1780,1,314,52,5,4,4,1011,70,17855,1385,163547,181402,11/10/2020
7/19/2020,82,26308,2696,294608,320916,7,2153,3,1783,0,314,56,6,4,2,1013,57,17912,1142,164689,182601,11/10/2020
7/20/2020,71,26379,2666,297274,323653,9,2162,7,1790,0,314,58,7,5,2,1015,68,17980,1443,166132,184112,11/10/2020
7/21/2020,130,26509,4304,301578,328087,9,2171,11,1801,0,314,56,9,6,1,1016,108,18088,1903,168035,186123,11/10/2020
7/22/2020,130,26639,3928,305506,332145,7,2178,8,1809,1,315,54,7,6,1,1017,86,18174,1665,169700,187874,11/10/2020
7/23/2020,141,26780,4415,309921,336701,8,2186,6,1815,0,315,56,8,7,0,1017,115,18289,1957,171657,189946,11/10/2020
7/24/2020,172,26952,5966,315887,342839,14,2200,12,1827,0,315,58,9,7,0,1017,119,18408,2300,173957,192365,11/10/2020
7/25/2020,134,27086,4398,320285,347371,7,2207,7,1834,0,315,58,10,8,3,1020,108,18516,2077,176034,194550,11/10/2020
7/26/2020,62,27148,3033,323318,350466,8,2215,9,1843,0,315,57,11,7,1,1021,54,18570,1326,177360,195930,11/10/2020
7/27/2020,188,27336,4191,327509,354845,12,2227,7,1850,0,315,62,13,8,1,1022,138,18708,2328,179688,198396,11/10/2020
7/28/2020,105,27441,3840,331349,358790,5,2232,5,1855,0,315,62,14,7,1,1023,95,18803,1622,181310,200113,11/10/2020
7/29/2020,190,27631,5139,336488,364119,9,2241,10,1865,0,315,61,15,7,0,1023,154,18957,2288,183598,202555,11/10/2020
7/30/2020,121,27752,4345,340833,368585,6,2247,2,1867,1,316,64,15,6,1,1024,97,19054,1632,185230,204284,11/10/2020
7/31/2020,131,27883,5512,346345,374228,7,2254,9,1876,0,316,62,15,7,1,1025,89,19143,1825,187055,206198,11/10/2020
8/1/2020,109,27992,4294,350639,378631,7,2261,2,1878,0,316,67,14,7,1,1026,89,19232,1547,188602,207834,11/10/2020
8/2/2020,84,28076,2804,353443,381519,12,2273,12,1890,2,318,65,14,8,2,1028,62,19294,1259,189861,209155,11/10/2020
8/3/2020,188,28264,5248,358691,386955,11,2284,10,1900,0,318,66,16,7,1,1029,150,19444,2184,192045,211489,11/10/2020
8/4/2020,125,28389,3691,362382,390771,8,2292,5,1905,1,319,68,12,5,2,1031,99,19543,1754,193799,213342,11/10/2020
8/5/2020,147,28536,5935,368317,396853,11,2303,9,1914,1,320,69,10,5,2,1033,119,19662,2447,196246,215908,11/10/2020
8/6/2020,169,28705,5546,373863,402568,7,2310,9,1923,0,320,67,9,4,0,1033,120,19782,2382,198628,218410,11/10/2020
8/7/2020,123,28828,4851,378714,407542,12,2322,9,1932,1,321,69,9,3,2,1035,87,19869,2121,200749,220618,11/10/2020
8/8/2020,123,28951,4112,382826,411777,19,2341,6,1938,1,322,81,8,3,1,1036,91,19960,1768,202517,222477,11/10/2020
8/9/2020,42,28993,1727,384553,413546,6,2347,8,1946,0,322,79,9,4,0,1036,35,19995,1061,203578,223573,11/10/2020
8/10/2020,149,29142,4587,389140,418282,8,2355,9,1955,0,322,78,9,4,1,1037,113,20108,2005,205583,225691,11/10/2020
8/11/2020,106,29248,4334,393474,422722,5,2360,13,1968,0,322,70,10,4,3,1040,92,20200,2252,207835,228035,11/10/2020
8/12/2020,121,29369,5188,398662,428031,8,2368,11,1979,0,322,67,9,3,1,1041,101,20301,2604,210439,230740,11/10/2020
8/13/2020,135,29504,4196,402858,432362,13,2381,12,1991,0,322,68,11,3,0,1041,95,20396,1889,212328,232724,11/10/2020
8/14/2020,145,29649,5498,408356,438005,13,2394,11,2002,0,322,70,11,4,3,1044,98,20494,1964,214292,234786,11/10/2020
8/15/2020,106,29755,4534,412890,442645,9,2403,11,2013,1,323,67,11,5,0,1044,88,20582,1674,215966,236548,11/10/2020
8/16/2020,83,29838,2477,415367,445205,6,2409,5,2018,4,327,64,8,4,6,1050,70,20652,952,216918,237570,11/10/2020
8/17/2020,106,29944,4575,419942,449886,8,2417,6,2024,0,327,66,8,5,2,1052,87,20739,2369,219287,240026,11/10/2020
8/18/2020,128,30072,4911,424853,454925,11,2428,8,2032,1,328,68,8,4,5,1057,94,20833,2735,222022,242855,11/10/2020
8/19/2020,113,30185,5077,429930,460115,8,2436,9,2041,1,329,66,9,5,0,1057,90,20923,2621,224643,245566,11/10/2020
8/20/2020,173,30358,7411,437341,467699,12,2448,6,2047,2,331,70,10,5,3,1060,139,21062,3489,228132,249194,11/10/2020
8/21/2020,151,30509,6577,443918,474427,8,2456,5,2052,1,332,72,9,4,2,1062,125,21187,2925,231057,252244,11/10/2020
8/22/2020,96,30605,5550,449468,480073,11,2467,12,2064,0,332,71,11,4,1,1063,84,21271,2579,233636,254907,11/10/2020
8/23/2020,71,30676,4375,453843,484519,11,2478,6,2070,0,332,76,12,2,1,1064,56,21327,2459,236095,257422,11/10/2020
8/24/2020,105,30781,5784,459627,490408,7,2485,10,2080,1,333,72,14,4,1,1065,77,21404,3133,239228,260632,11/10/2020
8/25/2020,108,30889,4764,464391,495280,10,2495,4,2084,1,334,77,12,4,1,1066,92,21496,2273,241501,262997,11/10/2020
8/26/2020,170,31059,9482,473873,504932,4,2499,8,2092,0,334,73,10,5,1,1067,127,21623,3069,244570,266193,11/10/2020
8/27/2020,92,31151,8565,482438,513589,6,2505,13,2105,1,335,65,7,5,2,1069,70,21693,3135,247705,269398,11/10/2020
8/28/2020,113,31264,7994,490432,521696,14,2519,4,2109,0,335,75,10,7,2,1071,87,21780,2419,250124,271904,11/10/2020
8/29/2020,65,31329,5374,495806,527135,6,2525,8,2117,1,336,72,11,6,2,1073,51,21831,1904,252028,273859,11/10/2020
8/30/2020,66,31395,4323,500129,531524,7,2532,4,2121,0,336,75,9,5,2,1075,48,21879,1985,254013,275892,11/10/2020
8/31/2020,105,31500,4863,504992,536492,12,2544,16,2137,0,336,71,8,4,1,1076,81,21960,2173,256186,278146,11/10/2020
9/1/2020,98,31598,7109,512101,543699,6,2550,9,2146,1,337,67,7,4,2,1078,66,22026,2364,258550,280576,11/10/2020
9/2/2020,125,31723,10529,522630,554353,9,2559,10,2156,1,338,65,8,4,2,1080,104,22130,3034,261584,283714,11/10/2020
9/3/2020,90,31813,11079,533709,565522,8,2567,8,2164,0,338,65,9,4,3,1083,73,22203,2572,264156,286359,11/10/2020
9/4/2020,103,31916,8963,542672,574588,11,2578,4,2168,0,338,72,9,4,1,1084,83,22286,2360,266516,288802,11/10/2020
9/5/2020,52,31968,6309,548981,580949,6,2584,9,2177,0,338,69,8,3,1,1085,42,22328,1592,268108,290436,11/10/2020
9/6/2020,88,32056,4325,553306,585362,4,2588,8,2185,1,339,64,6,3,1,1086,65,22393,1942,270050,292443,11/10/2020
9/7/2020,35,32091,3002,556308,588399,11,2599,3,2188,0,339,72,5,3,1,1087,26,22419,641,270691,293110,11/10/2020
9/8/2020,74,32165,6381,562689,594854,6,2605,12,2200,1,340,65,6,3,2,1089,66,22485,1582,272273,294758,11/10/2020
9/9/2020,118,32283,8650,571339,603622,10,2615,5,2205,1,341,69,9,3,1,1090,102,22587,2137,274410,296997,11/10/2020
9/10/2020,164,32447,11334,582673,615120,9,2624,8,2213,0,341,70,10,3,1,1091,111,22698,2264,276674,299372,11/10/2020
9/11/2020,120,32567,9454,592127,624694,11,2635,11,2224,0,341,70,10,5,0,1091,97,22795,1960,278634,301429,11/10/2020
9/12/2020,110,32677,6173,598300,630977,8,2643,5,2229,2,343,71,9,5,3,1094,97,22892,1514,280148,303040,11/10/2020
9/13/2020,58,32735,2716,601016,633751,4,2647,3,2232,0,343,72,10,5,0,1094,54,22946,860,281008,303954,11/10/2020
9/14/2020,104,32839,6446,607462,640301,6,2653,3,2235,2,345,73,10,5,2,1096,95,23041,1726,282734,305775,11/10/2020
9/15/2020,122,32961,8466,615928,648889,7,2660,2,2237,1,346,77,10,5,2,1098,124,23165,2188,284922,308087,11/10/2020
9/16/2020,137,33098,9715,625643,658741,7,2667,7,2244,2,348,75,9,6,5,1103,118,23283,1964,286886,310169,11/10/2020
9/17/2020,125,33223,9239,634882,668105,7,2674,15,2259,0,348,67,8,4,0,1103,154,23437,1942,288828,312265,11/10/2020
9/18/2020,132,33355,10045,644927,678282,7,2681,7,2266,1,349,66,11,6,2,1105,132,23569,1919,290747,314316,11/10/2020
9/19/2020,115,33470,8297,653224,686694,7,2688,3,2269,0,349,70,10,6,4,1109,112,23681,1688,292435,316116,11/10/2020
9/20/2020,60,33530,3676,656900,690430,7,2695,6,2275,2,351,69,9,8,4,1113,49,23730,1322,293757,317487,11/10/2020
9/21/2020,102,33632,7018,663918,697550,12,2707,3,2278,2,353,76,8,6,2,1115,94,23824,2400,296157,319981,11/10/2020
9/22/2020,154,33786,9287,673205,706991,12,2719,3,2281,1,354,84,7,5,1,1116,124,23948,2198,298355,322303,11/10/2020
9/23/2020,136,33922,10650,683855,717777,12,2731,7,2288,0,354,89,6,5,0,1116,127,24075,2211,300566,324641,11/10/2020
9/24/2020,120,34042,12479,696334,730376,7,2738,9,2297,1,355,86,7,5,1,1117,121,24196,3159,303725,327921,11/10/2020
9/25/2020,149,34191,10553,706887,741078,9,2747,10,2307,0,355,85,6,5,1,1118,142,24338,2996,306721,331059,11/10/2020
9/26/2020,146,34337,10559,717446,751783,12,2759,9,2316,0,355,88,6,5,1,1119,119,24457,2415,309136,333593,11/10/2020
9/27/2020,43,34380,2764,720210,754590,7,2766,5,2321,0,355,90,9,5,0,1119,34,24491,843,309979,334470,11/10/2020
9/28/2020,152,34532,7308,727518,762050,7,2773,7,2328,2,357,88,7,5,2,1121,134,24625,2257,312236,336861,11/10/2020
9/29/2020,208,34740,11046,738564,773304,12,2785,18,2346,1,358,81,6,6,1,1122,190,24815,2822,315058,339873,11/10/2020
9/30/2020,221,34961,12230,750794,785755,6,2791,6,2352,0,358,81,6,6,1,1123,187,25002,2588,317646,342648,11/10/2020
10/1/2020,185,35146,12503,763297,798443,17,2808,13,2365,1,359,84,6,4,2,1125,166,25168,2411,320057,345225,11/10/2020
10/2/2020,210,35356,12153,775450,810806,14,2822,13,2378,1,360,84,8,5,2,1127,182,25350,2498,322555,347905,11/10/2020
10/3/2020,157,35513,9312,784762,820275,9,2831,9,2387,2,362,82,9,4,2,1129,131,25481,2022,324577,350058,11/10/2020
10/4/2020,81,35594,2369,787131,822725,11,2842,9,2396,1,363,83,8,5,2,1131,78,25559,953,325530,351089,11/10/2020
10/5/2020,174,35768,8982,796113,831881,30,2872,11,2407,2,365,100,9,6,4,1135,160,25719,3031,328561,354280,11/10/2020
10/6/2020,177,35945,11185,807298,843243,11,2883,5,2412,0,365,106,11,7,0,1135,186,25905,2902,331463,357368,11/10/2020
10/7/2020,231,36176,12440,819738,855914,13,2896,14,2426,2,367,103,9,7,2,1137,244,26149,3538,335001,361150,11/10/2020
10/8/2020,262,36438,15233,834971,871409,17,2913,13,2439,2,369,105,7,5,4,1141,274,26423,4211,339212,365635,11/10/2020
10/9/2020,217,36655,13745,848716,885371,21,2934,12,2451,0,369,114,10,7,3,1144,199,26622,4330,343542,370164,11/10/2020
10/10/2020,229,36884,13832,862548,899432,19,2953,10,2461,1,370,122,13,7,2,1146,194,26816,3808,347350,374166,11/10/2020
10/11/2020,97,36981,3263,865811,902792,12,2965,9,2470,1,371,124,14,5,6,1152,88,26904,1165,348515,375419,11/10/2020
10/12/2020,169,37150,6439,872250,909400,19,2984,15,2485,2,373,126,14,5,4,1156,159,27063,1746,350261,377324,11/10/2020
10/13/2020,213,37363,8521,880771,918134,15,2999,15,2500,4,377,122,13,5,7,1163,208,27271,2309,352570,379841,11/10/2020
10/14/2020,322,37685,15038,895809,933494,17,3016,7,2507,0,377,132,15,5,2,1165,303,27574,4044,356614,384188,11/10/2020
10/15/2020,262,37947,14640,910449,948396,11,3027,16,2523,1,378,126,13,5,2,1167,254,27828,3589,360203,388031,11/10/2020
10/16/2020,279,38226,15011,925460,963686,13,3040,20,2543,1,379,118,13,4,2,1169,275,28103,3393,363596,391699,11/10/2020
10/17/2020,354,38580,14068,939528,978108,19,3059,11,2554,1,380,125,17,4,2,1171,311,28414,3271,366867,395281,11/10/2020
10/18/2020,155,38735,4039,943567,982302,18,3077,11,2565,0,380,132,17,6,2,1173,129,28543,1328,368195,396738,11/10/2020
10/19/2020,388,39123,8489,952056,991179,21,3098,23,2588,2,382,128,15,6,1,1174,326,28869,2570,370765,399634,11/10/2020
10/20/2020,439,39562,13242,965298,1004860,22,3120,17,2605,0,382,133,14,8,3,1177,387,29256,3017,373782,403038,11/10/2020
10/21/2020,544,40106,17462,982760,1022866,21,3141,9,2614,2,384,143,15,9,3,1180,473,29729,3533,377315,407044,11/10/2020
10/22/2020,538,40644,15863,998623,1039267,24,3165,21,2635,3,387,143,14,9,3,1183,490,30219,3207,380522,410741,11/10/2020
10/23/2020,514,41158,16632,1015255,1056413,22,3187,26,2661,1,388,138,15,9,3,1186,460,30679,2894,383416,414095,11/10/2020
10/24/2020,359,41517,10248,1025503,1067020,17,3204,11,2672,0,388,144,14,8,1,1187,339,31018,2270,385686,416704,11/10/2020
10/25/2020,233,41750,4762,1030265,1072015,16,3220,15,2687,1,389,144,15,8,2,1189,208,31226,1473,387159,418385,11/10/2020
10/26/2020,454,42204,9174,1039439,1081643,25,3245,20,2707,2,391,147,18,8,3,1192,402,31628,2981,390140,421768,11/10/2020
10/27/2020,517,42721,13992,1053431,1096152,28,3273,11,2718,2,393,162,17,9,4,1196,454,32082,2398,392538,424620,11/10/2020
10/28/2020,469,43190,15230,1068661,1111851,22,3295,23,2741,1,394,160,16,9,3,1199,406,32488,2714,395252,427740,11/10/2020
10/29/2020,609,43799,16234,1084895,1128694,20,3315,18,2759,3,397,159,19,11,4,1203,529,33017,3142,398394,431411,11/10/2020
10/30/2020,544,44343,14318,1099213,1143556,21,3336,20,2779,5,402,155,19,9,4,1207,465,33482,2960,401354,434836,11/10/2020
10/31/2020,585,44928,11843,1111056,1155984,31,3367,12,2791,1,403,173,22,9,3,1210,488,33970,2420,403774,437744,11/10/2020
11/1/2020,329,45257,5073,1116129,1161386,19,3386,15,2806,1,404,176,25,12,4,1214,272,34242,1259,405033,439275,11/10/2020
11/2/2020,520,45777,9914,1126043,1171820,34,3420,27,2833,3,407,180,22,11,5,1219,453,34695,2939,407972,442667,11/10/2020
11/3/2020,603,46380,13057,1139100,1185480,30,3450,24,2857,1,408,185,21,11,1,1220,528,35223,2539,410511,445734,11/10/2020
11/4/2020,679,47059,16119,1155219,1202278,33,3483,23,2880,2,410,193,21,11,3,1223,632,35855,2946,413457,449312,11/10/2020
11/5/2020,759,47818,18883,1174102,1221920,46,3529,33,2913,1,411,205,20,13,3,1226,676,36531,5186,418643,455174,11/10/2020
11/6/2020,776,48594,17187,1191289,1239883,35,3564,29,2942,1,412,210,25,16,5,1231,693,37224,4374,423017,460241,11/10/2020
11/7/2020,606,49200,13221,1204510,1253710,31,3595,23,2965,1,413,217,27,17,1,1232,571,37795,2496,425513,463308,11/10/2020
11/8/2020,327,49527,3859,1208369,1257896,26,3621,24,2989,1,414,218,26,18,3,1235,302,38097,1256,426769,464866,11/10/2020
11/9/2020,784,50311,8595,1216964,1267275,,,,,,,,,,2,1237,701,38798,2310,429079,467877,11/10/2020
2/27/2020,0,0,0,0,0,1,1,0,0,0,0,1,0,0,0,0,0,0,0,0,0,11/11/2020
2/28/2020,0,0,0,0,0,0,1,0,0,0,0,1,1,0,0,0,0,0,0,0,0,11/11/2020
2/29/2020,0,0,0,0,0,0,1,0,0,0,0,1,1,0,0,0,0,0,0,0,0,11/11/2020
3/1/2020,2,2,2,2,4,0,1,0,0,0,0,1,1,1,0,0,2,2,2,2,4,11/11/2020
3/2/2020,0,2,1,3,5,1,2,0,0,0,0,2,2,2,0,0,0,2,0,2,4,11/11/2020
3/3/2020,0,2,2,5,7,0,2,0,0,0,0,2,2,2,0,0,0,2,1,3,5,11/11/2020
3/4/2020,0,2,12,17,19,1,3,0,0,0,0,3,2,2,0,0,0,2,10,13,15,11/11/2020
3/5/2020,0,2,4,21,23,0,3,0,0,0,0,3,2,2,0,0,1,3,4,17,20,11/11/2020
3/6/2020,1,3,12,33,36,0,3,0,0,0,0,3,2,2,0,0,0,3,11,28,31,11/11/2020
3/7/2020,0,3,19,52,55,0,3,0,0,0,0,3,2,1,0,0,0,3,19,47,50,11/11/2020
3/8/2020,0,3,18,70,73,0,3,0,0,0,0,3,2,1,0,0,0,3,18,65,68,11/11/2020
3/9/2020,1,4,15,85,89,0,3,0,0,0,0,3,2,1,0,0,1,4,14,79,83,11/11/2020
3/10/2020,2,6,25,110,116,0,3,0,0,0,0,3,2,1,0,0,1,5,23,102,107,11/11/2020
3/11/2020,0,6,34,144,150,1,4,0,0,0,0,4,1,1,0,0,0,5,34,136,141,11/11/2020
3/12/2020,9,15,41,185,200,1,5,0,0,0,0,5,1,1,0,0,8,13,38,174,187,11/11/2020
3/13/2020,6,21,50,235,256,4,9,1,1,0,0,8,1,1,0,0,6,19,47,221,240,11/11/2020
3/14/2020,0,21,90,325,346,0,9,0,1,0,0,8,1,1,0,0,0,19,83,304,323,11/11/2020
3/15/2020,1,22,54,379,401,1,10,0,1,0,0,9,2,1,0,0,1,20,53,357,377,11/11/2020
3/16/2020,2,24,95,474,498,2,12,0,1,0,0,11,2,0,0,0,2,22,91,448,470,11/11/2020
3/17/2020,12,36,162,636,672,6,18,0,1,0,0,17,2,0,0,0,11,33,149,597,630,11/11/2020
3/18/2020,9,45,116,752,797,3,21,0,1,0,0,20,2,0,0,0,11,44,110,707,751,11/11/2020
3/19/2020,15,60,262,1014,1074,2,23,1,2,0,0,21,3,0,1,1,17,61,247,954,1015,11/11/2020
3/20/2020,13,73,197,1211,1284,5,28,0,2,0,0,26,4,0,0,1,13,74,187,1141,1215,11/11/2020
3/21/2020,12,85,126,1337,1422,3,31,2,4,0,0,27,5,0,0,1,14,88,122,1263,1351,11/11/2020
3/22/2020,27,112,282,1619,1731,2,33,0,4,0,0,29,5,0,0,1,25,113,257,1520,1633,11/11/2020
3/23/2020,14,126,169,1788,1914,15,48,1,5,0,0,43,9,3,0,1,16,129,161,1681,1810,11/11/2020
3/24/2020,20,146,242,2030,2176,8,56,0,5,0,0,51,10,5,0,1,19,148,230,1911,2059,11/11/2020
3/25/2020,26,172,182,2212,2384,5,61,2,7,0,0,54,11,3,0,1,28,176,165,2076,2252,11/11/2020
3/26/2020,35,207,181,2393,2600,9,70,5,12,0,0,58,14,5,0,1,41,217,170,2246,2463,11/11/2020
3/27/2020,27,234,214,2607,2841,9,79,1,13,1,1,65,16,6,2,3,31,248,198,2444,2692,11/11/2020
3/28/2020,59,293,260,2867,3160,11,90,2,15,1,2,73,15,6,1,4,64,312,240,2684,2996,11/11/2020
3/29/2020,100,393,350,3217,3610,8,98,3,18,1,3,77,18,8,2,6,105,417,310,2994,3411,11/11/2020
3/30/2020,62,455,222,3439,3894,19,117,5,23,0,3,91,19,11,3,9,78,495,181,3175,3670,11/11/2020
3/31/2020,71,526,369,3808,4334,11,128,7,30,1,4,94,21,13,2,11,73,568,294,3469,4037,11/11/2020
4/1/2020,99,625,698,4506,5131,18,146,7,37,0,4,105,29,15,1,12,100,668,628,4097,4765,11/11/2020
4/2/2020,52,677,477,4983,5660,22,168,6,43,2,6,119,35,21,4,16,62,730,426,4523,5253,11/11/2020
4/3/2020,108,785,774,5757,6542,23,191,7,50,0,6,135,42,25,3,19,100,830,696,5219,6049,11/11/2020
4/4/2020,143,928,660,6417,7345,22,213,4,54,5,11,148,40,29,9,28,138,968,605,5824,6792,11/11/2020
4/5/2020,187,1115,1156,7573,8688,20,233,9,63,1,12,158,43,35,2,30,181,1149,1040,6864,8013,11/11/2020
4/6/2020,218,1333,1706,9279,10612,26,259,7,70,0,12,177,47,39,7,37,207,1356,1519,8383,9739,11/11/2020
4/7/2020,284,1617,1629,10908,12525,20,279,4,74,2,14,191,49,41,5,42,261,1617,1458,9841,11458,11/11/2020
4/8/2020,290,1907,1720,12628,14535,19,298,7,81,6,20,197,49,37,10,52,271,1888,1521,11362,13250,11/11/2020
4/9/2020,283,2190,1516,14144,16334,32,330,8,89,4,24,217,53,40,7,59,277,2165,1334,12696,14861,11/11/2020
4/10/2020,419,2609,2574,16718,19327,29,359,17,106,5,29,224,59,41,11,70,400,2565,2325,15021,17586,11/11/2020
4/11/2020,297,2906,1905,18623,21529,29,388,11,117,2,31,240,61,48,12,82,281,2846,1686,16707,19553,11/11/2020
4/12/2020,314,3220,1670,20293,23513,35,423,13,130,5,36,257,59,49,9,91,285,3131,1398,18105,21236,11/11/2020
4/13/2020,161,3381,935,21228,24609,35,458,13,143,3,39,276,64,54,9,100,187,3318,827,18932,22250,11/11/2020
4/14/2020,289,3670,1787,23015,26685,27,485,18,161,5,44,280,72,53,8,108,262,3580,1495,20427,24007,11/11/2020
4/15/2020,351,4021,1799,24814,28835,31,516,20,181,3,47,288,72,54,17,125,306,3886,1516,21943,25829,11/11/2020
4/16/2020,447,4468,2494,27308,31776,36,552,25,206,6,53,293,72,53,14,139,387,4273,2037,23980,28253,11/11/2020
4/17/2020,304,4772,1821,29129,33901,32,584,20,226,7,60,298,66,45,21,160,290,4563,1412,25392,29955,11/11/2020
4/18/2020,321,5093,1725,30854,35947,26,610,18,244,4,64,302,63,49,15,175,284,4847,1297,26689,31536,11/11/2020
4/19/2020,381,5474,2047,32901,38375,23,633,26,270,1,65,298,65,55,11,186,337,5184,1702,28391,33575,11/11/2020
4/20/2020,394,5868,1907,34808,40676,46,679,29,299,2,67,313,75,56,10,196,376,5560,1546,29937,35497,11/11/2020
4/21/2020,444,6312,2110,36918,43230,45,724,32,331,5,72,321,72,56,18,214,383,5943,1668,31605,37548,11/11/2020
4/22/2020,418,6730,2390,39308,46038,41,765,32,363,5,77,325,73,58,18,232,379,6322,1876,33481,39803,11/11/2020
4/23/2020,479,7209,2469,41777,48986,32,797,28,391,5,82,324,76,62,15,247,412,6734,1827,35308,42042,11/11/2020
4/24/2020,491,7700,3284,45061,52761,35,832,26,417,4,86,329,85,63,15,262,407,7141,2567,37875,45016,11/11/2020
4/25/2020,393,8093,2206,47267,55360,34,866,17,434,5,91,341,85,62,14,276,299,7440,1728,39603,47043,11/11/2020
4/26/2020,316,8409,2309,49576,57985,33,899,15,449,3,94,356,86,59,14,290,274,7714,1838,41441,49155,11/11/2020
4/27/2020,249,8658,1620,51196,59854,29,928,21,470,4,98,360,86,61,10,300,206,7920,1138,42579,50499,11/11/2020
4/28/2020,410,9068,2263,53459,62527,44,972,24,494,3,101,377,88,59,22,322,332,8252,1692,44271,52523,11/11/2020
4/29/2020,476,9544,3343,56802,66346,36,1008,38,532,11,112,364,78,53,18,340,370,8622,2339,46610,55232,11/11/2020
4/30/2020,432,9976,2769,59571,69547,33,1041,38,570,6,118,353,83,57,24,364,349,8971,1854,48464,57435,11/11/2020
5/1/2020,454,10430,3086,62657,73087,51,1092,39,609,3,121,362,84,58,14,378,323,9294,2111,50575,59869,11/11/2020
5/2/2020,257,10687,1926,64583,75270,36,1128,38,647,5,126,355,93,63,24,402,192,9486,1245,51820,61306,11/11/2020
5/3/2020,283,10970,2160,66743,77713,31,1159,27,674,8,134,351,91,61,21,423,183,9669,1536,53356,63025,11/11/2020
5/4/2020,387,11357,2098,68841,80198,30,1189,31,705,5,139,345,89,58,18,441,290,9959,1529,54885,64844,11/11/2020
5/5/2020,433,11790,2873,71714,83504,29,1218,32,737,6,145,336,83,55,16,457,300,10259,1922,56807,67066,11/11/2020
5/6/2020,488,12278,2830,74544,86822,28,1246,44,781,9,154,311,80,55,21,478,340,10599,1890,58697,69296,11/11/2020
5/7/2020,425,12703,2969,77513,90216,36,1282,43,824,5,159,299,72,53,21,499,269,10868,1929,60626,71494,11/11/2020
5/8/2020,359,13062,2598,80111,93173,30,1312,29,853,5,164,295,72,54,22,521,229,11097,1710,62336,73433,11/11/2020
5/9/2020,467,13529,3346,83457,96986,22,1334,21,874,4,168,292,70,52,15,536,290,11387,2204,64540,75927,11/11/2020
5/10/2020,285,13814,2117,85574,99388,20,1354,23,897,6,174,283,71,50,14,550,189,11576,1488,66028,77604,11/11/2020
5/11/2020,257,14071,1857,87431,101502,31,1385,16,913,6,180,292,72,50,15,565,174,11750,1274,67302,79052,11/11/2020
5/12/2020,387,14458,2611,90042,104500,23,1408,18,931,4,184,293,70,49,22,587,224,11974,1637,68939,80913,11/11/2020
5/13/2020,351,14809,3630,93672,108481,23,1431,25,956,1,185,290,70,50,13,600,199,12173,1922,70861,83034,11/11/2020
5/14/2020,329,15138,3408,97080,112218,19,1450,27,983,3,188,279,65,46,15,615,232,12405,1965,72826,85231,11/11/2020
5/15/2020,381,15519,3458,100538,116057,24,1474,41,1024,5,193,257,63,46,14,629,232,12637,1769,74595,87232,11/11/2020
5/16/2020,449,15968,4156,104694,120662,25,1499,15,1039,5,198,262,62,47,15,644,247,12884,1908,76503,89387,11/11/2020
5/17/2020,240,16208,2768,107462,123670,17,1516,9,1048,5,203,265,60,46,10,654,126,13010,1518,78021,91031,11/11/2020
5/18/2020,250,16458,2001,109463,125921,19,1535,16,1064,5,208,263,58,41,18,672,135,13145,1350,79371,92516,11/11/2020
5/19/2020,415,16873,3168,112631,129504,23,1558,33,1097,5,213,248,57,39,11,683,215,13360,1895,81266,94626,11/11/2020
5/20/2020,326,17199,2771,115402,132601,19,1577,23,1120,7,220,237,53,34,22,705,184,13544,1498,82764,96308,11/11/2020
5/21/2020,374,17573,3757,119159,136732,25,1602,15,1135,3,223,244,54,30,20,725,168,13712,1912,84676,98388,11/11/2020
5/22/2020,351,17924,3161,122320,140244,20,1622,28,1163,5,228,231,53,30,11,736,206,13918,1577,86253,100171,11/11/2020
5/23/2020,253,18177,2742,125062,143239,19,1641,11,1174,3,231,236,53,33,13,749,109,14027,1249,87502,101529,11/11/2020
5/24/2020,163,18340,1370,126432,144772,13,1654,14,1188,2,233,233,54,36,8,757,83,14110,765,88267,102377,11/11/2020
5/25/2020,147,18487,1385,127817,146304,14,1668,14,1202,0,233,233,54,34,10,767,76,14186,754,89021,103207,11/11/2020
5/26/2020,285,18772,2620,130437,149209,24,1692,21,1223,5,238,231,49,33,15,782,158,14344,1752,90773,105117,11/11/2020
5/27/2020,276,19048,2057,132494,151542,20,1712,18,1241,3,241,230,51,33,10,792,132,14476,1119,91892,106368,11/11/2020
5/28/2020,348,19396,3359,135853,155249,17,1729,29,1270,4,245,214,47,32,8,800,130,14606,1106,92998,107604,11/11/2020
5/29/2020,410,19806,3915,139768,159574,19,1748,26,1296,7,252,200,43,31,12,812,174,14780,1554,94552,109332,11/11/2020
5/30/2020,225,20031,3915,143683,163714,16,1764,19,1315,4,256,193,41,29,12,824,109,14889,1792,96344,111233,11/11/2020
5/31/2020,155,20186,1690,145373,165559,11,1775,11,1326,1,257,192,44,26,3,827,78,14967,848,97192,112159,11/11/2020
6/1/2020,212,20398,2792,148165,168563,8,1783,14,1340,1,258,185,45,29,5,832,93,15060,1367,98559,113619,11/11/2020
6/2/2020,273,20671,3022,151187,171858,8,1791,10,1350,3,261,180,38,25,10,842,98,15158,1415,99974,115132,11/11/2020
6/3/2020,254,20925,3486,154673,175598,14,1805,18,1368,6,267,170,34,25,11,853,99,15257,1640,101614,116871,11/11/2020
6/4/2020,276,21201,4471,159144,180345,7,1812,26,1394,4,271,147,31,24,12,865,107,15364,2007,103621,118985,11/11/2020
6/5/2020,215,21416,3513,162657,184073,15,1827,13,1407,6,277,143,27,21,11,876,99,15463,1544,105165,120628,11/11/2020
6/6/2020,201,21617,2616,165273,186890,10,1837,7,1414,2,279,144,29,19,6,882,67,15530,1107,106272,121802,11/11/2020
6/7/2020,83,21700,1625,166898,188598,11,1848,7,1421,1,280,147,25,17,4,886,51,15581,777,107049,122630,11/11/2020
6/8/2020,119,21819,1849,168747,190566,15,1863,13,1434,2,282,147,27,18,4,890,45,15626,947,107996,123622,11/11/2020
6/9/2020,223,22042,2673,171420,193462,10,1873,19,1453,0,282,138,28,21,1,891,64,15690,1240,109236,124926,11/11/2020
6/10/2020,209,22251,2987,174407,196658,13,1886,12,1465,2,284,137,24,17,4,895,100,15790,1448,110684,126474,11/11/2020
6/11/2020,195,22446,3513,177920,200366,7,1893,15,1480,1,285,128,25,16,6,901,88,15878,1511,112195,128073,11/11/2020
6/12/2020,209,22655,4601,182521,205176,9,1902,16,1496,1,286,120,24,16,2,903,78,15956,2157,114352,130308,11/11/2020
6/13/2020,113,22768,3036,185557,208325,6,1908,5,1501,0,286,121,20,15,3,906,49,16005,1358,115710,131715,11/11/2020
6/14/2020,81,22849,2046,187603,210452,7,1915,8,1509,1,287,119,20,14,3,909,33,16038,958,116668,132706,11/11/2020
6/15/2020,188,23037,3108,190711,213748,14,1929,19,1528,0,287,114,20,16,5,914,75,16113,1764,118432,134545,11/11/2020
6/16/2020,110,23147,3017,193728,216875,11,1940,9,1537,1,288,115,22,16,8,922,50,16163,1520,119952,136115,11/11/2020
6/17/2020,127,23274,2835,196563,219837,15,1955,21,1558,4,292,105,18,14,6,928,50,16213,1295,121247,137460,11/11/2020
6/18/2020,149,23423,3048,199611,223034,9,1964,15,1573,1,293,98,19,16,7,935,70,16283,1305,122552,138835,11/11/2020
6/19/2020,141,23564,3769,203380,226944,12,1976,12,1585,1,294,97,20,17,3,938,59,16342,1344,123896,140238,11/11/2020
6/20/2020,84,23648,1891,205271,228919,9,1985,12,1597,0,294,94,20,18,4,942,36,16378,807,124703,141081,11/11/2020
6/21/2020,37,23685,1064,206335,230020,8,1993,5,1602,0,294,97,20,18,2,944,30,16408,685,125388,141796,11/11/2020
6/22/2020,138,23823,3730,210065,233888,12,2005,17,1619,0,294,92,19,18,2,946,65,16473,1688,127076,143549,11/11/2020
6/23/2020,163,23986,3831,213896,237882,3,2008,13,1632,3,297,79,18,18,7,953,81,16554,1763,128839,145393,11/11/2020
6/24/2020,120,24106,3502,217398,241504,9,2017,11,1643,1,298,76,18,18,5,958,44,16598,1665,130504,147102,11/11/2020
6/25/2020,103,24209,2883,220281,244490,6,2023,14,1657,1,299,67,17,17,1,959,50,16648,1487,131991,148639,11/11/2020
6/26/2020,94,24303,2488,222769,247072,2,2025,10,1667,0,299,59,18,18,1,960,60,16708,1312,133303,150011,11/11/2020
6/27/2020,84,24387,3216,225985,250372,5,2030,3,1670,1,300,60,17,17,5,965,37,16745,1198,134501,151246,11/11/2020
6/28/2020,39,24426,1469,227454,251880,4,2034,4,1674,4,304,56,15,14,6,971,17,16762,589,135090,151852,11/11/2020
6/29/2020,85,24511,3697,231151,255662,4,2038,5,1679,0,304,55,14,14,1,972,39,16801,1337,136427,153228,11/11/2020
6/30/2020,57,24568,1958,233109,257677,1,2039,5,1684,1,305,50,12,11,4,976,33,16834,988,137415,154249,11/11/2020
7/1/2020,144,24712,4098,237207,261919,8,2047,10,1694,0,305,48,11,11,1,977,79,16913,1908,139323,156236,11/11/2020
7/2/2020,103,24815,2803,240010,264825,5,2052,5,1699,1,306,47,10,10,3,980,59,16972,1072,140395,157367,11/11/2020
7/3/2020,50,24865,2079,242089,266954,9,2061,6,1705,0,306,50,9,9,3,983,25,16997,775,141170,158167,11/11/2020
7/4/2020,57,24922,2345,244434,269356,2,2063,4,1709,1,307,47,10,9,2,985,33,17030,991,142161,159191,11/11/2020
7/5/2020,49,24971,2932,247366,272337,1,2064,2,1711,1,308,45,8,8,2,987,26,17056,1424,143585,160641,11/11/2020
7/6/2020,101,25072,2814,250180,275252,6,2070,6,1717,0,308,45,9,9,4,991,57,17113,1534,145119,162232,11/11/2020
7/7/2020,81,25153,3457,253637,278790,5,2075,7,1724,0,308,43,8,8,2,993,47,17160,1526,146645,163805,11/11/2020
7/8/2020,105,25258,3409,257046,282304,4,2079,2,1726,0,308,45,9,8,0,993,64,17224,1402,148047,165271,11/11/2020
7/9/2020,94,25352,3714,260760,286112,9,2088,3,1729,0,308,51,9,8,0,993,50,17274,1602,149649,166923,11/11/2020
7/10/2020,132,25484,4437,265197,290681,6,2094,3,1732,2,310,52,7,7,3,996,80,17354,2055,151704,169058,11/11/2020
7/11/2020,63,25547,2938,268135,293682,6,2100,3,1735,1,311,54,6,6,3,999,36,17390,1306,153010,170400,11/11/2020
7/12/2020,47,25594,1838,269973,295567,1,2101,3,1738,1,312,51,6,5,3,1002,34,17424,933,153943,171367,11/11/2020
7/13/2020,84,25678,3209,273182,298860,8,2109,10,1748,0,312,49,6,5,1,1003,61,17485,1491,155434,172919,11/11/2020
7/14/2020,74,25752,3298,276480,302232,7,2116,4,1752,0,312,52,5,5,1,1004,44,17529,1365,156799,174328,11/11/2020
7/15/2020,130,25882,4181,280661,306543,5,2121,7,1759,0,312,50,5,4,0,1004,100,17629,1736,158535,176164,11/11/2020
7/16/2020,103,25985,3740,284401,310386,6,2127,9,1768,0,312,47,6,5,1,1005,76,17705,1605,160140,177845,11/11/2020
7/17/2020,156,26141,4239,288640,314781,14,2141,3,1771,1,313,57,5,5,2,1007,79,17784,1833,161973,179757,11/11/2020
7/18/2020,85,26226,3272,291912,318138,5,2146,9,1780,1,314,52,5,4,4,1011,70,17854,1384,163357,181211,11/11/2020
7/19/2020,82,26308,2696,294608,320916,7,2153,3,1783,0,314,56,6,4,2,1013,57,17911,1140,164497,182408,11/11/2020
7/20/2020,71,26379,2666,297274,323653,9,2162,7,1790,0,314,58,7,5,2,1015,68,17979,1442,165939,183918,11/11/2020
7/21/2020,130,26509,4304,301578,328087,9,2171,11,1801,0,314,56,9,6,1,1016,108,18087,1899,167838,185925,11/11/2020
7/22/2020,130,26639,3928,305506,332145,7,2178,8,1809,1,315,54,7,6,1,1017,86,18173,1664,169502,187675,11/11/2020
7/23/2020,141,26780,4415,309921,336701,8,2186,6,1815,0,315,56,8,7,0,1017,115,18288,1955,171457,189745,11/11/2020
7/24/2020,172,26952,5966,315887,342839,14,2200,12,1827,0,315,58,9,7,0,1017,119,18407,2299,173756,192163,11/11/2020
7/25/2020,134,27086,4398,320285,347371,7,2207,7,1834,0,315,58,10,8,3,1020,108,18515,2075,175831,194346,11/11/2020
7/26/2020,62,27148,3033,323318,350466,8,2215,9,1843,0,315,57,11,7,1,1021,54,18569,1325,177156,195725,11/11/2020
7/27/2020,188,27336,4191,327509,354845,12,2227,7,1850,0,315,62,13,8,1,1022,138,18707,2327,179483,198190,11/11/2020
7/28/2020,105,27441,3840,331349,358790,5,2232,5,1855,0,315,62,14,7,1,1023,95,18802,1622,181105,199907,11/11/2020
7/29/2020,190,27631,5139,336488,364119,9,2241,10,1865,0,315,61,15,7,0,1023,154,18956,2286,183391,202347,11/11/2020
7/30/2020,121,27752,4345,340833,368585,6,2247,2,1867,1,316,64,15,6,1,1024,97,19053,1631,185022,204075,11/11/2020
7/31/2020,131,27883,5512,346345,374228,7,2254,9,1876,0,316,62,15,7,1,1025,89,19142,1820,186842,205984,11/11/2020
8/1/2020,109,27992,4294,350639,378631,7,2261,2,1878,0,316,67,14,7,1,1026,89,19231,1547,188389,207620,11/11/2020
8/2/2020,84,28076,2804,353443,381519,12,2273,12,1890,2,318,65,14,8,2,1028,62,19293,1259,189648,208941,11/11/2020
8/3/2020,188,28264,5248,358691,386955,11,2284,10,1900,0,318,66,16,7,1,1029,150,19443,2183,191831,211274,11/11/2020
8/4/2020,125,28389,3691,362382,390771,8,2292,5,1905,1,319,68,12,5,2,1031,99,19542,1752,193583,213125,11/11/2020
8/5/2020,147,28536,5935,368317,396853,11,2303,9,1914,1,320,69,10,5,2,1033,119,19661,2444,196027,215688,11/11/2020
8/6/2020,169,28705,5546,373863,402568,7,2310,9,1923,0,320,67,9,4,0,1033,120,19781,2378,198405,218186,11/11/2020
8/7/2020,123,28828,4851,378714,407542,12,2322,9,1932,1,321,69,9,3,2,1035,87,19868,2118,200523,220391,11/11/2020
8/8/2020,123,28951,4112,382826,411777,19,2341,6,1938,1,322,81,8,3,1,1036,91,19959,1768,202291,222250,11/11/2020
8/9/2020,42,28993,1727,384553,413546,6,2347,8,1946,0,322,79,9,4,0,1036,35,19994,1061,203352,223346,11/11/2020
8/10/2020,149,29142,4587,389140,418282,8,2355,9,1955,0,322,78,9,4,1,1037,113,20107,2004,205356,225463,11/11/2020
8/11/2020,106,29248,4334,393474,422722,5,2360,13,1968,0,322,70,10,4,3,1040,92,20199,2250,207606,227805,11/11/2020
8/12/2020,121,29369,5188,398662,428031,8,2368,11,1979,0,322,67,9,3,1,1041,101,20300,2603,210209,230509,11/11/2020
8/13/2020,135,29504,4196,402858,432362,13,2381,12,1991,0,322,68,11,3,0,1041,95,20395,1889,212098,232493,11/11/2020
8/14/2020,145,29649,5498,408356,438005,13,2394,11,2002,0,322,70,11,4,3,1044,98,20493,1962,214060,234553,11/11/2020
8/15/2020,106,29755,4534,412890,442645,9,2403,11,2013,1,323,67,11,5,0,1044,88,20581,1673,215733,236314,11/11/2020
8/16/2020,83,29838,2477,415367,445205,6,2409,5,2018,4,327,64,8,4,6,1050,70,20651,950,216683,237334,11/11/2020
8/17/2020,106,29944,4575,419942,449886,8,2417,6,2024,0,327,66,8,5,2,1052,87,20738,2366,219049,239787,11/11/2020
8/18/2020,128,30072,4911,424853,454925,11,2428,8,2032,1,328,68,8,4,5,1057,94,20832,2733,221782,242614,11/11/2020
8/19/2020,113,30185,5077,429930,460115,8,2436,9,2041,1,329,66,9,5,0,1057,90,20922,2616,224398,245320,11/11/2020
8/20/2020,173,30358,7411,437341,467699,12,2448,6,2047,2,331,70,10,5,3,1060,139,21061,3486,227884,248945,11/11/2020
8/21/2020,151,30509,6577,443918,474427,8,2456,5,2052,1,332,72,9,4,2,1062,125,21186,2921,230805,251991,11/11/2020
8/22/2020,96,30605,5550,449468,480073,11,2467,12,2064,0,332,71,11,4,1,1063,84,21270,2576,233381,254651,11/11/2020
8/23/2020,71,30676,4375,453843,484519,11,2478,6,2070,0,332,76,12,2,1,1064,56,21326,2458,235839,257165,11/11/2020
8/24/2020,105,30781,5784,459627,490408,7,2485,10,2080,1,333,72,14,4,1,1065,77,21403,3128,238967,260370,11/11/2020
8/25/2020,108,30889,4764,464391,495280,10,2495,4,2084,1,334,77,12,4,1,1066,92,21495,2273,241240,262735,11/11/2020
8/26/2020,170,31059,9482,473873,504932,4,2499,8,2092,0,334,73,10,5,1,1067,127,21622,3067,244307,265929,11/11/2020
8/27/2020,92,31151,8565,482438,513589,6,2505,13,2105,1,335,65,7,5,2,1069,70,21692,3134,247441,269133,11/11/2020
8/28/2020,113,31264,7994,490432,521696,14,2519,4,2109,0,335,75,10,7,2,1071,87,21779,2413,249854,271633,11/11/2020
8/29/2020,65,31329,5374,495806,527135,6,2525,8,2117,1,336,72,11,6,2,1073,51,21830,1904,251758,273588,11/11/2020
8/30/2020,66,31395,4323,500129,531524,7,2532,4,2121,0,336,75,9,5,2,1075,48,21878,1981,253739,275617,11/11/2020
8/31/2020,105,31500,4863,504992,536492,12,2544,16,2137,0,336,71,8,4,1,1076,81,21959,2173,255912,277871,11/11/2020
9/1/2020,98,31598,7109,512101,543699,6,2550,9,2146,1,337,67,7,4,2,1078,66,22025,2362,258274,280299,11/11/2020
9/2/2020,125,31723,10529,522630,554353,9,2559,10,2156,1,338,65,8,4,2,1080,104,22129,3031,261305,283434,11/11/2020
9/3/2020,90,31813,11079,533709,565522,8,2567,8,2164,0,338,65,9,4,3,1083,73,22202,2568,263873,286075,11/11/2020
9/4/2020,103,31916,8963,542672,574588,11,2578,4,2168,0,338,72,9,4,1,1084,83,22285,2359,266232,288517,11/11/2020
9/5/2020,52,31968,6309,548981,580949,6,2584,9,2177,0,338,69,8,3,1,1085,42,22327,1591,267823,290150,11/11/2020
9/6/2020,88,32056,4325,553306,585362,4,2588,8,2185,1,339,64,6,3,1,1086,65,22392,1938,269761,292153,11/11/2020
9/7/2020,35,32091,3002,556308,588399,11,2599,3,2188,0,339,72,5,3,1,1087,26,22418,640,270401,292819,11/11/2020
9/8/2020,74,32165,6381,562689,594854,6,2605,12,2200,1,340,65,6,3,2,1089,66,22484,1581,271982,294466,11/11/2020
9/9/2020,118,32283,8650,571339,603622,10,2615,5,2205,1,341,69,9,3,1,1090,102,22586,2134,274116,296702,11/11/2020
9/10/2020,164,32447,11334,582673,615120,9,2624,8,2213,0,341,70,10,3,1,1091,111,22697,2262,276378,299075,11/11/2020
9/11/2020,120,32567,9454,592127,624694,11,2635,11,2224,0,341,70,10,5,0,1091,97,22794,1959,278337,301131,11/11/2020
9/12/2020,110,32677,6173,598300,630977,8,2643,5,2229,2,343,71,9,5,3,1094,97,22891,1514,279851,302742,11/11/2020
9/13/2020,58,32735,2716,601016,633751,4,2647,3,2232,0,343,72,10,5,0,1094,54,22945,858,280709,303654,11/11/2020
9/14/2020,104,32839,6446,607462,640301,6,2653,3,2235,2,345,73,10,5,2,1096,95,23040,1725,282434,305474,11/11/2020
9/15/2020,122,32961,8466,615928,648889,7,2660,2,2237,1,346,77,10,5,2,1098,124,23164,2185,284619,307783,11/11/2020
9/16/2020,137,33098,9715,625643,658741,7,2667,7,2244,2,348,75,9,6,5,1103,118,23282,1964,286583,309865,11/11/2020
9/17/2020,125,33223,9239,634882,668105,7,2674,15,2259,0,348,67,8,4,0,1103,154,23436,1940,288523,311959,11/11/2020
9/18/2020,132,33355,10045,644927,678282,7,2681,7,2266,1,349,66,11,6,2,1105,132,23568,1919,290442,314010,11/11/2020
9/19/2020,115,33470,8297,653224,686694,7,2688,3,2269,0,349,70,10,6,4,1109,112,23680,1687,292129,315809,11/11/2020
9/20/2020,60,33530,3676,656900,690430,7,2695,6,2275,2,351,69,9,8,4,1113,49,23729,1321,293450,317179,11/11/2020
9/21/2020,102,33632,7018,663918,697550,12,2707,3,2278,2,353,76,8,6,2,1115,94,23823,2398,295848,319671,11/11/2020
9/22/2020,154,33786,9287,673205,706991,12,2719,3,2281,1,354,84,7,5,1,1116,124,23947,2198,298046,321993,11/11/2020
9/23/2020,136,33922,10650,683855,717777,12,2731,7,2288,0,354,89,6,5,0,1116,127,24074,2210,300256,324330,11/11/2020
9/24/2020,120,34042,12479,696334,730376,7,2738,9,2297,1,355,86,7,5,1,1117,121,24195,3158,303414,327609,11/11/2020
9/25/2020,149,34191,10553,706887,741078,9,2747,10,2307,0,355,85,6,5,1,1118,142,24337,2995,306409,330746,11/11/2020
9/26/2020,146,34337,10559,717446,751783,12,2759,9,2316,0,355,88,6,5,1,1119,119,24456,2414,308823,333279,11/11/2020
9/27/2020,43,34380,2764,720210,754590,7,2766,5,2321,0,355,90,9,5,0,1119,34,24490,843,309666,334156,11/11/2020
9/28/2020,152,34532,7308,727518,762050,7,2773,7,2328,2,357,88,7,5,2,1121,134,24624,2257,311923,336547,11/11/2020
9/29/2020,208,34740,11046,738564,773304,12,2785,18,2346,1,358,81,6,6,1,1122,190,24814,2821,314744,339558,11/11/2020
9/30/2020,221,34961,12230,750794,785755,6,2791,6,2352,0,358,81,6,6,1,1123,187,25001,2581,317325,342326,11/11/2020
10/1/2020,185,35146,12503,763297,798443,17,2808,13,2365,1,359,84,6,4,2,1125,166,25167,2410,319735,344902,11/11/2020
10/2/2020,210,35356,12153,775450,810806,14,2822,13,2378,1,360,84,8,5,2,1127,182,25349,2495,322230,347579,11/11/2020
10/3/2020,157,35513,9312,784762,820275,9,2831,9,2387,2,362,82,9,4,2,1129,131,25480,2022,324252,349732,11/11/2020
10/4/2020,81,35594,2369,787131,822725,11,2842,9,2396,1,363,83,8,5,2,1131,78,25558,953,325205,350763,11/11/2020
10/5/2020,174,35768,8982,796113,831881,30,2872,11,2407,2,365,100,9,6,4,1135,160,25718,3028,328233,353951,11/11/2020
10/6/2020,177,35945,11185,807298,843243,11,2883,5,2412,0,365,106,11,7,0,1135,186,25904,2900,331133,357037,11/11/2020
10/7/2020,231,36176,12440,819738,855914,13,2896,14,2426,2,367,103,9,7,2,1137,244,26148,3537,334670,360818,11/11/2020
10/8/2020,262,36438,15233,834971,871409,17,2913,13,2439,2,369,105,7,5,4,1141,274,26422,4208,338878,365300,11/11/2020
10/9/2020,217,36655,13745,848716,885371,21,2934,12,2451,0,369,114,10,7,3,1144,199,26621,4323,343201,369822,11/11/2020
10/10/2020,229,36884,13832,862548,899432,19,2953,10,2461,1,370,122,13,7,2,1146,194,26815,3799,347000,373815,11/11/2020
10/11/2020,97,36981,3263,865811,902792,12,2965,9,2470,1,371,124,14,5,6,1152,88,26903,1165,348165,375068,11/11/2020
10/12/2020,169,37150,6439,872250,909400,19,2984,15,2485,2,373,126,14,5,4,1156,159,27062,1742,349907,376969,11/11/2020
10/13/2020,213,37363,8521,880771,918134,15,2999,15,2500,4,377,122,13,5,7,1163,208,27270,2309,352216,379486,11/11/2020
10/14/2020,322,37685,15038,895809,933494,17,3016,7,2507,0,377,132,15,5,2,1165,303,27573,4044,356260,383833,11/11/2020
10/15/2020,262,37947,14640,910449,948396,12,3028,16,2523,1,378,127,13,5,2,1167,254,27827,3585,359845,387672,11/11/2020
10/16/2020,279,38226,15011,925460,963686,13,3041,20,2543,1,379,119,13,4,2,1169,275,28102,3389,363234,391336,11/11/2020
10/17/2020,354,38580,14068,939528,978108,19,3060,11,2554,1,380,126,17,4,2,1171,311,28413,3268,366502,394915,11/11/2020
10/18/2020,155,38735,4039,943567,982302,18,3078,11,2565,0,380,133,17,6,2,1173,129,28542,1326,367828,396370,11/11/2020
10/19/2020,388,39123,8489,952056,991179,21,3099,23,2588,2,382,129,15,6,1,1174,326,28868,2564,370392,399260,11/11/2020
10/20/2020,439,39562,13242,965298,1004860,22,3121,17,2605,0,382,134,14,8,3,1177,387,29255,3014,373406,402661,11/11/2020
10/21/2020,544,40106,17462,982760,1022866,21,3142,9,2614,2,384,144,15,9,3,1180,473,29728,3529,376935,406663,11/11/2020
10/22/2020,538,40644,15863,998623,1039267,24,3166,21,2635,3,387,144,14,9,3,1183,490,30218,3205,380140,410358,11/11/2020
10/23/2020,514,41158,16632,1015255,1056413,22,3188,26,2661,1,388,139,15,9,3,1186,459,30677,2892,383032,413709,11/11/2020
10/24/2020,359,41517,10248,1025503,1067020,17,3205,11,2672,0,388,145,14,8,1,1187,339,31016,2267,385299,416315,11/11/2020
10/25/2020,233,41750,4762,1030265,1072015,16,3221,15,2687,1,389,145,15,8,2,1189,209,31225,1473,386772,417997,11/11/2020
10/26/2020,454,42204,9174,1039439,1081643,25,3246,20,2707,2,391,148,18,8,3,1192,402,31627,2978,389750,421377,11/11/2020
10/27/2020,517,42721,13992,1053431,1096152,28,3274,11,2718,2,393,163,17,9,4,1196,455,32082,2396,392146,424228,11/11/2020
10/28/2020,469,43190,15230,1068661,1111851,22,3296,23,2741,1,394,161,16,9,3,1199,407,32489,2711,394857,427346,11/11/2020
10/29/2020,609,43799,16234,1084895,1128694,20,3316,18,2759,3,397,160,19,11,4,1203,529,33018,3136,397993,431011,11/11/2020
10/30/2020,544,44343,14318,1099213,1143556,21,3337,20,2779,5,402,156,19,9,4,1207,466,33484,2956,400949,434433,11/11/2020
10/31/2020,585,44928,11843,1111056,1155984,31,3368,12,2791,1,403,174,22,9,3,1210,488,33972,2418,403367,437339,11/11/2020
11/1/2020,329,45257,5073,1116129,1161386,19,3387,15,2806,1,404,177,25,12,4,1214,272,34244,1258,404625,438869,11/11/2020
11/2/2020,520,45777,9918,1126047,1171824,34,3421,27,2833,3,407,181,22,11,5,1219,453,34697,2943,407568,442265,11/11/2020
11/3/2020,603,46380,13060,1139107,1185487,30,3451,24,2857,1,408,186,21,11,1,1220,527,35224,2540,410108,445332,11/11/2020
11/4/2020,679,47059,16119,1155226,1202285,34,3485,23,2880,2,410,195,21,11,4,1224,632,35856,2943,413051,448907,11/11/2020
11/5/2020,759,47818,18883,1174109,1221927,46,3531,33,2913,1,411,207,20,13,3,1227,676,36532,5183,418234,454766,11/11/2020
11/6/2020,776,48594,17199,1191308,1239902,36,3567,29,2942,1,412,213,25,16,5,1232,698,37230,4369,422603,459833,11/11/2020
11/7/2020,606,49200,13247,1204555,1253755,31,3598,23,2965,1,413,220,27,17,1,1233,569,37799,2494,425097,462896,11/11/2020
11/8/2020,338,49538,3964,1208519,1258057,27,3625,25,2990,1,414,221,26,18,3,1236,320,38119,1295,426392,464511,11/11/2020
11/9/2020,789,50327,8670,1217189,1267516,31,3656,30,3020,2,416,220,25,17,3,1239,738,38857,2325,428717,467574,11/11/2020
11/10/2020,1026,51353,12603,1229792,1281145,,,,,,,,,,4,1243,919,39776,2791,431508,471284,11/11/2020
2/27/2020,0,0,0,0,0,1,1,0,0,0,0,1,0,0,0,0,0,0,0,0,0,11/12/2020
2/28/2020,0,0,0,0,0,0,1,0,0,0,0,1,1,0,0,0,0,0,0,0,0,11/12/2020
2/29/2020,0,0,0,0,0,0,1,0,0,0,0,1,1,0,0,0,0,0,0,0,0,11/12/2020
3/1/2020,2,2,2,2,4,0,1,0,0,0,0,1,1,1,0,0,2,2,2,2,4,11/12/2020
3/2/2020,0,2,1,3,5,1,2,0,0,0,0,2,2,2,0,0,0,2,0,2,4,11/12/2020
3/3/2020,0,2,2,5,7,0,2,0,0,0,0,2,2,2,0,0,0,2,1,3,5,11/12/2020
3/4/2020,0,2,12,17,19,1,3,0,0,0,0,3,2,2,0,0,0,2,10,13,15,11/12/2020
3/5/2020,0,2,4,21,23,0,3,0,0,0,0,3,2,2,0,0,1,3,4,17,20,11/12/2020
3/6/2020,1,3,12,33,36,0,3,0,0,0,0,3,2,2,0,0,0,3,11,28,31,11/12/2020
3/7/2020,0,3,19,52,55,0,3,0,0,0,0,3,2,1,0,0,0,3,19,47,50,11/12/2020
3/8/2020,0,3,18,70,73,0,3,0,0,0,0,3,2,1,0,0,0,3,18,65,68,11/12/2020
3/9/2020,1,4,15,85,89,0,3,0,0,0,0,3,2,1,0,0,1,4,14,79,83,11/12/2020
3/10/2020,2,6,25,110,116,0,3,0,0,0,0,3,2,1,0,0,1,5,23,102,107,11/12/2020
3/11/2020,0,6,34,144,150,1,4,0,0,0,0,4,1,1,0,0,0,5,34,136,141,11/12/2020
3/12/2020,9,15,41,185,200,1,5,0,0,0,0,5,1,1,0,0,8,13,38,174,187,11/12/2020
3/13/2020,6,21,50,235,256,4,9,1,1,0,0,8,1,1,0,0,6,19,47,221,240,11/12/2020
3/14/2020,0,21,90,325,346,0,9,0,1,0,0,8,1,1,0,0,0,19,83,304,323,11/12/2020
3/15/2020,1,22,54,379,401,1,10,0,1,0,0,9,2,1,0,0,1,20,53,357,377,11/12/2020
3/16/2020,2,24,95,474,498,2,12,0,1,0,0,11,2,0,0,0,2,22,91,448,470,11/12/2020
3/17/2020,12,36,162,636,672,6,18,0,1,0,0,17,2,0,0,0,11,33,148,596,629,11/12/2020
3/18/2020,9,45,116,752,797,3,21,0,1,0,0,20,2,0,0,0,11,44,110,706,750,11/12/2020
3/19/2020,15,60,262,1014,1074,2,23,1,2,0,0,21,3,0,1,1,17,61,247,953,1014,11/12/2020
3/20/2020,13,73,197,1211,1284,5,28,0,2,0,0,26,4,0,0,1,13,74,187,1140,1214,11/12/2020
3/21/2020,12,85,126,1337,1422,3,31,2,4,0,0,27,5,0,0,1,14,88,122,1262,1350,11/12/2020
3/22/2020,27,112,282,1619,1731,2,33,0,4,0,0,29,5,0,0,1,25,113,257,1519,1632,11/12/2020
3/23/2020,14,126,169,1788,1914,15,48,1,5,0,0,43,9,3,0,1,16,129,161,1680,1809,11/12/2020
3/24/2020,20,146,242,2030,2176,8,56,0,5,0,0,51,10,5,0,1,19,148,230,1910,2058,11/12/2020
3/25/2020,26,172,182,2212,2384,5,61,2,7,0,0,54,11,3,0,1,28,176,164,2074,2250,11/12/2020
3/26/2020,35,207,181,2393,2600,9,70,5,12,0,0,58,14,5,0,1,41,217,169,2243,2460,11/12/2020
3/27/2020,27,234,214,2607,2841,9,79,1,13,1,1,65,16,6,2,3,31,248,195,2438,2686,11/12/2020
3/28/2020,59,293,260,2867,3160,11,90,2,15,1,2,73,15,6,1,4,64,312,240,2678,2990,11/12/2020
3/29/2020,100,393,350,3217,3610,8,98,3,18,1,3,77,18,8,2,6,105,417,309,2987,3404,11/12/2020
3/30/2020,62,455,222,3439,3894,19,117,5,23,0,3,91,19,11,3,9,78,495,181,3168,3663,11/12/2020
3/31/2020,71,526,369,3808,4334,11,128,7,30,1,4,94,21,13,2,11,73,568,294,3462,4030,11/12/2020
4/1/2020,99,625,698,4506,5131,18,146,7,37,0,4,105,29,15,1,12,100,668,626,4088,4756,11/12/2020
4/2/2020,52,677,477,4983,5660,22,168,6,43,2,6,119,35,21,4,16,62,730,426,4514,5244,11/12/2020
4/3/2020,108,785,774,5757,6542,23,191,7,50,0,6,135,42,25,3,19,100,830,695,5209,6039,11/12/2020
4/4/2020,143,928,660,6417,7345,22,213,4,54,5,11,148,40,29,9,28,138,968,604,5813,6781,11/12/2020
4/5/2020,187,1115,1156,7573,8688,20,233,9,63,1,12,158,43,35,2,30,181,1149,1037,6850,7999,11/12/2020
4/6/2020,218,1333,1706,9279,10612,26,259,7,70,0,12,177,47,39,7,37,207,1356,1514,8364,9720,11/12/2020
4/7/2020,284,1617,1629,10908,12525,20,279,4,74,2,14,191,49,41,5,42,261,1617,1457,9821,11438,11/12/2020
4/8/2020,290,1907,1720,12628,14535,19,298,7,81,6,20,197,49,37,10,52,271,1888,1519,11340,13228,11/12/2020
4/9/2020,283,2190,1516,14144,16334,32,330,8,89,4,24,217,53,40,7,59,277,2165,1330,12670,14835,11/12/2020
4/10/2020,419,2609,2574,16718,19327,29,359,17,106,5,29,224,59,41,11,70,400,2565,2318,14988,17553,11/12/2020
4/11/2020,297,2906,1905,18623,21529,29,388,11,117,2,31,240,61,48,12,82,281,2846,1682,16670,19516,11/12/2020
4/12/2020,314,3220,1670,20293,23513,35,423,13,130,5,36,257,59,49,9,91,286,3132,1394,18064,21196,11/12/2020
4/13/2020,161,3381,935,21228,24609,35,458,13,143,3,39,276,64,54,9,100,187,3319,826,18890,22209,11/12/2020
4/14/2020,289,3670,1787,23015,26685,27,485,18,161,5,44,280,72,53,8,108,262,3581,1492,20382,23963,11/12/2020
4/15/2020,351,4021,1799,24814,28835,31,516,20,181,3,47,288,72,54,17,125,306,3887,1509,21891,25778,11/12/2020
4/16/2020,447,4468,2494,27308,31776,36,552,25,206,6,53,293,72,53,14,139,387,4274,2026,23917,28191,11/12/2020
4/17/2020,304,4772,1821,29129,33901,32,584,20,226,7,60,298,66,45,21,160,290,4564,1411,25328,29892,11/12/2020
4/18/2020,321,5093,1725,30854,35947,26,610,18,244,4,64,302,63,49,15,175,284,4848,1296,26624,31472,11/12/2020
4/19/2020,381,5474,2047,32901,38375,23,633,26,270,1,65,298,65,55,11,186,337,5185,1701,28325,33510,11/12/2020
4/20/2020,394,5868,1907,34808,40676,46,679,29,299,2,67,313,75,56,10,196,376,5561,1546,29871,35432,11/12/2020
4/21/2020,444,6312,2110,36918,43230,45,724,32,331,5,72,321,72,56,18,214,383,5944,1668,31539,37483,11/12/2020
4/22/2020,418,6730,2390,39308,46038,41,765,32,363,5,77,325,73,58,18,232,379,6323,1872,33411,39734,11/12/2020
4/23/2020,479,7209,2469,41777,48986,32,797,28,391,5,82,324,76,62,15,247,412,6735,1823,35234,41969,11/12/2020
4/24/2020,491,7700,3284,45061,52761,35,832,26,417,4,86,329,85,63,15,262,407,7142,2564,37798,44940,11/12/2020
4/25/2020,393,8093,2206,47267,55360,34,866,17,434,5,91,341,85,62,14,276,299,7441,1727,39525,46966,11/12/2020
4/26/2020,316,8409,2309,49576,57985,33,899,15,449,3,94,356,86,59,14,290,274,7715,1837,41362,49077,11/12/2020
4/27/2020,249,8658,1620,51196,59854,29,928,21,470,4,98,360,86,61,10,300,206,7921,1133,42495,50416,11/12/2020
4/28/2020,410,9068,2263,53459,62527,44,972,24,494,3,101,377,88,59,22,322,332,8253,1678,44173,52426,11/12/2020
4/29/2020,476,9544,3343,56802,66346,36,1008,38,532,11,112,364,78,53,18,340,370,8623,2332,46505,55128,11/12/2020
4/30/2020,432,9976,2769,59571,69547,33,1041,38,570,6,118,353,83,57,24,364,349,8972,1854,48359,57331,11/12/2020
5/1/2020,454,10430,3086,62657,73087,51,1092,39,609,3,121,362,84,58,14,378,323,9295,2110,50469,59764,11/12/2020
5/2/2020,257,10687,1926,64583,75270,36,1128,38,647,5,126,355,93,63,24,402,192,9487,1243,51712,61199,11/12/2020
5/3/2020,283,10970,2160,66743,77713,31,1159,26,673,8,134,352,91,61,21,423,183,9670,1530,53242,62912,11/12/2020
5/4/2020,387,11357,2098,68841,80198,30,1189,31,704,6,140,345,89,58,18,441,290,9960,1527,54769,64729,11/12/2020
5/5/2020,433,11790,2873,71714,83504,29,1218,32,736,6,146,336,83,55,16,457,300,10260,1921,56690,66950,11/12/2020
5/6/2020,488,12278,2830,74544,86822,28,1246,44,780,9,155,311,80,55,21,478,340,10600,1885,58575,69175,11/12/2020
5/7/2020,425,12703,2969,77513,90216,36,1282,43,823,5,160,299,72,53,21,499,269,10869,1927,60502,71371,11/12/2020
5/8/2020,359,13062,2598,80111,93173,30,1312,29,852,5,165,295,72,54,22,521,229,11098,1706,62208,73306,11/12/2020
5/9/2020,467,13529,3346,83457,96986,22,1334,21,873,4,169,292,70,52,15,536,290,11388,2200,64408,75796,11/12/2020
5/10/2020,285,13814,2117,85574,99388,20,1354,23,896,6,175,283,71,50,14,550,189,11577,1486,65894,77471,11/12/2020
5/11/2020,257,14071,1857,87431,101502,31,1385,16,912,6,181,292,72,50,15,565,174,11751,1272,67166,78917,11/12/2020
5/12/2020,387,14458,2611,90042,104500,23,1408,18,930,4,185,293,70,49,22,587,224,11975,1631,68797,80772,11/12/2020
5/13/2020,351,14809,3630,93672,108481,23,1431,25,955,1,186,290,70,50,13,600,199,12174,1914,70711,82885,11/12/2020
5/14/2020,329,15138,3408,97080,112218,19,1450,27,982,3,189,279,65,46,15,615,232,12406,1952,72663,85069,11/12/2020
5/15/2020,381,15519,3458,100538,116057,24,1474,41,1023,5,194,257,63,46,14,629,232,12638,1763,74426,87064,11/12/2020
5/16/2020,449,15968,4156,104694,120662,25,1499,15,1038,5,199,262,62,47,15,644,247,12885,1906,76332,89217,11/12/2020
5/17/2020,240,16208,2768,107462,123670,17,1516,9,1047,5,204,265,60,46,10,654,126,13011,1514,77846,90857,11/12/2020
5/18/2020,250,16458,2001,109463,125921,19,1535,16,1063,5,209,263,58,41,18,672,135,13146,1349,79195,92341,11/12/2020
5/19/2020,415,16873,3168,112631,129504,23,1558,33,1096,5,214,248,57,39,11,683,215,13361,1894,81089,94450,11/12/2020
5/20/2020,326,17199,2771,115402,132601,19,1577,23,1119,7,221,237,53,34,22,705,184,13545,1497,82586,96131,11/12/2020
5/21/2020,374,17573,3757,119159,136732,25,1602,15,1134,3,224,244,54,30,20,725,168,13713,1912,84498,98211,11/12/2020
5/22/2020,351,17924,3161,122320,140244,20,1622,28,1162,5,229,231,53,30,11,736,206,13919,1576,86074,99993,11/12/2020
5/23/2020,253,18177,2742,125062,143239,19,1641,11,1173,3,232,236,53,33,13,749,109,14028,1248,87322,101350,11/12/2020
5/24/2020,163,18340,1370,126432,144772,13,1654,14,1187,2,234,233,54,36,8,757,83,14111,764,88086,102197,11/12/2020
5/25/2020,147,18487,1385,127817,146304,14,1668,14,1201,0,234,233,54,34,10,767,76,14187,746,88832,103019,11/12/2020
5/26/2020,285,18772,2620,130437,149209,24,1692,21,1222,5,239,231,49,33,15,782,158,14345,1734,90566,104911,11/12/2020
5/27/2020,276,19048,2057,132494,151542,20,1712,18,1240,3,242,230,51,33,10,792,132,14477,1119,91685,106162,11/12/2020
5/28/2020,348,19396,3359,135853,155249,17,1729,29,1269,4,246,214,47,32,8,800,130,14607,1105,92790,107397,11/12/2020
5/29/2020,410,19806,3915,139768,159574,19,1748,26,1295,7,253,200,43,31,12,812,174,14781,1549,94339,109120,11/12/2020
5/30/2020,225,20031,3915,143683,163714,16,1764,19,1314,4,257,193,41,29,12,824,109,14890,1782,96121,111011,11/12/2020
5/31/2020,155,20186,1690,145373,165559,11,1775,11,1325,1,258,192,44,26,3,827,78,14968,840,96961,111929,11/12/2020
6/1/2020,212,20398,2792,148165,168563,8,1783,14,1339,1,259,185,45,29,5,832,93,15061,1362,98323,113384,11/12/2020
6/2/2020,273,20671,3022,151187,171858,8,1791,10,1349,3,262,180,38,25,10,842,98,15159,1413,99736,114895,11/12/2020
6/3/2020,254,20925,3486,154673,175598,14,1805,18,1367,6,268,170,34,25,11,853,99,15258,1637,101373,116631,11/12/2020
6/4/2020,276,21201,4471,159144,180345,7,1812,26,1393,4,272,147,31,24,12,865,107,15365,2002,103375,118740,11/12/2020
6/5/2020,215,21416,3513,162657,184073,15,1827,13,1406,6,278,143,27,21,11,876,99,15464,1536,104911,120375,11/12/2020
6/6/2020,201,21617,2616,165273,186890,10,1837,7,1413,2,280,144,29,19,6,882,67,15531,1105,106016,121547,11/12/2020
6/7/2020,83,21700,1625,166898,188598,11,1848,7,1420,1,281,147,25,17,4,886,51,15582,776,106792,122374,11/12/2020
6/8/2020,119,21819,1849,168747,190566,15,1863,13,1433,2,283,147,27,18,4,890,45,15627,943,107735,123362,11/12/2020
6/9/2020,223,22042,2673,171420,193462,10,1873,19,1452,0,283,138,28,21,1,891,64,15691,1238,108973,124664,11/12/2020
6/10/2020,209,22251,2987,174407,196658,13,1886,12,1464,2,285,137,24,17,4,895,100,15791,1447,110420,126211,11/12/2020
6/11/2020,195,22446,3513,177920,200366,7,1893,15,1479,1,286,128,25,16,6,901,88,15879,1510,111930,127809,11/12/2020
6/12/2020,209,22655,4601,182521,205176,9,1902,16,1495,1,287,120,24,16,2,903,78,15957,2153,114083,130040,11/12/2020
6/13/2020,113,22768,3036,185557,208325,6,1908,5,1500,0,287,121,20,15,3,906,49,16006,1357,115440,131446,11/12/2020
6/14/2020,81,22849,2046,187603,210452,7,1915,8,1508,1,288,119,20,14,3,909,33,16039,957,116397,132436,11/12/2020
6/15/2020,188,23037,3108,190711,213748,14,1929,19,1527,0,288,114,20,16,5,914,75,16114,1762,118159,134273,11/12/2020
6/16/2020,110,23147,3017,193728,216875,11,1940,9,1536,1,289,115,22,16,8,922,50,16164,1516,119675,135839,11/12/2020
6/17/2020,127,23274,2835,196563,219837,15,1955,21,1557,4,293,105,18,14,6,928,50,16214,1295,120970,137184,11/12/2020
6/18/2020,149,23423,3048,199611,223034,9,1964,15,1572,1,294,98,19,16,7,935,70,16284,1304,122274,138558,11/12/2020
6/19/2020,141,23564,3769,203380,226944,12,1976,12,1584,1,295,97,20,17,3,938,59,16343,1343,123617,139960,11/12/2020
6/20/2020,84,23648,1891,205271,228919,9,1985,12,1596,0,295,94,20,18,4,942,36,16379,806,124423,140802,11/12/2020
6/21/2020,37,23685,1064,206335,230020,8,1993,5,1601,0,295,97,20,18,2,944,30,16409,684,125107,141516,11/12/2020
6/22/2020,138,23823,3730,210065,233888,12,2005,17,1618,0,295,92,19,18,2,946,65,16474,1685,126792,143266,11/12/2020
6/23/2020,163,23986,3831,213896,237882,3,2008,13,1631,3,298,79,18,18,7,953,81,16555,1761,128553,145108,11/12/2020
6/24/2020,120,24106,3502,217398,241504,9,2017,11,1642,1,299,76,18,18,5,958,44,16599,1665,130218,146817,11/12/2020
6/25/2020,103,24209,2883,220281,244490,6,2023,14,1656,1,300,67,17,17,1,959,50,16649,1483,131701,148350,11/12/2020
6/26/2020,94,24303,2488,222769,247072,2,2025,10,1666,0,300,59,18,18,1,960,60,16709,1311,133012,149721,11/12/2020
6/27/2020,84,24387,3216,225985,250372,5,2030,3,1669,1,301,60,17,17,5,965,37,16746,1197,134209,150955,11/12/2020
6/28/2020,39,24426,1469,227454,251880,4,2034,4,1673,4,305,56,15,14,6,971,17,16763,588,134797,151560,11/12/2020
6/29/2020,85,24511,3697,231151,255662,4,2038,5,1678,0,305,55,14,14,1,972,39,16802,1336,136133,152935,11/12/2020
6/30/2020,57,24568,1958,233109,257677,1,2039,5,1683,1,306,50,12,11,4,976,33,16835,987,137120,153955,11/12/2020
7/1/2020,144,24712,4098,237207,261919,8,2047,10,1693,0,306,48,11,11,1,977,79,16914,1905,139025,155939,11/12/2020
7/2/2020,103,24815,2803,240010,264825,5,2052,5,1698,1,307,47,10,10,3,980,59,16973,1071,140096,157069,11/12/2020
7/3/2020,50,24865,2079,242089,266954,9,2061,6,1704,0,307,50,9,9,3,983,25,16998,775,140871,157869,11/12/2020
7/4/2020,57,24922,2345,244434,269356,2,2063,4,1708,1,308,47,10,9,2,985,33,17031,990,141861,158892,11/12/2020
7/5/2020,49,24971,2932,247366,272337,1,2064,2,1710,1,309,45,8,8,2,987,26,17057,1420,143281,160338,11/12/2020
7/6/2020,101,25072,2814,250180,275252,6,2070,6,1716,0,309,45,9,9,4,991,57,17114,1534,144815,161929,11/12/2020
7/7/2020,81,25153,3457,253637,278790,5,2075,7,1723,0,309,43,8,8,2,993,47,17161,1525,146340,163501,11/12/2020
7/8/2020,105,25258,3409,257046,282304,4,2079,2,1725,0,309,45,9,8,0,993,64,17225,1401,147741,164966,11/12/2020
7/9/2020,94,25352,3714,260760,286112,9,2088,3,1728,0,309,51,9,8,0,993,50,17275,1602,149343,166618,11/12/2020
7/10/2020,132,25484,4437,265197,290681,6,2094,3,1731,2,311,52,7,7,3,996,80,17355,2053,151396,168751,11/12/2020
7/11/2020,63,25547,2938,268135,293682,6,2100,3,1734,1,312,54,6,6,3,999,36,17391,1306,152702,170093,11/12/2020
7/12/2020,47,25594,1838,269973,295567,1,2101,3,1737,1,313,51,6,5,3,1002,34,17425,932,153634,171059,11/12/2020
7/13/2020,84,25678,3209,273182,298860,8,2109,10,1747,0,313,49,6,5,1,1003,61,17486,1489,155123,172609,11/12/2020
7/14/2020,74,25752,3298,276480,302232,7,2116,4,1751,0,313,52,5,5,1,1004,44,17530,1365,156488,174018,11/12/2020
7/15/2020,130,25882,4181,280661,306543,5,2121,7,1758,0,313,50,5,4,0,1004,100,17630,1734,158222,175852,11/12/2020
7/16/2020,103,25985,3740,284401,310386,6,2127,9,1767,0,313,47,6,5,1,1005,76,17706,1600,159822,177528,11/12/2020
7/17/2020,156,26141,4239,288640,314781,14,2141,3,1770,1,314,57,5,5,2,1007,79,17785,1832,161654,179439,11/12/2020
7/18/2020,85,26226,3272,291912,318138,5,2146,9,1779,1,315,52,5,4,4,1011,70,17855,1382,163036,180891,11/12/2020
7/19/2020,82,26308,2696,294608,320916,7,2153,3,1782,0,315,56,6,4,2,1013,57,17912,1137,164173,182085,11/12/2020
7/20/2020,71,26379,2666,297274,323653,9,2162,7,1789,0,315,58,7,5,2,1015,68,17980,1442,165615,183595,11/12/2020
7/21/2020,130,26509,4304,301578,328087,9,2171,11,1800,0,315,56,9,6,1,1016,108,18088,1899,167514,185602,11/12/2020
7/22/2020,130,26639,3928,305506,332145,7,2178,8,1808,1,316,54,7,6,1,1017,86,18174,1664,169178,187352,11/12/2020
7/23/2020,141,26780,4415,309921,336701,8,2186,6,1814,0,316,56,8,7,0,1017,115,18289,1954,171132,189421,11/12/2020
7/24/2020,172,26952,5966,315887,342839,15,2201,12,1826,0,316,59,9,7,0,1017,119,18408,2294,173426,191834,11/12/2020
7/25/2020,134,27086,4398,320285,347371,7,2208,7,1833,0,316,59,10,8,3,1020,108,18516,2075,175501,194017,11/12/2020
7/26/2020,62,27148,3033,323318,350466,8,2216,9,1842,0,316,58,11,7,1,1021,54,18570,1324,176825,195395,11/12/2020
7/27/2020,188,27336,4191,327509,354845,12,2228,7,1849,0,316,63,13,8,1,1022,138,18708,2326,179151,197859,11/12/2020
7/28/2020,105,27441,3840,331349,358790,5,2233,5,1854,0,316,63,14,7,1,1023,95,18803,1621,180772,199575,11/12/2020
7/29/2020,190,27631,5139,336488,364119,9,2242,10,1864,0,316,62,15,7,0,1023,154,18957,2285,183057,202014,11/12/2020
7/30/2020,121,27752,4345,340833,368585,6,2248,2,1866,1,317,65,15,6,1,1024,97,19054,1631,184688,203742,11/12/2020
7/31/2020,131,27883,5512,346345,374228,7,2255,9,1875,0,317,63,15,7,1,1025,89,19143,1818,186506,205649,11/12/2020
8/1/2020,109,27992,4294,350639,378631,7,2262,2,1877,0,317,68,14,7,1,1026,89,19232,1546,188052,207284,11/12/2020
8/2/2020,84,28076,2804,353443,381519,12,2274,12,1889,2,319,66,14,8,2,1028,62,19294,1257,189309,208603,11/12/2020
8/3/2020,188,28264,5248,358691,386955,11,2285,10,1899,0,319,67,16,7,1,1029,150,19444,2183,191492,210936,11/12/2020
8/4/2020,125,28389,3691,362382,390771,8,2293,5,1904,1,320,69,12,5,2,1031,99,19543,1750,193242,212785,11/12/2020
8/5/2020,147,28536,5935,368317,396853,11,2304,9,1913,1,321,70,10,5,2,1033,119,19662,2442,195684,215346,11/12/2020
8/6/2020,169,28705,5546,373863,402568,7,2311,9,1922,0,321,68,9,4,0,1033,120,19782,2376,198060,217842,11/12/2020
8/7/2020,123,28828,4851,378714,407542,12,2323,9,1931,1,322,70,9,3,2,1035,87,19869,2117,200177,220046,11/12/2020
8/8/2020,123,28951,4112,382826,411777,19,2342,6,1937,1,323,82,8,3,1,1036,91,19960,1768,201945,221905,11/12/2020
8/9/2020,42,28993,1727,384553,413546,6,2348,8,1945,0,323,80,9,4,0,1036,35,19995,1060,203005,223000,11/12/2020
8/10/2020,149,29142,4587,389140,418282,8,2356,9,1954,0,323,79,9,4,1,1037,113,20108,2004,205009,225117,11/12/2020
8/11/2020,106,29248,4334,393474,422722,5,2361,13,1967,0,323,71,10,4,3,1040,92,20200,2249,207258,227458,11/12/2020
8/12/2020,121,29369,5188,398662,428031,8,2369,11,1978,0,323,68,9,3,1,1041,101,20301,2599,209857,230158,11/12/2020
8/13/2020,135,29504,4196,402858,432362,13,2382,12,1990,0,323,69,11,3,0,1041,95,20396,1888,211745,232141,11/12/2020
8/14/2020,145,29649,5498,408356,438005,13,2395,11,2001,0,323,71,11,4,3,1044,98,20494,1959,213704,234198,11/12/2020
8/15/2020,106,29755,4534,412890,442645,9,2404,11,2012,1,324,68,11,5,0,1044,88,20582,1671,215375,235957,11/12/2020
8/16/2020,83,29838,2477,415367,445205,6,2410,5,2017,4,328,65,8,4,6,1050,70,20652,950,216325,236977,11/12/2020
8/17/2020,106,29944,4575,419942,449886,8,2418,6,2023,0,328,67,8,5,2,1052,87,20739,2365,218690,239429,11/12/2020
8/18/2020,128,30072,4911,424853,454925,11,2429,8,2031,1,329,69,8,4,5,1057,94,20833,2728,221418,242251,11/12/2020
8/19/2020,113,30185,5077,429930,460115,8,2437,9,2040,1,330,67,9,5,0,1057,90,20923,2614,224032,244955,11/12/2020
8/20/2020,173,30358,7411,437341,467699,12,2449,6,2046,2,332,71,10,5,3,1060,139,21062,3482,227514,248576,11/12/2020
8/21/2020,151,30509,6577,443918,474427,8,2457,5,2051,1,333,73,9,4,2,1062,125,21187,2917,230431,251618,11/12/2020
8/22/2020,96,30605,5550,449468,480073,11,2468,12,2063,0,333,72,11,4,1,1063,84,21271,2574,233005,254276,11/12/2020
8/23/2020,71,30676,4375,453843,484519,11,2479,6,2069,0,333,77,12,2,1,1064,56,21327,2457,235462,256789,11/12/2020
8/24/2020,105,30781,5784,459627,490408,7,2486,10,2079,1,334,73,14,4,1,1065,77,21404,3128,238590,259994,11/12/2020
8/25/2020,108,30889,4764,464391,495280,10,2496,4,2083,1,335,78,12,4,1,1066,92,21496,2273,240863,262359,11/12/2020
8/26/2020,170,31059,9482,473873,504932,4,2500,8,2091,0,335,74,10,5,1,1067,127,21623,3064,243927,265550,11/12/2020
8/27/2020,92,31151,8565,482438,513589,6,2506,13,2104,1,336,66,7,5,2,1069,70,21693,3129,247056,268749,11/12/2020
8/28/2020,113,31264,7994,490432,521696,14,2520,4,2108,0,336,76,10,7,2,1071,87,21780,2411,249467,271247,11/12/2020
8/29/2020,65,31329,5374,495806,527135,6,2526,8,2116,1,337,73,11,6,2,1073,51,21831,1902,251369,273200,11/12/2020
8/30/2020,66,31395,4323,500129,531524,7,2533,4,2120,0,337,76,9,5,2,1075,48,21879,1978,253347,275226,11/12/2020
8/31/2020,105,31500,4863,504992,536492,12,2545,16,2136,0,337,72,8,4,1,1076,81,21960,2170,255517,277477,11/12/2020
9/1/2020,98,31598,7109,512101,543699,6,2551,9,2145,1,338,68,7,4,2,1078,66,22026,2361,257878,279904,11/12/2020
9/2/2020,125,31723,10529,522630,554353,9,2560,10,2155,1,339,66,8,4,2,1080,104,22130,3025,260903,283033,11/12/2020
9/3/2020,90,31813,11079,533709,565522,8,2568,8,2163,0,339,66,9,4,3,1083,73,22203,2563,263466,285669,11/12/2020
9/4/2020,103,31916,8963,542672,574588,11,2579,4,2167,0,339,73,9,4,1,1084,83,22286,2359,265825,288111,11/12/2020
9/5/2020,52,31968,6309,548981,580949,6,2585,9,2176,0,339,70,8,3,1,1085,42,22328,1591,267416,289744,11/12/2020
9/6/2020,88,32056,4325,553306,585362,4,2589,8,2184,1,340,65,6,3,1,1086,65,22393,1938,269354,291747,11/12/2020
9/7/2020,35,32091,3002,556308,588399,11,2600,3,2187,0,340,73,5,3,1,1087,26,22419,640,269994,292413,11/12/2020
9/8/2020,74,32165,6381,562689,594854,6,2606,12,2199,1,341,66,6,3,2,1089,66,22485,1580,271574,294059,11/12/2020
9/9/2020,118,32283,8650,571339,603622,10,2616,5,2204,1,342,70,9,3,1,1090,102,22587,2131,273705,296292,11/12/2020
9/10/2020,164,32447,11334,582673,615120,9,2625,8,2212,0,342,71,10,3,1,1091,111,22698,2258,275963,298661,11/12/2020
9/11/2020,120,32567,9454,592127,624694,11,2636,11,2223,0,342,71,10,5,0,1091,97,22795,1956,277919,300714,11/12/2020
9/12/2020,110,32677,6173,598300,630977,8,2644,5,2228,2,344,72,9,5,3,1094,97,22892,1511,279430,302322,11/12/2020
9/13/2020,58,32735,2716,601016,633751,4,2648,3,2231,0,344,73,10,5,0,1094,54,22946,858,280288,303234,11/12/2020
9/14/2020,104,32839,6446,607462,640301,6,2654,3,2234,2,346,74,10,5,2,1096,95,23041,1721,282009,305050,11/12/2020
9/15/2020,122,32961,8466,615928,648889,7,2661,2,2236,1,347,78,10,5,2,1098,124,23165,2182,284191,307356,11/12/2020
9/16/2020,137,33098,9715,625643,658741,7,2668,7,2243,2,349,76,9,6,5,1103,118,23283,1963,286154,309437,11/12/2020
9/17/2020,125,33223,9239,634882,668105,7,2675,15,2258,0,349,68,8,4,0,1103,154,23437,1935,288089,311526,11/12/2020
9/18/2020,132,33355,10045,644927,678282,7,2682,7,2265,1,350,67,11,6,2,1105,132,23569,1917,290006,313575,11/12/2020
9/19/2020,115,33470,8297,653224,686694,7,2689,3,2268,0,350,71,10,6,4,1109,112,23681,1685,291691,315372,11/12/2020
9/20/2020,60,33530,3676,656900,690430,7,2696,6,2274,2,352,70,9,8,4,1113,49,23730,1321,293012,316742,11/12/2020
9/21/2020,102,33632,7018,663918,697550,12,2708,3,2277,2,354,77,8,6,2,1115,94,23824,2398,295410,319234,11/12/2020
9/22/2020,154,33786,9287,673205,706991,12,2720,3,2280,1,355,85,7,5,1,1116,124,23948,2198,297608,321556,11/12/2020
9/23/2020,136,33922,10650,683855,717777,12,2732,7,2287,0,355,90,6,5,0,1116,127,24075,2208,299816,323891,11/12/2020
9/24/2020,120,34042,12479,696334,730376,7,2739,9,2296,1,356,87,7,5,1,1117,121,24196,3153,302969,327165,11/12/2020
9/25/2020,149,34191,10553,706887,741078,9,2748,10,2306,0,356,86,6,5,1,1118,142,24338,2991,305960,330298,11/12/2020
9/26/2020,146,34337,10559,717446,751783,12,2760,9,2315,0,356,89,6,5,1,1119,119,24457,2413,308373,332830,11/12/2020
9/27/2020,43,34380,2764,720210,754590,7,2767,5,2320,0,356,91,9,5,0,1119,34,24491,841,309214,333705,11/12/2020
9/28/2020,152,34532,7308,727518,762050,7,2774,7,2327,2,358,89,7,5,2,1121,134,24625,2254,311468,336093,11/12/2020
9/29/2020,208,34740,11046,738564,773304,12,2786,18,2345,1,359,82,6,6,1,1122,190,24815,2820,314288,339103,11/12/2020
9/30/2020,221,34961,12230,750794,785755,6,2792,6,2351,0,359,82,6,6,1,1123,187,25002,2580,316868,341870,11/12/2020
10/1/2020,185,35146,12503,763297,798443,17,2809,13,2364,1,360,85,6,4,2,1125,166,25168,2405,319273,344441,11/12/2020
10/2/2020,210,35356,12153,775450,810806,14,2823,13,2377,1,361,85,8,5,2,1127,182,25350,2495,321768,347118,11/12/2020
10/3/2020,157,35513,9312,784762,820275,9,2832,9,2386,2,363,83,9,4,2,1129,131,25481,2020,323788,349269,11/12/2020
10/4/2020,81,35594,2369,787131,822725,11,2843,9,2395,1,364,84,8,5,2,1131,78,25559,952,324740,350299,11/12/2020
10/5/2020,174,35768,8982,796113,831881,30,2873,11,2406,2,366,101,9,6,4,1135,160,25719,3027,327767,353486,11/12/2020
10/6/2020,177,35945,11185,807298,843243,11,2884,5,2411,0,366,107,11,7,0,1135,186,25905,2900,330667,356572,11/12/2020
10/7/2020,231,36176,12440,819738,855914,13,2897,14,2425,2,368,104,9,7,2,1137,244,26149,3532,334199,360348,11/12/2020
10/8/2020,262,36438,15233,834971,871409,17,2914,13,2438,2,370,106,7,5,4,1141,274,26423,4207,338406,364829,11/12/2020
10/9/2020,217,36655,13745,848716,885371,21,2935,12,2450,0,370,115,10,7,3,1144,199,26622,4319,342725,369347,11/12/2020
10/10/2020,229,36884,13832,862548,899432,19,2954,10,2460,1,371,123,13,7,2,1146,194,26816,3797,346522,373338,11/12/2020
10/11/2020,97,36981,3263,865811,902792,12,2966,9,2469,1,372,125,14,5,6,1152,88,26904,1164,347686,374590,11/12/2020
10/12/2020,169,37150,6439,872250,909400,19,2985,15,2484,2,374,127,14,5,4,1156,159,27063,1737,349423,376486,11/12/2020
10/13/2020,213,37363,8521,880771,918134,15,3000,15,2499,4,378,123,13,5,7,1163,208,27271,2308,351731,379002,11/12/2020
10/14/2020,322,37685,15038,895809,933494,17,3017,7,2506,0,378,133,15,5,2,1165,303,27574,4041,355772,383346,11/12/2020
10/15/2020,262,37947,14640,910449,948396,12,3029,16,2522,1,379,128,13,5,2,1167,254,27828,3578,359350,387178,11/12/2020
10/16/2020,279,38226,15011,925460,963686,13,3042,20,2542,1,380,120,13,4,2,1169,275,28103,3388,362738,390841,11/12/2020
10/17/2020,354,38580,14068,939528,978108,19,3061,11,2553,1,381,127,17,4,2,1171,311,28414,3267,366005,394419,11/12/2020
10/18/2020,155,38735,4039,943567,982302,18,3079,11,2564,0,381,134,17,6,2,1173,129,28543,1326,367331,395874,11/12/2020
10/19/2020,388,39123,8489,952056,991179,21,3100,23,2587,2,383,130,15,6,1,1174,325,28868,2563,369894,398762,11/12/2020
10/20/2020,439,39562,13242,965298,1004860,22,3122,17,2604,0,383,135,14,8,3,1177,387,29255,3014,372908,402163,11/12/2020
10/21/2020,544,40106,17462,982760,1022866,21,3143,9,2613,2,385,145,15,9,3,1180,473,29728,3526,376434,406162,11/12/2020
10/22/2020,538,40644,15863,998623,1039267,24,3167,21,2634,3,388,145,14,9,3,1183,490,30218,3199,379633,409851,11/12/2020
10/23/2020,514,41158,16632,1015255,1056413,22,3189,26,2660,1,389,140,15,9,3,1186,460,30678,2889,382522,413200,11/12/2020
10/24/2020,359,41517,10248,1025503,1067020,17,3206,11,2671,0,389,146,14,8,1,1187,338,31016,2266,384788,415804,11/12/2020
10/25/2020,233,41750,4762,1030265,1072015,16,3222,15,2686,1,390,146,15,8,2,1189,209,31225,1471,386259,417484,11/12/2020
10/26/2020,454,42204,9174,1039439,1081643,25,3247,20,2706,2,392,149,18,8,3,1192,402,31627,2976,389235,420862,11/12/2020
10/27/2020,517,42721,13993,1053432,1096153,28,3275,11,2717,2,394,164,17,9,4,1196,454,32081,2394,391629,423710,11/12/2020
10/28/2020,469,43190,15230,1068662,1111852,22,3297,23,2740,1,395,162,16,9,3,1199,407,32488,2707,394336,426824,11/12/2020
10/29/2020,609,43799,16234,1084896,1128695,20,3317,18,2758,3,398,161,19,11,4,1203,529,33017,3131,397467,430484,11/12/2020
10/30/2020,544,44343,14319,1099215,1143558,21,3338,20,2778,5,403,157,19,9,4,1207,466,33483,2955,400422,433905,11/12/2020
10/31/2020,585,44928,11843,1111058,1155986,31,3369,12,2790,1,404,175,22,9,3,1210,488,33971,2417,402839,436810,11/12/2020
11/1/2020,329,45257,5073,1116131,1161388,19,3388,15,2805,1,405,178,25,12,4,1214,272,34243,1258,404097,438340,11/12/2020
11/2/2020,520,45777,9918,1126049,1171826,34,3422,27,2832,3,408,182,22,11,5,1219,453,34696,2941,407038,441734,11/12/2020
11/3/2020,603,46380,13060,1139109,1185489,31,3453,24,2856,1,409,188,21,11,1,1220,528,35224,2536,409574,444798,11/12/2020
11/4/2020,679,47059,16119,1155228,1202287,34,3487,23,2879,2,411,197,21,11,4,1224,630,35854,2940,412514,448368,11/12/2020
11/5/2020,759,47818,18883,1174111,1221929,46,3533,33,2912,1,412,209,20,13,3,1227,674,36528,5180,417694,454222,11/12/2020
11/6/2020,776,48594,17197,1191308,1239902,37,3570,29,2941,1,413,216,25,16,5,1232,698,37226,4361,422055,459281,11/12/2020
11/7/2020,606,49200,13245,1204553,1253753,31,3601,24,2965,1,414,222,27,17,1,1233,570,37796,2492,424547,462343,11/12/2020
11/8/2020,338,49538,3964,1208517,1258055,28,3629,25,2990,1,415,224,26,18,3,1236,319,38115,1293,425840,463955,11/12/2020
11/9/2020,789,50327,8672,1217189,1267516,35,3664,32,3022,2,417,225,25,17,3,1239,744,38859,2325,428165,467024,11/12/2020
11/10/2020,1062,51389,12867,1230056,1281445,37,3701,30,3052,0,417,232,28,17,5,1244,969,39828,2910,431075,470903,11/12/2020
11/11/2020,1021,52410,18820,1248876,1301286,,,,,,,,,,6,1250,936,40764,2575,433650,474414,11/12/2020
2/27/2020,0,0,0,0,0,1,1,0,0,0,0,1,0,0,0,0,0,0,0,0,0,11/13/2020
2/28/2020,0,0,0,0,0,0,1,0,0,0,0,1,1,0,0,0,0,0,0,0,0,11/13/2020
2/29/2020,0,0,0,0,0,0,1,0,0,0,0,1,1,0,0,0,0,0,0,0,0,11/13/2020
3/1/2020,2,2,2,2,4,0,1,0,0,0,0,1,1,1,0,0,2,2,2,2,4,11/13/2020
3/2/2020,0,2,1,3,5,1,2,0,0,0,0,2,2,2,0,0,0,2,0,2,4,11/13/2020
3/3/2020,0,2,2,5,7,0,2,0,0,0,0,2,2,2,0,0,0,2,1,3,5,11/13/2020
3/4/2020,0,2,12,17,19,1,3,0,0,0,0,3,2,2,0,0,0,2,10,13,15,11/13/2020
3/5/2020,0,2,4,21,23,0,3,0,0,0,0,3,2,2,0,0,1,3,4,17,20,11/13/2020
3/6/2020,1,3,12,33,36,0,3,0,0,0,0,3,2,2,0,0,0,3,11,28,31,11/13/2020
3/7/2020,0,3,19,52,55,0,3,0,0,0,0,3,2,1,0,0,0,3,19,47,50,11/13/2020
3/8/2020,0,3,18,70,73,0,3,0,0,0,0,3,2,1,0,0,0,3,18,65,68,11/13/2020
3/9/2020,1,4,15,85,89,0,3,0,0,0,0,3,2,1,0,0,1,4,14,79,83,11/13/2020
3/10/2020,2,6,25,110,116,0,3,0,0,0,0,3,2,1,0,0,1,5,23,102,107,11/13/2020
3/11/2020,0,6,34,144,150,1,4,0,0,0,0,4,1,1,0,0,0,5,34,136,141,11/13/2020
3/12/2020,9,15,41,185,200,1,5,0,0,0,0,5,1,1,0,0,8,13,38,174,187,11/13/2020
3/13/2020,6,21,50,235,256,4,9,1,1,0,0,8,1,1,0,0,6,19,47,221,240,11/13/2020
3/14/2020,0,21,90,325,346,0,9,0,1,0,0,8,1,1,0,0,0,19,83,304,323,11/13/2020
3/15/2020,1,22,54,379,401,1,10,0,1,0,0,9,2,1,0,0,1,20,53,357,377,11/13/2020
3/16/2020,2,24,95,474,498,2,12,0,1,0,0,11,2,0,0,0,2,22,91,448,470,11/13/2020
3/17/2020,12,36,162,636,672,6,18,0,1,0,0,17,2,0,0,0,11,33,148,596,629,11/13/2020
3/18/2020,9,45,116,752,797,3,21,0,1,0,0,20,2,0,0,0,11,44,110,706,750,11/13/2020
3/19/2020,15,60,262,1014,1074,2,23,1,2,0,0,21,3,0,1,1,17,61,247,953,1014,11/13/2020
3/20/2020,13,73,197,1211,1284,5,28,0,2,0,0,26,4,0,0,1,13,74,187,1140,1214,11/13/2020
3/21/2020,12,85,126,1337,1422,3,31,2,4,0,0,27,5,0,0,1,14,88,122,1262,1350,11/13/2020
3/22/2020,27,112,282,1619,1731,2,33,0,4,0,0,29,5,0,0,1,25,113,257,1519,1632,11/13/2020
3/23/2020,14,126,169,1788,1914,15,48,1,5,0,0,43,9,3,0,1,16,129,161,1680,1809,11/13/2020
3/24/2020,20,146,242,2030,2176,8,56,0,5,0,0,51,10,5,0,1,19,148,229,1909,2057,11/13/2020
3/25/2020,26,172,182,2212,2384,5,61,2,7,0,0,54,11,3,0,1,28,176,163,2072,2248,11/13/2020
3/26/2020,35,207,181,2393,2600,9,70,5,12,0,0,58,14,5,0,1,41,217,169,2241,2458,11/13/2020
3/27/2020,27,234,214,2607,2841,9,79,1,13,1,1,65,16,6,2,3,31,248,195,2436,2684,11/13/2020
3/28/2020,59,293,260,2867,3160,11,90,2,15,1,2,73,15,6,1,4,64,312,240,2676,2988,11/13/2020
3/29/2020,100,393,350,3217,3610,8,98,3,18,1,3,77,18,8,2,6,105,417,309,2985,3402,11/13/2020
3/30/2020,62,455,222,3439,3894,19,117,5,23,0,3,91,19,11,3,9,78,495,181,3166,3661,11/13/2020
3/31/2020,71,526,369,3808,4334,11,128,7,30,1,4,94,21,13,2,11,73,568,294,3460,4028,11/13/2020
4/1/2020,99,625,698,4506,5131,18,146,7,37,0,4,105,29,15,1,12,100,668,625,4085,4753,11/13/2020
4/2/2020,52,677,477,4983,5660,22,168,6,43,2,6,119,35,21,4,16,62,730,424,4509,5239,11/13/2020
4/3/2020,108,785,774,5757,6542,23,191,7,50,0,6,135,42,25,3,19,100,830,692,5201,6031,11/13/2020
4/4/2020,143,928,660,6417,7345,22,213,4,54,5,11,148,40,29,9,28,138,968,604,5805,6773,11/13/2020
4/5/2020,187,1115,1156,7573,8688,20,233,9,63,1,12,158,43,35,2,30,181,1149,1037,6842,7991,11/13/2020
4/6/2020,218,1333,1706,9279,10612,26,259,7,70,0,12,177,47,39,7,37,207,1356,1514,8356,9712,11/13/2020
4/7/2020,284,1617,1629,10908,12525,20,279,4,74,2,14,191,49,41,5,42,261,1617,1457,9813,11430,11/13/2020
4/8/2020,290,1907,1720,12628,14535,19,298,8,82,5,19,197,49,37,10,52,271,1888,1518,11331,13219,11/13/2020
4/9/2020,283,2190,1516,14144,16334,32,330,8,90,4,23,217,53,40,7,59,277,2165,1329,12660,14825,11/13/2020
4/10/2020,419,2609,2574,16718,19327,29,359,17,107,5,28,224,59,41,11,70,400,2565,2316,14976,17541,11/13/2020
4/11/2020,297,2906,1905,18623,21529,29,388,11,118,2,30,240,61,48,12,82,281,2846,1681,16657,19503,11/13/2020
4/12/2020,314,3220,1670,20293,23513,35,423,13,131,5,35,257,59,49,9,91,286,3132,1392,18049,21181,11/13/2020
4/13/2020,161,3381,935,21228,24609,35,458,13,144,3,38,276,64,54,9,100,187,3319,826,18875,22194,11/13/2020
4/14/2020,289,3670,1787,23015,26685,27,485,18,162,5,43,280,72,53,8,108,262,3581,1491,20366,23947,11/13/2020
4/15/2020,351,4021,1799,24814,28835,31,516,20,182,3,46,288,72,54,17,125,306,3887,1505,21871,25758,11/13/2020
4/16/2020,447,4468,2494,27308,31776,36,552,25,207,6,52,293,72,53,14,139,387,4274,2023,23894,28168,11/13/2020
4/17/2020,304,4772,1821,29129,33901,32,584,20,227,7,59,298,66,45,21,160,290,4564,1411,25305,29869,11/13/2020
4/18/2020,321,5093,1725,30854,35947,26,610,18,245,4,63,302,63,49,15,175,284,4848,1294,26599,31447,11/13/2020
4/19/2020,381,5474,2047,32901,38375,23,633,26,271,1,64,298,65,55,11,186,337,5185,1700,28299,33484,11/13/2020
4/20/2020,394,5868,1907,34808,40676,46,679,29,300,2,66,313,75,56,10,196,376,5561,1545,29844,35405,11/13/2020
4/21/2020,444,6312,2110,36918,43230,45,724,32,332,5,71,321,72,56,18,214,383,5944,1668,31512,37456,11/13/2020
4/22/2020,418,6730,2390,39308,46038,41,765,32,364,5,76,325,73,58,18,232,379,6323,1871,33383,39706,11/13/2020
4/23/2020,479,7209,2469,41777,48986,32,797,28,392,5,81,324,76,62,15,247,412,6735,1820,35203,41938,11/13/2020
4/24/2020,491,7700,3284,45061,52761,35,832,26,418,4,85,329,85,63,15,262,407,7142,2562,37765,44907,11/13/2020
4/25/2020,393,8093,2206,47267,55360,34,866,17,435,5,90,341,85,62,14,276,299,7441,1726,39491,46932,11/13/2020
4/26/2020,316,8409,2309,49576,57985,33,899,15,450,3,93,356,86,59,14,290,274,7715,1835,41326,49041,11/13/2020
4/27/2020,249,8658,1620,51196,59854,29,928,21,471,4,97,360,86,61,10,300,206,7921,1131,42457,50378,11/13/2020
4/28/2020,410,9068,2263,53459,62527,44,972,24,495,3,100,377,88,59,22,322,332,8253,1675,44132,52385,11/13/2020
4/29/2020,476,9544,3343,56802,66346,36,1008,38,533,11,111,364,78,53,18,340,370,8623,2326,46458,55081,11/13/2020
4/30/2020,432,9976,2769,59571,69547,33,1041,38,571,6,117,353,83,57,24,364,349,8972,1852,48310,57282,11/13/2020
5/1/2020,454,10430,3086,62657,73087,51,1092,38,609,3,120,363,84,58,14,378,323,9295,2108,50418,59713,11/13/2020
5/2/2020,257,10687,1926,64583,75270,36,1128,39,648,5,125,355,93,63,24,402,192,9487,1242,51660,61147,11/13/2020
5/3/2020,283,10970,2160,66743,77713,31,1159,27,675,8,133,351,91,61,21,423,183,9670,1529,53189,62859,11/13/2020
5/4/2020,387,11357,2098,68841,80198,30,1189,31,706,5,138,345,89,58,18,441,290,9960,1526,54715,64675,11/13/2020
5/5/2020,433,11790,2873,71714,83504,29,1218,32,738,6,144,336,83,55,16,457,300,10260,1915,56630,66890,11/13/2020
5/6/2020,488,12278,2830,74544,86822,28,1246,44,782,9,153,311,80,55,21,478,340,10600,1880,58510,69110,11/13/2020
5/7/2020,425,12703,2969,77513,90216,36,1282,43,825,5,158,299,72,53,21,499,269,10869,1926,60436,71305,11/13/2020
5/8/2020,359,13062,2598,80111,93173,30,1312,29,854,5,163,295,72,54,22,521,229,11098,1705,62141,73239,11/13/2020
5/9/2020,467,13529,3346,83457,96986,22,1334,21,875,4,167,292,70,52,15,536,290,11388,2193,64334,75722,11/13/2020
5/10/2020,285,13814,2117,85574,99388,20,1354,23,898,6,173,283,71,50,14,550,189,11577,1477,65811,77388,11/13/2020
5/11/2020,257,14071,1857,87431,101502,31,1385,16,914,6,179,292,72,50,15,565,174,11751,1268,67079,78830,11/13/2020
5/12/2020,387,14458,2611,90042,104500,23,1408,18,932,4,183,293,70,49,22,587,224,11975,1630,68709,80684,11/13/2020
5/13/2020,351,14809,3630,93672,108481,23,1431,25,957,1,184,290,70,50,13,600,199,12174,1913,70622,82796,11/13/2020
5/14/2020,329,15138,3408,97080,112218,19,1450,27,984,3,187,279,65,46,15,615,232,12406,1950,72572,84978,11/13/2020
5/15/2020,381,15519,3458,100538,116057,24,1474,41,1025,5,192,257,63,46,14,629,232,12638,1762,74334,86972,11/13/2020
5/16/2020,449,15968,4156,104694,120662,25,1499,15,1040,5,197,262,62,47,15,644,247,12885,1905,76239,89124,11/13/2020
5/17/2020,240,16208,2768,107462,123670,17,1516,9,1049,5,202,265,60,46,10,654,126,13011,1512,77751,90762,11/13/2020
5/18/2020,250,16458,2001,109463,125921,19,1535,16,1065,5,207,263,58,41,18,672,135,13146,1347,79098,92244,11/13/2020
5/19/2020,415,16873,3168,112631,129504,23,1558,33,1098,5,212,248,57,39,11,683,215,13361,1894,80992,94353,11/13/2020
5/20/2020,326,17199,2771,115402,132601,19,1577,23,1121,7,219,237,53,34,22,705,184,13545,1497,82489,96034,11/13/2020
5/21/2020,374,17573,3757,119159,136732,25,1602,15,1136,3,222,244,54,30,20,725,168,13713,1911,84400,98113,11/13/2020
5/22/2020,351,17924,3161,122320,140244,20,1622,28,1164,5,227,231,53,30,11,736,206,13919,1574,85974,99893,11/13/2020
5/23/2020,253,18177,2742,125062,143239,19,1641,11,1175,3,230,236,53,33,13,749,109,14028,1247,87221,101249,11/13/2020
5/24/2020,163,18340,1370,126432,144772,13,1654,14,1189,2,232,233,54,36,8,757,83,14111,763,87984,102095,11/13/2020
5/25/2020,147,18487,1385,127817,146304,14,1668,14,1203,0,232,233,54,34,10,767,76,14187,745,88729,102916,11/13/2020
5/26/2020,285,18772,2620,130437,149209,24,1692,21,1224,5,237,231,49,33,15,782,158,14345,1730,90459,104804,11/13/2020
5/27/2020,276,19048,2057,132494,151542,20,1712,18,1242,3,240,230,51,33,10,792,132,14477,1118,91577,106054,11/13/2020
5/28/2020,348,19396,3359,135853,155249,17,1729,29,1271,4,244,214,47,32,8,800,130,14607,1103,92680,107287,11/13/2020
5/29/2020,410,19806,3915,139768,159574,19,1748,26,1297,7,251,200,43,31,12,812,174,14781,1549,94229,109010,11/13/2020
5/30/2020,225,20031,3915,143683,163714,16,1764,19,1316,4,255,193,41,29,12,824,109,14890,1775,96004,110894,11/13/2020
5/31/2020,155,20186,1690,145373,165559,11,1775,11,1327,1,256,192,44,26,3,827,78,14968,838,96842,111810,11/13/2020
6/1/2020,212,20398,2792,148165,168563,8,1783,14,1341,1,257,185,45,29,5,832,93,15061,1361,98203,113264,11/13/2020
6/2/2020,273,20671,3022,151187,171858,8,1791,10,1351,3,260,180,38,25,10,842,98,15159,1411,99614,114773,11/13/2020
6/3/2020,254,20925,3486,154673,175598,14,1805,18,1369,6,266,170,34,25,11,853,99,15258,1636,101250,116508,11/13/2020
6/4/2020,276,21201,4471,159144,180345,7,1812,26,1395,4,270,147,31,24,12,865,107,15365,2001,103251,118616,11/13/2020
6/5/2020,215,21416,3513,162657,184073,15,1827,13,1408,6,276,143,27,21,11,876,99,15464,1534,104785,120249,11/13/2020
6/6/2020,201,21617,2616,165273,186890,10,1837,7,1415,2,278,144,29,19,6,882,67,15531,1104,105889,121420,11/13/2020
6/7/2020,83,21700,1625,166898,188598,11,1848,7,1422,1,279,147,25,17,4,886,51,15582,776,106665,122247,11/13/2020
6/8/2020,119,21819,1849,168747,190566,15,1863,13,1435,2,281,147,27,18,4,890,45,15627,942,107607,123234,11/13/2020
6/9/2020,223,22042,2673,171420,193462,10,1873,19,1454,0,281,138,28,21,1,891,64,15691,1238,108845,124536,11/13/2020
6/10/2020,209,22251,2987,174407,196658,13,1886,12,1466,2,283,137,24,17,4,895,100,15791,1445,110290,126081,11/13/2020
6/11/2020,195,22446,3513,177920,200366,7,1893,15,1481,1,284,128,25,16,6,901,88,15879,1509,111799,127678,11/13/2020
6/12/2020,209,22655,4601,182521,205176,9,1902,16,1497,1,285,120,24,16,2,903,78,15957,2152,113951,129908,11/13/2020
6/13/2020,113,22768,3036,185557,208325,6,1908,5,1502,0,285,121,20,15,3,906,49,16006,1357,115308,131314,11/13/2020
6/14/2020,81,22849,2046,187603,210452,7,1915,8,1510,1,286,119,20,14,3,909,33,16039,957,116265,132304,11/13/2020
6/15/2020,188,23037,3108,190711,213748,14,1929,19,1529,0,286,114,20,16,5,914,75,16114,1762,118027,134141,11/13/2020
6/16/2020,110,23147,3017,193728,216875,11,1940,9,1538,1,287,115,22,16,8,922,50,16164,1516,119543,135707,11/13/2020
6/17/2020,127,23274,2835,196563,219837,15,1955,21,1559,4,291,105,18,14,6,928,50,16214,1295,120838,137052,11/13/2020
6/18/2020,149,23423,3048,199611,223034,9,1964,15,1574,1,292,98,19,16,7,935,70,16284,1304,122142,138426,11/13/2020
6/19/2020,141,23564,3769,203380,226944,12,1976,12,1586,1,293,97,20,17,3,938,59,16343,1342,123484,139827,11/13/2020
6/20/2020,84,23648,1891,205271,228919,9,1985,12,1598,0,293,94,20,18,4,942,36,16379,806,124290,140669,11/13/2020
6/21/2020,37,23685,1064,206335,230020,8,1993,5,1603,0,293,97,20,18,2,944,30,16409,684,124974,141383,11/13/2020
6/22/2020,138,23823,3730,210065,233888,12,2005,17,1620,0,293,92,19,18,2,946,65,16474,1683,126657,143131,11/13/2020
6/23/2020,163,23986,3831,213896,237882,3,2008,13,1633,3,296,79,18,18,7,953,81,16555,1760,128417,144972,11/13/2020
6/24/2020,120,24106,3502,217398,241504,9,2017,11,1644,1,297,76,18,18,5,958,44,16599,1665,130082,146681,11/13/2020
6/25/2020,103,24209,2883,220281,244490,6,2023,14,1658,1,298,67,17,17,1,959,50,16649,1482,131564,148213,11/13/2020
6/26/2020,94,24303,2488,222769,247072,2,2025,10,1668,0,298,59,18,18,1,960,60,16709,1311,132875,149584,11/13/2020
6/27/2020,84,24387,3216,225985,250372,5,2030,3,1671,1,299,60,17,17,5,965,37,16746,1196,134071,150817,11/13/2020
6/28/2020,39,24426,1469,227454,251880,4,2034,4,1675,4,303,56,15,14,6,971,17,16763,588,134659,151422,11/13/2020
6/29/2020,85,24511,3697,231151,255662,4,2038,5,1680,0,303,55,14,14,1,972,39,16802,1336,135995,152797,11/13/2020
6/30/2020,57,24568,1958,233109,257677,1,2039,5,1685,1,304,50,12,11,4,976,33,16835,986,136981,153816,11/13/2020
7/1/2020,144,24712,4098,237207,261919,8,2047,10,1695,0,304,48,11,11,1,977,79,16914,1903,138884,155798,11/13/2020
7/2/2020,103,24815,2803,240010,264825,5,2052,5,1700,1,305,47,10,10,3,980,59,16973,1070,139954,156927,11/13/2020
7/3/2020,50,24865,2079,242089,266954,9,2061,6,1706,0,305,50,9,9,3,983,25,16998,775,140729,157727,11/13/2020
7/4/2020,57,24922,2345,244434,269356,2,2063,4,1710,1,306,47,10,9,2,985,33,17031,989,141718,158749,11/13/2020
7/5/2020,49,24971,2932,247366,272337,1,2064,2,1712,1,307,45,8,8,2,987,26,17057,1418,143136,160193,11/13/2020
7/6/2020,101,25072,2814,250180,275252,6,2070,6,1718,0,307,45,9,9,4,991,57,17114,1534,144670,161784,11/13/2020
7/7/2020,81,25153,3457,253637,278790,5,2075,7,1725,0,307,43,8,8,2,993,47,17161,1525,146195,163356,11/13/2020
7/8/2020,105,25258,3409,257046,282304,4,2079,2,1727,0,307,45,9,8,0,993,64,17225,1398,147593,164818,11/13/2020
7/9/2020,94,25352,3714,260760,286112,9,2088,3,1730,0,307,51,9,8,0,993,50,17275,1601,149194,166469,11/13/2020
7/10/2020,132,25484,4437,265197,290681,6,2094,3,1733,2,309,52,7,7,3,996,80,17355,2052,151246,168601,11/13/2020
7/11/2020,63,25547,2938,268135,293682,6,2100,3,1736,1,310,54,6,6,3,999,36,17391,1305,152551,169942,11/13/2020
7/12/2020,47,25594,1838,269973,295567,1,2101,3,1739,1,311,51,6,5,3,1002,34,17425,932,153483,170908,11/13/2020
7/13/2020,84,25678,3209,273182,298860,8,2109,10,1749,0,311,49,6,5,1,1003,61,17486,1488,154971,172457,11/13/2020
7/14/2020,74,25752,3298,276480,302232,7,2116,4,1753,0,311,52,5,5,1,1004,44,17530,1364,156335,173865,11/13/2020
7/15/2020,130,25882,4181,280661,306543,5,2121,7,1760,0,311,50,5,4,0,1004,100,17630,1733,158068,175698,11/13/2020
7/16/2020,103,25985,3740,284401,310386,6,2127,9,1769,0,311,47,6,5,1,1005,76,17706,1600,159668,177374,11/13/2020
7/17/2020,156,26141,4239,288640,314781,14,2141,3,1772,1,312,57,5,5,2,1007,79,17785,1829,161497,179282,11/13/2020
7/18/2020,85,26226,3272,291912,318138,5,2146,9,1781,1,313,52,5,4,4,1011,70,17855,1382,162879,180734,11/13/2020
7/19/2020,82,26308,2696,294608,320916,7,2153,3,1784,0,313,56,6,4,2,1013,57,17912,1136,164015,181927,11/13/2020
7/20/2020,71,26379,2666,297274,323653,9,2162,7,1791,0,313,58,7,5,2,1015,68,17980,1442,165457,183437,11/13/2020
7/21/2020,130,26509,4304,301578,328087,9,2171,11,1802,0,313,56,9,6,1,1016,108,18088,1899,167356,185444,11/13/2020
7/22/2020,130,26639,3928,305506,332145,7,2178,8,1810,1,314,54,7,6,1,1017,86,18174,1663,169019,187193,11/13/2020
7/23/2020,141,26780,4415,309921,336701,8,2186,6,1816,0,314,56,8,7,0,1017,115,18289,1951,170970,189259,11/13/2020
7/24/2020,172,26952,5966,315887,342839,15,2201,12,1828,0,314,59,9,7,0,1017,119,18408,2294,173264,191672,11/13/2020
7/25/2020,134,27086,4398,320285,347371,7,2208,7,1835,0,314,59,10,8,3,1020,108,18516,2074,175338,193854,11/13/2020
7/26/2020,62,27148,3033,323318,350466,8,2216,9,1844,0,314,58,11,7,1,1021,54,18570,1324,176662,195232,11/13/2020
7/27/2020,188,27336,4191,327509,354845,12,2228,7,1851,0,314,63,13,8,1,1022,138,18708,2322,178984,197692,11/13/2020
7/28/2020,105,27441,3840,331349,358790,5,2233,5,1856,0,314,63,14,7,1,1023,95,18803,1621,180605,199408,11/13/2020
7/29/2020,190,27631,5139,336488,364119,9,2242,10,1866,0,314,62,15,7,0,1023,154,18957,2283,182888,201845,11/13/2020
7/30/2020,121,27752,4345,340833,368585,6,2248,2,1868,1,315,65,15,6,1,1024,97,19054,1629,184517,203571,11/13/2020
7/31/2020,131,27883,5512,346345,374228,7,2255,9,1877,0,315,63,15,7,1,1025,89,19143,1818,186335,205478,11/13/2020
8/1/2020,109,27992,4294,350639,378631,7,2262,2,1879,0,315,68,14,7,1,1026,89,19232,1545,187880,207112,11/13/2020
8/2/2020,84,28076,2804,353443,381519,12,2274,12,1891,2,317,66,14,8,2,1028,62,19294,1256,189136,208430,11/13/2020
8/3/2020,188,28264,5248,358691,386955,11,2285,10,1901,0,317,67,16,7,1,1029,150,19444,2183,191319,210763,11/13/2020
8/4/2020,125,28389,3691,362382,390771,8,2293,5,1906,1,318,69,12,5,2,1031,99,19543,1749,193068,212611,11/13/2020
8/5/2020,147,28536,5935,368317,396853,11,2304,9,1915,1,319,70,10,5,2,1033,119,19662,2440,195508,215170,11/13/2020
8/6/2020,169,28705,5546,373863,402568,7,2311,9,1924,0,319,68,9,4,0,1033,120,19782,2373,197881,217663,11/13/2020
8/7/2020,123,28828,4851,378714,407542,12,2323,9,1933,1,320,70,9,3,2,1035,87,19869,2117,199998,219867,11/13/2020
8/8/2020,123,28951,4112,382826,411777,19,2342,6,1939,1,321,82,8,3,1,1036,91,19960,1766,201764,221724,11/13/2020
8/9/2020,42,28993,1727,384553,413546,6,2348,8,1947,0,321,80,9,4,0,1036,35,19995,1058,202822,222817,11/13/2020
8/10/2020,149,29142,4587,389140,418282,8,2356,9,1956,0,321,79,9,4,1,1037,113,20108,2004,204826,224934,11/13/2020
8/11/2020,106,29248,4334,393474,422722,5,2361,13,1969,0,321,71,10,4,3,1040,92,20200,2247,207073,227273,11/13/2020
8/12/2020,121,29369,5188,398662,428031,8,2369,11,1980,0,321,68,9,3,1,1041,101,20301,2592,209665,229966,11/13/2020
8/13/2020,135,29504,4196,402858,432362,13,2382,12,1992,0,321,69,11,3,0,1041,95,20396,1887,211552,231948,11/13/2020
8/14/2020,145,29649,5498,408356,438005,13,2395,11,2003,0,321,71,11,4,3,1044,98,20494,1959,213511,234005,11/13/2020
8/15/2020,106,29755,4534,412890,442645,9,2404,11,2014,1,322,68,11,5,0,1044,88,20582,1669,215180,235762,11/13/2020
8/16/2020,83,29838,2477,415367,445205,6,2410,5,2019,4,326,65,8,4,6,1050,70,20652,950,216130,236782,11/13/2020
8/17/2020,106,29944,4575,419942,449886,8,2418,6,2025,0,326,67,8,5,2,1052,87,20739,2363,218493,239232,11/13/2020
8/18/2020,128,30072,4911,424853,454925,11,2429,8,2033,1,327,69,8,4,5,1057,94,20833,2725,221218,242051,11/13/2020
8/19/2020,113,30185,5077,429930,460115,8,2437,9,2042,1,328,67,9,5,0,1057,90,20923,2612,223830,244753,11/13/2020
8/20/2020,173,30358,7411,437341,467699,12,2449,6,2048,2,330,71,10,5,3,1060,139,21062,3480,227310,248372,11/13/2020
8/21/2020,151,30509,6577,443918,474427,8,2457,5,2053,1,331,73,9,4,2,1062,125,21187,2916,230226,251413,11/13/2020
8/22/2020,96,30605,5550,449468,480073,11,2468,12,2065,0,331,72,11,4,1,1063,84,21271,2573,232799,254070,11/13/2020
8/23/2020,71,30676,4375,453843,484519,11,2479,6,2071,0,331,77,12,2,1,1064,56,21327,2454,235253,256580,11/13/2020
8/24/2020,105,30781,5784,459627,490408,7,2486,10,2081,1,332,73,14,4,1,1065,77,21404,3127,238380,259784,11/13/2020
8/25/2020,108,30889,4764,464391,495280,10,2496,4,2085,1,333,78,12,4,1,1066,92,21496,2273,240653,262149,11/13/2020
8/26/2020,170,31059,9482,473873,504932,4,2500,8,2093,0,333,74,10,5,1,1067,127,21623,3061,243714,265337,11/13/2020
8/27/2020,92,31151,8565,482438,513589,6,2506,13,2106,1,334,66,7,5,2,1069,70,21693,3121,246835,268528,11/13/2020
8/28/2020,113,31264,7994,490432,521696,14,2520,4,2110,0,334,76,10,7,2,1071,87,21780,2408,249243,271023,11/13/2020
8/29/2020,65,31329,5374,495806,527135,6,2526,8,2118,1,335,73,11,6,2,1073,51,21831,1902,251145,272976,11/13/2020
8/30/2020,66,31395,4323,500129,531524,7,2533,4,2122,0,335,76,9,5,2,1075,48,21879,1977,253122,275001,11/13/2020
8/31/2020,105,31500,4863,504992,536492,12,2545,16,2138,0,335,72,8,4,1,1076,81,21960,2168,255290,277250,11/13/2020
9/1/2020,98,31598,7109,512101,543699,6,2551,9,2147,1,336,68,7,4,2,1078,66,22026,2359,257649,279675,11/13/2020
9/2/2020,125,31723,10529,522630,554353,9,2560,10,2157,1,337,66,8,4,2,1080,104,22130,3024,260673,282803,11/13/2020
9/3/2020,90,31813,11079,533709,565522,8,2568,8,2165,0,337,66,9,4,3,1083,73,22203,2562,263235,285438,11/13/2020
9/4/2020,103,31916,8963,542672,574588,11,2579,4,2169,0,337,73,9,4,1,1084,83,22286,2358,265593,287879,11/13/2020
9/5/2020,52,31968,6309,548981,580949,6,2585,9,2178,0,337,70,8,3,1,1085,42,22328,1590,267183,289511,11/13/2020
9/6/2020,88,32056,4325,553306,585362,4,2589,8,2186,1,338,65,6,3,1,1086,65,22393,1936,269119,291512,11/13/2020
9/7/2020,35,32091,3002,556308,588399,11,2600,3,2189,0,338,73,5,3,1,1087,26,22419,640,269759,292178,11/13/2020
9/8/2020,74,32165,6381,562689,594854,6,2606,12,2201,1,339,66,6,3,2,1089,66,22485,1578,271337,293822,11/13/2020
9/9/2020,118,32283,8650,571339,603622,10,2616,5,2206,1,340,70,9,3,1,1090,102,22587,2127,273464,296051,11/13/2020
9/10/2020,164,32447,11334,582673,615120,9,2625,8,2214,0,340,71,10,3,1,1091,111,22698,2258,275722,298420,11/13/2020
9/11/2020,120,32567,9454,592127,624694,11,2636,11,2225,0,340,71,10,5,0,1091,97,22795,1955,277677,300472,11/13/2020
9/12/2020,110,32677,6173,598300,630977,8,2644,5,2230,2,342,72,9,5,3,1094,97,22892,1509,279186,302078,11/13/2020
9/13/2020,58,32735,2716,601016,633751,4,2648,3,2233,0,342,73,10,5,0,1094,54,22946,858,280044,302990,11/13/2020
9/14/2020,104,32839,6446,607462,640301,6,2654,3,2236,2,344,74,10,5,2,1096,95,23041,1720,281764,304805,11/13/2020
9/15/2020,122,32961,8466,615928,648889,7,2661,2,2238,1,345,78,10,5,2,1098,124,23165,2181,283945,307110,11/13/2020
9/16/2020,137,33098,9715,625643,658741,7,2668,7,2245,2,347,76,9,6,5,1103,118,23283,1962,285907,309190,11/13/2020
9/17/2020,125,33223,9239,634882,668105,7,2675,15,2260,0,347,68,8,4,0,1103,154,23437,1935,287842,311279,11/13/2020
9/18/2020,132,33355,10045,644927,678282,7,2682,7,2267,1,348,67,11,6,2,1105,132,23569,1917,289759,313328,11/13/2020
9/19/2020,115,33470,8297,653224,686694,7,2689,3,2270,0,348,71,10,6,4,1109,112,23681,1685,291444,315125,11/13/2020
9/20/2020,60,33530,3676,656900,690430,7,2696,6,2276,2,350,70,9,8,4,1113,49,23730,1318,292762,316492,11/13/2020
9/21/2020,102,33632,7018,663918,697550,12,2708,3,2279,2,352,77,8,6,2,1115,94,23824,2397,295159,318983,11/13/2020
9/22/2020,154,33786,9287,673205,706991,12,2720,3,2282,1,353,85,7,5,1,1116,124,23948,2197,297356,321304,11/13/2020
9/23/2020,136,33922,10650,683855,717777,12,2732,7,2289,0,353,90,6,5,0,1116,127,24075,2207,299563,323638,11/13/2020
9/24/2020,120,34042,12479,696334,730376,7,2739,9,2298,1,354,87,7,5,1,1117,121,24196,3151,302714,326910,11/13/2020
9/25/2020,149,34191,10553,706887,741078,9,2748,10,2308,0,354,86,6,5,1,1118,142,24338,2991,305705,330043,11/13/2020
9/26/2020,146,34337,10559,717446,751783,12,2760,9,2317,0,354,89,6,5,1,1119,119,24457,2413,308118,332575,11/13/2020
9/27/2020,43,34380,2764,720210,754590,7,2767,5,2322,0,354,91,9,5,0,1119,34,24491,839,308957,333448,11/13/2020
9/28/2020,152,34532,7308,727518,762050,7,2774,7,2329,2,356,89,7,5,2,1121,134,24625,2253,311210,335835,11/13/2020
9/29/2020,208,34740,11046,738564,773304,12,2786,18,2347,1,357,82,6,6,1,1122,190,24815,2819,314029,338844,11/13/2020
9/30/2020,221,34961,12230,750794,785755,6,2792,6,2353,0,357,82,6,6,1,1123,187,25002,2578,316607,341609,11/13/2020
10/1/2020,185,35146,12503,763297,798443,17,2809,13,2366,1,358,85,6,4,2,1125,166,25168,2404,319011,344179,11/13/2020
10/2/2020,210,35356,12153,775450,810806,14,2823,13,2379,1,359,85,8,5,2,1127,182,25350,2495,321506,346856,11/13/2020
10/3/2020,157,35513,9312,784762,820275,9,2832,9,2388,2,361,83,9,4,2,1129,131,25481,2017,323523,349004,11/13/2020
10/4/2020,81,35594,2369,787131,822725,11,2843,9,2397,1,362,84,8,5,2,1131,78,25559,952,324475,350034,11/13/2020
10/5/2020,174,35768,8982,796113,831881,30,2873,11,2408,2,364,101,9,6,4,1135,160,25719,3024,327499,353218,11/13/2020
10/6/2020,177,35945,11185,807298,843243,11,2884,5,2413,0,364,107,11,7,0,1135,186,25905,2900,330399,356304,11/13/2020
10/7/2020,231,36176,12440,819738,855914,13,2897,14,2427,2,366,104,9,7,2,1137,243,26148,3527,333926,360074,11/13/2020
10/8/2020,262,36438,15233,834971,871409,17,2914,13,2440,2,368,106,7,5,4,1141,274,26422,4206,338132,364554,11/13/2020
10/9/2020,217,36655,13745,848716,885371,21,2935,12,2452,0,368,115,10,7,3,1144,199,26621,4316,342448,369069,11/13/2020
10/10/2020,229,36884,13832,862548,899432,19,2954,10,2462,1,369,123,13,7,2,1146,194,26815,3795,346243,373058,11/13/2020
10/11/2020,97,36981,3263,865811,902792,12,2966,9,2471,1,370,125,14,5,6,1152,88,26903,1163,347406,374309,11/13/2020
10/12/2020,169,37150,6439,872250,909400,19,2985,15,2486,2,372,127,14,5,4,1156,159,27062,1736,349142,376204,11/13/2020
10/13/2020,213,37363,8521,880771,918134,15,3000,15,2501,4,376,123,13,5,7,1163,208,27270,2308,351450,378720,11/13/2020
10/14/2020,322,37685,15038,895809,933494,17,3017,7,2508,0,376,133,15,5,2,1165,303,27573,4037,355487,383060,11/13/2020
10/15/2020,262,37947,14640,910449,948396,12,3029,16,2524,1,377,128,13,5,2,1167,254,27827,3577,359064,386891,11/13/2020
10/16/2020,279,38226,15011,925460,963686,13,3042,20,2544,1,378,120,13,4,2,1169,275,28102,3385,362449,390551,11/13/2020
10/17/2020,354,38580,14068,939528,978108,19,3061,11,2555,1,379,127,17,4,2,1171,311,28413,3267,365716,394129,11/13/2020
10/18/2020,155,38735,4039,943567,982302,18,3079,11,2566,0,379,134,17,6,2,1173,129,28542,1323,367039,395581,11/13/2020
10/19/2020,388,39123,8489,952056,991179,21,3100,23,2589,2,381,130,15,6,1,1174,325,28867,2563,369602,398469,11/13/2020
10/20/2020,439,39562,13242,965298,1004860,22,3122,17,2606,0,381,135,14,8,3,1177,387,29254,3013,372615,401869,11/13/2020
10/21/2020,544,40106,17462,982760,1022866,21,3143,9,2615,2,383,145,15,9,3,1180,472,29726,3524,376139,405865,11/13/2020
10/22/2020,538,40644,15863,998623,1039267,24,3167,21,2636,3,386,145,14,9,3,1183,490,30216,3194,379333,409549,11/13/2020
10/23/2020,514,41158,16632,1015255,1056413,22,3189,26,2662,1,387,140,15,9,3,1186,460,30676,2886,382219,412895,11/13/2020
10/24/2020,359,41517,10248,1025503,1067020,17,3206,11,2673,0,387,146,14,8,1,1187,338,31014,2265,384484,415498,11/13/2020
10/25/2020,233,41750,4762,1030265,1072015,16,3222,15,2688,1,388,146,15,8,2,1189,210,31224,1470,385954,417178,11/13/2020
10/26/2020,454,42204,9174,1039439,1081643,26,3248,20,2708,2,390,150,18,8,3,1192,403,31627,2974,388928,420555,11/13/2020
10/27/2020,517,42721,13993,1053432,1096153,28,3276,11,2719,2,392,165,17,9,4,1196,454,32081,2394,391322,423403,11/13/2020
10/28/2020,469,43190,15230,1068662,1111852,24,3300,23,2742,1,393,165,16,9,3,1199,409,32490,2705,394027,426517,11/13/2020
10/29/2020,609,43799,16234,1084896,1128695,20,3320,18,2760,3,396,164,19,11,4,1203,529,33019,3129,397156,430175,11/13/2020
10/30/2020,544,44343,14319,1099215,1143558,21,3341,20,2780,5,401,160,19,9,4,1207,467,33486,2954,400110,433596,11/13/2020
10/31/2020,585,44928,11843,1111058,1155986,31,3372,12,2792,1,402,178,22,9,3,1210,489,33975,2416,402526,436501,11/13/2020
11/1/2020,329,45257,5073,1116131,1161388,20,3392,15,2807,1,403,182,25,12,4,1214,273,34248,1257,403783,438031,11/13/2020
11/2/2020,520,45777,9918,1126049,1171826,35,3427,27,2834,3,406,187,22,11,5,1219,454,34702,2939,406722,441424,11/13/2020
11/3/2020,603,46380,13060,1139109,1185489,32,3459,24,2858,1,407,194,21,11,1,1220,529,35231,2532,409254,444485,11/13/2020
11/4/2020,679,47059,16119,1155228,1202287,34,3493,25,2883,2,409,201,21,11,4,1224,629,35860,2938,412192,448052,11/13/2020
11/5/2020,759,47818,18883,1174111,1221929,46,3539,34,2917,1,410,212,20,13,3,1227,674,36534,5178,417370,453904,11/13/2020
11/6/2020,776,48594,17197,1191308,1239902,41,3580,31,2948,1,411,221,25,16,5,1232,700,37234,4356,421726,458960,11/13/2020
11/7/2020,606,49200,13245,1204553,1253753,32,3612,25,2973,1,412,227,27,17,1,1233,572,37806,2487,424213,462019,11/13/2020
11/8/2020,338,49538,3964,1208517,1258055,30,3642,25,2998,1,413,231,26,18,3,1236,320,38126,1292,425505,463631,11/13/2020
11/9/2020,790,50328,8671,1217188,1267516,36,3678,33,3031,2,415,232,25,17,3,1239,742,38868,2324,427829,466697,11/13/2020
11/10/2020,1062,51390,12890,1230078,1281468,43,3721,33,3064,0,415,242,28,17,6,1245,970,39838,2911,430740,470578,11/13/2020
11/11/2020,1073,52463,19061,1249139,1301602,35,3756,22,3086,5,420,250,27,14,6,1251,981,40819,2660,433400,474219,11/13/2020
11/12/2020,801,53264,12980,1262119,1315383,,,,,,,,,,3,1254,710,41529,2001,435401,476930,11/13/2020
2/27/2020,0,0,0,0,0,1,1,0,0,0,0,1,0,0,0,0,0,0,0,0,0,11/16/2020
2/28/2020,0,0,0,0,0,0,1,0,0,0,0,1,1,0,0,0,0,0,0,0,0,11/16/2020
2/29/2020,0,0,0,0,0,0,1,0,0,0,0,1,1,0,0,0,0,0,0,0,0,11/16/2020
3/1/2020,2,2,2,2,4,0,1,0,0,0,0,1,1,1,0,0,2,2,2,2,4,11/16/2020
3/2/2020,0,2,1,3,5,1,2,0,0,0,0,2,2,2,0,0,0,2,0,2,4,11/16/2020
3/3/2020,0,2,2,5,7,0,2,0,0,0,0,2,2,2,0,0,0,2,1,3,5,11/16/2020
3/4/2020,0,2,12,17,19,1,3,0,0,0,0,3,2,2,0,0,0,2,10,13,15,11/16/2020
3/5/2020,0,2,4,21,23,0,3,0,0,0,0,3,2,2,0,0,1,3,4,17,20,11/16/2020
3/6/2020,1,3,12,33,36,0,3,0,0,0,0,3,2,2,0,0,0,3,11,28,31,11/16/2020
3/7/2020,0,3,19,52,55,0,3,0,0,0,0,3,2,1,0,0,0,3,19,47,50,11/16/2020
3/8/2020,0,3,18,70,73,0,3,0,0,0,0,3,2,1,0,0,0,3,18,65,68,11/16/2020
3/9/2020,1,4,15,85,89,0,3,0,0,0,0,3,2,1,0,0,1,4,14,79,83,11/16/2020
3/10/2020,2,6,25,110,116,0,3,0,0,0,0,3,2,1,0,0,1,5,23,102,107,11/16/2020
3/11/2020,0,6,34,144,150,1,4,0,0,0,0,4,1,1,0,0,0,5,34,136,141,11/16/2020
3/12/2020,9,15,41,185,200,1,5,0,0,0,0,5,1,1,0,0,8,13,38,174,187,11/16/2020
3/13/2020,6,21,50,235,256,4,9,1,1,0,0,8,1,1,0,0,6,19,47,221,240,11/16/2020
3/14/2020,0,21,90,325,346,0,9,0,1,0,0,8,1,1,0,0,0,19,83,304,323,11/16/2020
3/15/2020,1,22,54,379,401,1,10,0,1,0,0,9,2,1,0,0,1,20,53,357,377,11/16/2020
3/16/2020,2,24,95,474,498,2,12,0,1,0,0,11,2,0,0,0,2,22,91,448,470,11/16/2020
3/17/2020,12,36,162,636,672,6,18,0,1,0,0,17,2,0,0,0,11,33,148,596,629,11/16/2020
3/18/2020,9,45,116,752,797,3,21,0,1,0,0,20,2,0,0,0,11,44,110,706,750,11/16/2020
3/19/2020,15,60,262,1014,1074,2,23,1,2,0,0,21,3,0,1,1,17,61,247,953,1014,11/16/2020
3/20/2020,13,73,197,1211,1284,5,28,0,2,0,0,26,4,0,0,1,13,74,186,1139,1213,11/16/2020
3/21/2020,12,85,126,1337,1422,3,31,2,4,0,0,27,5,0,0,1,14,88,122,1261,1349,11/16/2020
3/22/2020,27,112,282,1619,1731,2,33,0,4,0,0,29,5,0,0,1,25,113,257,1518,1631,11/16/2020
3/23/2020,14,126,169,1788,1914,15,48,1,5,0,0,43,9,3,0,1,16,129,161,1679,1808,11/16/2020
3/24/2020,20,146,242,2030,2176,8,56,0,5,0,0,51,10,5,0,1,19,148,229,1908,2056,11/16/2020
3/25/2020,26,172,182,2212,2384,5,61,2,7,0,0,54,11,3,0,1,28,176,163,2071,2247,11/16/2020
3/26/2020,35,207,181,2393,2600,9,70,5,12,0,0,58,14,5,0,1,41,217,169,2240,2457,11/16/2020
3/27/2020,27,234,214,2607,2841,9,79,1,13,1,1,65,16,6,2,3,31,248,195,2435,2683,11/16/2020
3/28/2020,59,293,260,2867,3160,11,90,2,15,1,2,73,15,6,1,4,64,312,240,2675,2987,11/16/2020
3/29/2020,100,393,350,3217,3610,8,98,3,18,1,3,77,18,8,2,6,105,417,309,2984,3401,11/16/2020
3/30/2020,62,455,222,3439,3894,19,117,5,23,0,3,91,19,11,3,9,78,495,181,3165,3660,11/16/2020
3/31/2020,71,526,369,3808,4334,11,128,7,30,1,4,94,21,13,2,11,73,568,294,3459,4027,11/16/2020
4/1/2020,99,625,698,4506,5131,18,146,7,37,0,4,105,29,15,1,12,100,668,624,4083,4751,11/16/2020
4/2/2020,52,677,477,4983,5660,22,168,6,43,2,6,119,35,21,4,16,62,730,423,4506,5236,11/16/2020
4/3/2020,108,785,774,5757,6542,23,191,7,50,0,6,135,42,25,3,19,100,830,691,5197,6027,11/16/2020
4/4/2020,143,928,660,6417,7345,22,213,4,54,5,11,148,40,29,9,28,138,968,603,5800,6768,11/16/2020
4/5/2020,187,1115,1156,7573,8688,20,233,9,63,1,12,158,43,35,2,30,181,1149,1030,6830,7979,11/16/2020
4/6/2020,218,1333,1706,9279,10612,26,259,7,70,0,12,177,47,39,7,37,207,1356,1506,8336,9692,11/16/2020
4/7/2020,284,1617,1629,10908,12525,20,279,4,74,2,14,191,49,41,5,42,261,1617,1456,9792,11409,11/16/2020
4/8/2020,290,1907,1720,12628,14535,19,298,8,82,5,19,197,49,37,10,52,271,1888,1512,11304,13192,11/16/2020
4/9/2020,283,2190,1516,14144,16334,32,330,8,90,4,23,217,53,40,7,59,277,2165,1323,12627,14792,11/16/2020
4/10/2020,419,2609,2574,16718,19327,29,359,17,107,5,28,224,59,41,11,70,400,2565,2311,14938,17503,11/16/2020
4/11/2020,297,2906,1905,18623,21529,29,388,11,118,2,30,240,61,48,12,82,281,2846,1678,16616,19462,11/16/2020
4/12/2020,314,3220,1670,20293,23513,35,423,13,131,5,35,257,59,49,9,91,286,3132,1385,18001,21133,11/16/2020
4/13/2020,161,3381,935,21228,24609,35,458,13,144,3,38,276,64,54,9,100,187,3319,825,18826,22145,11/16/2020
4/14/2020,289,3670,1787,23015,26685,27,485,18,162,5,43,280,72,53,8,108,262,3581,1481,20307,23888,11/16/2020
4/15/2020,351,4021,1799,24814,28835,31,516,20,182,3,46,288,72,54,17,125,306,3887,1504,21811,25698,11/16/2020
4/16/2020,447,4468,2494,27308,31776,36,552,25,207,6,52,293,72,53,14,139,387,4274,2017,23828,28102,11/16/2020
4/17/2020,304,4772,1821,29129,33901,32,584,20,227,7,59,298,66,45,21,160,290,4564,1408,25236,29800,11/16/2020
4/18/2020,321,5093,1725,30854,35947,26,610,18,245,4,63,302,63,49,15,175,284,4848,1289,26525,31373,11/16/2020
4/19/2020,381,5474,2047,32901,38375,23,633,26,271,1,64,298,65,55,11,186,337,5185,1696,28221,33406,11/16/2020
4/20/2020,394,5868,1907,34808,40676,46,679,29,300,2,66,313,75,56,10,196,376,5561,1541,29762,35323,11/16/2020
4/21/2020,444,6312,2110,36918,43230,45,724,32,332,5,71,321,72,56,18,214,383,5944,1666,31428,37372,11/16/2020
4/22/2020,418,6730,2390,39308,46038,41,765,32,364,5,76,325,73,58,18,232,379,6323,1869,33297,39620,11/16/2020
4/23/2020,479,7209,2469,41777,48986,32,797,28,392,5,81,324,76,62,15,247,412,6735,1815,35112,41847,11/16/2020
4/24/2020,491,7700,3284,45061,52761,35,832,26,418,4,85,329,85,63,15,262,407,7142,2554,37666,44808,11/16/2020
4/25/2020,393,8093,2206,47267,55360,34,866,17,435,5,90,341,85,62,14,276,299,7441,1720,39386,46827,11/16/2020
4/26/2020,316,8409,2309,49576,57985,33,899,15,450,3,93,356,86,59,14,290,274,7715,1829,41215,48930,11/16/2020
4/27/2020,249,8658,1620,51196,59854,29,928,21,471,4,97,360,86,61,10,300,206,7921,1121,42336,50257,11/16/2020
4/28/2020,410,9068,2263,53459,62527,44,972,24,495,3,100,377,88,59,22,322,332,8253,1666,44002,52255,11/16/2020
4/29/2020,476,9544,3343,56802,66346,36,1008,38,533,11,111,364,78,53,18,340,370,8623,2320,46322,54945,11/16/2020
4/30/2020,432,9976,2769,59571,69547,33,1041,38,571,6,117,353,83,57,24,364,349,8972,1840,48162,57134,11/16/2020
5/1/2020,454,10430,3086,62657,73087,51,1092,39,610,3,120,362,84,58,14,378,323,9295,2096,50258,59553,11/16/2020
5/2/2020,257,10687,1926,64583,75270,36,1128,38,648,5,125,355,93,63,24,402,192,9487,1238,51496,60983,11/16/2020
5/3/2020,283,10970,2160,66743,77713,31,1159,26,674,8,133,352,91,61,21,423,183,9670,1519,53015,62685,11/16/2020
5/4/2020,387,11357,2098,68841,80198,30,1189,31,705,6,139,345,89,58,18,441,290,9960,1523,54538,64498,11/16/2020
5/5/2020,433,11790,2873,71714,83504,29,1218,32,737,6,145,336,83,55,16,457,300,10260,1915,56453,66713,11/16/2020
5/6/2020,488,12278,2830,74544,86822,28,1246,44,781,9,154,311,80,55,21,478,340,10600,1874,58327,68927,11/16/2020
5/7/2020,425,12703,2969,77513,90216,36,1282,43,824,5,159,299,72,53,21,499,269,10869,1918,60245,71114,11/16/2020
5/8/2020,359,13062,2598,80111,93173,30,1312,29,853,5,164,295,72,54,22,521,229,11098,1694,61939,73037,11/16/2020
5/9/2020,467,13529,3346,83457,96986,22,1334,21,874,4,168,292,70,52,15,536,290,11388,2187,64126,75514,11/16/2020
5/10/2020,285,13814,2117,85574,99388,20,1354,23,897,6,174,283,71,50,14,550,189,11577,1471,65597,77174,11/16/2020
5/11/2020,257,14071,1857,87431,101502,31,1385,16,913,6,180,292,72,50,15,565,174,11751,1263,66860,78611,11/16/2020
5/12/2020,387,14458,2611,90042,104500,23,1408,18,931,4,184,293,70,49,22,587,224,11975,1623,68483,80458,11/16/2020
5/13/2020,351,14809,3630,93672,108481,23,1431,25,956,1,185,290,70,50,13,600,199,12174,1902,70385,82559,11/16/2020
5/14/2020,329,15138,3408,97080,112218,19,1450,27,983,3,188,279,65,46,15,615,232,12406,1935,72320,84726,11/16/2020
5/15/2020,381,15519,3458,100538,116057,24,1474,41,1024,5,193,257,63,46,14,629,232,12638,1758,74078,86716,11/16/2020
5/16/2020,449,15968,4156,104694,120662,25,1499,15,1039,5,198,262,62,47,15,644,247,12885,1895,75973,88858,11/16/2020
5/17/2020,240,16208,2768,107462,123670,17,1516,9,1048,5,203,265,60,46,10,654,126,13011,1503,77476,90487,11/16/2020
5/18/2020,250,16458,2001,109463,125921,19,1535,16,1064,5,208,263,58,41,18,672,135,13146,1337,78813,91959,11/16/2020
5/19/2020,415,16873,3168,112631,129504,23,1558,33,1097,5,213,248,57,39,11,683,215,13361,1891,80704,94065,11/16/2020
5/20/2020,326,17199,2771,115402,132601,19,1577,23,1120,7,220,237,53,34,22,705,184,13545,1495,82199,95744,11/16/2020
5/21/2020,374,17573,3757,119159,136732,25,1602,15,1135,3,223,244,54,30,20,725,168,13713,1907,84106,97819,11/16/2020
5/22/2020,351,17924,3161,122320,140244,20,1622,28,1163,5,228,231,53,30,11,736,206,13919,1566,85672,99591,11/16/2020
5/23/2020,253,18177,2742,125062,143239,19,1641,11,1174,3,231,236,53,33,13,749,109,14028,1244,86916,100944,11/16/2020
5/24/2020,163,18340,1370,126432,144772,13,1654,14,1188,2,233,233,54,36,8,757,83,14111,759,87675,101786,11/16/2020
5/25/2020,147,18487,1385,127817,146304,14,1668,14,1202,0,233,233,54,34,10,767,76,14187,740,88415,102602,11/16/2020
5/26/2020,285,18772,2620,130437,149209,24,1692,21,1223,5,238,231,49,33,15,782,158,14345,1712,90127,104472,11/16/2020
5/27/2020,276,19048,2057,132494,151542,20,1712,18,1241,3,241,230,51,33,10,792,132,14477,1116,91243,105720,11/16/2020
5/28/2020,348,19396,3359,135853,155249,17,1729,29,1270,4,245,214,47,32,8,800,130,14607,1099,92342,106949,11/16/2020
5/29/2020,410,19806,3915,139768,159574,19,1748,26,1296,7,252,200,43,31,12,812,174,14781,1542,93884,108665,11/16/2020
5/30/2020,225,20031,3915,143683,163714,16,1764,19,1315,4,256,193,41,29,12,824,109,14890,1771,95655,110545,11/16/2020
5/31/2020,155,20186,1690,145373,165559,11,1775,11,1326,1,257,192,44,26,3,827,78,14968,837,96492,111460,11/16/2020
6/1/2020,212,20398,2792,148165,168563,8,1783,14,1340,1,258,185,45,29,5,832,93,15061,1359,97851,112912,11/16/2020
6/2/2020,273,20671,3022,151187,171858,8,1791,9,1349,3,261,181,38,25,10,842,98,15159,1404,99255,114414,11/16/2020
6/3/2020,254,20925,3486,154673,175598,14,1805,18,1367,6,267,171,34,25,11,853,99,15258,1635,100890,116148,11/16/2020
6/4/2020,276,21201,4471,159144,180345,7,1812,26,1393,4,271,148,31,24,12,865,107,15365,1993,102883,118248,11/16/2020
6/5/2020,215,21416,3513,162657,184073,15,1827,13,1406,6,277,144,27,21,11,876,99,15464,1527,104410,119874,11/16/2020
6/6/2020,201,21617,2616,165273,186890,10,1837,7,1413,2,279,145,29,19,6,882,67,15531,1099,105509,121040,11/16/2020
6/7/2020,83,21700,1625,166898,188598,11,1848,7,1420,1,280,148,25,17,4,886,51,15582,775,106284,121866,11/16/2020
6/8/2020,119,21819,1849,168747,190566,15,1863,13,1433,2,282,148,27,18,4,890,45,15627,939,107223,122850,11/16/2020
6/9/2020,223,22042,2673,171420,193462,10,1873,19,1452,0,282,139,28,21,1,891,64,15691,1236,108459,124150,11/16/2020
6/10/2020,209,22251,2987,174407,196658,13,1886,12,1464,2,284,138,24,17,4,895,100,15791,1443,109902,125693,11/16/2020
6/11/2020,195,22446,3513,177920,200366,7,1893,15,1479,1,285,129,25,16,6,901,88,15879,1503,111405,127284,11/16/2020
6/12/2020,209,22655,4601,182521,205176,9,1902,16,1495,1,286,121,24,16,2,903,78,15957,2145,113550,129507,11/16/2020
6/13/2020,113,22768,3036,185557,208325,6,1908,5,1500,0,286,122,20,15,3,906,49,16006,1353,114903,130909,11/16/2020
6/14/2020,81,22849,2046,187603,210452,7,1915,8,1508,1,287,120,20,14,3,909,33,16039,954,115857,131896,11/16/2020
6/15/2020,188,23037,3108,190711,213748,14,1929,19,1527,0,287,115,20,16,5,914,75,16114,1754,117611,133725,11/16/2020
6/16/2020,110,23147,3017,193728,216875,11,1940,9,1536,1,288,116,22,16,8,922,50,16164,1511,119122,135286,11/16/2020
6/17/2020,127,23274,2835,196563,219837,15,1955,20,1556,4,292,107,18,14,6,928,50,16214,1293,120415,136629,11/16/2020
6/18/2020,149,23423,3048,199611,223034,9,1964,15,1571,1,293,100,19,16,7,935,70,16284,1299,121714,137998,11/16/2020
6/19/2020,141,23564,3769,203380,226944,12,1976,12,1583,1,294,99,20,17,3,938,59,16343,1334,123048,139391,11/16/2020
6/20/2020,84,23648,1891,205271,228919,9,1985,12,1595,0,294,96,20,18,4,942,36,16379,805,123853,140232,11/16/2020
6/21/2020,37,23685,1064,206335,230020,8,1993,5,1600,0,294,99,20,18,2,944,30,16409,682,124535,140944,11/16/2020
6/22/2020,138,23823,3730,210065,233888,12,2005,17,1617,0,294,94,19,18,2,946,65,16474,1681,126216,142690,11/16/2020
6/23/2020,163,23986,3831,213896,237882,3,2008,13,1630,3,297,81,18,18,7,953,81,16555,1759,127975,144530,11/16/2020
6/24/2020,120,24106,3502,217398,241504,9,2017,10,1640,1,298,79,18,18,5,958,44,16599,1662,129637,146236,11/16/2020
6/25/2020,103,24209,2883,220281,244490,6,2023,14,1654,1,299,70,17,17,1,959,50,16649,1479,131116,147765,11/16/2020
6/26/2020,94,24303,2488,222769,247072,2,2025,10,1664,0,299,62,18,18,1,960,60,16709,1308,132424,149133,11/16/2020
6/27/2020,84,24387,3216,225985,250372,5,2030,3,1667,1,300,63,17,17,5,965,37,16746,1188,133612,150358,11/16/2020
6/28/2020,39,24426,1469,227454,251880,4,2034,4,1671,4,304,59,15,14,6,971,17,16763,585,134197,150960,11/16/2020
6/29/2020,85,24511,3697,231151,255662,4,2038,5,1676,0,304,58,14,14,1,972,39,16802,1335,135532,152334,11/16/2020
6/30/2020,57,24568,1958,233109,257677,1,2039,5,1681,1,305,53,12,11,4,976,33,16835,983,136515,153350,11/16/2020
7/1/2020,144,24712,4098,237207,261919,8,2047,10,1691,0,305,51,11,11,1,977,79,16914,1900,138415,155329,11/16/2020
7/2/2020,103,24815,2803,240010,264825,5,2052,5,1696,1,306,50,10,10,3,980,59,16973,1068,139483,156456,11/16/2020
7/3/2020,50,24865,2079,242089,266954,9,2061,6,1702,0,306,53,9,9,3,983,25,16998,774,140257,157255,11/16/2020
7/4/2020,57,24922,2345,244434,269356,2,2063,4,1706,1,307,50,10,9,2,985,33,17031,986,141243,158274,11/16/2020
7/5/2020,49,24971,2932,247366,272337,1,2064,2,1708,1,308,48,8,8,2,987,26,17057,1411,142654,159711,11/16/2020
7/6/2020,101,25072,2814,250180,275252,6,2070,6,1714,0,308,48,9,9,4,991,57,17114,1531,144185,161299,11/16/2020
7/7/2020,81,25153,3457,253637,278790,5,2075,7,1721,0,308,46,8,8,2,993,47,17161,1524,145709,162870,11/16/2020
7/8/2020,105,25258,3409,257046,282304,4,2079,2,1723,0,308,48,9,8,0,993,64,17225,1394,147103,164328,11/16/2020
7/9/2020,94,25352,3714,260760,286112,9,2088,3,1726,0,308,54,9,8,0,993,50,17275,1598,148701,165976,11/16/2020
7/10/2020,132,25484,4437,265197,290681,6,2094,3,1729,2,310,55,7,7,3,996,80,17355,2045,150746,168101,11/16/2020
7/11/2020,63,25547,2938,268135,293682,6,2100,3,1732,1,311,57,6,6,3,999,36,17391,1301,152047,169438,11/16/2020
7/12/2020,47,25594,1838,269973,295567,1,2101,3,1735,1,312,54,6,5,3,1002,34,17425,930,152977,170402,11/16/2020
7/13/2020,84,25678,3209,273182,298860,8,2109,10,1745,0,312,52,6,5,1,1003,61,17486,1484,154461,171947,11/16/2020
7/14/2020,74,25752,3298,276480,302232,7,2116,4,1749,0,312,55,5,5,1,1004,44,17530,1362,155823,173353,11/16/2020
7/15/2020,130,25882,4181,280661,306543,5,2121,7,1756,0,312,53,5,4,0,1004,100,17630,1731,157554,175184,11/16/2020
7/16/2020,103,25985,3740,284401,310386,6,2127,9,1765,0,312,50,6,5,1,1005,76,17706,1596,159150,176856,11/16/2020
7/17/2020,156,26141,4239,288640,314781,14,2141,3,1768,1,313,60,5,5,2,1007,79,17785,1827,160977,178762,11/16/2020
7/18/2020,85,26226,3272,291912,318138,5,2146,9,1777,1,314,55,5,4,4,1011,70,17855,1379,162356,180211,11/16/2020
7/19/2020,82,26308,2696,294608,320916,7,2153,3,1780,0,314,59,6,4,2,1013,57,17912,1131,163487,181399,11/16/2020
7/20/2020,71,26379,2666,297274,323653,9,2162,7,1787,0,314,61,7,5,2,1015,68,17980,1440,164927,182907,11/16/2020
7/21/2020,130,26509,4304,301578,328087,9,2171,11,1798,0,314,59,9,6,1,1016,108,18088,1898,166825,184913,11/16/2020
7/22/2020,130,26639,3928,305506,332145,7,2178,8,1806,1,315,57,7,6,1,1017,86,18174,1658,168483,186657,11/16/2020
7/23/2020,141,26780,4415,309921,336701,8,2186,6,1812,0,315,59,8,7,0,1017,115,18289,1946,170429,188718,11/16/2020
7/24/2020,172,26952,5966,315887,342839,15,2201,12,1824,0,315,62,9,7,0,1017,119,18408,2285,172714,191122,11/16/2020
7/25/2020,134,27086,4398,320285,347371,7,2208,7,1831,0,315,62,10,8,3,1020,108,18516,2071,174785,193301,11/16/2020
7/26/2020,62,27148,3033,323318,350466,8,2216,9,1840,0,315,61,11,7,1,1021,54,18570,1324,176109,194679,11/16/2020
7/27/2020,188,27336,4191,327509,354845,12,2228,7,1847,0,315,66,13,8,1,1022,138,18708,2316,178425,197133,11/16/2020
7/28/2020,105,27441,3840,331349,358790,5,2233,5,1852,0,315,66,14,7,1,1023,95,18803,1615,180040,198843,11/16/2020
7/29/2020,190,27631,5139,336488,364119,9,2242,10,1862,0,315,65,15,7,0,1023,154,18957,2277,182317,201274,11/16/2020
7/30/2020,121,27752,4345,340833,368585,6,2248,2,1864,1,316,68,15,6,1,1024,97,19054,1624,183941,202995,11/16/2020
7/31/2020,131,27883,5512,346345,374228,7,2255,9,1873,0,316,66,15,7,1,1025,89,19143,1816,185757,204900,11/16/2020
8/1/2020,109,27992,4294,350639,378631,7,2262,2,1875,0,316,71,14,7,1,1026,89,19232,1541,187298,206530,11/16/2020
8/2/2020,84,28076,2804,353443,381519,12,2274,12,1887,2,318,69,14,8,2,1028,62,19294,1251,188549,207843,11/16/2020
8/3/2020,188,28264,5248,358691,386955,11,2285,10,1897,0,318,70,16,7,1,1029,150,19444,2181,190730,210174,11/16/2020
8/4/2020,125,28389,3691,362382,390771,8,2293,5,1902,1,319,72,12,5,2,1031,99,19543,1748,192478,212021,11/16/2020
8/5/2020,147,28536,5935,368317,396853,11,2304,9,1911,1,320,73,10,5,2,1033,119,19662,2434,194912,214574,11/16/2020
8/6/2020,169,28705,5546,373863,402568,7,2311,9,1920,0,320,71,9,4,0,1033,120,19782,2366,197278,217060,11/16/2020
8/7/2020,123,28828,4851,378714,407542,12,2323,9,1929,1,321,73,9,3,2,1035,87,19869,2116,199394,219263,11/16/2020
8/8/2020,123,28951,4112,382826,411777,19,2342,6,1935,1,322,85,8,3,1,1036,91,19960,1764,201158,221118,11/16/2020
8/9/2020,42,28993,1727,384553,413546,6,2348,8,1943,0,322,83,9,4,0,1036,35,19995,1057,202215,222210,11/16/2020
8/10/2020,149,29142,4587,389140,418282,8,2356,9,1952,0,322,82,9,4,1,1037,113,20108,2002,204217,224325,11/16/2020
8/11/2020,106,29248,4334,393474,422722,5,2361,13,1965,0,322,74,10,4,3,1040,92,20200,2240,206457,226657,11/16/2020
8/12/2020,121,29369,5188,398662,428031,8,2369,11,1976,0,322,71,9,3,1,1041,101,20301,2589,209046,229347,11/16/2020
8/13/2020,135,29504,4196,402858,432362,13,2382,12,1988,0,322,72,11,3,0,1041,95,20396,1884,210930,231326,11/16/2020
8/14/2020,145,29649,5498,408356,438005,13,2395,11,1999,0,322,74,11,4,3,1044,98,20494,1953,212883,233377,11/16/2020
8/15/2020,106,29755,4534,412890,442645,9,2404,11,2010,1,323,71,11,5,0,1044,88,20582,1666,214549,235131,11/16/2020
8/16/2020,83,29838,2477,415367,445205,6,2410,5,2015,4,327,68,8,4,6,1050,70,20652,949,215498,236150,11/16/2020
8/17/2020,106,29944,4575,419942,449886,8,2418,6,2021,0,327,70,8,5,2,1052,87,20739,2355,217853,238592,11/16/2020
8/18/2020,128,30072,4911,424853,454925,11,2429,8,2029,1,328,72,8,4,5,1057,94,20833,2719,220572,241405,11/16/2020
8/19/2020,113,30185,5077,429930,460115,8,2437,9,2038,1,329,70,9,5,0,1057,90,20923,2603,223175,244098,11/16/2020
8/20/2020,173,30358,7411,437341,467699,12,2449,6,2044,2,331,74,10,5,3,1060,139,21062,3476,226651,247713,11/16/2020
8/21/2020,151,30509,6577,443918,474427,8,2457,5,2049,1,332,76,9,4,2,1062,125,21187,2906,229557,250744,11/16/2020
8/22/2020,96,30605,5550,449468,480073,11,2468,12,2061,0,332,75,11,4,1,1063,84,21271,2568,232125,253396,11/16/2020
8/23/2020,71,30676,4375,453843,484519,11,2479,5,2066,0,332,81,12,2,1,1064,56,21327,2452,234577,255904,11/16/2020
8/24/2020,105,30781,5784,459627,490408,7,2486,10,2076,1,333,77,14,4,1,1065,77,21404,3118,237695,259099,11/16/2020
8/25/2020,108,30889,4764,464391,495280,10,2496,4,2080,1,334,82,12,4,1,1066,92,21496,2267,239962,261458,11/16/2020
8/26/2020,170,31059,9482,473873,504932,4,2500,8,2088,0,334,78,10,5,1,1067,127,21623,3055,243017,264640,11/16/2020
8/27/2020,92,31151,8565,482438,513589,6,2506,14,2102,1,335,69,7,5,2,1069,70,21693,3116,246133,267826,11/16/2020
8/28/2020,113,31264,7994,490432,521696,14,2520,4,2106,0,335,79,10,7,2,1071,87,21780,2403,248536,270316,11/16/2020
8/29/2020,65,31329,5374,495806,527135,6,2526,8,2114,1,336,76,11,6,2,1073,51,21831,1899,250435,272266,11/16/2020
8/30/2020,66,31395,4323,500129,531524,7,2533,4,2118,0,336,79,9,5,2,1075,48,21879,1966,252401,274280,11/16/2020
8/31/2020,105,31500,4863,504992,536492,12,2545,16,2134,0,336,75,8,4,1,1076,81,21960,2163,254564,276524,11/16/2020
9/1/2020,98,31598,7109,512101,543699,6,2551,9,2143,1,337,71,7,4,2,1078,66,22026,2355,256919,278945,11/16/2020
9/2/2020,125,31723,10529,522630,554353,9,2560,10,2153,1,338,69,8,4,2,1080,104,22130,3021,259940,282070,11/16/2020
9/3/2020,90,31813,11079,533709,565522,8,2568,8,2161,0,338,69,9,4,3,1083,73,22203,2556,262496,284699,11/16/2020
9/4/2020,103,31916,8963,542672,574588,11,2579,4,2165,0,338,76,9,4,1,1084,83,22286,2352,264848,287134,11/16/2020
9/5/2020,52,31968,6309,548981,580949,6,2585,9,2174,0,338,73,8,3,1,1085,42,22328,1586,266434,288762,11/16/2020
9/6/2020,88,32056,4325,553306,585362,4,2589,8,2182,1,339,68,6,3,1,1086,65,22393,1931,268365,290758,11/16/2020
9/7/2020,35,32091,3002,556308,588399,11,2600,3,2185,0,339,76,5,3,1,1087,26,22419,637,269002,291421,11/16/2020
9/8/2020,74,32165,6381,562689,594854,6,2606,12,2197,1,340,69,6,3,2,1089,66,22485,1576,270578,293063,11/16/2020
9/9/2020,118,32283,8650,571339,603622,10,2616,5,2202,1,341,73,9,3,1,1090,102,22587,2122,272700,295287,11/16/2020
9/10/2020,164,32447,11334,582673,615120,9,2625,8,2210,0,341,74,10,3,1,1091,111,22698,2251,274951,297649,11/16/2020
9/11/2020,120,32567,9454,592127,624694,11,2636,11,2221,0,341,74,10,5,0,1091,97,22795,1953,276904,299699,11/16/2020
9/12/2020,110,32677,6173,598300,630977,8,2644,5,2226,2,343,75,9,5,3,1094,97,22892,1503,278407,301299,11/16/2020
9/13/2020,58,32735,2716,601016,633751,4,2648,3,2229,0,343,76,10,5,0,1094,54,22946,853,279260,302206,11/16/2020
9/14/2020,104,32839,6446,607462,640301,6,2654,3,2232,2,345,77,10,5,2,1096,95,23041,1717,280977,304018,11/16/2020
9/15/2020,122,32961,8466,615928,648889,7,2661,2,2234,1,346,81,10,5,2,1098,124,23165,2175,283152,306317,11/16/2020
9/16/2020,137,33098,9715,625643,658741,7,2668,7,2241,2,348,79,9,6,5,1103,118,23283,1960,285112,308395,11/16/2020
9/17/2020,125,33223,9239,634882,668105,7,2675,15,2256,0,348,71,8,4,0,1103,154,23437,1932,287044,310481,11/16/2020
9/18/2020,132,33355,10045,644927,678282,7,2682,7,2263,1,349,70,11,6,2,1105,132,23569,1914,288958,312527,11/16/2020
9/19/2020,115,33470,8297,653224,686694,7,2689,3,2266,0,349,74,10,6,4,1109,112,23681,1683,290641,314322,11/16/2020
9/20/2020,60,33530,3676,656900,690430,7,2696,6,2272,2,351,73,9,8,4,1113,49,23730,1311,291952,315682,11/16/2020
9/21/2020,102,33632,7018,663918,697550,12,2708,3,2275,2,353,80,8,6,2,1115,94,23824,2396,294348,318172,11/16/2020
9/22/2020,154,33786,9287,673205,706991,12,2720,3,2278,1,354,88,7,5,1,1116,124,23948,2193,296541,320489,11/16/2020
9/23/2020,136,33922,10650,683855,717777,12,2732,7,2285,0,354,93,6,5,0,1116,127,24075,2204,298745,322820,11/16/2020
9/24/2020,120,34042,12479,696334,730376,7,2739,9,2294,1,355,90,7,5,1,1117,121,24196,3148,301893,326089,11/16/2020
9/25/2020,149,34191,10553,706887,741078,9,2748,10,2304,0,355,89,6,5,1,1118,142,24338,2987,304880,329218,11/16/2020
9/26/2020,146,34337,10559,717446,751783,12,2760,9,2313,0,355,92,6,5,1,1119,119,24457,2410,307290,331747,11/16/2020
9/27/2020,43,34380,2764,720210,754590,7,2767,5,2318,0,355,94,9,5,0,1119,34,24491,838,308128,332619,11/16/2020
9/28/2020,152,34532,7308,727518,762050,7,2774,7,2325,2,357,92,7,5,2,1121,134,24625,2251,310379,335004,11/16/2020
9/29/2020,208,34740,11046,738564,773304,12,2786,18,2343,1,358,85,6,6,1,1122,190,24815,2812,313191,338006,11/16/2020
9/30/2020,221,34961,12230,750794,785755,6,2792,6,2349,0,358,85,6,6,1,1123,187,25002,2574,315765,340767,11/16/2020
10/1/2020,185,35146,12503,763297,798443,17,2809,13,2362,1,359,88,6,4,2,1125,166,25168,2401,318166,343334,11/16/2020
10/2/2020,210,35356,12153,775450,810806,14,2823,13,2375,1,360,88,8,5,2,1127,182,25350,2490,320656,346006,11/16/2020
10/3/2020,157,35513,9312,784762,820275,9,2832,9,2384,2,362,86,9,4,2,1129,131,25481,2011,322667,348148,11/16/2020
10/4/2020,81,35594,2369,787131,822725,11,2843,9,2393,1,363,87,8,5,2,1131,78,25559,950,323617,349176,11/16/2020
10/5/2020,174,35768,8983,796114,831882,30,2873,10,2403,2,365,105,9,6,4,1135,160,25719,3019,326636,352355,11/16/2020
10/6/2020,177,35945,11186,807300,843245,11,2884,4,2407,0,365,112,11,7,0,1135,186,25905,2892,329528,355433,11/16/2020
10/7/2020,231,36176,12440,819740,855916,13,2897,14,2421,2,367,109,9,7,2,1137,243,26148,3525,333053,359201,11/16/2020
10/8/2020,262,36438,15231,834971,871409,17,2914,13,2434,2,369,111,7,5,4,1141,274,26422,4199,337252,363674,11/16/2020
10/9/2020,217,36655,13745,848716,885371,21,2935,12,2446,0,369,120,10,7,3,1144,199,26621,4305,341557,368178,11/16/2020
10/10/2020,229,36884,13832,862548,899432,19,2954,10,2456,1,370,128,13,7,2,1146,194,26815,3779,345336,372151,11/16/2020
10/11/2020,97,36981,3263,865811,902792,12,2966,9,2465,1,371,130,14,5,6,1152,88,26903,1161,346497,373400,11/16/2020
10/12/2020,169,37150,6439,872250,909400,19,2985,15,2480,2,373,132,14,5,4,1156,159,27062,1734,348231,375293,11/16/2020
10/13/2020,213,37363,8521,880771,918134,15,3000,13,2493,4,377,130,13,5,7,1163,207,27269,2302,350533,377802,11/16/2020
10/14/2020,322,37685,15038,895809,933494,18,3018,7,2500,0,377,141,15,5,2,1165,303,27572,4025,354558,382130,11/16/2020
10/15/2020,262,37947,14640,910449,948396,12,3030,16,2516,1,378,136,13,5,2,1167,254,27826,3570,358128,385954,11/16/2020
10/16/2020,279,38226,15011,925460,963686,13,3043,18,2534,1,379,130,13,4,2,1169,275,28101,3378,361506,389607,11/16/2020
10/17/2020,354,38580,14068,939528,978108,19,3062,11,2545,1,380,137,17,4,2,1171,311,28412,3257,364763,393175,11/16/2020
10/18/2020,155,38735,4039,943567,982302,18,3080,11,2556,0,380,144,17,6,2,1173,129,28541,1322,366085,394626,11/16/2020
10/19/2020,388,39123,8489,952056,991179,21,3101,22,2578,2,382,141,15,6,1,1174,325,28866,2560,368645,397511,11/16/2020
10/20/2020,439,39562,13242,965298,1004860,22,3123,17,2595,0,382,146,14,8,3,1177,387,29253,3005,371650,400903,11/16/2020
10/21/2020,544,40106,17462,982760,1022866,21,3144,8,2603,2,384,157,15,9,3,1180,471,29724,3517,375167,404891,11/16/2020
10/22/2020,538,40644,15863,998623,1039267,24,3168,20,2623,3,387,158,14,9,3,1183,489,30213,3187,378354,408567,11/16/2020
10/23/2020,514,41158,16632,1015255,1056413,22,3190,22,2645,1,388,157,15,9,3,1186,460,30673,2877,381231,411904,11/16/2020
10/24/2020,359,41517,10248,1025503,1067020,17,3207,11,2656,0,388,163,14,8,1,1187,338,31011,2261,383492,414503,11/16/2020
10/25/2020,233,41750,4760,1030263,1072013,16,3223,15,2671,1,389,163,15,8,2,1189,210,31221,1465,384957,416178,11/16/2020
10/26/2020,454,42204,9174,1039437,1081641,26,3249,15,2686,2,391,172,18,8,3,1192,404,31625,2972,387929,419554,11/16/2020
10/27/2020,517,42721,13993,1053430,1096151,28,3277,15,2701,2,393,183,17,9,4,1196,454,32079,2385,390314,422393,11/16/2020
10/28/2020,469,43190,15230,1068660,1111850,25,3302,26,2727,1,394,181,16,9,3,1199,409,32488,2696,393010,425498,11/16/2020
10/29/2020,609,43799,16234,1084894,1128693,20,3322,22,2749,3,397,176,19,11,4,1203,529,33017,3124,396134,429151,11/16/2020
10/30/2020,544,44343,14319,1099213,1143556,21,3343,21,2770,5,402,171,19,9,4,1207,466,33483,2948,399082,432565,11/16/2020
10/31/2020,585,44928,11843,1111056,1155984,31,3374,13,2783,1,403,188,22,9,3,1210,489,33972,2411,401493,435465,11/16/2020
11/1/2020,330,45258,5078,1116134,1161392,20,3394,15,2798,1,404,192,26,12,4,1214,273,34245,1262,402755,437000,11/16/2020
11/2/2020,520,45778,9918,1126052,1171830,35,3429,27,2825,3,407,197,23,11,5,1219,454,34699,2932,405687,440386,11/16/2020
11/3/2020,603,46381,13062,1139114,1185495,32,3461,25,2850,1,408,203,22,11,1,1220,529,35228,2521,408208,443436,11/16/2020
11/4/2020,680,47061,16119,1155233,1202294,34,3495,27,2877,2,410,208,22,11,4,1224,628,35856,2933,411141,446997,11/16/2020
11/5/2020,760,47821,18887,1174120,1221941,46,3541,35,2912,1,411,218,21,13,3,1227,673,36529,5171,416312,452841,11/16/2020
11/6/2020,777,48598,17300,1191420,1240018,41,3582,31,2943,1,412,227,26,16,5,1232,702,37231,4342,420654,457885,11/16/2020
11/7/2020,608,49206,13649,1205069,1254275,33,3615,25,2968,1,413,234,29,17,1,1233,576,37807,2476,423130,460937,11/16/2020
11/8/2020,338,49544,4160,1209229,1258773,31,3646,26,2994,1,414,238,28,18,3,1236,323,38130,1288,424418,462548,11/16/2020
11/9/2020,791,50335,9038,1218267,1268602,37,3683,33,3027,2,416,240,26,17,3,1239,742,38872,2323,426741,465613,11/16/2020
11/10/2020,1059,51394,12982,1231249,1282643,44,3727,36,3063,0,416,248,29,17,6,1245,971,39843,2907,429648,469491,11/16/2020
11/11/2020,1100,52494,19741,1250990,1303484,38,3765,22,3085,5,421,259,28,14,6,1251,1014,40857,2716,432364,473221,11/16/2020
11/12/2020,892,53386,13869,1264859,1318245,35,3800,31,3116,3,424,260,26,14,5,1256,815,41672,2222,434586,476258,11/16/2020
11/13/2020,1158,54544,16356,1281215,1335759,29,3829,31,3147,0,424,258,23,15,1,1257,1091,42763,3128,437714,480477,11/16/2020
11/14/2020,752,55296,13011,1294226,1349522,28,3857,25,3172,5,429,256,21,12,8,1265,679,43442,2427,440141,483583,11/16/2020
11/15/2020,542,55838,5653,1299879,1355717,,,,,,,,,,5,1270,481,43923,1336,441477,485400,11/16/2020
2020-02-27,0,0,0,0,0,1.0,1.0,0.0,0.0,0.0,0.0,1.0,0.0,0.0,0,0,0,0,0,0,0,11/17/2020
2020-02-28,0,0,0,0,0,0.0,1.0,0.0,0.0,0.0,0.0,1.0,1.0,0.0,0,0,0,0,0,0,0,11/17/2020
2020-02-29,0,0,0,0,0,0.0,1.0,0.0,0.0,0.0,0.0,1.0,1.0,0.0,0,0,0,0,0,0,0,11/17/2020
2020-03-01,2,2,2,2,4,0.0,1.0,0.0,0.0,0.0,0.0,1.0,1.0,1.0,0,0,2,2,2,2,4,11/17/2020
2020-03-02,0,2,1,3,5,1.0,2.0,0.0,0.0,0.0,0.0,2.0,2.0,2.0,0,0,0,2,0,2,4,11/17/2020
2020-03-03,0,2,2,5,7,0.0,2.0,0.0,0.0,0.0,0.0,2.0,2.0,2.0,0,0,0,2,1,3,5,11/17/2020
2020-03-04,0,2,12,17,19,1.0,3.0,0.0,0.0,0.0,0.0,3.0,2.0,2.0,0,0,0,2,10,13,15,11/17/2020
2020-03-05,0,2,4,21,23,0.0,3.0,0.0,0.0,0.0,0.0,3.0,2.0,2.0,0,0,1,3,4,17,20,11/17/2020
2020-03-06,1,3,12,33,36,0.0,3.0,0.0,0.0,0.0,0.0,3.0,2.0,2.0,0,0,0,3,11,28,31,11/17/2020
2020-03-07,0,3,19,52,55,0.0,3.0,0.0,0.0,0.0,0.0,3.0,2.0,1.0,0,0,0,3,19,47,50,11/17/2020
2020-03-08,0,3,18,70,73,0.0,3.0,0.0,0.0,0.0,0.0,3.0,2.0,1.0,0,0,0,3,18,65,68,11/17/2020
2020-03-09,1,4,15,85,89,0.0,3.0,0.0,0.0,0.0,0.0,3.0,2.0,1.0,0,0,1,4,14,79,83,11/17/2020
2020-03-10,2,6,25,110,116,0.0,3.0,0.0,0.0,0.0,0.0,3.0,2.0,1.0,0,0,1,5,23,102,107,11/17/2020
2020-03-11,0,6,34,144,150,1.0,4.0,0.0,0.0,0.0,0.0,4.0,1.0,1.0,0,0,0,5,34,136,141,11/17/2020
2020-03-12,9,15,41,185,200,1.0,5.0,0.0,0.0,0.0,0.0,5.0,1.0,1.0,0,0,8,13,38,174,187,11/17/2020
2020-03-13,6,21,50,235,256,4.0,9.0,1.0,1.0,0.0,0.0,8.0,1.0,1.0,0,0,6,19,47,221,240,11/17/2020
2020-03-14,0,21,90,325,346,0.0,9.0,0.0,1.0,0.0,0.0,8.0,1.0,1.0,0,0,0,19,83,304,323,11/17/2020
2020-03-15,1,22,54,379,401,1.0,10.0,0.0,1.0,0.0,0.0,9.0,2.0,1.0,0,0,1,20,53,357,377,11/17/2020
2020-03-16,2,24,95,474,498,2.0,12.0,0.0,1.0,0.0,0.0,11.0,2.0,0.0,0,0,2,22,91,448,470,11/17/2020
2020-03-17,12,36,162,636,672,6.0,18.0,0.0,1.0,0.0,0.0,17.0,2.0,0.0,0,0,11,33,148,596,629,11/17/2020
2020-03-18,9,45,116,752,797,3.0,21.0,0.0,1.0,0.0,0.0,20.0,2.0,0.0,0,0,11,44,110,706,750,11/17/2020
2020-03-19,15,60,262,1014,1074,2.0,23.0,1.0,2.0,0.0,0.0,21.0,3.0,0.0,1,1,17,61,247,953,1014,11/17/2020
2020-03-20,13,73,197,1211,1284,5.0,28.0,0.0,2.0,0.0,0.0,26.0,4.0,0.0,0,1,13,74,186,1139,1213,11/17/2020
2020-03-21,12,85,126,1337,1422,3.0,31.0,2.0,4.0,0.0,0.0,27.0,5.0,0.0,0,1,14,88,122,1261,1349,11/17/2020
2020-03-22,27,112,282,1619,1731,2.0,33.0,0.0,4.0,0.0,0.0,29.0,5.0,0.0,0,1,25,113,257,1518,1631,11/17/2020
2020-03-23,14,126,169,1788,1914,15.0,48.0,1.0,5.0,0.0,0.0,43.0,9.0,3.0,0,1,16,129,161,1679,1808,11/17/2020
2020-03-24,20,146,242,2030,2176,8.0,56.0,0.0,5.0,0.0,0.0,51.0,10.0,5.0,0,1,19,148,229,1908,2056,11/17/2020
2020-03-25,26,172,182,2212,2384,5.0,61.0,2.0,7.0,0.0,0.0,54.0,11.0,3.0,0,1,28,176,162,2070,2246,11/17/2020
2020-03-26,35,207,181,2393,2600,9.0,70.0,5.0,12.0,0.0,0.0,58.0,14.0,5.0,0,1,41,217,169,2239,2456,11/17/2020
2020-03-27,27,234,214,2607,2841,9.0,79.0,1.0,13.0,1.0,1.0,65.0,16.0,6.0,2,3,31,248,195,2434,2682,11/17/2020
2020-03-28,59,293,260,2867,3160,11.0,90.0,2.0,15.0,1.0,2.0,73.0,15.0,6.0,1,4,64,312,240,2674,2986,11/17/2020
2020-03-29,100,393,350,3217,3610,8.0,98.0,3.0,18.0,1.0,3.0,77.0,18.0,8.0,2,6,105,417,309,2983,3400,11/17/2020
2020-03-30,62,455,222,3439,3894,19.0,117.0,5.0,23.0,0.0,3.0,91.0,19.0,11.0,3,9,78,495,181,3164,3659,11/17/2020
2020-03-31,71,526,369,3808,4334,11.0,128.0,7.0,30.0,1.0,4.0,94.0,21.0,13.0,2,11,73,568,294,3458,4026,11/17/2020
2020-04-01,99,625,698,4506,5131,18.0,146.0,7.0,37.0,0.0,4.0,105.0,29.0,15.0,1,12,100,668,623,4081,4749,11/17/2020
2020-04-02,52,677,477,4983,5660,22.0,168.0,6.0,43.0,2.0,6.0,119.0,35.0,21.0,4,16,62,730,423,4504,5234,11/17/2020
2020-04-03,108,785,774,5757,6542,23.0,191.0,7.0,50.0,0.0,6.0,135.0,42.0,25.0,3,19,100,830,691,5195,6025,11/17/2020
2020-04-04,143,928,660,6417,7345,22.0,213.0,4.0,54.0,5.0,11.0,148.0,40.0,29.0,9,28,138,968,602,5797,6765,11/17/2020
2020-04-05,187,1115,1156,7573,8688,20.0,233.0,9.0,63.0,1.0,12.0,158.0,43.0,35.0,2,30,181,1149,1029,6826,7975,11/17/2020
2020-04-06,218,1333,1706,9279,10612,26.0,259.0,7.0,70.0,0.0,12.0,177.0,47.0,39.0,7,37,207,1356,1506,8332,9688,11/17/2020
2020-04-07,284,1617,1629,10908,12525,20.0,279.0,4.0,74.0,2.0,14.0,191.0,49.0,41.0,5,42,261,1617,1455,9787,11404,11/17/2020
2020-04-08,290,1907,1720,12628,14535,19.0,298.0,8.0,82.0,5.0,19.0,197.0,49.0,37.0,10,52,271,1888,1512,11299,13187,11/17/2020
2020-04-09,283,2190,1516,14144,16334,32.0,330.0,8.0,90.0,4.0,23.0,217.0,53.0,40.0,7,59,277,2165,1321,12620,14785,11/17/2020
2020-04-10,419,2609,2574,16718,19327,29.0,359.0,17.0,107.0,5.0,28.0,224.0,59.0,41.0,11,70,400,2565,2309,14929,17494,11/17/2020
2020-04-11,297,2906,1905,18623,21529,29.0,388.0,11.0,118.0,2.0,30.0,240.0,61.0,48.0,12,82,281,2846,1676,16605,19451,11/17/2020
2020-04-12,314,3220,1670,20293,23513,35.0,423.0,13.0,131.0,5.0,35.0,257.0,59.0,49.0,9,91,286,3132,1384,17989,21121,11/17/2020
2020-04-13,161,3381,935,21228,24609,35.0,458.0,13.0,144.0,3.0,38.0,276.0,64.0,54.0,9,100,187,3319,824,18813,22132,11/17/2020
2020-04-14,289,3670,1787,23015,26685,27.0,485.0,18.0,162.0,5.0,43.0,280.0,72.0,53.0,8,108,262,3581,1481,20294,23875,11/17/2020
2020-04-15,351,4021,1799,24814,28835,31.0,516.0,20.0,182.0,3.0,46.0,288.0,72.0,54.0,17,125,306,3887,1500,21794,25681,11/17/2020
2020-04-16,447,4468,2494,27308,31776,36.0,552.0,25.0,207.0,6.0,52.0,293.0,72.0,53.0,14,139,387,4274,2014,23808,28082,11/17/2020
2020-04-17,304,4772,1821,29129,33901,32.0,584.0,20.0,227.0,7.0,59.0,298.0,66.0,45.0,21,160,290,4564,1408,25216,29780,11/17/2020
2020-04-18,321,5093,1725,30854,35947,26.0,610.0,18.0,245.0,4.0,63.0,302.0,63.0,49.0,15,175,284,4848,1289,26505,31353,11/17/2020
2020-04-19,381,5474,2047,32901,38375,23.0,633.0,26.0,271.0,1.0,64.0,298.0,65.0,55.0,11,186,337,5185,1695,28200,33385,11/17/2020
2020-04-20,394,5868,1907,34808,40676,46.0,679.0,29.0,300.0,2.0,66.0,313.0,75.0,56.0,10,196,376,5561,1540,29740,35301,11/17/2020
2020-04-21,444,6312,2110,36918,43230,45.0,724.0,32.0,332.0,5.0,71.0,321.0,72.0,56.0,18,214,383,5944,1666,31406,37350,11/17/2020
2020-04-22,418,6730,2390,39308,46038,41.0,765.0,32.0,364.0,5.0,76.0,325.0,73.0,58.0,18,232,379,6323,1867,33273,39596,11/17/2020
2020-04-23,479,7209,2469,41777,48986,32.0,797.0,28.0,392.0,5.0,81.0,324.0,76.0,62.0,15,247,412,6735,1813,35086,41821,11/17/2020
2020-04-24,491,7700,3284,45061,52761,35.0,832.0,26.0,418.0,4.0,85.0,329.0,85.0,63.0,15,262,407,7142,2553,37639,44781,11/17/2020
2020-04-25,393,8093,2206,47267,55360,34.0,866.0,17.0,435.0,5.0,90.0,341.0,85.0,62.0,14,276,299,7441,1719,39358,46799,11/17/2020
2020-04-26,316,8409,2309,49576,57985,33.0,899.0,15.0,450.0,3.0,93.0,356.0,86.0,59.0,14,290,274,7715,1828,41186,48901,11/17/2020
2020-04-27,249,8658,1620,51196,59854,29.0,928.0,21.0,471.0,4.0,97.0,360.0,86.0,61.0,10,300,206,7921,1121,42307,50228,11/17/2020
2020-04-28,410,9068,2263,53459,62527,44.0,972.0,24.0,495.0,3.0,100.0,377.0,88.0,59.0,22,322,332,8253,1665,43972,52225,11/17/2020
2020-04-29,476,9544,3343,56802,66346,36.0,1008.0,38.0,533.0,11.0,111.0,364.0,78.0,53.0,18,340,370,8623,2320,46292,54915,11/17/2020
2020-04-30,432,9976,2769,59571,69547,33.0,1041.0,38.0,571.0,6.0,117.0,353.0,83.0,57.0,24,364,349,8972,1839,48131,57103,11/17/2020
2020-05-01,454,10430,3086,62657,73087,52.0,1093.0,39.0,610.0,3.0,120.0,363.0,84.0,58.0,14,378,323,9295,2085,50216,59511,11/17/2020
2020-05-02,257,10687,1926,64583,75270,36.0,1129.0,38.0,648.0,5.0,125.0,356.0,93.0,63.0,24,402,192,9487,1237,51453,60940,11/17/2020
2020-05-03,283,10970,2160,66743,77713,31.0,1160.0,26.0,674.0,8.0,133.0,353.0,91.0,61.0,21,423,183,9670,1515,52968,62638,11/17/2020
2020-05-04,387,11357,2098,68841,80198,30.0,1190.0,31.0,705.0,6.0,139.0,346.0,89.0,58.0,18,441,290,9960,1522,54490,64450,11/17/2020
2020-05-05,433,11790,2873,71714,83504,29.0,1219.0,32.0,737.0,6.0,145.0,337.0,83.0,55.0,16,457,300,10260,1914,56404,66664,11/17/2020
2020-05-06,488,12278,2830,74544,86822,28.0,1247.0,44.0,781.0,9.0,154.0,312.0,80.0,55.0,21,478,340,10600,1873,58277,68877,11/17/2020
2020-05-07,425,12703,2969,77513,90216,36.0,1283.0,44.0,825.0,5.0,159.0,299.0,72.0,53.0,21,499,269,10869,1916,60193,71062,11/17/2020
2020-05-08,359,13062,2598,80111,93173,30.0,1313.0,29.0,854.0,5.0,164.0,295.0,72.0,54.0,22,521,229,11098,1690,61883,72981,11/17/2020
2020-05-09,467,13529,3346,83457,96986,22.0,1335.0,21.0,875.0,4.0,168.0,292.0,70.0,52.0,15,536,290,11388,2185,64068,75456,11/17/2020
2020-05-10,285,13814,2117,85574,99388,20.0,1355.0,23.0,898.0,6.0,174.0,283.0,71.0,50.0,14,550,189,11577,1469,65537,77114,11/17/2020
2020-05-11,257,14071,1857,87431,101502,31.0,1386.0,16.0,914.0,6.0,180.0,292.0,72.0,50.0,15,565,174,11751,1261,66798,78549,11/17/2020
2020-05-12,387,14458,2611,90042,104500,23.0,1409.0,18.0,932.0,4.0,184.0,293.0,70.0,49.0,22,587,224,11975,1622,68420,80395,11/17/2020
2020-05-13,351,14809,3630,93672,108481,23.0,1432.0,25.0,957.0,1.0,185.0,290.0,70.0,50.0,13,600,199,12174,1900,70320,82494,11/17/2020
2020-05-14,329,15138,3408,97080,112218,19.0,1451.0,27.0,984.0,3.0,188.0,279.0,65.0,46.0,15,615,232,12406,1935,72255,84661,11/17/2020
2020-05-15,381,15519,3458,100538,116057,24.0,1475.0,41.0,1025.0,5.0,193.0,257.0,63.0,46.0,14,629,232,12638,1758,74013,86651,11/17/2020
2020-05-16,449,15968,4156,104694,120662,25.0,1500.0,15.0,1040.0,5.0,198.0,262.0,62.0,47.0,15,644,247,12885,1893,75906,88791,11/17/2020
2020-05-17,240,16208,2768,107462,123670,17.0,1517.0,9.0,1049.0,5.0,203.0,265.0,60.0,46.0,10,654,126,13011,1503,77409,90420,11/17/2020
2020-05-18,250,16458,2001,109463,125921,19.0,1536.0,16.0,1065.0,5.0,208.0,263.0,58.0,41.0,18,672,135,13146,1336,78745,91891,11/17/2020
2020-05-19,415,16873,3168,112631,129504,23.0,1559.0,33.0,1098.0,5.0,213.0,248.0,57.0,39.0,11,683,215,13361,1890,80635,93996,11/17/2020
2020-05-20,326,17199,2771,115402,132601,19.0,1578.0,23.0,1121.0,7.0,220.0,237.0,53.0,34.0,22,705,184,13545,1495,82130,95675,11/17/2020
2020-05-21,374,17573,3757,119159,136732,25.0,1603.0,15.0,1136.0,3.0,223.0,244.0,54.0,30.0,20,725,168,13713,1904,84034,97747,11/17/2020
2020-05-22,351,17924,3161,122320,140244,20.0,1623.0,28.0,1164.0,5.0,228.0,231.0,53.0,30.0,11,736,206,13919,1566,85600,99519,11/17/2020
2020-05-23,253,18177,2742,125062,143239,19.0,1642.0,11.0,1175.0,3.0,231.0,236.0,53.0,33.0,13,749,109,14028,1242,86842,100870,11/17/2020
2020-05-24,163,18340,1370,126432,144772,13.0,1655.0,14.0,1189.0,2.0,233.0,233.0,54.0,36.0,8,757,83,14111,759,87601,101712,11/17/2020
2020-05-25,147,18487,1385,127817,146304,14.0,1669.0,14.0,1203.0,0.0,233.0,233.0,54.0,34.0,10,767,76,14187,740,88341,102528,11/17/2020
2020-05-26,285,18772,2620,130437,149209,24.0,1693.0,21.0,1224.0,5.0,238.0,231.0,49.0,33.0,15,782,158,14345,1711,90052,104397,11/17/2020
2020-05-27,276,19048,2057,132494,151542,20.0,1713.0,18.0,1242.0,3.0,241.0,230.0,51.0,33.0,10,792,132,14477,1113,91165,105642,11/17/2020
2020-05-28,348,19396,3359,135853,155249,17.0,1730.0,29.0,1271.0,4.0,245.0,214.0,47.0,32.0,8,800,130,14607,1098,92263,106870,11/17/2020
2020-05-29,410,19806,3915,139768,159574,19.0,1749.0,26.0,1297.0,7.0,252.0,200.0,43.0,31.0,12,812,174,14781,1542,93805,108586,11/17/2020
2020-05-30,225,20031,3915,143683,163714,16.0,1765.0,19.0,1316.0,4.0,256.0,193.0,41.0,29.0,12,824,109,14890,1766,95571,110461,11/17/2020
2020-05-31,155,20186,1690,145373,165559,11.0,1776.0,11.0,1327.0,1.0,257.0,192.0,44.0,26.0,3,827,78,14968,837,96408,111376,11/17/2020
2020-06-01,212,20398,2792,148165,168563,8.0,1784.0,14.0,1341.0,1.0,258.0,185.0,45.0,29.0,5,832,93,15061,1358,97766,112827,11/17/2020
2020-06-02,273,20671,3022,151187,171858,8.0,1792.0,9.0,1350.0,3.0,261.0,181.0,38.0,25.0,10,842,98,15159,1404,99170,114329,11/17/2020
2020-06-03,254,20925,3486,154673,175598,14.0,1806.0,18.0,1368.0,6.0,267.0,171.0,34.0,25.0,11,853,99,15258,1633,100803,116061,11/17/2020
2020-06-04,276,21201,4471,159144,180345,7.0,1813.0,26.0,1394.0,4.0,271.0,148.0,31.0,24.0,12,865,107,15365,1991,102794,118159,11/17/2020
2020-06-05,215,21416,3513,162657,184073,15.0,1828.0,13.0,1407.0,6.0,277.0,144.0,27.0,21.0,11,876,99,15464,1525,104319,119783,11/17/2020
2020-06-06,201,21617,2616,165273,186890,10.0,1838.0,7.0,1414.0,2.0,279.0,145.0,29.0,19.0,6,882,67,15531,1098,105417,120948,11/17/2020
2020-06-07,83,21700,1625,166898,188598,11.0,1849.0,7.0,1421.0,1.0,280.0,148.0,25.0,17.0,4,886,51,15582,775,106192,121774,11/17/2020
2020-06-08,119,21819,1849,168747,190566,15.0,1864.0,13.0,1434.0,2.0,282.0,148.0,27.0,18.0,4,890,45,15627,939,107131,122758,11/17/2020
2020-06-09,223,22042,2673,171420,193462,10.0,1874.0,19.0,1453.0,0.0,282.0,139.0,28.0,21.0,1,891,64,15691,1233,108364,124055,11/17/2020
2020-06-10,209,22251,2987,174407,196658,13.0,1887.0,12.0,1465.0,2.0,284.0,138.0,24.0,17.0,4,895,100,15791,1443,109807,125598,11/17/2020
2020-06-11,195,22446,3513,177920,200366,7.0,1894.0,15.0,1480.0,1.0,285.0,129.0,25.0,16.0,6,901,88,15879,1502,111309,127188,11/17/2020
2020-06-12,209,22655,4601,182521,205176,9.0,1903.0,16.0,1496.0,1.0,286.0,121.0,24.0,16.0,2,903,78,15957,2140,113449,129406,11/17/2020
2020-06-13,113,22768,3036,185557,208325,6.0,1909.0,5.0,1501.0,0.0,286.0,122.0,20.0,15.0,3,906,49,16006,1352,114801,130807,11/17/2020
2020-06-14,81,22849,2046,187603,210452,7.0,1916.0,8.0,1509.0,1.0,287.0,120.0,20.0,14.0,3,909,33,16039,954,115755,131794,11/17/2020
2020-06-15,188,23037,3108,190711,213748,14.0,1930.0,19.0,1528.0,0.0,287.0,115.0,20.0,16.0,5,914,75,16114,1753,117508,133622,11/17/2020
2020-06-16,110,23147,3017,193728,216875,11.0,1941.0,9.0,1537.0,1.0,288.0,116.0,22.0,16.0,8,922,50,16164,1511,119019,135183,11/17/2020
2020-06-17,127,23274,2835,196563,219837,15.0,1956.0,20.0,1557.0,4.0,292.0,107.0,18.0,14.0,6,928,50,16214,1292,120311,136525,11/17/2020
2020-06-18,149,23423,3048,199611,223034,9.0,1965.0,15.0,1572.0,1.0,293.0,100.0,19.0,16.0,7,935,70,16284,1298,121609,137893,11/17/2020
2020-06-19,141,23564,3769,203380,226944,12.0,1977.0,12.0,1584.0,1.0,294.0,99.0,20.0,17.0,3,938,59,16343,1334,122943,139286,11/17/2020
2020-06-20,84,23648,1891,205271,228919,9.0,1986.0,12.0,1596.0,0.0,294.0,96.0,20.0,18.0,4,942,36,16379,805,123748,140127,11/17/2020
2020-06-21,37,23685,1064,206335,230020,8.0,1994.0,5.0,1601.0,0.0,294.0,99.0,20.0,18.0,2,944,30,16409,682,124430,140839,11/17/2020
2020-06-22,138,23823,3730,210065,233888,12.0,2006.0,17.0,1618.0,0.0,294.0,94.0,19.0,18.0,2,946,65,16474,1680,126110,142584,11/17/2020
2020-06-23,163,23986,3831,213896,237882,3.0,2009.0,13.0,1631.0,3.0,297.0,81.0,18.0,18.0,7,953,81,16555,1758,127868,144423,11/17/2020
2020-06-24,120,24106,3502,217398,241504,9.0,2018.0,10.0,1641.0,1.0,298.0,79.0,18.0,18.0,5,958,44,16599,1661,129529,146128,11/17/2020
2020-06-25,103,24209,2883,220281,244490,6.0,2024.0,14.0,1655.0,1.0,299.0,70.0,17.0,17.0,1,959,50,16649,1477,131006,147655,11/17/2020
2020-06-26,94,24303,2488,222769,247072,2.0,2026.0,10.0,1665.0,0.0,299.0,62.0,18.0,18.0,1,960,60,16709,1308,132314,149023,11/17/2020
2020-06-27,84,24387,3216,225985,250372,5.0,2031.0,3.0,1668.0,1.0,300.0,63.0,17.0,17.0,5,965,37,16746,1188,133502,150248,11/17/2020
2020-06-28,39,24426,1469,227454,251880,4.0,2035.0,4.0,1672.0,4.0,304.0,59.0,15.0,14.0,6,971,17,16763,585,134087,150850,11/17/2020
2020-06-29,85,24511,3697,231151,255662,4.0,2039.0,5.0,1677.0,0.0,304.0,58.0,14.0,14.0,1,972,39,16802,1335,135422,152224,11/17/2020
2020-06-30,57,24568,1958,233109,257677,1.0,2040.0,5.0,1682.0,1.0,305.0,53.0,12.0,11.0,4,976,33,16835,983,136405,153240,11/17/2020
2020-07-01,144,24712,4098,237207,261919,8.0,2048.0,10.0,1692.0,0.0,305.0,51.0,11.0,11.0,1,977,79,16914,1898,138303,155217,11/17/2020
2020-07-02,103,24815,2803,240010,264825,5.0,2053.0,5.0,1697.0,1.0,306.0,50.0,10.0,10.0,3,980,59,16973,1068,139371,156344,11/17/2020
2020-07-03,50,24865,2079,242089,266954,9.0,2062.0,6.0,1703.0,0.0,306.0,53.0,9.0,9.0,3,983,25,16998,774,140145,157143,11/17/2020
2020-07-04,57,24922,2345,244434,269356,2.0,2064.0,4.0,1707.0,1.0,307.0,50.0,10.0,9.0,2,985,33,17031,986,141131,158162,11/17/2020
2020-07-05,49,24971,2932,247366,272337,1.0,2065.0,2.0,1709.0,1.0,308.0,48.0,8.0,8.0,2,987,26,17057,1410,142541,159598,11/17/2020
2020-07-06,101,25072,2814,250180,275252,6.0,2071.0,6.0,1715.0,0.0,308.0,48.0,9.0,9.0,4,991,57,17114,1531,144072,161186,11/17/2020
2020-07-07,81,25153,3457,253637,278790,5.0,2076.0,7.0,1722.0,0.0,308.0,46.0,8.0,8.0,2,993,47,17161,1522,145594,162755,11/17/2020
2020-07-08,105,25258,3409,257046,282304,4.0,2080.0,2.0,1724.0,0.0,308.0,48.0,9.0,8.0,0,993,64,17225,1393,146987,164212,11/17/2020
2020-07-09,94,25352,3714,260760,286112,9.0,2089.0,3.0,1727.0,0.0,308.0,54.0,9.0,8.0,0,993,50,17275,1597,148584,165859,11/17/2020
2020-07-10,132,25484,4437,265197,290681,6.0,2095.0,3.0,1730.0,2.0,310.0,55.0,7.0,7.0,3,996,80,17355,2044,150628,167983,11/17/2020
2020-07-11,63,25547,2938,268135,293682,6.0,2101.0,3.0,1733.0,1.0,311.0,57.0,6.0,6.0,3,999,36,17391,1300,151928,169319,11/17/2020
2020-07-12,47,25594,1838,269973,295567,1.0,2102.0,3.0,1736.0,1.0,312.0,54.0,6.0,5.0,3,1002,34,17425,930,152858,170283,11/17/2020
2020-07-13,84,25678,3209,273182,298860,8.0,2110.0,10.0,1746.0,0.0,312.0,52.0,6.0,5.0,1,1003,61,17486,1484,154342,171828,11/17/2020
2020-07-14,74,25752,3298,276480,302232,7.0,2117.0,4.0,1750.0,0.0,312.0,55.0,5.0,5.0,1,1004,44,17530,1361,155703,173233,11/17/2020
2020-07-15,130,25882,4181,280661,306543,5.0,2122.0,7.0,1757.0,0.0,312.0,53.0,5.0,4.0,0,1004,100,17630,1729,157432,175062,11/17/2020
2020-07-16,103,25985,3740,284401,310386,6.0,2128.0,9.0,1766.0,0.0,312.0,50.0,6.0,5.0,1,1005,76,17706,1594,159026,176732,11/17/2020
2020-07-17,156,26141,4239,288640,314781,14.0,2142.0,3.0,1769.0,1.0,313.0,60.0,5.0,5.0,2,1007,79,17785,1822,160848,178633,11/17/2020
2020-07-18,85,26226,3272,291912,318138,5.0,2147.0,9.0,1778.0,1.0,314.0,55.0,5.0,4.0,4,1011,70,17855,1378,162226,180081,11/17/2020
2020-07-19,82,26308,2696,294608,320916,7.0,2154.0,3.0,1781.0,0.0,314.0,59.0,6.0,4.0,2,1013,57,17912,1131,163357,181269,11/17/2020
2020-07-20,71,26379,2666,297274,323653,9.0,2163.0,7.0,1788.0,0.0,314.0,61.0,7.0,5.0,2,1015,68,17980,1439,164796,182776,11/17/2020
2020-07-21,130,26509,4304,301578,328087,9.0,2172.0,11.0,1799.0,0.0,314.0,59.0,9.0,6.0,1,1016,108,18088,1898,166694,184782,11/17/2020
2020-07-22,130,26639,3928,305506,332145,7.0,2179.0,8.0,1807.0,1.0,315.0,57.0,7.0,6.0,1,1017,86,18174,1655,168349,186523,11/17/2020
2020-07-23,141,26780,4415,309921,336701,8.0,2187.0,6.0,1813.0,0.0,315.0,59.0,8.0,7.0,0,1017,115,18289,1942,170291,188580,11/17/2020
2020-07-24,172,26952,5966,315887,342839,15.0,2202.0,12.0,1825.0,0.0,315.0,62.0,9.0,7.0,0,1017,119,18408,2284,172575,190983,11/17/2020
2020-07-25,134,27086,4398,320285,347371,7.0,2209.0,7.0,1832.0,0.0,315.0,62.0,10.0,8.0,3,1020,108,18516,2071,174646,193162,11/17/2020
2020-07-26,62,27148,3033,323318,350466,8.0,2217.0,9.0,1841.0,0.0,315.0,61.0,11.0,7.0,1,1021,54,18570,1322,175968,194538,11/17/2020
2020-07-27,188,27336,4191,327509,354845,12.0,2229.0,7.0,1848.0,0.0,315.0,66.0,13.0,8.0,1,1022,138,18708,2314,178282,196990,11/17/2020
2020-07-28,105,27441,3840,331349,358790,5.0,2234.0,5.0,1853.0,0.0,315.0,66.0,14.0,7.0,1,1023,95,18803,1615,179897,198700,11/17/2020
2020-07-29,190,27631,5139,336488,364119,9.0,2243.0,10.0,1863.0,0.0,315.0,65.0,15.0,7.0,0,1023,154,18957,2277,182174,201131,11/17/2020
2020-07-30,121,27752,4345,340833,368585,6.0,2249.0,2.0,1865.0,1.0,316.0,68.0,15.0,6.0,1,1024,97,19054,1624,183798,202852,11/17/2020
2020-07-31,131,27883,5512,346345,374228,7.0,2256.0,9.0,1874.0,0.0,316.0,66.0,15.0,7.0,1,1025,89,19143,1812,185610,204753,11/17/2020
2020-08-01,109,27992,4294,350639,378631,7.0,2263.0,2.0,1876.0,0.0,316.0,71.0,14.0,7.0,1,1026,89,19232,1540,187150,206382,11/17/2020
2020-08-02,84,28076,2804,353443,381519,12.0,2275.0,12.0,1888.0,2.0,318.0,69.0,14.0,8.0,2,1028,62,19294,1249,188399,207693,11/17/2020
2020-08-03,188,28264,5248,358691,386955,11.0,2286.0,10.0,1898.0,0.0,318.0,70.0,16.0,7.0,1,1029,150,19444,2179,190578,210022,11/17/2020
2020-08-04,125,28389,3691,362382,390771,8.0,2294.0,5.0,1903.0,1.0,319.0,72.0,12.0,5.0,2,1031,99,19543,1746,192324,211867,11/17/2020
2020-08-05,147,28536,5935,368317,396853,11.0,2305.0,9.0,1912.0,1.0,320.0,73.0,10.0,5.0,2,1033,119,19662,2433,194757,214419,11/17/2020
2020-08-06,169,28705,5546,373863,402568,7.0,2312.0,9.0,1921.0,0.0,320.0,71.0,9.0,4.0,0,1033,120,19782,2364,197121,216903,11/17/2020
2020-08-07,123,28828,4851,378714,407542,12.0,2324.0,9.0,1930.0,1.0,321.0,73.0,9.0,3.0,2,1035,87,19869,2114,199235,219104,11/17/2020
2020-08-08,123,28951,4112,382826,411777,19.0,2343.0,6.0,1936.0,1.0,322.0,85.0,8.0,3.0,1,1036,91,19960,1762,200997,220957,11/17/2020
2020-08-09,42,28993,1727,384553,413546,6.0,2349.0,8.0,1944.0,0.0,322.0,83.0,9.0,4.0,0,1036,35,19995,1056,202053,222048,11/17/2020
2020-08-10,149,29142,4587,389140,418282,8.0,2357.0,9.0,1953.0,0.0,322.0,82.0,9.0,4.0,1,1037,113,20108,2002,204055,224163,11/17/2020
2020-08-11,106,29248,4334,393474,422722,5.0,2362.0,13.0,1966.0,0.0,322.0,74.0,10.0,4.0,3,1040,92,20200,2238,206293,226493,11/17/2020
2020-08-12,121,29369,5188,398662,428031,8.0,2370.0,11.0,1977.0,0.0,322.0,71.0,9.0,3.0,1,1041,101,20301,2587,208880,229181,11/17/2020
2020-08-13,135,29504,4196,402858,432362,13.0,2383.0,12.0,1989.0,0.0,322.0,72.0,11.0,3.0,0,1041,95,20396,1882,210762,231158,11/17/2020
2020-08-14,145,29649,5498,408356,438005,13.0,2396.0,11.0,2000.0,0.0,322.0,74.0,11.0,4.0,3,1044,98,20494,1950,212712,233206,11/17/2020
2020-08-15,106,29755,4534,412890,442645,9.0,2405.0,11.0,2011.0,1.0,323.0,71.0,11.0,5.0,0,1044,88,20582,1665,214377,234959,11/17/2020
2020-08-16,83,29838,2477,415367,445205,6.0,2411.0,5.0,2016.0,4.0,327.0,68.0,8.0,4.0,6,1050,70,20652,947,215324,235976,11/17/2020
2020-08-17,106,29944,4575,419942,449886,8.0,2419.0,6.0,2022.0,0.0,327.0,70.0,8.0,5.0,2,1052,87,20739,2353,217677,238416,11/17/2020
2020-08-18,128,30072,4911,424853,454925,11.0,2430.0,8.0,2030.0,1.0,328.0,72.0,8.0,4.0,5,1057,94,20833,2718,220395,241228,11/17/2020
2020-08-19,113,30185,5077,429930,460115,8.0,2438.0,9.0,2039.0,1.0,329.0,70.0,9.0,5.0,0,1057,90,20923,2601,222996,243919,11/17/2020
2020-08-20,173,30358,7411,437341,467699,12.0,2450.0,6.0,2045.0,2.0,331.0,74.0,10.0,5.0,3,1060,139,21062,3476,226472,247534,11/17/2020
2020-08-21,151,30509,6577,443918,474427,8.0,2458.0,5.0,2050.0,1.0,332.0,76.0,9.0,4.0,2,1062,125,21187,2904,229376,250563,11/17/2020
2020-08-22,96,30605,5550,449468,480073,11.0,2469.0,12.0,2062.0,0.0,332.0,75.0,11.0,4.0,1,1063,84,21271,2567,231943,253214,11/17/2020
2020-08-23,71,30676,4375,453843,484519,11.0,2480.0,5.0,2067.0,0.0,332.0,81.0,12.0,2.0,1,1064,56,21327,2451,234394,255721,11/17/2020
2020-08-24,105,30781,5784,459627,490408,7.0,2487.0,10.0,2077.0,1.0,333.0,77.0,14.0,4.0,1,1065,77,21404,3113,237507,258911,11/17/2020
2020-08-25,108,30889,4764,464391,495280,10.0,2497.0,4.0,2081.0,1.0,334.0,82.0,12.0,4.0,1,1066,92,21496,2264,239771,261267,11/17/2020
2020-08-26,170,31059,9482,473873,504932,4.0,2501.0,8.0,2089.0,0.0,334.0,78.0,10.0,5.0,1,1067,127,21623,3055,242826,264449,11/17/2020
2020-08-27,92,31151,8565,482438,513589,6.0,2507.0,14.0,2103.0,1.0,335.0,69.0,7.0,5.0,2,1069,70,21693,3115,245941,267634,11/17/2020
2020-08-28,113,31264,7994,490432,521696,14.0,2521.0,4.0,2107.0,0.0,335.0,79.0,10.0,7.0,2,1071,87,21780,2401,248342,270122,11/17/2020
2020-08-29,65,31329,5374,495806,527135,6.0,2527.0,8.0,2115.0,1.0,336.0,76.0,11.0,6.0,2,1073,51,21831,1897,250239,272070,11/17/2020
2020-08-30,66,31395,4323,500129,531524,7.0,2534.0,4.0,2119.0,0.0,336.0,79.0,9.0,5.0,2,1075,48,21879,1966,252205,274084,11/17/2020
2020-08-31,105,31500,4863,504992,536492,12.0,2546.0,16.0,2135.0,0.0,336.0,75.0,8.0,4.0,1,1076,81,21960,2161,254366,276326,11/17/2020
2020-09-01,98,31598,7109,512101,543699,6.0,2552.0,9.0,2144.0,1.0,337.0,71.0,7.0,4.0,2,1078,66,22026,2353,256719,278745,11/17/2020
2020-09-02,125,31723,10529,522630,554353,9.0,2561.0,10.0,2154.0,1.0,338.0,69.0,8.0,4.0,2,1080,104,22130,3020,259739,281869,11/17/2020
2020-09-03,90,31813,11079,533709,565522,8.0,2569.0,8.0,2162.0,0.0,338.0,69.0,9.0,4.0,3,1083,73,22203,2555,262294,284497,11/17/2020
2020-09-04,103,31916,8963,542672,574588,11.0,2580.0,4.0,2166.0,0.0,338.0,76.0,9.0,4.0,1,1084,83,22286,2350,264644,286930,11/17/2020
2020-09-05,52,31968,6309,548981,580949,6.0,2586.0,9.0,2175.0,0.0,338.0,73.0,8.0,3.0,1,1085,42,22328,1583,266227,288555,11/17/2020
2020-09-06,88,32056,4325,553306,585362,4.0,2590.0,8.0,2183.0,1.0,339.0,68.0,6.0,3.0,1,1086,65,22393,1931,268158,290551,11/17/2020
2020-09-07,35,32091,3002,556308,588399,11.0,2601.0,3.0,2186.0,0.0,339.0,76.0,5.0,3.0,1,1087,26,22419,635,268793,291212,11/17/2020
2020-09-08,74,32165,6381,562689,594854,6.0,2607.0,12.0,2198.0,1.0,340.0,69.0,6.0,3.0,2,1089,66,22485,1575,270368,292853,11/17/2020
2020-09-09,118,32283,8650,571339,603622,10.0,2617.0,5.0,2203.0,1.0,341.0,73.0,9.0,3.0,1,1090,102,22587,2119,272487,295074,11/17/2020
2020-09-10,164,32447,11334,582673,615120,9.0,2626.0,8.0,2211.0,0.0,341.0,74.0,10.0,3.0,1,1091,111,22698,2246,274733,297431,11/17/2020
2020-09-11,120,32567,9454,592127,624694,11.0,2637.0,11.0,2222.0,0.0,341.0,74.0,10.0,5.0,0,1091,97,22795,1952,276685,299480,11/17/2020
2020-09-12,110,32677,6173,598300,630977,8.0,2645.0,5.0,2227.0,2.0,343.0,75.0,9.0,5.0,3,1094,97,22892,1502,278187,301079,11/17/2020
2020-09-13,58,32735,2716,601016,633751,4.0,2649.0,3.0,2230.0,0.0,343.0,76.0,10.0,5.0,0,1094,54,22946,853,279040,301986,11/17/2020
2020-09-14,104,32839,6446,607462,640301,6.0,2655.0,3.0,2233.0,2.0,345.0,77.0,10.0,5.0,2,1096,95,23041,1716,280756,303797,11/17/2020
2020-09-15,122,32961,8466,615928,648889,7.0,2662.0,2.0,2235.0,1.0,346.0,81.0,10.0,5.0,2,1098,124,23165,2173,282929,306094,11/17/2020
2020-09-16,137,33098,9715,625643,658741,7.0,2669.0,7.0,2242.0,2.0,348.0,79.0,9.0,6.0,5,1103,118,23283,1959,284888,308171,11/17/2020
2020-09-17,125,33223,9239,634882,668105,7.0,2676.0,15.0,2257.0,0.0,348.0,71.0,8.0,4.0,0,1103,154,23437,1932,286820,310257,11/17/2020
2020-09-18,132,33355,10045,644927,678282,7.0,2683.0,7.0,2264.0,1.0,349.0,70.0,11.0,6.0,2,1105,132,23569,1913,288733,312302,11/17/2020
2020-09-19,115,33470,8297,653224,686694,7.0,2690.0,3.0,2267.0,0.0,349.0,74.0,10.0,6.0,4,1109,112,23681,1681,290414,314095,11/17/2020
2020-09-20,60,33530,3676,656900,690430,7.0,2697.0,6.0,2273.0,2.0,351.0,73.0,9.0,8.0,4,1113,49,23730,1311,291725,315455,11/17/2020
2020-09-21,102,33632,7018,663918,697550,12.0,2709.0,3.0,2276.0,2.0,353.0,80.0,8.0,6.0,2,1115,94,23824,2394,294119,317943,11/17/2020
2020-09-22,154,33786,9287,673205,706991,12.0,2721.0,3.0,2279.0,1.0,354.0,88.0,7.0,5.0,1,1116,124,23948,2192,296311,320259,11/17/2020
2020-09-23,136,33922,10650,683855,717777,12.0,2733.0,7.0,2286.0,0.0,354.0,93.0,6.0,5.0,0,1116,127,24075,2203,298514,322589,11/17/2020
2020-09-24,120,34042,12479,696334,730376,7.0,2740.0,9.0,2295.0,1.0,355.0,90.0,7.0,5.0,1,1117,121,24196,3147,301661,325857,11/17/2020
2020-09-25,149,34191,10553,706887,741078,9.0,2749.0,10.0,2305.0,0.0,355.0,89.0,6.0,5.0,1,1118,142,24338,2987,304648,328986,11/17/2020
2020-09-26,146,34337,10559,717446,751783,12.0,2761.0,9.0,2314.0,0.0,355.0,92.0,6.0,5.0,1,1119,119,24457,2408,307056,331513,11/17/2020
2020-09-27,43,34380,2764,720210,754590,7.0,2768.0,5.0,2319.0,0.0,355.0,94.0,9.0,5.0,0,1119,34,24491,838,307894,332385,11/17/2020
2020-09-28,152,34532,7308,727518,762050,7.0,2775.0,7.0,2326.0,2.0,357.0,92.0,7.0,5.0,2,1121,134,24625,2247,310141,334766,11/17/2020
2020-09-29,208,34740,11046,738564,773304,12.0,2787.0,18.0,2344.0,1.0,358.0,85.0,6.0,6.0,1,1122,190,24815,2809,312950,337765,11/17/2020
2020-09-30,221,34961,12230,750794,785755,6.0,2793.0,6.0,2350.0,0.0,358.0,85.0,6.0,6.0,1,1123,187,25002,2572,315522,340524,11/17/2020
2020-10-01,185,35146,12503,763297,798443,17.0,2810.0,13.0,2363.0,1.0,359.0,88.0,6.0,4.0,2,1125,166,25168,2398,317920,343088,11/17/2020
2020-10-02,210,35356,12153,775450,810806,14.0,2824.0,13.0,2376.0,1.0,360.0,88.0,8.0,5.0,2,1127,182,25350,2487,320407,345757,11/17/2020
2020-10-03,157,35513,9312,784762,820275,9.0,2833.0,9.0,2385.0,2.0,362.0,86.0,9.0,4.0,2,1129,131,25481,2010,322417,347898,11/17/2020
2020-10-04,81,35594,2369,787131,822725,11.0,2844.0,9.0,2394.0,1.0,363.0,87.0,8.0,5.0,2,1131,78,25559,949,323366,348925,11/17/2020
2020-10-05,174,35768,8983,796114,831882,30.0,2874.0,10.0,2404.0,2.0,365.0,105.0,9.0,6.0,4,1135,160,25719,3013,326379,352098,11/17/2020
2020-10-06,177,35945,11186,807300,843245,11.0,2885.0,4.0,2408.0,0.0,365.0,112.0,11.0,7.0,0,1135,186,25905,2892,329271,355176,11/17/2020
2020-10-07,231,36176,12440,819740,855916,13.0,2898.0,14.0,2422.0,2.0,367.0,109.0,9.0,7.0,2,1137,243,26148,3516,332787,358935,11/17/2020
2020-10-08,262,36438,15231,834971,871409,17.0,2915.0,13.0,2435.0,2.0,369.0,111.0,7.0,5.0,4,1141,274,26422,4196,336983,363405,11/17/2020
2020-10-09,217,36655,13745,848716,885371,21.0,2936.0,12.0,2447.0,0.0,369.0,120.0,10.0,7.0,3,1144,199,26621,4303,341286,367907,11/17/2020
2020-10-10,229,36884,13832,862548,899432,19.0,2955.0,10.0,2457.0,1.0,370.0,128.0,13.0,7.0,2,1146,194,26815,3777,345063,371878,11/17/2020
2020-10-11,97,36981,3263,865811,902792,12.0,2967.0,9.0,2466.0,1.0,371.0,130.0,14.0,5.0,6,1152,88,26903,1161,346224,373127,11/17/2020
2020-10-12,169,37150,6439,872250,909400,19.0,2986.0,15.0,2481.0,2.0,373.0,132.0,14.0,5.0,4,1156,158,27061,1731,347955,375016,11/17/2020
2020-10-13,213,37363,8521,880771,918134,15.0,3001.0,13.0,2494.0,4.0,377.0,130.0,13.0,5.0,7,1163,207,27268,2301,350256,377524,11/17/2020
2020-10-14,322,37685,15038,895809,933494,17.0,3018.0,7.0,2501.0,0.0,377.0,140.0,15.0,5.0,2,1165,303,27571,4024,354280,381851,11/17/2020
2020-10-15,262,37947,14640,910449,948396,12.0,3030.0,16.0,2517.0,1.0,378.0,135.0,13.0,5.0,2,1167,254,27825,3568,357848,385673,11/17/2020
2020-10-16,279,38226,15011,925460,963686,13.0,3043.0,18.0,2535.0,1.0,379.0,129.0,13.0,4.0,2,1169,275,28100,3377,361225,389325,11/17/2020
2020-10-17,354,38580,14068,939528,978108,19.0,3062.0,11.0,2546.0,1.0,380.0,136.0,17.0,4.0,2,1171,311,28411,3256,364481,392892,11/17/2020
2020-10-18,155,38735,4039,943567,982302,18.0,3080.0,11.0,2557.0,0.0,380.0,143.0,17.0,6.0,2,1173,129,28540,1317,365798,394338,11/17/2020
2020-10-19,388,39123,8489,952056,991179,21.0,3101.0,22.0,2579.0,2.0,382.0,140.0,15.0,6.0,1,1174,325,28865,2556,368354,397219,11/17/2020
2020-10-20,439,39562,13242,965298,1004860,22.0,3123.0,17.0,2596.0,0.0,382.0,145.0,14.0,8.0,3,1177,387,29252,3002,371356,400608,11/17/2020
2020-10-21,544,40106,17462,982760,1022866,21.0,3144.0,8.0,2604.0,2.0,384.0,156.0,15.0,9.0,3,1180,471,29723,3513,374869,404592,11/17/2020
2020-10-22,538,40644,15863,998623,1039267,24.0,3168.0,20.0,2624.0,3.0,387.0,157.0,14.0,9.0,3,1183,489,30212,3185,378054,408266,11/17/2020
2020-10-23,514,41158,16632,1015255,1056413,22.0,3190.0,22.0,2646.0,1.0,388.0,156.0,15.0,9.0,3,1186,460,30672,2875,380929,411601,11/17/2020
2020-10-24,359,41517,10248,1025503,1067020,17.0,3207.0,11.0,2657.0,0.0,388.0,162.0,14.0,8.0,1,1187,338,31010,2260,383189,414199,11/17/2020
2020-10-25,233,41750,4760,1030263,1072013,16.0,3223.0,15.0,2672.0,1.0,389.0,162.0,15.0,8.0,2,1189,210,31220,1463,384652,415872,11/17/2020
2020-10-26,454,42204,9174,1039437,1081641,26.0,3249.0,15.0,2687.0,2.0,391.0,171.0,18.0,8.0,3,1192,404,31624,2970,387622,419246,11/17/2020
2020-10-27,517,42721,13993,1053430,1096151,28.0,3277.0,15.0,2702.0,2.0,393.0,182.0,17.0,9.0,4,1196,453,32077,2383,390005,422082,11/17/2020
2020-10-28,469,43190,15230,1068660,1111850,25.0,3302.0,26.0,2728.0,1.0,394.0,180.0,16.0,9.0,3,1199,409,32486,2695,392700,425186,11/17/2020
2020-10-29,609,43799,16234,1084894,1128693,20.0,3322.0,22.0,2750.0,3.0,397.0,175.0,19.0,11.0,4,1203,529,33015,3120,395820,428835,11/17/2020
2020-10-30,544,44343,14319,1099213,1143556,21.0,3343.0,21.0,2771.0,5.0,402.0,170.0,19.0,9.0,4,1207,467,33482,2945,398765,432247,11/17/2020
2020-10-31,585,44928,11843,1111056,1155984,31.0,3374.0,13.0,2784.0,1.0,403.0,187.0,22.0,9.0,3,1210,488,33970,2410,401175,435145,11/17/2020
2020-11-01,330,45258,5078,1116134,1161392,20.0,3394.0,15.0,2799.0,1.0,404.0,191.0,26.0,12.0,4,1214,273,34243,1262,402437,436680,11/17/2020
2020-11-02,520,45778,9918,1126052,1171830,35.0,3429.0,27.0,2826.0,3.0,407.0,196.0,23.0,11.0,5,1219,455,34698,2928,405365,440063,11/17/2020
2020-11-03,603,46381,13062,1139114,1185495,32.0,3461.0,25.0,2851.0,1.0,408.0,202.0,22.0,11.0,1,1220,529,35227,2520,407885,443112,11/17/2020
2020-11-04,680,47061,16119,1155233,1202294,34.0,3495.0,27.0,2878.0,2.0,410.0,207.0,22.0,11.0,4,1224,629,35856,2932,410817,446673,11/17/2020
2020-11-05,760,47821,18887,1174120,1221941,46.0,3541.0,35.0,2913.0,1.0,411.0,217.0,21.0,13.0,3,1227,673,36529,5167,415984,452513,11/17/2020
2020-11-06,777,48598,17300,1191420,1240018,42.0,3583.0,31.0,2944.0,1.0,412.0,227.0,26.0,16.0,5,1232,701,37230,4338,420322,457552,11/17/2020
2020-11-07,608,49206,13649,1205069,1254275,34.0,3617.0,25.0,2969.0,1.0,413.0,235.0,29.0,17.0,1,1233,580,37810,2474,422796,460606,11/17/2020
2020-11-08,338,49544,4160,1209229,1258773,30.0,3647.0,26.0,2995.0,1.0,414.0,238.0,28.0,18.0,3,1236,322,38132,1287,424083,462215,11/17/2020
2020-11-09,791,50335,9038,1218267,1268602,37.0,3684.0,33.0,3028.0,2.0,416.0,240.0,26.0,17.0,3,1239,744,38876,2321,426404,465280,11/17/2020
2020-11-10,1059,51394,12982,1231249,1282643,45.0,3729.0,36.0,3064.0,0.0,416.0,249.0,29.0,17.0,6,1245,972,39848,2906,429310,469158,11/17/2020
2020-11-11,1100,52494,19741,1250990,1303484,38.0,3767.0,22.0,3086.0,5.0,421.0,260.0,28.0,14.0,6,1251,1013,40861,2713,432023,472884,11/17/2020
2020-11-12,892,53386,13871,1264861,1318247,35.0,3802.0,31.0,3117.0,3.0,424.0,261.0,26.0,14.0,5,1256,810,41671,2219,434242,475913,11/17/2020
2020-11-13,1158,54544,16369,1281230,1335774,31.0,3833.0,31.0,3148.0,0.0,424.0,261.0,23.0,14.0,2,1258,1098,42769,3131,437373,480142,11/17/2020
2020-11-14,753,55297,13012,1294242,1349539,31.0,3864.0,26.0,3174.0,5.0,429.0,261.0,21.0,11.0,9,1267,693,43462,2422,439795,483257,11/17/2020
2020-11-15,564,55861,5780,1300022,1355883,30.0,3894.0,21.0,3195.0,5.0,434.0,265.0,22.0,10.0,7,1274,461,43923,1396,441191,485114,11/17/2020
2020-11-16,694,56555,9015,1309037,1365592,,,,,,,,,,4,1278,605,44528,2531,443722,488250,11/17/2020
2020-02-27,0,0,0,0,0,1.0,1.0,0.0,0.0,0.0,0.0,1.0,0.0,0.0,0,0,0,0,0,0,0,11/18/2020
2020-02-28,0,0,0,0,0,0.0,1.0,0.0,0.0,0.0,0.0,1.0,1.0,0.0,0,0,0,0,0,0,0,11/18/2020
2020-02-29,0,0,0,0,0,0.0,1.0,0.0,0.0,0.0,0.0,1.0,1.0,0.0,0,0,0,0,0,0,0,11/18/2020
2020-03-01,2,2,2,2,4,0.0,1.0,0.0,0.0,0.0,0.0,1.0,1.0,1.0,0,0,2,2,2,2,4,11/18/2020
2020-03-02,0,2,1,3,5,1.0,2.0,0.0,0.0,0.0,0.0,2.0,2.0,2.0,0,0,0,2,0,2,4,11/18/2020
2020-03-03,0,2,2,5,7,0.0,2.0,0.0,0.0,0.0,0.0,2.0,2.0,2.0,0,0,0,2,1,3,5,11/18/2020
2020-03-04,0,2,12,17,19,1.0,3.0,0.0,0.0,0.0,0.0,3.0,2.0,2.0,0,0,0,2,10,13,15,11/18/2020
2020-03-05,0,2,4,21,23,0.0,3.0,0.0,0.0,0.0,0.0,3.0,2.0,2.0,0,0,1,3,4,17,20,11/18/2020
2020-03-06,1,3,12,33,36,0.0,3.0,0.0,0.0,0.0,0.0,3.0,2.0,2.0,0,0,0,3,11,28,31,11/18/2020
2020-03-07,0,3,19,52,55,0.0,3.0,0.0,0.0,0.0,0.0,3.0,2.0,1.0,0,0,0,3,19,47,50,11/18/2020
2020-03-08,0,3,18,70,73,0.0,3.0,0.0,0.0,0.0,0.0,3.0,2.0,1.0,0,0,0,3,18,65,68,11/18/2020
2020-03-09,1,4,15,85,89,0.0,3.0,0.0,0.0,0.0,0.0,3.0,2.0,1.0,0,0,1,4,14,79,83,11/18/2020
2020-03-10,2,6,25,110,116,0.0,3.0,0.0,0.0,0.0,0.0,3.0,2.0,1.0,0,0,1,5,23,102,107,11/18/2020
2020-03-11,0,6,34,144,150,1.0,4.0,0.0,0.0,0.0,0.0,4.0,1.0,1.0,0,0,0,5,34,136,141,11/18/2020
2020-03-12,9,15,41,185,200,1.0,5.0,0.0,0.0,0.0,0.0,5.0,1.0,1.0,0,0,8,13,38,174,187,11/18/2020
2020-03-13,6,21,50,235,256,4.0,9.0,1.0,1.0,0.0,0.0,8.0,1.0,1.0,0,0,6,19,47,221,240,11/18/2020
2020-03-14,0,21,90,325,346,0.0,9.0,0.0,1.0,0.0,0.0,8.0,1.0,1.0,0,0,0,19,83,304,323,11/18/2020
2020-03-15,1,22,54,379,401,1.0,10.0,0.0,1.0,0.0,0.0,9.0,2.0,1.0,0,0,1,20,53,357,377,11/18/2020
2020-03-16,2,24,95,474,498,2.0,12.0,0.0,1.0,0.0,0.0,11.0,2.0,0.0,0,0,2,22,91,448,470,11/18/2020
2020-03-17,12,36,162,636,672,6.0,18.0,0.0,1.0,0.0,0.0,17.0,2.0,0.0,0,0,11,33,148,596,629,11/18/2020
2020-03-18,9,45,116,752,797,3.0,21.0,0.0,1.0,0.0,0.0,20.0,2.0,0.0,0,0,11,44,110,706,750,11/18/2020
2020-03-19,15,60,262,1014,1074,2.0,23.0,1.0,2.0,0.0,0.0,21.0,3.0,0.0,1,1,17,61,247,953,1014,11/18/2020
2020-03-20,13,73,197,1211,1284,5.0,28.0,0.0,2.0,0.0,0.0,26.0,4.0,0.0,0,1,13,74,186,1139,1213,11/18/2020
2020-03-21,12,85,126,1337,1422,3.0,31.0,2.0,4.0,0.0,0.0,27.0,5.0,0.0,0,1,14,88,121,1260,1348,11/18/2020
2020-03-22,27,112,282,1619,1731,2.0,33.0,0.0,4.0,0.0,0.0,29.0,5.0,0.0,0,1,25,113,257,1517,1630,11/18/2020
2020-03-23,14,126,169,1788,1914,15.0,48.0,1.0,5.0,0.0,0.0,43.0,9.0,3.0,0,1,16,129,161,1678,1807,11/18/2020
2020-03-24,20,146,242,2030,2176,8.0,56.0,0.0,5.0,0.0,0.0,51.0,10.0,5.0,0,1,19,148,229,1907,2055,11/18/2020
2020-03-25,26,172,182,2212,2384,5.0,61.0,2.0,7.0,0.0,0.0,54.0,11.0,3.0,0,1,28,176,162,2069,2245,11/18/2020
2020-03-26,35,207,181,2393,2600,9.0,70.0,5.0,12.0,0.0,0.0,58.0,14.0,5.0,0,1,41,217,169,2238,2455,11/18/2020
2020-03-27,27,234,214,2607,2841,9.0,79.0,1.0,13.0,1.0,1.0,65.0,16.0,6.0,2,3,31,248,194,2432,2680,11/18/2020
2020-03-28,59,293,260,2867,3160,11.0,90.0,2.0,15.0,1.0,2.0,73.0,15.0,6.0,1,4,64,312,239,2671,2983,11/18/2020
2020-03-29,100,393,350,3217,3610,8.0,98.0,3.0,18.0,1.0,3.0,77.0,18.0,8.0,2,6,105,417,309,2980,3397,11/18/2020
2020-03-30,62,455,222,3439,3894,19.0,117.0,5.0,23.0,0.0,3.0,91.0,19.0,11.0,3,9,78,495,181,3161,3656,11/18/2020
2020-03-31,71,526,369,3808,4334,11.0,128.0,7.0,30.0,1.0,4.0,94.0,21.0,13.0,2,11,73,568,293,3454,4022,11/18/2020
2020-04-01,99,625,698,4506,5131,18.0,146.0,7.0,37.0,0.0,4.0,105.0,29.0,15.0,1,12,100,668,621,4075,4743,11/18/2020
2020-04-02,52,677,477,4983,5660,22.0,168.0,6.0,43.0,2.0,6.0,119.0,35.0,21.0,4,16,62,730,423,4498,5228,11/18/2020
2020-04-03,108,785,774,5757,6542,23.0,191.0,7.0,50.0,0.0,6.0,135.0,42.0,25.0,3,19,100,830,688,5186,6016,11/18/2020
2020-04-04,143,928,660,6417,7345,22.0,213.0,4.0,54.0,5.0,11.0,148.0,40.0,29.0,9,28,138,968,600,5786,6754,11/18/2020
2020-04-05,187,1115,1156,7573,8688,20.0,233.0,9.0,63.0,1.0,12.0,158.0,43.0,35.0,2,30,181,1149,1026,6812,7961,11/18/2020
2020-04-06,218,1333,1706,9279,10612,26.0,259.0,7.0,70.0,0.0,12.0,177.0,47.0,39.0,7,37,207,1356,1505,8317,9673,11/18/2020
2020-04-07,284,1617,1629,10908,12525,20.0,279.0,4.0,74.0,2.0,14.0,191.0,49.0,41.0,5,42,261,1617,1453,9770,11387,11/18/2020
2020-04-08,290,1907,1720,12628,14535,19.0,298.0,8.0,82.0,5.0,19.0,197.0,49.0,37.0,10,52,271,1888,1510,11280,13168,11/18/2020
2020-04-09,283,2190,1516,14144,16334,32.0,330.0,8.0,90.0,4.0,23.0,217.0,53.0,40.0,7,59,277,2165,1317,12597,14762,11/18/2020
2020-04-10,419,2609,2574,16718,19327,29.0,359.0,17.0,107.0,5.0,28.0,224.0,59.0,41.0,11,70,400,2565,2306,14903,17468,11/18/2020
2020-04-11,297,2906,1905,18623,21529,29.0,388.0,11.0,118.0,2.0,30.0,240.0,61.0,48.0,12,82,281,2846,1675,16578,19424,11/18/2020
2020-04-12,314,3220,1670,20293,23513,35.0,423.0,13.0,131.0,5.0,35.0,257.0,59.0,49.0,9,91,286,3132,1381,17959,21091,11/18/2020
2020-04-13,161,3381,935,21228,24609,35.0,458.0,13.0,144.0,3.0,38.0,276.0,64.0,54.0,9,100,187,3319,822,18781,22100,11/18/2020
2020-04-14,289,3670,1787,23015,26685,27.0,485.0,18.0,162.0,5.0,43.0,280.0,72.0,53.0,8,108,262,3581,1479,20260,23841,11/18/2020
2020-04-15,351,4021,1799,24814,28835,31.0,516.0,20.0,182.0,3.0,46.0,288.0,72.0,54.0,17,125,306,3887,1492,21752,25639,11/18/2020
2020-04-16,447,4468,2494,27308,31776,36.0,552.0,25.0,207.0,6.0,52.0,293.0,72.0,53.0,14,139,387,4274,2012,23764,28038,11/18/2020
2020-04-17,304,4772,1821,29129,33901,32.0,584.0,20.0,227.0,7.0,59.0,298.0,66.0,45.0,21,160,290,4564,1405,25169,29733,11/18/2020
2020-04-18,321,5093,1725,30854,35947,26.0,610.0,18.0,245.0,4.0,63.0,302.0,63.0,49.0,15,175,284,4848,1284,26453,31301,11/18/2020
2020-04-19,381,5474,2047,32901,38375,23.0,633.0,26.0,271.0,1.0,64.0,298.0,65.0,55.0,11,186,337,5185,1693,28146,33331,11/18/2020
2020-04-20,394,5868,1907,34808,40676,46.0,679.0,29.0,300.0,2.0,66.0,313.0,75.0,56.0,10,196,376,5561,1540,29686,35247,11/18/2020
2020-04-21,444,6312,2110,36918,43230,45.0,724.0,32.0,332.0,5.0,71.0,321.0,72.0,56.0,18,214,383,5944,1664,31350,37294,11/18/2020
2020-04-22,418,6730,2390,39308,46038,41.0,765.0,32.0,364.0,5.0,76.0,325.0,73.0,58.0,18,232,379,6323,1866,33216,39539,11/18/2020
2020-04-23,479,7209,2469,41777,48986,32.0,797.0,28.0,392.0,5.0,81.0,324.0,76.0,62.0,15,247,412,6735,1811,35027,41762,11/18/2020
2020-04-24,491,7700,3284,45061,52761,35.0,832.0,26.0,418.0,4.0,85.0,329.0,85.0,63.0,15,262,407,7142,2550,37577,44719,11/18/2020
2020-04-25,393,8093,2206,47267,55360,34.0,866.0,17.0,435.0,5.0,90.0,341.0,85.0,62.0,14,276,299,7441,1715,39292,46733,11/18/2020
2020-04-26,316,8409,2309,49576,57985,33.0,899.0,15.0,450.0,3.0,93.0,356.0,86.0,59.0,14,290,274,7715,1824,41116,48831,11/18/2020
2020-04-27,249,8658,1620,51196,59854,29.0,928.0,21.0,471.0,4.0,97.0,360.0,86.0,61.0,10,300,206,7921,1121,42237,50158,11/18/2020
2020-04-28,410,9068,2263,53459,62527,44.0,972.0,24.0,495.0,3.0,100.0,377.0,88.0,59.0,22,322,332,8253,1664,43901,52154,11/18/2020
2020-04-29,476,9544,3343,56802,66346,36.0,1008.0,38.0,533.0,11.0,111.0,364.0,78.0,53.0,18,340,370,8623,2316,46217,54840,11/18/2020
2020-04-30,432,9976,2769,59571,69547,33.0,1041.0,38.0,571.0,6.0,117.0,353.0,83.0,57.0,24,364,349,8972,1833,48050,57022,11/18/2020
2020-05-01,454,10430,3086,62657,73087,52.0,1093.0,38.0,609.0,3.0,120.0,364.0,84.0,58.0,14,378,323,9295,2071,50121,59416,11/18/2020
2020-05-02,257,10687,1926,64583,75270,36.0,1129.0,39.0,648.0,5.0,125.0,356.0,93.0,63.0,24,402,192,9487,1236,51357,60844,11/18/2020
2020-05-03,283,10970,2160,66743,77713,31.0,1160.0,27.0,675.0,8.0,133.0,352.0,91.0,61.0,21,423,183,9670,1513,52870,62540,11/18/2020
2020-05-04,387,11357,2098,68841,80198,30.0,1190.0,31.0,706.0,5.0,138.0,346.0,89.0,58.0,18,441,290,9960,1521,54391,64351,11/18/2020
2020-05-05,433,11790,2873,71714,83504,29.0,1219.0,32.0,738.0,6.0,144.0,337.0,83.0,55.0,16,457,300,10260,1908,56299,66559,11/18/2020
2020-05-06,488,12278,2830,74544,86822,28.0,1247.0,44.0,782.0,9.0,153.0,312.0,80.0,55.0,21,478,340,10600,1872,58171,68771,11/18/2020
2020-05-07,425,12703,2969,77513,90216,36.0,1283.0,44.0,826.0,5.0,158.0,299.0,72.0,53.0,21,499,269,10869,1912,60083,70952,11/18/2020
2020-05-08,359,13062,2598,80111,93173,30.0,1313.0,29.0,855.0,5.0,163.0,295.0,72.0,54.0,22,521,229,11098,1688,61771,72869,11/18/2020
2020-05-09,467,13529,3346,83457,96986,22.0,1335.0,21.0,876.0,4.0,167.0,292.0,70.0,52.0,15,536,290,11388,2183,63954,75342,11/18/2020
2020-05-10,285,13814,2117,85574,99388,20.0,1355.0,23.0,899.0,6.0,173.0,283.0,71.0,50.0,14,550,189,11577,1464,65418,76995,11/18/2020
2020-05-11,257,14071,1857,87431,101502,31.0,1386.0,16.0,915.0,6.0,179.0,292.0,72.0,50.0,15,565,174,11751,1258,66676,78427,11/18/2020
2020-05-12,387,14458,2611,90042,104500,23.0,1409.0,18.0,933.0,4.0,183.0,293.0,70.0,49.0,22,587,224,11975,1620,68296,80271,11/18/2020
2020-05-13,351,14809,3630,93672,108481,23.0,1432.0,25.0,958.0,1.0,184.0,290.0,70.0,50.0,13,600,199,12174,1895,70191,82365,11/18/2020
2020-05-14,329,15138,3408,97080,112218,19.0,1451.0,27.0,985.0,3.0,187.0,279.0,65.0,46.0,15,615,232,12406,1928,72119,84525,11/18/2020
2020-05-15,381,15519,3458,100538,116057,24.0,1475.0,41.0,1026.0,5.0,192.0,257.0,63.0,46.0,14,629,232,12638,1757,73876,86514,11/18/2020
2020-05-16,449,15968,4156,104694,120662,25.0,1500.0,15.0,1041.0,5.0,197.0,262.0,62.0,47.0,15,644,247,12885,1892,75768,88653,11/18/2020
2020-05-17,240,16208,2768,107462,123670,17.0,1517.0,9.0,1050.0,5.0,202.0,265.0,60.0,46.0,10,654,126,13011,1502,77270,90281,11/18/2020
2020-05-18,250,16458,2001,109463,125921,19.0,1536.0,16.0,1066.0,5.0,207.0,263.0,58.0,41.0,18,672,135,13146,1333,78603,91749,11/18/2020
2020-05-19,415,16873,3168,112631,129504,23.0,1559.0,33.0,1099.0,5.0,212.0,248.0,57.0,39.0,11,683,215,13361,1889,80492,93853,11/18/2020
2020-05-20,326,17199,2771,115402,132601,19.0,1578.0,23.0,1122.0,7.0,219.0,237.0,53.0,34.0,22,705,184,13545,1494,81986,95531,11/18/2020
2020-05-21,374,17573,3757,119159,136732,25.0,1603.0,15.0,1137.0,3.0,222.0,244.0,54.0,30.0,20,725,168,13713,1901,83887,97600,11/18/2020
2020-05-22,351,17924,3161,122320,140244,20.0,1623.0,28.0,1165.0,5.0,227.0,231.0,53.0,30.0,11,736,206,13919,1565,85452,99371,11/18/2020
2020-05-23,253,18177,2742,125062,143239,19.0,1642.0,11.0,1176.0,3.0,230.0,236.0,53.0,33.0,13,749,109,14028,1242,86694,100722,11/18/2020
2020-05-24,163,18340,1370,126432,144772,13.0,1655.0,14.0,1190.0,2.0,232.0,233.0,54.0,36.0,8,757,83,14111,758,87452,101563,11/18/2020
2020-05-25,147,18487,1385,127817,146304,14.0,1669.0,14.0,1204.0,0.0,232.0,233.0,54.0,34.0,10,767,76,14187,731,88183,102370,11/18/2020
2020-05-26,285,18772,2620,130437,149209,24.0,1693.0,21.0,1225.0,5.0,237.0,231.0,49.0,33.0,15,782,158,14345,1674,89857,104202,11/18/2020
2020-05-27,276,19048,2057,132494,151542,20.0,1713.0,18.0,1243.0,3.0,240.0,230.0,51.0,33.0,10,792,132,14477,1112,90969,105446,11/18/2020
2020-05-28,348,19396,3359,135853,155249,17.0,1730.0,29.0,1272.0,4.0,244.0,214.0,47.0,32.0,8,800,130,14607,1098,92067,106674,11/18/2020
2020-05-29,410,19806,3915,139768,159574,19.0,1749.0,26.0,1298.0,7.0,251.0,200.0,43.0,31.0,12,812,174,14781,1525,93592,108373,11/18/2020
2020-05-30,225,20031,3915,143683,163714,16.0,1765.0,19.0,1317.0,4.0,255.0,193.0,41.0,29.0,12,824,109,14890,1730,95322,110212,11/18/2020
2020-05-31,155,20186,1690,145373,165559,11.0,1776.0,11.0,1328.0,1.0,256.0,192.0,44.0,26.0,3,827,78,14968,821,96143,111111,11/18/2020
2020-06-01,212,20398,2792,148165,168563,8.0,1784.0,14.0,1342.0,1.0,257.0,185.0,45.0,29.0,5,832,93,15061,1351,97494,112555,11/18/2020
2020-06-02,273,20671,3022,151187,171858,8.0,1792.0,9.0,1351.0,3.0,260.0,181.0,38.0,25.0,10,842,98,15159,1402,98896,114055,11/18/2020
2020-06-03,254,20925,3486,154673,175598,14.0,1806.0,18.0,1369.0,6.0,266.0,171.0,34.0,25.0,11,853,99,15258,1630,100526,115784,11/18/2020
2020-06-04,276,21201,4471,159144,180345,7.0,1813.0,26.0,1395.0,4.0,270.0,148.0,31.0,24.0,12,865,107,15365,1990,102516,117881,11/18/2020
2020-06-05,215,21416,3513,162657,184073,15.0,1828.0,13.0,1408.0,6.0,276.0,144.0,27.0,21.0,11,876,99,15464,1524,104040,119504,11/18/2020
2020-06-06,201,21617,2616,165273,186890,10.0,1838.0,7.0,1415.0,2.0,278.0,145.0,29.0,19.0,6,882,67,15531,1094,105134,120665,11/18/2020
2020-06-07,83,21700,1625,166898,188598,11.0,1849.0,7.0,1422.0,1.0,279.0,148.0,25.0,17.0,4,886,51,15582,775,105909,121491,11/18/2020
2020-06-08,119,21819,1849,168747,190566,15.0,1864.0,13.0,1435.0,2.0,281.0,148.0,27.0,18.0,4,890,45,15627,936,106845,122472,11/18/2020
2020-06-09,223,22042,2673,171420,193462,10.0,1874.0,19.0,1454.0,0.0,281.0,139.0,28.0,21.0,1,891,64,15691,1233,108078,123769,11/18/2020
2020-06-10,209,22251,2987,174407,196658,13.0,1887.0,12.0,1466.0,2.0,283.0,138.0,24.0,17.0,4,895,100,15791,1442,109520,125311,11/18/2020
2020-06-11,195,22446,3513,177920,200366,7.0,1894.0,15.0,1481.0,1.0,284.0,129.0,25.0,16.0,6,901,88,15879,1501,111021,126900,11/18/2020
2020-06-12,209,22655,4601,182521,205176,9.0,1903.0,16.0,1497.0,1.0,285.0,121.0,24.0,16.0,2,903,78,15957,2139,113160,129117,11/18/2020
2020-06-13,113,22768,3036,185557,208325,6.0,1909.0,5.0,1502.0,0.0,285.0,122.0,20.0,15.0,3,906,49,16006,1350,114510,130516,11/18/2020
2020-06-14,81,22849,2046,187603,210452,7.0,1916.0,8.0,1510.0,1.0,286.0,120.0,20.0,14.0,3,909,33,16039,952,115462,131501,11/18/2020
2020-06-15,188,23037,3108,190711,213748,14.0,1930.0,19.0,1529.0,0.0,286.0,115.0,20.0,16.0,5,914,75,16114,1753,117215,133329,11/18/2020
2020-06-16,110,23147,3017,193728,216875,11.0,1941.0,9.0,1538.0,1.0,287.0,116.0,22.0,16.0,8,922,50,16164,1509,118724,134888,11/18/2020
2020-06-17,127,23274,2835,196563,219837,15.0,1956.0,20.0,1558.0,4.0,291.0,107.0,18.0,14.0,6,928,50,16214,1291,120015,136229,11/18/2020
2020-06-18,149,23423,3048,199611,223034,9.0,1965.0,15.0,1573.0,1.0,292.0,100.0,19.0,16.0,7,935,70,16284,1296,121311,137595,11/18/2020
2020-06-19,141,23564,3769,203380,226944,12.0,1977.0,12.0,1585.0,1.0,293.0,99.0,20.0,17.0,3,938,59,16343,1332,122643,138986,11/18/2020
2020-06-20,84,23648,1891,205271,228919,9.0,1986.0,12.0,1597.0,0.0,293.0,96.0,20.0,18.0,4,942,36,16379,804,123447,139826,11/18/2020
2020-06-21,37,23685,1064,206335,230020,8.0,1994.0,5.0,1602.0,0.0,293.0,99.0,20.0,18.0,2,944,30,16409,681,124128,140537,11/18/2020
2020-06-22,138,23823,3730,210065,233888,12.0,2006.0,17.0,1619.0,0.0,293.0,94.0,19.0,18.0,2,946,65,16474,1677,125805,142279,11/18/2020
2020-06-23,163,23986,3831,213896,237882,3.0,2009.0,13.0,1632.0,3.0,296.0,81.0,18.0,18.0,7,953,81,16555,1756,127561,144116,11/18/2020
2020-06-24,120,24106,3502,217398,241504,9.0,2018.0,10.0,1642.0,1.0,297.0,79.0,18.0,18.0,5,958,44,16599,1661,129222,145821,11/18/2020
2020-06-25,103,24209,2883,220281,244490,6.0,2024.0,14.0,1656.0,1.0,298.0,70.0,17.0,17.0,1,959,50,16649,1476,130698,147347,11/18/2020
2020-06-26,94,24303,2488,222769,247072,2.0,2026.0,10.0,1666.0,0.0,298.0,62.0,18.0,18.0,1,960,60,16709,1307,132005,148714,11/18/2020
2020-06-27,84,24387,3216,225985,250372,5.0,2031.0,3.0,1669.0,1.0,299.0,63.0,17.0,17.0,5,965,37,16746,1186,133191,149937,11/18/2020
2020-06-28,39,24426,1469,227454,251880,4.0,2035.0,4.0,1673.0,4.0,303.0,59.0,15.0,14.0,6,971,17,16763,584,133775,150538,11/18/2020
2020-06-29,85,24511,3697,231151,255662,4.0,2039.0,5.0,1678.0,0.0,303.0,58.0,14.0,14.0,1,972,39,16802,1335,135110,151912,11/18/2020
2020-06-30,57,24568,1958,233109,257677,1.0,2040.0,5.0,1683.0,1.0,304.0,53.0,12.0,11.0,4,976,33,16835,983,136093,152928,11/18/2020
2020-07-01,144,24712,4098,237207,261919,8.0,2048.0,10.0,1693.0,0.0,304.0,51.0,11.0,11.0,1,977,79,16914,1897,137990,154904,11/18/2020
2020-07-02,103,24815,2803,240010,264825,5.0,2053.0,5.0,1698.0,1.0,305.0,50.0,10.0,10.0,3,980,59,16973,1067,139057,156030,11/18/2020
2020-07-03,50,24865,2079,242089,266954,9.0,2062.0,6.0,1704.0,0.0,305.0,53.0,9.0,9.0,3,983,25,16998,772,139829,156827,11/18/2020
2020-07-04,57,24922,2345,244434,269356,2.0,2064.0,4.0,1708.0,1.0,306.0,50.0,10.0,9.0,2,985,33,17031,985,140814,157845,11/18/2020
2020-07-05,49,24971,2932,247366,272337,1.0,2065.0,2.0,1710.0,1.0,307.0,48.0,8.0,8.0,2,987,26,17057,1407,142221,159278,11/18/2020
2020-07-06,101,25072,2814,250180,275252,6.0,2071.0,6.0,1716.0,0.0,307.0,48.0,9.0,9.0,4,991,57,17114,1530,143751,160865,11/18/2020
2020-07-07,81,25153,3457,253637,278790,5.0,2076.0,7.0,1723.0,0.0,307.0,46.0,8.0,8.0,2,993,47,17161,1521,145272,162433,11/18/2020
2020-07-08,105,25258,3409,257046,282304,4.0,2080.0,2.0,1725.0,0.0,307.0,48.0,9.0,8.0,0,993,64,17225,1386,146658,163883,11/18/2020
2020-07-09,94,25352,3714,260760,286112,9.0,2089.0,3.0,1728.0,0.0,307.0,54.0,9.0,8.0,0,993,50,17275,1593,148251,165526,11/18/2020
2020-07-10,132,25484,4437,265197,290681,6.0,2095.0,3.0,1731.0,2.0,309.0,55.0,7.0,7.0,3,996,80,17355,2040,150291,167646,11/18/2020
2020-07-11,63,25547,2938,268135,293682,6.0,2101.0,3.0,1734.0,1.0,310.0,57.0,6.0,6.0,3,999,36,17391,1299,151590,168981,11/18/2020
2020-07-12,47,25594,1838,269973,295567,1.0,2102.0,3.0,1737.0,1.0,311.0,54.0,6.0,5.0,3,1002,34,17425,929,152519,169944,11/18/2020
2020-07-13,84,25678,3209,273182,298860,8.0,2110.0,10.0,1747.0,0.0,311.0,52.0,6.0,5.0,1,1003,61,17486,1484,154003,171489,11/18/2020
2020-07-14,74,25752,3298,276480,302232,7.0,2117.0,4.0,1751.0,0.0,311.0,55.0,5.0,5.0,1,1004,44,17530,1361,155364,172894,11/18/2020
2020-07-15,130,25882,4181,280661,306543,5.0,2122.0,7.0,1758.0,0.0,311.0,53.0,5.0,4.0,0,1004,100,17630,1728,157092,174722,11/18/2020
2020-07-16,103,25985,3740,284401,310386,6.0,2128.0,9.0,1767.0,0.0,311.0,50.0,6.0,5.0,1,1005,76,17706,1594,158686,176392,11/18/2020
2020-07-17,156,26141,4239,288640,314781,14.0,2142.0,3.0,1770.0,1.0,312.0,60.0,5.0,5.0,2,1007,79,17785,1818,160504,178289,11/18/2020
2020-07-18,85,26226,3272,291912,318138,5.0,2147.0,9.0,1779.0,1.0,313.0,55.0,5.0,4.0,4,1011,70,17855,1377,161881,179736,11/18/2020
2020-07-19,82,26308,2696,294608,320916,7.0,2154.0,3.0,1782.0,0.0,313.0,59.0,6.0,4.0,2,1013,57,17912,1131,163012,180924,11/18/2020
2020-07-20,71,26379,2666,297274,323653,9.0,2163.0,7.0,1789.0,0.0,313.0,61.0,7.0,5.0,2,1015,68,17980,1437,164449,182429,11/18/2020
2020-07-21,130,26509,4304,301578,328087,9.0,2172.0,11.0,1800.0,0.0,313.0,59.0,9.0,6.0,1,1016,108,18088,1898,166347,184435,11/18/2020
2020-07-22,130,26639,3928,305506,332145,7.0,2179.0,8.0,1808.0,1.0,314.0,57.0,7.0,6.0,1,1017,86,18174,1651,167998,186172,11/18/2020
2020-07-23,141,26780,4415,309921,336701,8.0,2187.0,6.0,1814.0,0.0,314.0,59.0,8.0,7.0,0,1017,115,18289,1941,169939,188228,11/18/2020
2020-07-24,172,26952,5966,315887,342839,15.0,2202.0,12.0,1826.0,0.0,314.0,62.0,9.0,7.0,0,1017,119,18408,2281,172220,190628,11/18/2020
2020-07-25,134,27086,4398,320285,347371,7.0,2209.0,7.0,1833.0,0.0,314.0,62.0,10.0,8.0,3,1020,108,18516,2070,174290,192806,11/18/2020
2020-07-26,62,27148,3033,323318,350466,8.0,2217.0,9.0,1842.0,0.0,314.0,61.0,11.0,7.0,1,1021,54,18570,1322,175612,194182,11/18/2020
2020-07-27,188,27336,4191,327509,354845,12.0,2229.0,7.0,1849.0,0.0,314.0,66.0,13.0,8.0,1,1022,138,18708,2309,177921,196629,11/18/2020
2020-07-28,105,27441,3840,331349,358790,5.0,2234.0,5.0,1854.0,0.0,314.0,66.0,14.0,7.0,1,1023,95,18803,1614,179535,198338,11/18/2020
2020-07-29,190,27631,5139,336488,364119,9.0,2243.0,10.0,1864.0,0.0,314.0,65.0,15.0,7.0,0,1023,154,18957,2273,181808,200765,11/18/2020
2020-07-30,121,27752,4345,340833,368585,6.0,2249.0,2.0,1866.0,1.0,315.0,68.0,15.0,6.0,1,1024,97,19054,1620,183428,202482,11/18/2020
2020-07-31,131,27883,5512,346345,374228,7.0,2256.0,9.0,1875.0,0.0,315.0,66.0,15.0,7.0,1,1025,89,19143,1811,185239,204382,11/18/2020
2020-08-01,109,27992,4294,350639,378631,7.0,2263.0,2.0,1877.0,0.0,315.0,71.0,14.0,7.0,1,1026,89,19232,1537,186776,206008,11/18/2020
2020-08-02,84,28076,2804,353443,381519,12.0,2275.0,12.0,1889.0,2.0,317.0,69.0,14.0,8.0,2,1028,62,19294,1249,188025,207319,11/18/2020
2020-08-03,188,28264,5248,358691,386955,11.0,2286.0,10.0,1899.0,0.0,317.0,70.0,16.0,7.0,1,1029,150,19444,2179,190204,209648,11/18/2020
2020-08-04,125,28389,3691,362382,390771,8.0,2294.0,5.0,1904.0,1.0,318.0,72.0,12.0,5.0,2,1031,99,19543,1746,191950,211493,11/18/2020
2020-08-05,147,28536,5935,368317,396853,11.0,2305.0,9.0,1913.0,1.0,319.0,73.0,10.0,5.0,2,1033,119,19662,2430,194380,214042,11/18/2020
2020-08-06,169,28705,5546,373863,402568,7.0,2312.0,9.0,1922.0,0.0,319.0,71.0,9.0,4.0,0,1033,120,19782,2363,196743,216525,11/18/2020
2020-08-07,123,28828,4851,378714,407542,12.0,2324.0,9.0,1931.0,1.0,320.0,73.0,9.0,3.0,2,1035,87,19869,2113,198856,218725,11/18/2020
2020-08-08,123,28951,4112,382826,411777,19.0,2343.0,6.0,1937.0,1.0,321.0,85.0,8.0,3.0,1,1036,91,19960,1762,200618,220578,11/18/2020
2020-08-09,42,28993,1727,384553,413546,6.0,2349.0,8.0,1945.0,0.0,321.0,83.0,9.0,4.0,0,1036,35,19995,1055,201673,221668,11/18/2020
2020-08-10,149,29142,4587,389140,418282,8.0,2357.0,9.0,1954.0,0.0,321.0,82.0,9.0,4.0,1,1037,113,20108,1997,203670,223778,11/18/2020
2020-08-11,106,29248,4334,393474,422722,5.0,2362.0,13.0,1967.0,0.0,321.0,74.0,10.0,4.0,3,1040,92,20200,2235,205905,226105,11/18/2020
2020-08-12,121,29369,5188,398662,428031,8.0,2370.0,11.0,1978.0,0.0,321.0,71.0,9.0,3.0,1,1041,101,20301,2583,208488,228789,11/18/2020
2020-08-13,135,29504,4196,402858,432362,13.0,2383.0,12.0,1990.0,0.0,321.0,72.0,11.0,3.0,0,1041,95,20396,1882,210370,230766,11/18/2020
2020-08-14,145,29649,5498,408356,438005,13.0,2396.0,11.0,2001.0,0.0,321.0,74.0,11.0,4.0,3,1044,98,20494,1949,212319,232813,11/18/2020
2020-08-15,106,29755,4534,412890,442645,9.0,2405.0,11.0,2012.0,1.0,322.0,71.0,11.0,5.0,0,1044,88,20582,1663,213982,234564,11/18/2020
2020-08-16,83,29838,2477,415367,445205,6.0,2411.0,5.0,2017.0,4.0,326.0,68.0,8.0,4.0,6,1050,70,20652,945,214927,235579,11/18/2020
2020-08-17,106,29944,4575,419942,449886,8.0,2419.0,6.0,2023.0,0.0,326.0,70.0,8.0,5.0,2,1052,87,20739,2353,217280,238019,11/18/2020
2020-08-18,128,30072,4911,424853,454925,11.0,2430.0,8.0,2031.0,1.0,327.0,72.0,8.0,4.0,5,1057,94,20833,2714,219994,240827,11/18/2020
2020-08-19,113,30185,5077,429930,460115,8.0,2438.0,9.0,2040.0,1.0,328.0,70.0,9.0,5.0,0,1057,90,20923,2599,222593,243516,11/18/2020
2020-08-20,173,30358,7411,437341,467699,12.0,2450.0,6.0,2046.0,2.0,330.0,74.0,10.0,5.0,3,1060,139,21062,3476,226069,247131,11/18/2020
2020-08-21,151,30509,6577,443918,474427,8.0,2458.0,5.0,2051.0,1.0,331.0,76.0,9.0,4.0,2,1062,125,21187,2897,228966,250153,11/18/2020
2020-08-22,96,30605,5550,449468,480073,11.0,2469.0,12.0,2063.0,0.0,331.0,75.0,11.0,4.0,1,1063,84,21271,2564,231530,252801,11/18/2020
2020-08-23,71,30676,4375,453843,484519,11.0,2480.0,5.0,2068.0,0.0,331.0,81.0,12.0,2.0,1,1064,56,21327,2451,233981,255308,11/18/2020
2020-08-24,105,30781,5784,459627,490408,7.0,2487.0,10.0,2078.0,1.0,332.0,77.0,14.0,4.0,1,1065,77,21404,3107,237088,258492,11/18/2020
2020-08-25,108,30889,4764,464391,495280,10.0,2497.0,4.0,2082.0,1.0,333.0,82.0,12.0,4.0,1,1066,92,21496,2264,239352,260848,11/18/2020
2020-08-26,170,31059,9482,473873,504932,4.0,2501.0,8.0,2090.0,0.0,333.0,78.0,10.0,5.0,1,1067,127,21623,3052,242404,264027,11/18/2020
2020-08-27,92,31151,8565,482438,513589,6.0,2507.0,14.0,2104.0,1.0,334.0,69.0,7.0,5.0,2,1069,70,21693,3110,245514,267207,11/18/2020
2020-08-28,113,31264,7994,490432,521696,14.0,2521.0,4.0,2108.0,0.0,334.0,79.0,10.0,7.0,2,1071,87,21780,2399,247913,269693,11/18/2020
2020-08-29,65,31329,5374,495806,527135,6.0,2527.0,8.0,2116.0,1.0,335.0,76.0,11.0,6.0,2,1073,51,21831,1897,249810,271641,11/18/2020
2020-08-30,66,31395,4323,500129,531524,7.0,2534.0,4.0,2120.0,0.0,335.0,79.0,9.0,5.0,2,1075,48,21879,1962,251772,273651,11/18/2020
2020-08-31,105,31500,4863,504992,536492,12.0,2546.0,16.0,2136.0,0.0,335.0,75.0,8.0,4.0,1,1076,81,21960,2160,253932,275892,11/18/2020
2020-09-01,98,31598,7109,512101,543699,6.0,2552.0,9.0,2145.0,1.0,336.0,71.0,7.0,4.0,2,1078,66,22026,2351,256283,278309,11/18/2020
2020-09-02,125,31723,10529,522630,554353,9.0,2561.0,10.0,2155.0,1.0,337.0,69.0,8.0,4.0,2,1080,104,22130,3018,259301,281431,11/18/2020
2020-09-03,90,31813,11079,533709,565522,8.0,2569.0,8.0,2163.0,0.0,337.0,69.0,9.0,4.0,3,1083,73,22203,2551,261852,284055,11/18/2020
2020-09-04,103,31916,8963,542672,574588,11.0,2580.0,4.0,2167.0,0.0,337.0,76.0,9.0,4.0,1,1084,83,22286,2346,264198,286484,11/18/2020
2020-09-05,52,31968,6309,548981,580949,6.0,2586.0,9.0,2176.0,0.0,337.0,73.0,8.0,3.0,1,1085,42,22328,1582,265780,288108,11/18/2020
2020-09-06,88,32056,4325,553306,585362,4.0,2590.0,8.0,2184.0,1.0,338.0,68.0,6.0,3.0,1,1086,65,22393,1928,267708,290101,11/18/2020
2020-09-07,35,32091,3002,556308,588399,11.0,2601.0,3.0,2187.0,0.0,338.0,76.0,5.0,3.0,1,1087,26,22419,633,268341,290760,11/18/2020
2020-09-08,74,32165,6381,562689,594854,6.0,2607.0,12.0,2199.0,1.0,339.0,69.0,6.0,3.0,2,1089,66,22485,1572,269913,292398,11/18/2020
2020-09-09,118,32283,8650,571339,603622,10.0,2617.0,5.0,2204.0,1.0,340.0,73.0,9.0,3.0,1,1090,102,22587,2119,272032,294619,11/18/2020
2020-09-10,164,32447,11334,582673,615120,9.0,2626.0,8.0,2212.0,0.0,340.0,74.0,10.0,3.0,1,1091,111,22698,2244,274276,296974,11/18/2020
2020-09-11,120,32567,9454,592127,624694,11.0,2637.0,11.0,2223.0,0.0,340.0,74.0,10.0,5.0,0,1091,97,22795,1950,276226,299021,11/18/2020
2020-09-12,110,32677,6173,598300,630977,8.0,2645.0,5.0,2228.0,2.0,342.0,75.0,9.0,5.0,3,1094,97,22892,1500,277726,300618,11/18/2020
2020-09-13,58,32735,2716,601016,633751,4.0,2649.0,3.0,2231.0,0.0,342.0,76.0,10.0,5.0,0,1094,54,22946,851,278577,301523,11/18/2020
2020-09-14,104,32839,6446,607462,640301,6.0,2655.0,3.0,2234.0,2.0,344.0,77.0,10.0,5.0,2,1096,95,23041,1715,280292,303333,11/18/2020
2020-09-15,122,32961,8466,615928,648889,7.0,2662.0,2.0,2236.0,1.0,345.0,81.0,10.0,5.0,2,1098,124,23165,2169,282461,305626,11/18/2020
2020-09-16,137,33098,9715,625643,658741,7.0,2669.0,7.0,2243.0,2.0,347.0,79.0,9.0,6.0,5,1103,118,23283,1956,284417,307700,11/18/2020
2020-09-17,125,33223,9239,634882,668105,7.0,2676.0,15.0,2258.0,0.0,347.0,71.0,8.0,4.0,0,1103,154,23437,1932,286349,309786,11/18/2020
2020-09-18,132,33355,10045,644927,678282,7.0,2683.0,7.0,2265.0,1.0,348.0,70.0,11.0,6.0,2,1105,132,23569,1912,288261,311830,11/18/2020
2020-09-19,115,33470,8297,653224,686694,7.0,2690.0,3.0,2268.0,0.0,348.0,74.0,10.0,6.0,4,1109,112,23681,1679,289940,313621,11/18/2020
2020-09-20,60,33530,3676,656900,690430,7.0,2697.0,6.0,2274.0,2.0,350.0,73.0,9.0,8.0,4,1113,49,23730,1308,291248,314978,11/18/2020
2020-09-21,102,33632,7018,663918,697550,12.0,2709.0,3.0,2277.0,2.0,352.0,80.0,8.0,6.0,2,1115,94,23824,2389,293637,317461,11/18/2020
2020-09-22,154,33786,9287,673205,706991,12.0,2721.0,3.0,2280.0,1.0,353.0,88.0,7.0,5.0,1,1116,124,23948,2189,295826,319774,11/18/2020
2020-09-23,136,33922,10650,683855,717777,12.0,2733.0,7.0,2287.0,0.0,353.0,93.0,6.0,5.0,0,1116,127,24075,2201,298027,322102,11/18/2020
2020-09-24,120,34042,12479,696334,730376,7.0,2740.0,9.0,2296.0,1.0,354.0,90.0,7.0,5.0,1,1117,121,24196,3141,301168,325364,11/18/2020
2020-09-25,149,34191,10553,706887,741078,9.0,2749.0,10.0,2306.0,0.0,354.0,89.0,6.0,5.0,1,1118,142,24338,2983,304151,328489,11/18/2020
2020-09-26,146,34337,10559,717446,751783,12.0,2761.0,9.0,2315.0,0.0,354.0,92.0,6.0,5.0,1,1119,119,24457,2408,306559,331016,11/18/2020
2020-09-27,43,34380,2764,720210,754590,7.0,2768.0,5.0,2320.0,0.0,354.0,94.0,9.0,5.0,0,1119,34,24491,838,307397,331888,11/18/2020
2020-09-28,152,34532,7308,727518,762050,7.0,2775.0,7.0,2327.0,2.0,356.0,92.0,7.0,5.0,2,1121,134,24625,2247,309644,334269,11/18/2020
2020-09-29,208,34740,11046,738564,773304,12.0,2787.0,18.0,2345.0,1.0,357.0,85.0,6.0,6.0,1,1122,190,24815,2804,312448,337263,11/18/2020
2020-09-30,221,34961,12230,750794,785755,6.0,2793.0,6.0,2351.0,0.0,357.0,85.0,6.0,6.0,1,1123,187,25002,2568,315016,340018,11/18/2020
2020-10-01,185,35146,12503,763297,798443,17.0,2810.0,13.0,2364.0,1.0,358.0,88.0,6.0,4.0,2,1125,166,25168,2393,317409,342577,11/18/2020
2020-10-02,210,35356,12153,775450,810806,14.0,2824.0,13.0,2377.0,1.0,359.0,88.0,8.0,5.0,2,1127,182,25350,2482,319891,345241,11/18/2020
2020-10-03,157,35513,9312,784762,820275,9.0,2833.0,9.0,2386.0,2.0,361.0,86.0,9.0,4.0,2,1129,131,25481,2008,321899,347380,11/18/2020
2020-10-04,81,35594,2369,787131,822725,11.0,2844.0,9.0,2395.0,1.0,362.0,87.0,8.0,5.0,2,1131,78,25559,949,322848,348407,11/18/2020
2020-10-05,174,35768,8983,796114,831882,30.0,2874.0,10.0,2405.0,2.0,364.0,105.0,9.0,6.0,4,1135,160,25719,3011,325859,351578,11/18/2020
2020-10-06,177,35945,11186,807300,843245,11.0,2885.0,4.0,2409.0,0.0,364.0,112.0,11.0,7.0,0,1135,186,25905,2888,328747,354652,11/18/2020
2020-10-07,231,36176,12441,819741,855917,13.0,2898.0,14.0,2423.0,2.0,366.0,109.0,9.0,7.0,2,1137,243,26148,3512,332259,358407,11/18/2020
2020-10-08,262,36438,15230,834971,871409,17.0,2915.0,13.0,2436.0,2.0,368.0,111.0,7.0,5.0,4,1141,274,26422,4193,336452,362874,11/18/2020
2020-10-09,217,36655,13745,848716,885371,21.0,2936.0,12.0,2448.0,0.0,368.0,120.0,10.0,7.0,3,1144,199,26621,4297,340749,367370,11/18/2020
2020-10-10,229,36884,13832,862548,899432,19.0,2955.0,10.0,2458.0,1.0,369.0,128.0,13.0,7.0,2,1146,194,26815,3769,344518,371333,11/18/2020
2020-10-11,97,36981,3263,865811,902792,12.0,2967.0,9.0,2467.0,1.0,370.0,130.0,14.0,5.0,6,1152,88,26903,1161,345679,372582,11/18/2020
2020-10-12,169,37150,6440,872251,909401,19.0,2986.0,15.0,2482.0,2.0,372.0,132.0,14.0,5.0,4,1156,158,27061,1730,347409,374470,11/18/2020
2020-10-13,213,37363,8521,880772,918135,15.0,3001.0,13.0,2495.0,4.0,376.0,130.0,13.0,5.0,7,1163,207,27268,2299,349708,376976,11/18/2020
2020-10-14,322,37685,15038,895810,933495,17.0,3018.0,7.0,2502.0,0.0,376.0,140.0,15.0,5.0,2,1165,302,27570,4018,353726,381296,11/18/2020
2020-10-15,262,37947,14639,910449,948396,12.0,3030.0,16.0,2518.0,1.0,377.0,135.0,13.0,5.0,2,1167,254,27824,3566,357292,385116,11/18/2020
2020-10-16,279,38226,15011,925460,963686,12.0,3042.0,18.0,2536.0,1.0,378.0,128.0,13.0,4.0,2,1169,275,28099,3370,360662,388761,11/18/2020
2020-10-17,354,38580,14068,939528,978108,19.0,3061.0,11.0,2547.0,1.0,379.0,135.0,17.0,4.0,2,1171,311,28410,3251,363913,392323,11/18/2020
2020-10-18,155,38735,4039,943567,982302,18.0,3079.0,11.0,2558.0,0.0,379.0,142.0,17.0,6.0,2,1173,128,28538,1317,365230,393768,11/18/2020
2020-10-19,388,39123,8490,952057,991180,21.0,3100.0,22.0,2580.0,2.0,381.0,139.0,15.0,6.0,1,1174,325,28863,2555,367785,396648,11/18/2020
2020-10-20,439,39562,13241,965298,1004860,22.0,3122.0,16.0,2596.0,0.0,381.0,145.0,14.0,8.0,3,1177,386,29249,2997,370782,400031,11/18/2020
2020-10-21,544,40106,17462,982760,1022866,21.0,3143.0,8.0,2604.0,2.0,383.0,156.0,15.0,9.0,3,1180,471,29720,3510,374292,404012,11/18/2020
2020-10-22,538,40644,15863,998623,1039267,24.0,3167.0,20.0,2624.0,3.0,386.0,157.0,14.0,9.0,3,1183,489,30209,3182,377474,407683,11/18/2020
2020-10-23,514,41158,16632,1015255,1056413,22.0,3189.0,22.0,2646.0,1.0,387.0,156.0,15.0,9.0,3,1186,460,30669,2872,380346,411015,11/18/2020
2020-10-24,359,41517,10248,1025503,1067020,17.0,3206.0,11.0,2657.0,0.0,387.0,162.0,14.0,8.0,1,1187,338,31007,2260,382606,413613,11/18/2020
2020-10-25,233,41750,4760,1030263,1072013,16.0,3222.0,15.0,2672.0,1.0,388.0,162.0,15.0,8.0,2,1189,210,31217,1461,384067,415284,11/18/2020
2020-10-26,454,42204,9174,1039437,1081641,26.0,3248.0,15.0,2687.0,2.0,390.0,171.0,18.0,8.0,3,1192,403,31620,2968,387035,418655,11/18/2020
2020-10-27,517,42721,13993,1053430,1096151,28.0,3276.0,15.0,2702.0,2.0,392.0,182.0,17.0,9.0,4,1196,453,32073,2379,389414,421487,11/18/2020
2020-10-28,469,43190,15230,1068660,1111850,25.0,3301.0,26.0,2728.0,1.0,393.0,180.0,16.0,9.0,3,1199,409,32482,2692,392106,424588,11/18/2020
2020-10-29,609,43799,16234,1084894,1128693,20.0,3321.0,22.0,2750.0,3.0,396.0,175.0,19.0,11.0,4,1203,529,33011,3117,395223,428234,11/18/2020
2020-10-30,544,44343,14319,1099213,1143556,21.0,3342.0,21.0,2771.0,5.0,401.0,170.0,19.0,9.0,4,1207,466,33477,2943,398166,431643,11/18/2020
2020-10-31,585,44928,11843,1111056,1155984,31.0,3373.0,13.0,2784.0,1.0,402.0,187.0,22.0,9.0,3,1210,488,33965,2410,400576,434541,11/18/2020
2020-11-01,330,45258,5078,1116134,1161392,20.0,3393.0,15.0,2799.0,1.0,403.0,191.0,26.0,12.0,4,1214,273,34238,1262,401838,436076,11/18/2020
2020-11-02,520,45778,9918,1126052,1171830,35.0,3428.0,27.0,2826.0,3.0,406.0,196.0,23.0,11.0,5,1219,455,34693,2926,404764,439457,11/18/2020
2020-11-03,603,46381,13062,1139114,1185495,32.0,3460.0,25.0,2851.0,1.0,407.0,202.0,22.0,11.0,1,1220,527,35220,2514,407278,442498,11/18/2020
2020-11-04,680,47061,16119,1155233,1202294,34.0,3494.0,27.0,2878.0,2.0,409.0,207.0,22.0,11.0,4,1224,627,35847,2928,410206,446053,11/18/2020
2020-11-05,760,47821,18887,1174120,1221941,46.0,3540.0,35.0,2913.0,1.0,410.0,217.0,21.0,13.0,3,1227,673,36520,5164,415370,451890,11/18/2020
2020-11-06,777,48598,17300,1191420,1240018,42.0,3582.0,31.0,2944.0,1.0,411.0,227.0,26.0,16.0,5,1232,702,37222,4334,419704,456926,11/18/2020
2020-11-07,608,49206,13649,1205069,1254275,34.0,3616.0,25.0,2969.0,1.0,412.0,235.0,29.0,17.0,1,1233,578,37800,2472,422176,459976,11/18/2020
2020-11-08,338,49544,4160,1209229,1258773,30.0,3646.0,26.0,2995.0,1.0,413.0,238.0,28.0,18.0,4,1237,322,38122,1285,423461,461583,11/18/2020
2020-11-09,791,50335,9038,1218267,1268602,37.0,3683.0,33.0,3028.0,2.0,415.0,240.0,26.0,17.0,3,1240,743,38865,2318,425779,464644,11/18/2020
2020-11-10,1059,51394,12982,1231249,1282643,46.0,3729.0,36.0,3064.0,0.0,415.0,250.0,29.0,17.0,6,1246,980,39845,2904,428683,468528,11/18/2020
2020-11-11,1100,52494,19741,1250990,1303484,38.0,3767.0,23.0,3087.0,5.0,420.0,260.0,28.0,14.0,6,1252,1012,40857,2712,431395,472252,11/18/2020
2020-11-12,892,53386,13871,1264861,1318247,37.0,3804.0,31.0,3118.0,3.0,423.0,263.0,26.0,14.0,5,1257,811,41668,2215,433610,475278,11/18/2020
2020-11-13,1158,54544,16379,1281240,1335784,32.0,3836.0,31.0,3149.0,0.0,423.0,264.0,23.0,14.0,2,1259,1101,42769,3128,436738,479507,11/18/2020
2020-11-14,780,55324,13146,1294386,1349710,34.0,3870.0,26.0,3175.0,5.0,428.0,267.0,21.0,12.0,10,1269,735,43504,2483,439221,482725,11/18/2020
2020-11-15,574,55898,5871,1300257,1356155,39.0,3909.0,21.0,3196.0,5.0,433.0,280.0,22.0,11.0,7,1276,479,43983,1441,440662,484645,11/18/2020
2020-11-16,729,56627,9267,1309524,1366151,44.0,3953.0,37.0,3233.0,3.0,436.0,284.0,22.0,13.0,5,1281,648,44631,2644,443306,487937,11/18/2020
2020-11-17,1414,58041,17000,1326524,1384565,,,,,,,,,,3,1284,1280,45911,3854,447160,493071,11/18/2020
2020-02-27,0,0,0,0,0,1.0,1.0,0.0,0.0,0.0,0.0,1.0,0.0,0.0,0,0,0,0,0,0,0,11/19/2020
2020-02-28,0,0,0,0,0,0.0,1.0,0.0,0.0,0.0,0.0,1.0,1.0,0.0,0,0,0,0,0,0,0,11/19/2020
2020-02-29,0,0,0,0,0,0.0,1.0,0.0,0.0,0.0,0.0,1.0,1.0,0.0,0,0,0,0,0,0,0,11/19/2020
2020-03-01,2,2,2,2,4,0.0,1.0,0.0,0.0,0.0,0.0,1.0,1.0,1.0,0,0,2,2,2,2,4,11/19/2020
2020-03-02,0,2,1,3,5,1.0,2.0,0.0,0.0,0.0,0.0,2.0,2.0,2.0,0,0,0,2,0,2,4,11/19/2020
2020-03-03,0,2,2,5,7,0.0,2.0,0.0,0.0,0.0,0.0,2.0,2.0,2.0,0,0,0,2,1,3,5,11/19/2020
2020-03-04,0,2,12,17,19,1.0,3.0,0.0,0.0,0.0,0.0,3.0,2.0,2.0,0,0,0,2,10,13,15,11/19/2020
2020-03-05,0,2,4,21,23,0.0,3.0,0.0,0.0,0.0,0.0,3.0,2.0,2.0,0,0,1,3,4,17,20,11/19/2020
2020-03-06,1,3,12,33,36,0.0,3.0,0.0,0.0,0.0,0.0,3.0,2.0,2.0,0,0,0,3,11,28,31,11/19/2020
2020-03-07,0,3,19,52,55,0.0,3.0,0.0,0.0,0.0,0.0,3.0,2.0,1.0,0,0,0,3,19,47,50,11/19/2020
2020-03-08,0,3,18,70,73,0.0,3.0,0.0,0.0,0.0,0.0,3.0,2.0,1.0,0,0,0,3,18,65,68,11/19/2020
2020-03-09,1,4,15,85,89,0.0,3.0,0.0,0.0,0.0,0.0,3.0,2.0,1.0,0,0,1,4,14,79,83,11/19/2020
2020-03-10,2,6,25,110,116,0.0,3.0,0.0,0.0,0.0,0.0,3.0,2.0,1.0,0,0,1,5,23,102,107,11/19/2020
2020-03-11,0,6,34,144,150,1.0,4.0,0.0,0.0,0.0,0.0,4.0,1.0,1.0,0,0,0,5,34,136,141,11/19/2020
2020-03-12,9,15,41,185,200,1.0,5.0,0.0,0.0,0.0,0.0,5.0,1.0,1.0,0,0,8,13,38,174,187,11/19/2020
2020-03-13,6,21,50,235,256,4.0,9.0,1.0,1.0,0.0,0.0,8.0,1.0,1.0,0,0,6,19,47,221,240,11/19/2020
2020-03-14,0,21,90,325,346,0.0,9.0,0.0,1.0,0.0,0.0,8.0,1.0,1.0,0,0,0,19,83,304,323,11/19/2020
2020-03-15,1,22,54,379,401,1.0,10.0,0.0,1.0,0.0,0.0,9.0,2.0,1.0,0,0,1,20,53,357,377,11/19/2020
2020-03-16,2,24,95,474,498,2.0,12.0,0.0,1.0,0.0,0.0,11.0,2.0,0.0,0,0,2,22,91,448,470,11/19/2020
2020-03-17,12,36,162,636,672,6.0,18.0,0.0,1.0,0.0,0.0,17.0,2.0,0.0,0,0,11,33,148,596,629,11/19/2020
2020-03-18,9,45,116,752,797,3.0,21.0,0.0,1.0,0.0,0.0,20.0,2.0,0.0,0,0,11,44,110,706,750,11/19/2020
2020-03-19,15,60,262,1014,1074,2.0,23.0,1.0,2.0,0.0,0.0,21.0,3.0,0.0,1,1,17,61,247,953,1014,11/19/2020
2020-03-20,13,73,197,1211,1284,5.0,28.0,0.0,2.0,0.0,0.0,26.0,4.0,0.0,0,1,13,74,186,1139,1213,11/19/2020
2020-03-21,12,85,126,1337,1422,3.0,31.0,2.0,4.0,0.0,0.0,27.0,5.0,0.0,0,1,14,88,121,1260,1348,11/19/2020
2020-03-22,27,112,282,1619,1731,2.0,33.0,0.0,4.0,0.0,0.0,29.0,5.0,0.0,0,1,25,113,257,1517,1630,11/19/2020
2020-03-23,14,126,169,1788,1914,15.0,48.0,1.0,5.0,0.0,0.0,43.0,9.0,3.0,0,1,16,129,160,1677,1806,11/19/2020
2020-03-24,20,146,242,2030,2176,8.0,56.0,0.0,5.0,0.0,0.0,51.0,10.0,5.0,0,1,19,148,229,1906,2054,11/19/2020
2020-03-25,26,172,182,2212,2384,5.0,61.0,2.0,7.0,0.0,0.0,54.0,11.0,3.0,0,1,28,176,162,2068,2244,11/19/2020
2020-03-26,35,207,181,2393,2600,9.0,70.0,5.0,12.0,0.0,0.0,58.0,14.0,5.0,0,1,41,217,169,2237,2454,11/19/2020
2020-03-27,27,234,214,2607,2841,9.0,79.0,1.0,13.0,1.0,1.0,65.0,16.0,6.0,2,3,31,248,193,2430,2678,11/19/2020
2020-03-28,59,293,260,2867,3160,11.0,90.0,2.0,15.0,1.0,2.0,73.0,15.0,6.0,1,4,64,312,239,2669,2981,11/19/2020
2020-03-29,100,393,350,3217,3610,8.0,98.0,3.0,18.0,1.0,3.0,77.0,18.0,8.0,2,6,105,417,309,2978,3395,11/19/2020
2020-03-30,62,455,222,3439,3894,19.0,117.0,5.0,23.0,0.0,3.0,91.0,19.0,11.0,3,9,78,495,181,3159,3654,11/19/2020
2020-03-31,71,526,369,3808,4334,11.0,128.0,7.0,30.0,1.0,4.0,94.0,21.0,13.0,2,11,73,568,293,3452,4020,11/19/2020
2020-04-01,99,625,698,4506,5131,18.0,146.0,7.0,37.0,0.0,4.0,105.0,29.0,15.0,1,12,100,668,619,4071,4739,11/19/2020
2020-04-02,52,677,477,4983,5660,22.0,168.0,6.0,43.0,2.0,6.0,119.0,35.0,21.0,4,16,62,730,423,4494,5224,11/19/2020
2020-04-03,108,785,774,5757,6542,23.0,191.0,7.0,50.0,0.0,6.0,135.0,42.0,25.0,3,19,100,830,688,5182,6012,11/19/2020
2020-04-04,143,928,660,6417,7345,22.0,213.0,4.0,54.0,5.0,11.0,148.0,40.0,29.0,9,28,138,968,599,5781,6749,11/19/2020
2020-04-05,187,1115,1156,7573,8688,20.0,233.0,9.0,63.0,1.0,12.0,158.0,43.0,35.0,2,30,181,1149,1024,6805,7954,11/19/2020
2020-04-06,218,1333,1706,9279,10612,26.0,259.0,7.0,70.0,0.0,12.0,177.0,47.0,39.0,7,37,207,1356,1504,8309,9665,11/19/2020
2020-04-07,284,1617,1629,10908,12525,20.0,279.0,4.0,74.0,2.0,14.0,191.0,49.0,41.0,5,42,261,1617,1449,9758,11375,11/19/2020
2020-04-08,290,1907,1720,12628,14535,19.0,298.0,8.0,82.0,5.0,19.0,197.0,49.0,37.0,10,52,271,1888,1509,11267,13155,11/19/2020
2020-04-09,283,2190,1516,14144,16334,32.0,330.0,8.0,90.0,4.0,23.0,217.0,53.0,40.0,7,59,277,2165,1315,12582,14747,11/19/2020
2020-04-10,419,2609,2574,16718,19327,29.0,359.0,17.0,107.0,5.0,28.0,224.0,59.0,41.0,11,70,400,2565,2303,14885,17450,11/19/2020
2020-04-11,297,2906,1905,18623,21529,29.0,388.0,11.0,118.0,2.0,30.0,240.0,61.0,48.0,12,82,281,2846,1674,16559,19405,11/19/2020
2020-04-12,314,3220,1670,20293,23513,35.0,423.0,13.0,131.0,5.0,35.0,257.0,59.0,49.0,9,91,286,3132,1379,17938,21070,11/19/2020
2020-04-13,161,3381,935,21228,24609,35.0,458.0,13.0,144.0,3.0,38.0,276.0,64.0,54.0,9,100,187,3319,821,18759,22078,11/19/2020
2020-04-14,289,3670,1787,23015,26685,27.0,485.0,18.0,162.0,5.0,43.0,280.0,72.0,53.0,8,108,262,3581,1478,20237,23818,11/19/2020
2020-04-15,351,4021,1799,24814,28835,31.0,516.0,20.0,182.0,3.0,46.0,288.0,72.0,54.0,17,125,306,3887,1491,21728,25615,11/19/2020
2020-04-16,447,4468,2494,27308,31776,36.0,552.0,25.0,207.0,6.0,52.0,293.0,72.0,53.0,14,139,387,4274,2004,23732,28006,11/19/2020
2020-04-17,304,4772,1821,29129,33901,32.0,584.0,20.0,227.0,7.0,59.0,298.0,66.0,45.0,21,160,290,4564,1403,25135,29699,11/19/2020
2020-04-18,321,5093,1725,30854,35947,26.0,610.0,18.0,245.0,4.0,63.0,302.0,63.0,49.0,15,175,284,4848,1283,26418,31266,11/19/2020
2020-04-19,381,5474,2047,32901,38375,23.0,633.0,26.0,271.0,1.0,64.0,298.0,65.0,55.0,11,186,337,5185,1690,28108,33293,11/19/2020
2020-04-20,394,5868,1907,34808,40676,46.0,679.0,29.0,300.0,2.0,66.0,313.0,75.0,56.0,10,196,376,5561,1540,29648,35209,11/19/2020
2020-04-21,444,6312,2110,36918,43230,45.0,724.0,32.0,332.0,5.0,71.0,321.0,72.0,56.0,18,214,383,5944,1662,31310,37254,11/19/2020
2020-04-22,418,6730,2390,39308,46038,41.0,765.0,32.0,364.0,5.0,76.0,325.0,73.0,58.0,18,232,379,6323,1862,33172,39495,11/19/2020
2020-04-23,479,7209,2469,41777,48986,32.0,797.0,28.0,392.0,5.0,81.0,324.0,76.0,62.0,15,247,412,6735,1809,34981,41716,11/19/2020
2020-04-24,491,7700,3284,45061,52761,35.0,832.0,26.0,418.0,4.0,85.0,329.0,85.0,63.0,15,262,407,7142,2544,37525,44667,11/19/2020
2020-04-25,393,8093,2206,47267,55360,34.0,866.0,17.0,435.0,5.0,90.0,341.0,85.0,62.0,14,276,299,7441,1711,39236,46677,11/19/2020
2020-04-26,316,8409,2309,49576,57985,33.0,899.0,15.0,450.0,3.0,93.0,356.0,86.0,59.0,14,290,274,7715,1817,41053,48768,11/19/2020
2020-04-27,249,8658,1620,51196,59854,29.0,928.0,21.0,471.0,4.0,97.0,360.0,86.0,61.0,10,300,206,7921,1121,42174,50095,11/19/2020
2020-04-28,410,9068,2263,53459,62527,44.0,972.0,24.0,495.0,3.0,100.0,377.0,88.0,59.0,22,322,332,8253,1664,43838,52091,11/19/2020
2020-04-29,476,9544,3343,56802,66346,36.0,1008.0,38.0,533.0,11.0,111.0,364.0,78.0,53.0,18,340,370,8623,2314,46152,54775,11/19/2020
2020-04-30,432,9976,2769,59571,69547,33.0,1041.0,38.0,571.0,6.0,117.0,353.0,83.0,57.0,24,364,349,8972,1832,47984,56956,11/19/2020
2020-05-01,454,10430,3086,62657,73087,52.0,1093.0,39.0,610.0,3.0,120.0,363.0,84.0,58.0,14,378,323,9295,2063,50047,59342,11/19/2020
2020-05-02,257,10687,1926,64583,75270,36.0,1129.0,38.0,648.0,5.0,125.0,356.0,93.0,63.0,24,402,192,9487,1236,51283,60770,11/19/2020
2020-05-03,283,10970,2160,66743,77713,31.0,1160.0,27.0,675.0,8.0,133.0,352.0,91.0,61.0,21,423,183,9670,1510,52793,62463,11/19/2020
2020-05-04,387,11357,2098,68841,80198,30.0,1190.0,31.0,706.0,5.0,138.0,346.0,89.0,58.0,18,441,290,9960,1519,54312,64272,11/19/2020
2020-05-05,433,11790,2873,71714,83504,29.0,1219.0,32.0,738.0,6.0,144.0,337.0,83.0,55.0,16,457,300,10260,1906,56218,66478,11/19/2020
2020-05-06,488,12278,2830,74544,86822,28.0,1247.0,44.0,782.0,9.0,153.0,312.0,80.0,55.0,21,478,340,10600,1870,58088,68688,11/19/2020
2020-05-07,425,12703,2969,77513,90216,36.0,1283.0,44.0,826.0,5.0,158.0,299.0,72.0,53.0,21,499,269,10869,1907,59995,70864,11/19/2020
2020-05-08,359,13062,2598,80111,93173,30.0,1313.0,29.0,855.0,5.0,163.0,295.0,72.0,54.0,22,521,229,11098,1686,61681,72779,11/19/2020
2020-05-09,467,13529,3346,83457,96986,22.0,1335.0,21.0,876.0,4.0,167.0,292.0,70.0,52.0,15,536,290,11388,2179,63860,75248,11/19/2020
2020-05-10,285,13814,2117,85574,99388,20.0,1355.0,23.0,899.0,6.0,173.0,283.0,71.0,50.0,14,550,189,11577,1463,65323,76900,11/19/2020
2020-05-11,257,14071,1857,87431,101502,31.0,1386.0,16.0,915.0,6.0,179.0,292.0,72.0,50.0,15,565,174,11751,1255,66578,78329,11/19/2020
2020-05-12,387,14458,2611,90042,104500,23.0,1409.0,18.0,933.0,4.0,183.0,293.0,70.0,49.0,22,587,224,11975,1616,68194,80169,11/19/2020
2020-05-13,351,14809,3630,93672,108481,23.0,1432.0,25.0,958.0,1.0,184.0,290.0,70.0,50.0,13,600,199,12174,1894,70088,82262,11/19/2020
2020-05-14,329,15138,3408,97080,112218,19.0,1451.0,27.0,985.0,3.0,187.0,279.0,65.0,46.0,15,615,232,12406,1923,72011,84417,11/19/2020
2020-05-15,381,15519,3458,100538,116057,24.0,1475.0,41.0,1026.0,5.0,192.0,257.0,63.0,46.0,14,629,232,12638,1757,73768,86406,11/19/2020
2020-05-16,449,15968,4156,104694,120662,25.0,1500.0,15.0,1041.0,5.0,197.0,262.0,62.0,47.0,15,644,247,12885,1889,75657,88542,11/19/2020
2020-05-17,240,16208,2768,107462,123670,17.0,1517.0,9.0,1050.0,5.0,202.0,265.0,60.0,46.0,10,654,126,13011,1499,77156,90167,11/19/2020
2020-05-18,250,16458,2001,109463,125921,19.0,1536.0,16.0,1066.0,5.0,207.0,263.0,58.0,41.0,18,672,135,13146,1331,78487,91633,11/19/2020
2020-05-19,415,16873,3168,112631,129504,23.0,1559.0,33.0,1099.0,5.0,212.0,248.0,57.0,39.0,11,683,215,13361,1888,80375,93736,11/19/2020
2020-05-20,326,17199,2771,115402,132601,19.0,1578.0,23.0,1122.0,7.0,219.0,237.0,53.0,34.0,22,705,184,13545,1492,81867,95412,11/19/2020
2020-05-21,374,17573,3757,119159,136732,25.0,1603.0,15.0,1137.0,3.0,222.0,244.0,54.0,30.0,20,725,168,13713,1898,83765,97478,11/19/2020
2020-05-22,351,17924,3161,122320,140244,20.0,1623.0,28.0,1165.0,5.0,227.0,231.0,53.0,30.0,11,736,206,13919,1562,85327,99246,11/19/2020
2020-05-23,253,18177,2742,125062,143239,19.0,1642.0,11.0,1176.0,3.0,230.0,236.0,53.0,33.0,13,749,109,14028,1241,86568,100596,11/19/2020
2020-05-24,163,18340,1370,126432,144772,13.0,1655.0,14.0,1190.0,2.0,232.0,233.0,54.0,36.0,8,757,83,14111,758,87326,101437,11/19/2020
2020-05-25,147,18487,1385,127817,146304,14.0,1669.0,14.0,1204.0,0.0,232.0,233.0,54.0,34.0,10,767,76,14187,731,88057,102244,11/19/2020
2020-05-26,285,18772,2620,130437,149209,24.0,1693.0,21.0,1225.0,5.0,237.0,231.0,49.0,33.0,15,782,158,14345,1672,89729,104074,11/19/2020
2020-05-27,276,19048,2057,132494,151542,20.0,1713.0,18.0,1243.0,3.0,240.0,230.0,51.0,33.0,10,792,132,14477,1112,90841,105318,11/19/2020
2020-05-28,348,19396,3359,135853,155249,17.0,1730.0,29.0,1272.0,4.0,244.0,214.0,47.0,32.0,8,800,130,14607,1097,91938,106545,11/19/2020
2020-05-29,410,19806,3915,139768,159574,19.0,1749.0,26.0,1298.0,7.0,251.0,200.0,43.0,31.0,12,812,174,14781,1523,93461,108242,11/19/2020
2020-05-30,225,20031,3915,143683,163714,16.0,1765.0,19.0,1317.0,4.0,255.0,193.0,41.0,29.0,12,824,109,14890,1726,95187,110077,11/19/2020
2020-05-31,155,20186,1690,145373,165559,11.0,1776.0,11.0,1328.0,1.0,256.0,192.0,44.0,26.0,3,827,78,14968,821,96008,110976,11/19/2020
2020-06-01,212,20398,2792,148165,168563,8.0,1784.0,14.0,1342.0,1.0,257.0,185.0,45.0,29.0,5,832,93,15061,1350,97358,112419,11/19/2020
2020-06-02,273,20671,3022,151187,171858,8.0,1792.0,9.0,1351.0,3.0,260.0,181.0,38.0,25.0,10,842,98,15159,1402,98760,113919,11/19/2020
2020-06-03,254,20925,3486,154673,175598,14.0,1806.0,18.0,1369.0,6.0,266.0,171.0,34.0,25.0,11,853,99,15258,1629,100389,115647,11/19/2020
2020-06-04,276,21201,4471,159144,180345,7.0,1813.0,26.0,1395.0,4.0,270.0,148.0,31.0,24.0,12,865,107,15365,1985,102374,117739,11/19/2020
2020-06-05,215,21416,3513,162657,184073,15.0,1828.0,13.0,1408.0,6.0,276.0,144.0,27.0,21.0,11,876,99,15464,1520,103894,119358,11/19/2020
2020-06-06,201,21617,2616,165273,186890,10.0,1838.0,7.0,1415.0,2.0,278.0,145.0,29.0,19.0,6,882,67,15531,1094,104988,120519,11/19/2020
2020-06-07,83,21700,1625,166898,188598,11.0,1849.0,7.0,1422.0,1.0,279.0,148.0,25.0,17.0,4,886,51,15582,775,105763,121345,11/19/2020
2020-06-08,119,21819,1849,168747,190566,15.0,1864.0,13.0,1435.0,2.0,281.0,148.0,27.0,18.0,4,890,45,15627,935,106698,122325,11/19/2020
2020-06-09,223,22042,2673,171420,193462,10.0,1874.0,19.0,1454.0,0.0,281.0,139.0,28.0,21.0,1,891,64,15691,1233,107931,123622,11/19/2020
2020-06-10,209,22251,2987,174407,196658,13.0,1887.0,12.0,1466.0,2.0,283.0,138.0,24.0,17.0,4,895,100,15791,1441,109372,125163,11/19/2020
2020-06-11,195,22446,3513,177920,200366,7.0,1894.0,15.0,1481.0,1.0,284.0,129.0,25.0,16.0,6,901,88,15879,1498,110870,126749,11/19/2020
2020-06-12,209,22655,4601,182521,205176,9.0,1903.0,16.0,1497.0,1.0,285.0,121.0,24.0,16.0,2,903,78,15957,2138,113008,128965,11/19/2020
2020-06-13,113,22768,3036,185557,208325,6.0,1909.0,5.0,1502.0,0.0,285.0,122.0,20.0,15.0,3,906,49,16006,1348,114356,130362,11/19/2020
2020-06-14,81,22849,2046,187603,210452,7.0,1916.0,8.0,1510.0,1.0,286.0,120.0,20.0,14.0,3,909,33,16039,950,115306,131345,11/19/2020
2020-06-15,188,23037,3108,190711,213748,14.0,1930.0,19.0,1529.0,0.0,286.0,115.0,20.0,16.0,5,914,75,16114,1749,117055,133169,11/19/2020
2020-06-16,110,23147,3017,193728,216875,11.0,1941.0,9.0,1538.0,1.0,287.0,116.0,22.0,16.0,8,922,50,16164,1508,118563,134727,11/19/2020
2020-06-17,127,23274,2835,196563,219837,15.0,1956.0,20.0,1558.0,4.0,291.0,107.0,18.0,14.0,6,928,50,16214,1288,119851,136065,11/19/2020
2020-06-18,149,23423,3048,199611,223034,9.0,1965.0,15.0,1573.0,1.0,292.0,100.0,19.0,16.0,7,935,70,16284,1294,121145,137429,11/19/2020
2020-06-19,141,23564,3769,203380,226944,12.0,1977.0,12.0,1585.0,1.0,293.0,99.0,20.0,17.0,3,938,59,16343,1330,122475,138818,11/19/2020
2020-06-20,84,23648,1891,205271,228919,9.0,1986.0,12.0,1597.0,0.0,293.0,96.0,20.0,18.0,4,942,36,16379,804,123279,139658,11/19/2020
2020-06-21,37,23685,1064,206335,230020,8.0,1994.0,5.0,1602.0,0.0,293.0,99.0,20.0,18.0,2,944,30,16409,681,123960,140369,11/19/2020
2020-06-22,138,23823,3730,210065,233888,12.0,2006.0,17.0,1619.0,0.0,293.0,94.0,19.0,18.0,2,946,65,16474,1677,125637,142111,11/19/2020
2020-06-23,163,23986,3831,213896,237882,3.0,2009.0,13.0,1632.0,3.0,296.0,81.0,18.0,18.0,7,953,81,16555,1754,127391,143946,11/19/2020
2020-06-24,120,24106,3502,217398,241504,9.0,2018.0,10.0,1642.0,1.0,297.0,79.0,18.0,18.0,5,958,44,16599,1659,129050,145649,11/19/2020
2020-06-25,103,24209,2883,220281,244490,6.0,2024.0,14.0,1656.0,1.0,298.0,70.0,17.0,17.0,1,959,50,16649,1474,130524,147173,11/19/2020
2020-06-26,94,24303,2488,222769,247072,2.0,2026.0,10.0,1666.0,0.0,298.0,62.0,18.0,18.0,1,960,60,16709,1307,131831,148540,11/19/2020
2020-06-27,84,24387,3216,225985,250372,5.0,2031.0,3.0,1669.0,1.0,299.0,63.0,17.0,17.0,5,965,37,16746,1186,133017,149763,11/19/2020
2020-06-28,39,24426,1469,227454,251880,4.0,2035.0,4.0,1673.0,4.0,303.0,59.0,15.0,14.0,6,971,17,16763,584,133601,150364,11/19/2020
2020-06-29,85,24511,3697,231151,255662,4.0,2039.0,5.0,1678.0,0.0,303.0,58.0,14.0,14.0,1,972,39,16802,1334,134935,151737,11/19/2020
2020-06-30,57,24568,1958,233109,257677,1.0,2040.0,5.0,1683.0,1.0,304.0,53.0,12.0,11.0,4,976,33,16835,983,135918,152753,11/19/2020
2020-07-01,144,24712,4098,237207,261919,8.0,2048.0,10.0,1693.0,0.0,304.0,51.0,11.0,11.0,1,977,79,16914,1894,137812,154726,11/19/2020
2020-07-02,103,24815,2803,240010,264825,5.0,2053.0,5.0,1698.0,1.0,305.0,50.0,10.0,10.0,3,980,59,16973,1066,138878,155851,11/19/2020
2020-07-03,50,24865,2079,242089,266954,9.0,2062.0,6.0,1704.0,0.0,305.0,53.0,9.0,9.0,3,983,25,16998,772,139650,156648,11/19/2020
2020-07-04,57,24922,2345,244434,269356,2.0,2064.0,4.0,1708.0,1.0,306.0,50.0,10.0,9.0,2,985,33,17031,984,140634,157665,11/19/2020
2020-07-05,49,24971,2932,247366,272337,1.0,2065.0,2.0,1710.0,1.0,307.0,48.0,8.0,8.0,2,987,26,17057,1407,142041,159098,11/19/2020
2020-07-06,101,25072,2814,250180,275252,6.0,2071.0,6.0,1716.0,0.0,307.0,48.0,9.0,9.0,4,991,57,17114,1526,143567,160681,11/19/2020
2020-07-07,81,25153,3457,253637,278790,5.0,2076.0,7.0,1723.0,0.0,307.0,46.0,8.0,8.0,2,993,47,17161,1516,145083,162244,11/19/2020
2020-07-08,105,25258,3409,257046,282304,4.0,2080.0,2.0,1725.0,0.0,307.0,48.0,9.0,8.0,0,993,64,17225,1385,146468,163693,11/19/2020
2020-07-09,94,25352,3714,260760,286112,9.0,2089.0,3.0,1728.0,0.0,307.0,54.0,9.0,8.0,0,993,50,17275,1589,148057,165332,11/19/2020
2020-07-10,132,25484,4437,265197,290681,6.0,2095.0,3.0,1731.0,2.0,309.0,55.0,7.0,7.0,3,996,80,17355,2040,150097,167452,11/19/2020
2020-07-11,63,25547,2938,268135,293682,6.0,2101.0,3.0,1734.0,1.0,310.0,57.0,6.0,6.0,3,999,36,17391,1299,151396,168787,11/19/2020
2020-07-12,47,25594,1838,269973,295567,1.0,2102.0,3.0,1737.0,1.0,311.0,54.0,6.0,5.0,3,1002,34,17425,929,152325,169750,11/19/2020
2020-07-13,84,25678,3209,273182,298860,8.0,2110.0,10.0,1747.0,0.0,311.0,52.0,6.0,5.0,1,1003,61,17486,1483,153808,171294,11/19/2020
2020-07-14,74,25752,3298,276480,302232,7.0,2117.0,4.0,1751.0,0.0,311.0,55.0,5.0,5.0,1,1004,44,17530,1359,155167,172697,11/19/2020
2020-07-15,130,25882,4181,280661,306543,5.0,2122.0,7.0,1758.0,0.0,311.0,53.0,5.0,4.0,0,1004,100,17630,1724,156891,174521,11/19/2020
2020-07-16,103,25985,3740,284401,310386,6.0,2128.0,9.0,1767.0,0.0,311.0,50.0,6.0,5.0,1,1005,76,17706,1593,158484,176190,11/19/2020
2020-07-17,156,26141,4239,288640,314781,14.0,2142.0,3.0,1770.0,1.0,312.0,60.0,5.0,5.0,2,1007,79,17785,1817,160301,178086,11/19/2020
2020-07-18,85,26226,3272,291912,318138,5.0,2147.0,9.0,1779.0,1.0,313.0,55.0,5.0,4.0,4,1011,70,17855,1374,161675,179530,11/19/2020
2020-07-19,82,26308,2696,294608,320916,7.0,2154.0,3.0,1782.0,0.0,313.0,59.0,6.0,4.0,2,1013,57,17912,1131,162806,180718,11/19/2020
2020-07-20,71,26379,2666,297274,323653,9.0,2163.0,7.0,1789.0,0.0,313.0,61.0,7.0,5.0,2,1015,68,17980,1436,164242,182222,11/19/2020
2020-07-21,130,26509,4304,301578,328087,9.0,2172.0,11.0,1800.0,0.0,313.0,59.0,9.0,6.0,1,1016,108,18088,1896,166138,184226,11/19/2020
2020-07-22,130,26639,3928,305506,332145,7.0,2179.0,8.0,1808.0,1.0,314.0,57.0,7.0,6.0,1,1017,86,18174,1650,167788,185962,11/19/2020
2020-07-23,141,26780,4415,309921,336701,8.0,2187.0,6.0,1814.0,0.0,314.0,59.0,8.0,7.0,0,1017,115,18289,1937,169725,188014,11/19/2020
2020-07-24,172,26952,5966,315887,342839,15.0,2202.0,12.0,1826.0,0.0,314.0,62.0,9.0,7.0,0,1017,119,18408,2278,172003,190411,11/19/2020
2020-07-25,134,27086,4398,320285,347371,7.0,2209.0,7.0,1833.0,0.0,314.0,62.0,10.0,8.0,3,1020,108,18516,2068,174071,192587,11/19/2020
2020-07-26,62,27148,3033,323318,350466,8.0,2217.0,9.0,1842.0,0.0,314.0,61.0,11.0,7.0,1,1021,54,18570,1321,175392,193962,11/19/2020
2020-07-27,188,27336,4191,327509,354845,12.0,2229.0,7.0,1849.0,0.0,314.0,66.0,13.0,8.0,1,1022,138,18708,2309,177701,196409,11/19/2020
2020-07-28,105,27441,3840,331349,358790,5.0,2234.0,5.0,1854.0,0.0,314.0,66.0,14.0,7.0,1,1023,95,18803,1613,179314,198117,11/19/2020
2020-07-29,190,27631,5139,336488,364119,9.0,2243.0,10.0,1864.0,0.0,314.0,65.0,15.0,7.0,0,1023,154,18957,2272,181586,200543,11/19/2020
2020-07-30,121,27752,4345,340833,368585,6.0,2249.0,2.0,1866.0,1.0,315.0,68.0,15.0,6.0,1,1024,97,19054,1619,183205,202259,11/19/2020
2020-07-31,131,27883,5512,346345,374228,7.0,2256.0,9.0,1875.0,0.0,315.0,66.0,15.0,7.0,1,1025,89,19143,1810,185015,204158,11/19/2020
2020-08-01,109,27992,4294,350639,378631,7.0,2263.0,2.0,1877.0,0.0,315.0,71.0,14.0,7.0,1,1026,89,19232,1536,186551,205783,11/19/2020
2020-08-02,84,28076,2804,353443,381519,12.0,2275.0,12.0,1889.0,2.0,317.0,69.0,14.0,8.0,2,1028,62,19294,1248,187799,207093,11/19/2020
2020-08-03,188,28264,5248,358691,386955,11.0,2286.0,10.0,1899.0,0.0,317.0,70.0,16.0,7.0,1,1029,150,19444,2179,189978,209422,11/19/2020
2020-08-04,125,28389,3691,362382,390771,8.0,2294.0,5.0,1904.0,1.0,318.0,72.0,12.0,5.0,2,1031,99,19543,1746,191724,211267,11/19/2020
2020-08-05,147,28536,5935,368317,396853,11.0,2305.0,9.0,1913.0,1.0,319.0,73.0,10.0,5.0,2,1033,119,19662,2428,194152,213814,11/19/2020
2020-08-06,169,28705,5546,373863,402568,7.0,2312.0,9.0,1922.0,0.0,319.0,71.0,9.0,4.0,0,1033,120,19782,2359,196511,216293,11/19/2020
2020-08-07,123,28828,4851,378714,407542,12.0,2324.0,9.0,1931.0,1.0,320.0,73.0,9.0,3.0,2,1035,87,19869,2111,198622,218491,11/19/2020
2020-08-08,123,28951,4112,382826,411777,19.0,2343.0,6.0,1937.0,1.0,321.0,85.0,8.0,3.0,1,1036,91,19960,1760,200382,220342,11/19/2020
2020-08-09,42,28993,1727,384553,413546,6.0,2349.0,8.0,1945.0,0.0,321.0,83.0,9.0,4.0,0,1036,35,19995,1054,201436,221431,11/19/2020
2020-08-10,149,29142,4587,389140,418282,8.0,2357.0,9.0,1954.0,0.0,321.0,82.0,9.0,4.0,1,1037,113,20108,1994,203430,223538,11/19/2020
2020-08-11,106,29248,4334,393474,422722,5.0,2362.0,13.0,1967.0,0.0,321.0,74.0,10.0,4.0,3,1040,92,20200,2234,205664,225864,11/19/2020
2020-08-12,121,29369,5188,398662,428031,8.0,2370.0,11.0,1978.0,0.0,321.0,71.0,9.0,3.0,1,1041,101,20301,2581,208245,228546,11/19/2020
2020-08-13,135,29504,4196,402858,432362,13.0,2383.0,12.0,1990.0,0.0,321.0,72.0,11.0,3.0,0,1041,95,20396,1881,210126,230522,11/19/2020
2020-08-14,145,29649,5498,408356,438005,13.0,2396.0,11.0,2001.0,0.0,321.0,74.0,11.0,4.0,3,1044,98,20494,1947,212073,232567,11/19/2020
2020-08-15,106,29755,4534,412890,442645,9.0,2405.0,11.0,2012.0,1.0,322.0,71.0,11.0,5.0,0,1044,88,20582,1662,213735,234317,11/19/2020
2020-08-16,83,29838,2477,415367,445205,6.0,2411.0,5.0,2017.0,4.0,326.0,68.0,8.0,4.0,6,1050,70,20652,945,214680,235332,11/19/2020
2020-08-17,106,29944,4575,419942,449886,8.0,2419.0,6.0,2023.0,0.0,326.0,70.0,8.0,5.0,2,1052,87,20739,2351,217031,237770,11/19/2020
2020-08-18,128,30072,4911,424853,454925,11.0,2430.0,8.0,2031.0,1.0,327.0,72.0,8.0,4.0,5,1057,94,20833,2713,219744,240577,11/19/2020
2020-08-19,113,30185,5077,429930,460115,8.0,2438.0,9.0,2040.0,1.0,328.0,70.0,9.0,5.0,0,1057,90,20923,2597,222341,243264,11/19/2020
2020-08-20,173,30358,7411,437341,467699,12.0,2450.0,6.0,2046.0,2.0,330.0,74.0,10.0,5.0,3,1060,139,21062,3473,225814,246876,11/19/2020
2020-08-21,151,30509,6577,443918,474427,8.0,2458.0,5.0,2051.0,1.0,331.0,76.0,9.0,4.0,2,1062,125,21187,2896,228710,249897,11/19/2020
2020-08-22,96,30605,5550,449468,480073,11.0,2469.0,12.0,2063.0,0.0,331.0,75.0,11.0,4.0,1,1063,84,21271,2563,231273,252544,11/19/2020
2020-08-23,71,30676,4375,453843,484519,11.0,2480.0,5.0,2068.0,0.0,331.0,81.0,12.0,2.0,1,1064,56,21327,2448,233721,255048,11/19/2020
2020-08-24,105,30781,5784,459627,490408,7.0,2487.0,10.0,2078.0,1.0,332.0,77.0,14.0,4.0,1,1065,77,21404,3106,236827,258231,11/19/2020
2020-08-25,108,30889,4764,464391,495280,10.0,2497.0,4.0,2082.0,1.0,333.0,82.0,12.0,4.0,1,1066,92,21496,2262,239089,260585,11/19/2020
2020-08-26,170,31059,9482,473873,504932,4.0,2501.0,8.0,2090.0,0.0,333.0,78.0,10.0,5.0,1,1067,128,21624,3050,242139,263763,11/19/2020
2020-08-27,92,31151,8565,482438,513589,6.0,2507.0,14.0,2104.0,1.0,334.0,69.0,7.0,5.0,2,1069,70,21694,3110,245249,266943,11/19/2020
2020-08-28,113,31264,7994,490432,521696,14.0,2521.0,4.0,2108.0,0.0,334.0,79.0,10.0,7.0,2,1071,87,21781,2397,247646,269427,11/19/2020
2020-08-29,65,31329,5374,495806,527135,6.0,2527.0,8.0,2116.0,1.0,335.0,76.0,11.0,6.0,2,1073,51,21832,1897,249543,271375,11/19/2020
2020-08-30,66,31395,4323,500129,531524,7.0,2534.0,4.0,2120.0,0.0,335.0,79.0,9.0,5.0,2,1075,48,21880,1960,251503,273383,11/19/2020
2020-08-31,105,31500,4863,504992,536492,12.0,2546.0,16.0,2136.0,0.0,335.0,75.0,8.0,4.0,1,1076,81,21961,2160,253663,275624,11/19/2020
2020-09-01,98,31598,7109,512101,543699,6.0,2552.0,9.0,2145.0,1.0,336.0,71.0,7.0,4.0,2,1078,66,22027,2347,256010,278037,11/19/2020
2020-09-02,125,31723,10529,522630,554353,9.0,2561.0,10.0,2155.0,1.0,337.0,69.0,8.0,4.0,2,1080,104,22131,3014,259024,281155,11/19/2020
2020-09-03,90,31813,11079,533709,565522,8.0,2569.0,8.0,2163.0,0.0,337.0,69.0,9.0,4.0,3,1083,73,22204,2549,261573,283777,11/19/2020
2020-09-04,103,31916,8963,542672,574588,11.0,2580.0,4.0,2167.0,0.0,337.0,76.0,9.0,4.0,1,1084,83,22287,2345,263918,286205,11/19/2020
2020-09-05,52,31968,6309,548981,580949,6.0,2586.0,9.0,2176.0,0.0,337.0,73.0,8.0,3.0,1,1085,42,22329,1581,265499,287828,11/19/2020
2020-09-06,88,32056,4325,553306,585362,4.0,2590.0,8.0,2184.0,1.0,338.0,68.0,6.0,3.0,1,1086,65,22394,1927,267426,289820,11/19/2020
2020-09-07,35,32091,3002,556308,588399,11.0,2601.0,3.0,2187.0,0.0,338.0,76.0,5.0,3.0,1,1087,26,22420,633,268059,290479,11/19/2020
2020-09-08,74,32165,6381,562689,594854,6.0,2607.0,12.0,2199.0,1.0,339.0,69.0,6.0,3.0,2,1089,66,22486,1572,269631,292117,11/19/2020
2020-09-09,118,32283,8650,571339,603622,10.0,2617.0,5.0,2204.0,1.0,340.0,73.0,9.0,3.0,1,1090,102,22588,2113,271744,294332,11/19/2020
2020-09-10,164,32447,11334,582673,615120,9.0,2626.0,8.0,2212.0,0.0,340.0,74.0,10.0,3.0,1,1091,111,22699,2243,273987,296686,11/19/2020
2020-09-11,120,32567,9454,592127,624694,11.0,2637.0,11.0,2223.0,0.0,340.0,74.0,10.0,5.0,0,1091,97,22796,1948,275935,298731,11/19/2020
2020-09-12,110,32677,6173,598300,630977,8.0,2645.0,5.0,2228.0,2.0,342.0,75.0,9.0,5.0,3,1094,97,22893,1499,277434,300327,11/19/2020
2020-09-13,58,32735,2716,601016,633751,4.0,2649.0,3.0,2231.0,0.0,342.0,76.0,10.0,5.0,0,1094,54,22947,851,278285,301232,11/19/2020
2020-09-14,104,32839,6446,607462,640301,6.0,2655.0,3.0,2234.0,2.0,344.0,77.0,10.0,5.0,2,1096,95,23042,1714,279999,303041,11/19/2020
2020-09-15,122,32961,8466,615928,648889,7.0,2662.0,2.0,2236.0,1.0,345.0,81.0,10.0,5.0,2,1098,124,23166,2164,282163,305329,11/19/2020
2020-09-16,137,33098,9715,625643,658741,7.0,2669.0,7.0,2243.0,2.0,347.0,79.0,9.0,6.0,5,1103,118,23284,1953,284116,307400,11/19/2020
2020-09-17,125,33223,9239,634882,668105,7.0,2676.0,15.0,2258.0,0.0,347.0,71.0,8.0,4.0,0,1103,154,23438,1929,286045,309483,11/19/2020
2020-09-18,132,33355,10045,644927,678282,7.0,2683.0,7.0,2265.0,1.0,348.0,70.0,11.0,6.0,2,1105,132,23570,1911,287956,311526,11/19/2020
2020-09-19,115,33470,8297,653224,686694,7.0,2690.0,3.0,2268.0,0.0,348.0,74.0,10.0,6.0,4,1109,112,23682,1679,289635,313317,11/19/2020
2020-09-20,60,33530,3676,656900,690430,7.0,2697.0,6.0,2274.0,2.0,350.0,73.0,9.0,8.0,4,1113,49,23731,1308,290943,314674,11/19/2020
2020-09-21,102,33632,7018,663918,697550,12.0,2709.0,3.0,2277.0,2.0,352.0,80.0,8.0,6.0,2,1115,94,23825,2389,293332,317157,11/19/2020
2020-09-22,154,33786,9287,673205,706991,12.0,2721.0,3.0,2280.0,1.0,353.0,88.0,7.0,5.0,1,1116,124,23949,2184,295516,319465,11/19/2020
2020-09-23,136,33922,10650,683855,717777,12.0,2733.0,7.0,2287.0,0.0,353.0,93.0,6.0,5.0,0,1116,127,24076,2197,297713,321789,11/19/2020
2020-09-24,120,34042,12479,696334,730376,7.0,2740.0,9.0,2296.0,1.0,354.0,90.0,7.0,5.0,1,1117,121,24197,3140,300853,325050,11/19/2020
2020-09-25,149,34191,10553,706887,741078,9.0,2749.0,10.0,2306.0,0.0,354.0,89.0,6.0,5.0,1,1118,142,24339,2981,303834,328173,11/19/2020
2020-09-26,146,34337,10559,717446,751783,12.0,2761.0,9.0,2315.0,0.0,354.0,92.0,6.0,5.0,1,1119,119,24458,2406,306240,330698,11/19/2020
2020-09-27,43,34380,2764,720210,754590,7.0,2768.0,5.0,2320.0,0.0,354.0,94.0,9.0,5.0,0,1119,34,24492,837,307077,331569,11/19/2020
2020-09-28,152,34532,7308,727518,762050,7.0,2775.0,7.0,2327.0,2.0,356.0,92.0,7.0,5.0,2,1121,134,24626,2245,309322,333948,11/19/2020
2020-09-29,208,34740,11046,738564,773304,12.0,2787.0,18.0,2345.0,1.0,357.0,85.0,6.0,6.0,1,1122,190,24816,2804,312126,336942,11/19/2020
2020-09-30,221,34961,12230,750794,785755,6.0,2793.0,6.0,2351.0,0.0,357.0,85.0,6.0,6.0,1,1123,187,25003,2563,314689,339692,11/19/2020
2020-10-01,185,35146,12503,763297,798443,17.0,2810.0,13.0,2364.0,1.0,358.0,88.0,6.0,4.0,2,1125,166,25169,2392,317081,342250,11/19/2020
2020-10-02,210,35356,12153,775450,810806,14.0,2824.0,13.0,2377.0,1.0,359.0,88.0,8.0,5.0,2,1127,182,25351,2478,319559,344910,11/19/2020
2020-10-03,157,35513,9312,784762,820275,9.0,2833.0,9.0,2386.0,2.0,361.0,86.0,9.0,4.0,2,1129,131,25482,2005,321564,347046,11/19/2020
2020-10-04,81,35594,2369,787131,822725,11.0,2844.0,9.0,2395.0,1.0,362.0,87.0,8.0,5.0,2,1131,78,25560,948,322512,348072,11/19/2020
2020-10-05,174,35768,8983,796114,831882,30.0,2874.0,10.0,2405.0,2.0,364.0,105.0,9.0,6.0,4,1135,160,25720,3007,325519,351239,11/19/2020
2020-10-06,177,35945,11186,807300,843245,11.0,2885.0,4.0,2409.0,0.0,364.0,112.0,11.0,7.0,0,1135,186,25906,2884,328403,354309,11/19/2020
2020-10-07,231,36176,12441,819741,855917,13.0,2898.0,14.0,2423.0,2.0,366.0,109.0,9.0,7.0,2,1137,243,26149,3512,331915,358064,11/19/2020
2020-10-08,262,36438,15230,834971,871409,17.0,2915.0,13.0,2436.0,2.0,368.0,111.0,7.0,5.0,4,1141,273,26422,4189,336104,362526,11/19/2020
2020-10-09,217,36655,13745,848716,885371,21.0,2936.0,12.0,2448.0,0.0,368.0,120.0,10.0,7.0,3,1144,199,26621,4294,340398,367019,11/19/2020
2020-10-10,229,36884,13832,862548,899432,19.0,2955.0,10.0,2458.0,1.0,369.0,128.0,13.0,7.0,2,1146,194,26815,3768,344166,370981,11/19/2020
2020-10-11,97,36981,3263,865811,902792,12.0,2967.0,9.0,2467.0,1.0,370.0,130.0,14.0,5.0,6,1152,88,26903,1161,345327,372230,11/19/2020
2020-10-12,169,37150,6440,872251,909401,19.0,2986.0,15.0,2482.0,2.0,372.0,132.0,14.0,5.0,4,1156,158,27061,1728,347055,374116,11/19/2020
2020-10-13,213,37363,8521,880772,918135,15.0,3001.0,13.0,2495.0,4.0,376.0,130.0,13.0,5.0,7,1163,207,27268,2298,349353,376621,11/19/2020
2020-10-14,322,37685,15038,895810,933495,17.0,3018.0,7.0,2502.0,0.0,376.0,140.0,15.0,5.0,2,1165,301,27569,4014,353367,380936,11/19/2020
2020-10-15,262,37947,14639,910449,948396,12.0,3030.0,16.0,2518.0,1.0,377.0,135.0,13.0,5.0,2,1167,254,27823,3564,356931,384754,11/19/2020
2020-10-16,279,38226,15011,925460,963686,12.0,3042.0,18.0,2536.0,1.0,378.0,128.0,13.0,4.0,2,1169,275,28098,3364,360295,388393,11/19/2020
2020-10-17,354,38580,14068,939528,978108,19.0,3061.0,11.0,2547.0,1.0,379.0,135.0,17.0,4.0,2,1171,311,28409,3250,363545,391954,11/19/2020
2020-10-18,155,38735,4039,943567,982302,18.0,3079.0,11.0,2558.0,0.0,379.0,142.0,17.0,6.0,2,1173,128,28537,1314,364859,393396,11/19/2020
2020-10-19,388,39123,8491,952058,991181,21.0,3100.0,22.0,2580.0,2.0,381.0,139.0,15.0,6.0,1,1174,325,28862,2553,367412,396274,11/19/2020
2020-10-20,439,39562,13241,965299,1004861,22.0,3122.0,16.0,2596.0,0.0,381.0,145.0,14.0,8.0,3,1177,386,29248,2993,370405,399653,11/19/2020
2020-10-21,544,40106,17462,982761,1022867,21.0,3143.0,8.0,2604.0,2.0,383.0,156.0,15.0,9.0,3,1180,471,29719,3505,373910,403629,11/19/2020
2020-10-22,538,40644,15863,998624,1039268,24.0,3167.0,20.0,2624.0,3.0,386.0,157.0,14.0,9.0,3,1183,489,30208,3179,377089,407297,11/19/2020
2020-10-23,514,41158,16632,1015256,1056414,22.0,3189.0,22.0,2646.0,1.0,387.0,156.0,15.0,9.0,3,1186,460,30668,2869,379958,410626,11/19/2020
2020-10-24,359,41517,10248,1025504,1067021,17.0,3206.0,11.0,2657.0,0.0,387.0,162.0,14.0,8.0,1,1187,338,31006,2258,382216,413222,11/19/2020
2020-10-25,233,41750,4760,1030264,1072014,16.0,3222.0,15.0,2672.0,1.0,388.0,162.0,15.0,8.0,2,1189,210,31216,1459,383675,414891,11/19/2020
2020-10-26,454,42204,9174,1039438,1081642,26.0,3248.0,15.0,2687.0,2.0,390.0,171.0,18.0,8.0,3,1192,403,31619,2964,386639,418258,11/19/2020
2020-10-27,517,42721,13994,1053432,1096153,28.0,3276.0,15.0,2702.0,2.0,392.0,182.0,18.0,9.0,4,1196,453,32072,2378,389017,421089,11/19/2020
2020-10-28,469,43190,15229,1068661,1111851,25.0,3301.0,26.0,2728.0,1.0,393.0,180.0,17.0,9.0,3,1199,409,32481,2691,391708,424189,11/19/2020
2020-10-29,609,43799,16234,1084895,1128694,20.0,3321.0,22.0,2750.0,3.0,396.0,175.0,20.0,11.0,4,1203,529,33010,3115,394823,427833,11/19/2020
2020-10-30,544,44343,14319,1099214,1143557,21.0,3342.0,21.0,2771.0,5.0,401.0,170.0,20.0,9.0,4,1207,466,33476,2939,397762,431238,11/19/2020
2020-10-31,585,44928,11843,1111057,1155985,31.0,3373.0,13.0,2784.0,1.0,402.0,187.0,23.0,9.0,3,1210,488,33964,2408,400170,434134,11/19/2020
2020-11-01,330,45258,5078,1116135,1161393,20.0,3393.0,15.0,2799.0,1.0,403.0,191.0,27.0,12.0,4,1214,273,34237,1259,401429,435666,11/19/2020
2020-11-02,520,45778,9919,1126054,1171832,36.0,3429.0,27.0,2826.0,3.0,406.0,197.0,24.0,11.0,5,1219,455,34692,2923,404352,439044,11/19/2020
2020-11-03,603,46381,13062,1139116,1185497,32.0,3461.0,25.0,2851.0,1.0,407.0,203.0,23.0,11.0,1,1220,527,35219,2512,406864,442083,11/19/2020
2020-11-04,680,47061,16118,1155234,1202295,34.0,3495.0,27.0,2878.0,2.0,409.0,208.0,23.0,11.0,4,1224,625,35844,2924,409788,445632,11/19/2020
2020-11-05,760,47821,18887,1174121,1221942,46.0,3541.0,35.0,2913.0,1.0,410.0,218.0,22.0,13.0,3,1227,673,36517,5157,414945,451462,11/19/2020
2020-11-06,777,48598,17300,1191421,1240019,42.0,3583.0,31.0,2944.0,1.0,411.0,228.0,27.0,16.0,5,1232,700,37217,4331,419276,456493,11/19/2020
2020-11-07,608,49206,13649,1205070,1254276,34.0,3617.0,25.0,2969.0,1.0,412.0,236.0,30.0,17.0,1,1233,579,37796,2468,421744,459540,11/19/2020
2020-11-08,338,49544,4160,1209230,1258774,30.0,3647.0,26.0,2995.0,1.0,413.0,239.0,29.0,18.0,4,1237,322,38118,1284,423028,461146,11/19/2020
2020-11-09,807,50351,9038,1218268,1268619,38.0,3685.0,33.0,3028.0,2.0,415.0,242.0,27.0,17.0,3,1240,760,38878,2316,425344,464222,11/19/2020
2020-11-10,1061,51412,12982,1231250,1282662,45.0,3730.0,37.0,3065.0,0.0,415.0,250.0,30.0,17.0,6,1246,981,39859,2900,428244,468103,11/19/2020
2020-11-11,1088,52500,19741,1250991,1303491,38.0,3768.0,23.0,3088.0,5.0,420.0,260.0,29.0,14.0,6,1252,1004,40863,2705,430949,471812,11/19/2020
2020-11-12,890,53390,13871,1264862,1318252,37.0,3805.0,31.0,3119.0,3.0,423.0,263.0,27.0,14.0,5,1257,810,41673,2214,433163,474836,11/19/2020
2020-11-13,1154,54544,16379,1281241,1335785,32.0,3837.0,31.0,3150.0,0.0,423.0,264.0,25.0,14.0,2,1259,1098,42771,3125,436288,479059,11/19/2020
2020-11-14,780,55324,13146,1294387,1349711,36.0,3873.0,26.0,3176.0,5.0,428.0,269.0,23.0,12.0,10,1269,740,43511,2482,438770,482281,11/19/2020
2020-11-15,574,55898,5871,1300258,1356156,39.0,3912.0,21.0,3197.0,5.0,433.0,282.0,24.0,11.0,7,1276,482,43993,1441,440211,484204,11/19/2020
2020-11-16,729,56627,9267,1309525,1366152,48.0,3960.0,38.0,3235.0,3.0,436.0,289.0,24.0,13.0,5,1281,662,44655,2632,442843,487498,11/19/2020
2020-11-17,1517,58144,17675,1327200,1385344,53.0,4013.0,42.0,3277.0,2.0,438.0,298.0,26.0,13.0,4,1285,1375,46030,4119,446962,492992,11/19/2020
2020-11-18,1044,59188,14775,1341975,1401163,,,,,,,,,,3,1288,921,46951,2876,449838,496789,11/19/2020
2020-02-27,0,0,0,0,0,1.0,1.0,0.0,0.0,0.0,0.0,1.0,0.0,0.0,0,0,0,0,0,0,0,11/20/2020
2020-02-28,0,0,0,0,0,0.0,1.0,0.0,0.0,0.0,0.0,1.0,1.0,0.0,0,0,0,0,0,0,0,11/20/2020
2020-02-29,0,0,0,0,0,0.0,1.0,0.0,0.0,0.0,0.0,1.0,1.0,0.0,0,0,0,0,0,0,0,11/20/2020
2020-03-01,2,2,2,2,4,0.0,1.0,0.0,0.0,0.0,0.0,1.0,1.0,1.0,0,0,2,2,2,2,4,11/20/2020
2020-03-02,0,2,1,3,5,1.0,2.0,0.0,0.0,0.0,0.0,2.0,2.0,2.0,0,0,0,2,0,2,4,11/20/2020
2020-03-03,0,2,2,5,7,0.0,2.0,0.0,0.0,0.0,0.0,2.0,2.0,2.0,0,0,0,2,1,3,5,11/20/2020
2020-03-04,0,2,12,17,19,1.0,3.0,0.0,0.0,0.0,0.0,3.0,2.0,2.0,0,0,0,2,10,13,15,11/20/2020
2020-03-05,0,2,4,21,23,0.0,3.0,0.0,0.0,0.0,0.0,3.0,2.0,2.0,0,0,1,3,4,17,20,11/20/2020
2020-03-06,1,3,12,33,36,0.0,3.0,0.0,0.0,0.0,0.0,3.0,2.0,2.0,0,0,0,3,11,28,31,11/20/2020
2020-03-07,0,3,19,52,55,0.0,3.0,0.0,0.0,0.0,0.0,3.0,2.0,1.0,0,0,0,3,19,47,50,11/20/2020
2020-03-08,0,3,18,70,73,0.0,3.0,0.0,0.0,0.0,0.0,3.0,2.0,1.0,0,0,0,3,18,65,68,11/20/2020
2020-03-09,1,4,15,85,89,0.0,3.0,0.0,0.0,0.0,0.0,3.0,2.0,1.0,0,0,1,4,14,79,83,11/20/2020
2020-03-10,2,6,25,110,116,0.0,3.0,0.0,0.0,0.0,0.0,3.0,2.0,1.0,0,0,1,5,23,102,107,11/20/2020
2020-03-11,0,6,34,144,150,1.0,4.0,0.0,0.0,0.0,0.0,4.0,1.0,1.0,0,0,0,5,34,136,141,11/20/2020
2020-03-12,9,15,41,185,200,1.0,5.0,0.0,0.0,0.0,0.0,5.0,1.0,1.0,0,0,8,13,38,174,187,11/20/2020
2020-03-13,6,21,50,235,256,4.0,9.0,1.0,1.0,0.0,0.0,8.0,1.0,1.0,0,0,6,19,47,221,240,11/20/2020
2020-03-14,0,21,90,325,346,0.0,9.0,0.0,1.0,0.0,0.0,8.0,1.0,1.0,0,0,0,19,83,304,323,11/20/2020
2020-03-15,1,22,54,379,401,1.0,10.0,0.0,1.0,0.0,0.0,9.0,2.0,1.0,0,0,1,20,53,357,377,11/20/2020
2020-03-16,2,24,95,474,498,2.0,12.0,0.0,1.0,0.0,0.0,11.0,2.0,0.0,0,0,2,22,91,448,470,11/20/2020
2020-03-17,12,36,162,636,672,6.0,18.0,0.0,1.0,0.0,0.0,17.0,2.0,0.0,0,0,11,33,148,596,629,11/20/2020
2020-03-18,9,45,116,752,797,3.0,21.0,0.0,1.0,0.0,0.0,20.0,2.0,0.0,0,0,11,44,110,706,750,11/20/2020
2020-03-19,15,60,262,1014,1074,2.0,23.0,1.0,2.0,0.0,0.0,21.0,3.0,0.0,1,1,17,61,247,953,1014,11/20/2020
2020-03-20,13,73,197,1211,1284,5.0,28.0,0.0,2.0,0.0,0.0,26.0,4.0,0.0,0,1,13,74,186,1139,1213,11/20/2020
2020-03-21,12,85,126,1337,1422,3.0,31.0,2.0,4.0,0.0,0.0,27.0,5.0,0.0,0,1,14,88,121,1260,1348,11/20/2020
2020-03-22,27,112,282,1619,1731,2.0,33.0,0.0,4.0,0.0,0.0,29.0,5.0,0.0,0,1,25,113,257,1517,1630,11/20/2020
2020-03-23,14,126,169,1788,1914,15.0,48.0,1.0,5.0,0.0,0.0,43.0,9.0,3.0,0,1,16,129,160,1677,1806,11/20/2020
2020-03-24,20,146,242,2030,2176,8.0,56.0,0.0,5.0,0.0,0.0,51.0,10.0,5.0,0,1,19,148,229,1906,2054,11/20/2020
2020-03-25,26,172,182,2212,2384,5.0,61.0,2.0,7.0,0.0,0.0,54.0,11.0,3.0,0,1,28,176,162,2068,2244,11/20/2020
2020-03-26,35,207,181,2393,2600,9.0,70.0,5.0,12.0,0.0,0.0,58.0,14.0,5.0,0,1,41,217,168,2236,2453,11/20/2020
2020-03-27,27,234,214,2607,2841,9.0,79.0,1.0,13.0,1.0,1.0,65.0,16.0,6.0,2,3,31,248,193,2429,2677,11/20/2020
2020-03-28,59,293,260,2867,3160,11.0,90.0,2.0,15.0,1.0,2.0,73.0,15.0,6.0,1,4,64,312,239,2668,2980,11/20/2020
2020-03-29,100,393,350,3217,3610,8.0,98.0,3.0,18.0,1.0,3.0,77.0,18.0,8.0,2,6,105,417,309,2977,3394,11/20/2020
2020-03-30,62,455,222,3439,3894,19.0,117.0,5.0,23.0,0.0,3.0,91.0,19.0,11.0,3,9,78,495,181,3158,3653,11/20/2020
2020-03-31,71,526,369,3808,4334,11.0,128.0,7.0,30.0,1.0,4.0,94.0,21.0,13.0,2,11,73,568,293,3451,4019,11/20/2020
2020-04-01,99,625,698,4506,5131,18.0,146.0,7.0,37.0,0.0,4.0,105.0,29.0,15.0,1,12,100,668,618,4069,4737,11/20/2020
2020-04-02,52,677,477,4983,5660,22.0,168.0,6.0,43.0,2.0,6.0,119.0,35.0,21.0,4,16,62,730,422,4491,5221,11/20/2020
2020-04-03,108,785,774,5757,6542,23.0,191.0,7.0,50.0,0.0,6.0,135.0,42.0,25.0,3,19,100,830,686,5177,6007,11/20/2020
2020-04-04,143,928,660,6417,7345,22.0,213.0,4.0,54.0,5.0,11.0,148.0,40.0,29.0,9,28,138,968,598,5775,6743,11/20/2020
2020-04-05,187,1115,1156,7573,8688,20.0,233.0,9.0,63.0,1.0,12.0,158.0,43.0,35.0,2,30,181,1149,1024,6799,7948,11/20/2020
2020-04-06,218,1333,1706,9279,10612,26.0,259.0,7.0,70.0,0.0,12.0,177.0,47.0,39.0,7,37,207,1356,1503,8302,9658,11/20/2020
2020-04-07,284,1617,1629,10908,12525,20.0,279.0,4.0,74.0,2.0,14.0,191.0,49.0,41.0,5,42,261,1617,1445,9747,11364,11/20/2020
2020-04-08,290,1907,1720,12628,14535,19.0,298.0,8.0,82.0,5.0,19.0,197.0,49.0,37.0,10,52,271,1888,1508,11255,13143,11/20/2020
2020-04-09,283,2190,1516,14144,16334,32.0,330.0,8.0,90.0,4.0,23.0,217.0,53.0,40.0,7,59,277,2165,1315,12570,14735,11/20/2020
2020-04-10,419,2609,2574,16718,19327,29.0,359.0,17.0,107.0,5.0,28.0,224.0,59.0,41.0,11,70,400,2565,2295,14865,17430,11/20/2020
2020-04-11,297,2906,1905,18623,21529,29.0,388.0,11.0,118.0,2.0,30.0,240.0,61.0,48.0,12,82,281,2846,1673,16538,19384,11/20/2020
2020-04-12,314,3220,1670,20293,23513,35.0,423.0,13.0,131.0,5.0,35.0,257.0,59.0,49.0,9,91,286,3132,1379,17917,21049,11/20/2020
2020-04-13,161,3381,935,21228,24609,35.0,458.0,13.0,144.0,3.0,38.0,276.0,64.0,54.0,9,100,187,3319,818,18735,22054,11/20/2020
2020-04-14,289,3670,1787,23015,26685,27.0,485.0,18.0,162.0,5.0,43.0,280.0,72.0,53.0,8,108,262,3581,1476,20211,23792,11/20/2020
2020-04-15,351,4021,1799,24814,28835,31.0,516.0,20.0,182.0,3.0,46.0,288.0,72.0,54.0,17,125,306,3887,1487,21698,25585,11/20/2020
2020-04-16,447,4468,2494,27308,31776,36.0,552.0,25.0,207.0,6.0,52.0,293.0,72.0,53.0,14,139,387,4274,1999,23697,27971,11/20/2020
2020-04-17,304,4772,1821,29129,33901,32.0,584.0,20.0,227.0,7.0,59.0,298.0,66.0,45.0,21,160,290,4564,1399,25096,29660,11/20/2020
2020-04-18,321,5093,1725,30854,35947,26.0,610.0,18.0,245.0,4.0,63.0,302.0,63.0,49.0,15,175,284,4848,1281,26377,31225,11/20/2020
2020-04-19,381,5474,2047,32901,38375,23.0,633.0,26.0,271.0,1.0,64.0,298.0,65.0,55.0,11,186,337,5185,1687,28064,33249,11/20/2020
2020-04-20,394,5868,1907,34808,40676,46.0,679.0,29.0,300.0,2.0,66.0,313.0,75.0,56.0,10,196,376,5561,1537,29601,35162,11/20/2020
2020-04-21,444,6312,2110,36918,43230,45.0,724.0,32.0,332.0,5.0,71.0,321.0,72.0,56.0,18,214,383,5944,1656,31257,37201,11/20/2020
2020-04-22,418,6730,2390,39308,46038,41.0,765.0,32.0,364.0,5.0,76.0,325.0,73.0,58.0,18,232,379,6323,1860,33117,39440,11/20/2020
2020-04-23,479,7209,2469,41777,48986,32.0,797.0,28.0,392.0,5.0,81.0,324.0,76.0,62.0,15,247,412,6735,1808,34925,41660,11/20/2020
2020-04-24,491,7700,3284,45061,52761,35.0,832.0,26.0,418.0,4.0,85.0,329.0,85.0,63.0,15,262,407,7142,2539,37464,44606,11/20/2020
2020-04-25,393,8093,2206,47267,55360,34.0,866.0,17.0,435.0,5.0,90.0,341.0,85.0,62.0,14,276,299,7441,1708,39172,46613,11/20/2020
2020-04-26,316,8409,2309,49576,57985,33.0,899.0,15.0,450.0,3.0,93.0,356.0,86.0,59.0,14,290,274,7715,1816,40988,48703,11/20/2020
2020-04-27,249,8658,1620,51196,59854,29.0,928.0,21.0,471.0,4.0,97.0,360.0,86.0,61.0,10,300,206,7921,1118,42106,50027,11/20/2020
2020-04-28,410,9068,2263,53459,62527,44.0,972.0,24.0,495.0,3.0,100.0,377.0,88.0,59.0,22,322,332,8253,1661,43767,52020,11/20/2020
2020-04-29,476,9544,3343,56802,66346,36.0,1008.0,38.0,533.0,11.0,111.0,364.0,78.0,53.0,18,340,370,8623,2309,46076,54699,11/20/2020
2020-04-30,432,9976,2769,59571,69547,33.0,1041.0,38.0,571.0,6.0,117.0,353.0,83.0,57.0,24,364,349,8972,1830,47906,56878,11/20/2020
2020-05-01,454,10430,3086,62657,73087,52.0,1093.0,38.0,609.0,3.0,120.0,364.0,84.0,58.0,14,378,323,9295,2058,49964,59259,11/20/2020
2020-05-02,257,10687,1926,64583,75270,36.0,1129.0,39.0,648.0,5.0,125.0,356.0,93.0,63.0,24,402,192,9487,1235,51199,60686,11/20/2020
2020-05-03,283,10970,2160,66743,77713,31.0,1160.0,26.0,674.0,8.0,133.0,353.0,91.0,61.0,21,423,183,9670,1506,52705,62375,11/20/2020
2020-05-04,387,11357,2098,68841,80198,30.0,1190.0,31.0,705.0,6.0,139.0,346.0,89.0,58.0,18,441,290,9960,1516,54221,64181,11/20/2020
2020-05-05,433,11790,2873,71714,83504,29.0,1219.0,32.0,737.0,6.0,145.0,337.0,83.0,55.0,16,457,300,10260,1903,56124,66384,11/20/2020
2020-05-06,488,12278,2830,74544,86822,28.0,1247.0,44.0,781.0,9.0,154.0,312.0,80.0,55.0,21,478,340,10600,1867,57991,68591,11/20/2020
2020-05-07,425,12703,2969,77513,90216,36.0,1283.0,44.0,825.0,5.0,159.0,299.0,72.0,53.0,21,499,269,10869,1904,59895,70764,11/20/2020
2020-05-08,359,13062,2598,80111,93173,30.0,1313.0,29.0,854.0,5.0,164.0,295.0,72.0,54.0,22,521,229,11098,1681,61576,72674,11/20/2020
2020-05-09,467,13529,3346,83457,96986,22.0,1335.0,21.0,875.0,4.0,168.0,292.0,70.0,52.0,15,536,290,11388,2177,63753,75141,11/20/2020
2020-05-10,285,13814,2117,85574,99388,20.0,1355.0,23.0,898.0,6.0,174.0,283.0,71.0,50.0,14,550,189,11577,1460,65213,76790,11/20/2020
2020-05-11,257,14071,1857,87431,101502,31.0,1386.0,16.0,914.0,6.0,180.0,292.0,72.0,50.0,15,565,174,11751,1254,66467,78218,11/20/2020
2020-05-12,387,14458,2611,90042,104500,23.0,1409.0,18.0,932.0,4.0,184.0,293.0,70.0,49.0,22,587,224,11975,1614,68081,80056,11/20/2020
2020-05-13,351,14809,3630,93672,108481,23.0,1432.0,25.0,957.0,1.0,185.0,290.0,70.0,50.0,13,600,199,12174,1890,69971,82145,11/20/2020
2020-05-14,329,15138,3408,97080,112218,19.0,1451.0,27.0,984.0,3.0,188.0,279.0,65.0,46.0,15,615,232,12406,1919,71890,84296,11/20/2020
2020-05-15,381,15519,3458,100538,116057,24.0,1475.0,41.0,1025.0,5.0,193.0,257.0,63.0,46.0,14,629,232,12638,1757,73647,86285,11/20/2020
2020-05-16,449,15968,4156,104694,120662,25.0,1500.0,15.0,1040.0,5.0,198.0,262.0,62.0,47.0,15,644,247,12885,1888,75535,88420,11/20/2020
2020-05-17,240,16208,2768,107462,123670,17.0,1517.0,9.0,1049.0,5.0,203.0,265.0,60.0,46.0,10,654,126,13011,1495,77030,90041,11/20/2020
2020-05-18,250,16458,2001,109463,125921,19.0,1536.0,16.0,1065.0,5.0,208.0,263.0,58.0,41.0,18,672,135,13146,1329,78359,91505,11/20/2020
2020-05-19,415,16873,3168,112631,129504,23.0,1559.0,33.0,1098.0,5.0,213.0,248.0,57.0,39.0,11,683,215,13361,1887,80246,93607,11/20/2020
2020-05-20,326,17199,2771,115402,132601,19.0,1578.0,23.0,1121.0,7.0,220.0,237.0,53.0,34.0,22,705,184,13545,1490,81736,95281,11/20/2020
2020-05-21,374,17573,3757,119159,136732,25.0,1603.0,15.0,1136.0,3.0,223.0,244.0,54.0,30.0,20,725,168,13713,1895,83631,97344,11/20/2020
2020-05-22,351,17924,3161,122320,140244,20.0,1623.0,28.0,1164.0,5.0,228.0,231.0,53.0,30.0,11,736,206,13919,1560,85191,99110,11/20/2020
2020-05-23,253,18177,2742,125062,143239,19.0,1642.0,11.0,1175.0,3.0,231.0,236.0,53.0,33.0,13,749,109,14028,1238,86429,100457,11/20/2020
2020-05-24,163,18340,1370,126432,144772,13.0,1655.0,14.0,1189.0,2.0,233.0,233.0,54.0,36.0,8,757,83,14111,757,87186,101297,11/20/2020
2020-05-25,147,18487,1385,127817,146304,14.0,1669.0,14.0,1203.0,0.0,233.0,233.0,54.0,34.0,10,767,76,14187,730,87916,102103,11/20/2020
2020-05-26,285,18772,2620,130437,149209,24.0,1693.0,21.0,1224.0,5.0,238.0,231.0,49.0,33.0,15,782,158,14345,1669,89585,103930,11/20/2020
2020-05-27,276,19048,2057,132494,151542,20.0,1713.0,18.0,1242.0,3.0,241.0,230.0,51.0,33.0,10,792,132,14477,1112,90697,105174,11/20/2020
2020-05-28,348,19396,3359,135853,155249,17.0,1730.0,29.0,1271.0,4.0,245.0,214.0,47.0,32.0,8,800,130,14607,1094,91791,106398,11/20/2020
2020-05-29,410,19806,3915,139768,159574,19.0,1749.0,26.0,1297.0,7.0,252.0,200.0,43.0,31.0,12,812,174,14781,1520,93311,108092,11/20/2020
2020-05-30,225,20031,3915,143683,163714,16.0,1765.0,19.0,1316.0,4.0,256.0,193.0,41.0,29.0,12,824,109,14890,1723,95034,109924,11/20/2020
2020-05-31,155,20186,1690,145373,165559,11.0,1776.0,11.0,1327.0,1.0,257.0,192.0,44.0,26.0,3,827,78,14968,821,95855,110823,11/20/2020
2020-06-01,212,20398,2792,148165,168563,8.0,1784.0,14.0,1341.0,1.0,258.0,185.0,45.0,29.0,5,832,93,15061,1350,97205,112266,11/20/2020
2020-06-02,273,20671,3022,151187,171858,8.0,1792.0,9.0,1350.0,3.0,261.0,181.0,38.0,25.0,10,842,98,15159,1401,98606,113765,11/20/2020
2020-06-03,254,20925,3486,154673,175598,14.0,1806.0,18.0,1368.0,6.0,267.0,171.0,34.0,25.0,11,853,99,15258,1622,100228,115486,11/20/2020
2020-06-04,276,21201,4471,159144,180345,7.0,1813.0,26.0,1394.0,4.0,271.0,148.0,31.0,24.0,12,865,107,15365,1981,102209,117574,11/20/2020
2020-06-05,215,21416,3513,162657,184073,15.0,1828.0,13.0,1407.0,6.0,277.0,144.0,27.0,21.0,11,876,99,15464,1520,103729,119193,11/20/2020
2020-06-06,201,21617,2616,165273,186890,10.0,1838.0,7.0,1414.0,2.0,279.0,145.0,29.0,19.0,6,882,67,15531,1092,104821,120352,11/20/2020
2020-06-07,83,21700,1625,166898,188598,11.0,1849.0,7.0,1421.0,1.0,280.0,148.0,25.0,17.0,4,886,51,15582,775,105596,121178,11/20/2020
2020-06-08,119,21819,1849,168747,190566,15.0,1864.0,13.0,1434.0,2.0,282.0,148.0,27.0,18.0,4,890,45,15627,934,106530,122157,11/20/2020
2020-06-09,223,22042,2673,171420,193462,10.0,1874.0,19.0,1453.0,0.0,282.0,139.0,28.0,21.0,1,891,64,15691,1233,107763,123454,11/20/2020
2020-06-10,209,22251,2987,174407,196658,13.0,1887.0,12.0,1465.0,2.0,284.0,138.0,24.0,17.0,4,895,100,15791,1437,109200,124991,11/20/2020
2020-06-11,195,22446,3513,177920,200366,7.0,1894.0,15.0,1480.0,1.0,285.0,129.0,25.0,16.0,6,901,88,15879,1498,110698,126577,11/20/2020
2020-06-12,209,22655,4601,182521,205176,9.0,1903.0,16.0,1496.0,1.0,286.0,121.0,24.0,16.0,2,903,78,15957,2132,112830,128787,11/20/2020
2020-06-13,113,22768,3036,185557,208325,6.0,1909.0,5.0,1501.0,0.0,286.0,122.0,20.0,15.0,3,906,49,16006,1346,114176,130182,11/20/2020
2020-06-14,81,22849,2046,187603,210452,7.0,1916.0,8.0,1509.0,1.0,287.0,120.0,20.0,14.0,3,909,33,16039,949,115125,131164,11/20/2020
2020-06-15,188,23037,3108,190711,213748,14.0,1930.0,19.0,1528.0,0.0,287.0,115.0,20.0,16.0,5,914,75,16114,1748,116873,132987,11/20/2020
2020-06-16,110,23147,3017,193728,216875,11.0,1941.0,9.0,1537.0,1.0,288.0,116.0,22.0,16.0,8,922,50,16164,1506,118379,134543,11/20/2020
2020-06-17,127,23274,2835,196563,219837,15.0,1956.0,20.0,1557.0,4.0,292.0,107.0,18.0,14.0,6,928,51,16215,1288,119667,135882,11/20/2020
2020-06-18,149,23423,3048,199611,223034,9.0,1965.0,15.0,1572.0,1.0,293.0,100.0,19.0,16.0,7,935,70,16285,1294,120961,137246,11/20/2020
2020-06-19,141,23564,3769,203380,226944,12.0,1977.0,12.0,1584.0,1.0,294.0,99.0,20.0,17.0,3,938,59,16344,1330,122291,138635,11/20/2020
2020-06-20,84,23648,1891,205271,228919,9.0,1986.0,12.0,1596.0,0.0,294.0,96.0,20.0,18.0,4,942,36,16380,804,123095,139475,11/20/2020
2020-06-21,37,23685,1064,206335,230020,8.0,1994.0,5.0,1601.0,0.0,294.0,99.0,20.0,18.0,2,944,30,16410,680,123775,140185,11/20/2020
2020-06-22,138,23823,3730,210065,233888,12.0,2006.0,17.0,1618.0,0.0,294.0,94.0,19.0,18.0,2,946,65,16475,1676,125451,141926,11/20/2020
2020-06-23,163,23986,3831,213896,237882,3.0,2009.0,13.0,1631.0,3.0,297.0,81.0,18.0,18.0,7,953,81,16556,1754,127205,143761,11/20/2020
2020-06-24,120,24106,3502,217398,241504,9.0,2018.0,10.0,1641.0,1.0,298.0,79.0,18.0,18.0,5,958,44,16600,1658,128863,145463,11/20/2020
2020-06-25,103,24209,2883,220281,244490,6.0,2024.0,14.0,1655.0,1.0,299.0,70.0,17.0,17.0,1,959,50,16650,1473,130336,146986,11/20/2020
2020-06-26,94,24303,2488,222769,247072,2.0,2026.0,10.0,1665.0,0.0,299.0,62.0,18.0,18.0,1,960,60,16710,1305,131641,148351,11/20/2020
2020-06-27,84,24387,3216,225985,250372,5.0,2031.0,3.0,1668.0,1.0,300.0,63.0,17.0,17.0,5,965,37,16747,1186,132827,149574,11/20/2020
2020-06-28,39,24426,1469,227454,251880,4.0,2035.0,4.0,1672.0,4.0,304.0,59.0,15.0,14.0,6,971,17,16764,584,133411,150175,11/20/2020
2020-06-29,85,24511,3697,231151,255662,4.0,2039.0,5.0,1677.0,0.0,304.0,58.0,14.0,14.0,1,972,39,16803,1331,134742,151545,11/20/2020
2020-06-30,57,24568,1958,233109,257677,1.0,2040.0,5.0,1682.0,1.0,305.0,53.0,12.0,11.0,4,976,33,16836,983,135725,152561,11/20/2020
2020-07-01,144,24712,4098,237207,261919,8.0,2048.0,10.0,1692.0,0.0,305.0,51.0,11.0,11.0,1,977,79,16915,1893,137618,154533,11/20/2020
2020-07-02,103,24815,2803,240010,264825,5.0,2053.0,5.0,1697.0,1.0,306.0,50.0,10.0,10.0,3,980,59,16974,1066,138684,155658,11/20/2020
2020-07-03,50,24865,2079,242089,266954,9.0,2062.0,6.0,1703.0,0.0,306.0,53.0,9.0,9.0,3,983,25,16999,772,139456,156455,11/20/2020
2020-07-04,57,24922,2345,244434,269356,2.0,2064.0,4.0,1707.0,1.0,307.0,50.0,10.0,9.0,2,985,33,17032,984,140440,157472,11/20/2020
2020-07-05,49,24971,2932,247366,272337,1.0,2065.0,2.0,1709.0,1.0,308.0,48.0,8.0,8.0,2,987,26,17058,1405,141845,158903,11/20/2020
2020-07-06,101,25072,2814,250180,275252,6.0,2071.0,6.0,1715.0,0.0,308.0,48.0,9.0,9.0,4,991,57,17115,1525,143370,160485,11/20/2020
2020-07-07,81,25153,3457,253637,278790,5.0,2076.0,7.0,1722.0,0.0,308.0,46.0,8.0,8.0,2,993,47,17162,1516,144886,162048,11/20/2020
2020-07-08,105,25258,3409,257046,282304,4.0,2080.0,2.0,1724.0,0.0,308.0,48.0,9.0,8.0,0,993,64,17226,1383,146269,163495,11/20/2020
2020-07-09,94,25352,3714,260760,286112,9.0,2089.0,3.0,1727.0,0.0,308.0,54.0,9.0,8.0,0,993,50,17276,1588,147857,165133,11/20/2020
2020-07-10,132,25484,4437,265197,290681,6.0,2095.0,3.0,1730.0,2.0,310.0,55.0,7.0,7.0,3,996,80,17356,2035,149892,167248,11/20/2020
2020-07-11,63,25547,2938,268135,293682,6.0,2101.0,3.0,1733.0,1.0,311.0,57.0,6.0,6.0,3,999,36,17392,1299,151191,168583,11/20/2020
2020-07-12,47,25594,1838,269973,295567,1.0,2102.0,3.0,1736.0,1.0,312.0,54.0,6.0,5.0,3,1002,34,17426,929,152120,169546,11/20/2020
2020-07-13,84,25678,3209,273182,298860,8.0,2110.0,10.0,1746.0,0.0,312.0,52.0,6.0,5.0,1,1003,61,17487,1478,153598,171085,11/20/2020
2020-07-14,74,25752,3298,276480,302232,7.0,2117.0,4.0,1750.0,0.0,312.0,55.0,5.0,5.0,1,1004,44,17531,1358,154956,172487,11/20/2020
2020-07-15,130,25882,4181,280661,306543,5.0,2122.0,7.0,1757.0,0.0,312.0,53.0,5.0,4.0,0,1004,100,17631,1722,156678,174309,11/20/2020
2020-07-16,103,25985,3740,284401,310386,6.0,2128.0,9.0,1766.0,0.0,312.0,50.0,6.0,5.0,1,1005,76,17707,1590,158268,175975,11/20/2020
2020-07-17,156,26141,4239,288640,314781,14.0,2142.0,3.0,1769.0,1.0,313.0,60.0,5.0,5.0,2,1007,79,17786,1816,160084,177870,11/20/2020
2020-07-18,85,26226,3272,291912,318138,5.0,2147.0,9.0,1778.0,1.0,314.0,55.0,5.0,4.0,4,1011,70,17856,1373,161457,179313,11/20/2020
2020-07-19,82,26308,2696,294608,320916,7.0,2154.0,3.0,1781.0,0.0,314.0,59.0,6.0,4.0,2,1013,57,17913,1130,162587,180500,11/20/2020
2020-07-20,71,26379,2666,297274,323653,9.0,2163.0,7.0,1788.0,0.0,314.0,61.0,7.0,5.0,2,1015,68,17981,1435,164022,182003,11/20/2020
2020-07-21,130,26509,4304,301578,328087,9.0,2172.0,11.0,1799.0,0.0,314.0,59.0,9.0,6.0,1,1016,108,18089,1894,165916,184005,11/20/2020
2020-07-22,130,26639,3928,305506,332145,7.0,2179.0,8.0,1807.0,1.0,315.0,57.0,7.0,6.0,1,1017,86,18175,1649,167565,185740,11/20/2020
2020-07-23,141,26780,4415,309921,336701,8.0,2187.0,6.0,1813.0,0.0,315.0,59.0,8.0,7.0,0,1017,115,18290,1934,169499,187789,11/20/2020
2020-07-24,172,26952,5966,315887,342839,15.0,2202.0,12.0,1825.0,0.0,315.0,62.0,9.0,7.0,0,1017,119,18409,2275,171774,190183,11/20/2020
2020-07-25,134,27086,4398,320285,347371,7.0,2209.0,7.0,1832.0,0.0,315.0,62.0,10.0,8.0,3,1020,108,18517,2066,173840,192357,11/20/2020
2020-07-26,62,27148,3033,323318,350466,8.0,2217.0,9.0,1841.0,0.0,315.0,61.0,11.0,7.0,1,1021,54,18571,1320,175160,193731,11/20/2020
2020-07-27,188,27336,4191,327509,354845,12.0,2229.0,7.0,1848.0,0.0,315.0,66.0,13.0,8.0,1,1022,138,18709,2305,177465,196174,11/20/2020
2020-07-28,105,27441,3840,331349,358790,5.0,2234.0,5.0,1853.0,0.0,315.0,66.0,14.0,7.0,1,1023,95,18804,1613,179078,197882,11/20/2020
2020-07-29,190,27631,5139,336488,364119,9.0,2243.0,10.0,1863.0,0.0,315.0,65.0,15.0,7.0,0,1023,154,18958,2268,181346,200304,11/20/2020
2020-07-30,121,27752,4345,340833,368585,6.0,2249.0,2.0,1865.0,1.0,316.0,68.0,15.0,6.0,1,1024,97,19055,1617,182963,202018,11/20/2020
2020-07-31,131,27883,5512,346345,374228,7.0,2256.0,9.0,1874.0,0.0,316.0,66.0,15.0,7.0,1,1025,89,19144,1809,184772,203916,11/20/2020
2020-08-01,109,27992,4294,350639,378631,7.0,2263.0,2.0,1876.0,0.0,316.0,71.0,14.0,7.0,1,1026,89,19233,1535,186307,205540,11/20/2020
2020-08-02,84,28076,2804,353443,381519,12.0,2275.0,12.0,1888.0,2.0,318.0,69.0,14.0,8.0,2,1028,62,19295,1248,187555,206850,11/20/2020
2020-08-03,188,28264,5248,358691,386955,11.0,2286.0,10.0,1898.0,0.0,318.0,70.0,16.0,7.0,1,1029,150,19445,2174,189729,209174,11/20/2020
2020-08-04,125,28389,3691,362382,390771,8.0,2294.0,5.0,1903.0,1.0,319.0,72.0,12.0,5.0,2,1031,99,19544,1744,191473,211017,11/20/2020
2020-08-05,147,28536,5935,368317,396853,11.0,2305.0,9.0,1912.0,1.0,320.0,73.0,10.0,5.0,2,1033,119,19663,2426,193899,213562,11/20/2020
2020-08-06,169,28705,5546,373863,402568,7.0,2312.0,9.0,1921.0,0.0,320.0,71.0,9.0,4.0,0,1033,120,19783,2353,196252,216035,11/20/2020
2020-08-07,123,28828,4851,378714,407542,12.0,2324.0,9.0,1930.0,1.0,321.0,73.0,9.0,3.0,2,1035,87,19870,2107,198359,218229,11/20/2020
2020-08-08,123,28951,4112,382826,411777,19.0,2343.0,6.0,1936.0,1.0,322.0,85.0,8.0,3.0,1,1036,91,19961,1758,200117,220078,11/20/2020
2020-08-09,42,28993,1727,384553,413546,6.0,2349.0,8.0,1944.0,0.0,322.0,83.0,9.0,4.0,0,1036,35,19996,1054,201171,221167,11/20/2020
2020-08-10,149,29142,4587,389140,418282,8.0,2357.0,9.0,1953.0,0.0,322.0,82.0,9.0,4.0,1,1037,113,20109,1992,203163,223272,11/20/2020
2020-08-11,106,29248,4334,393474,422722,5.0,2362.0,13.0,1966.0,0.0,322.0,74.0,10.0,4.0,3,1040,92,20201,2233,205396,225597,11/20/2020
2020-08-12,121,29369,5188,398662,428031,8.0,2370.0,11.0,1977.0,0.0,322.0,71.0,9.0,3.0,1,1041,101,20302,2578,207974,228276,11/20/2020
2020-08-13,135,29504,4196,402858,432362,13.0,2383.0,12.0,1989.0,0.0,322.0,72.0,11.0,3.0,0,1041,95,20397,1879,209853,230250,11/20/2020
2020-08-14,145,29649,5498,408356,438005,13.0,2396.0,11.0,2000.0,0.0,322.0,74.0,11.0,4.0,3,1044,98,20495,1946,211799,232294,11/20/2020
2020-08-15,106,29755,4534,412890,442645,9.0,2405.0,11.0,2011.0,1.0,323.0,71.0,11.0,5.0,0,1044,88,20583,1659,213458,234041,11/20/2020
2020-08-16,83,29838,2477,415367,445205,6.0,2411.0,5.0,2016.0,4.0,327.0,68.0,8.0,4.0,6,1050,70,20653,944,214402,235055,11/20/2020
2020-08-17,106,29944,4575,419942,449886,8.0,2419.0,6.0,2022.0,0.0,327.0,70.0,8.0,5.0,2,1052,87,20740,2349,216751,237491,11/20/2020
2020-08-18,128,30072,4911,424853,454925,11.0,2430.0,8.0,2030.0,1.0,328.0,72.0,8.0,4.0,5,1057,94,20834,2710,219461,240295,11/20/2020
2020-08-19,113,30185,5077,429930,460115,8.0,2438.0,9.0,2039.0,1.0,329.0,70.0,9.0,5.0,0,1057,90,20924,2595,222056,242980,11/20/2020
2020-08-20,173,30358,7411,437341,467699,12.0,2450.0,6.0,2045.0,2.0,331.0,74.0,10.0,5.0,3,1060,139,21063,3469,225525,246588,11/20/2020
2020-08-21,152,30510,6577,443918,474428,8.0,2458.0,5.0,2050.0,1.0,332.0,76.0,9.0,4.0,2,1062,125,21188,2893,228418,249606,11/20/2020
2020-08-22,96,30606,5550,449468,480074,11.0,2469.0,12.0,2062.0,0.0,332.0,75.0,11.0,4.0,1,1063,84,21272,2561,230979,252251,11/20/2020
2020-08-23,71,30677,4375,453843,484520,11.0,2480.0,5.0,2067.0,0.0,332.0,81.0,12.0,2.0,1,1064,56,21328,2446,233425,254753,11/20/2020
2020-08-24,105,30782,5784,459627,490409,7.0,2487.0,10.0,2077.0,1.0,333.0,77.0,14.0,4.0,1,1065,77,21405,3103,236528,257933,11/20/2020
2020-08-25,108,30890,4764,464391,495281,10.0,2497.0,4.0,2081.0,1.0,334.0,82.0,12.0,4.0,1,1066,92,21497,2261,238789,260286,11/20/2020
2020-08-26,170,31060,9482,473873,504933,4.0,2501.0,8.0,2089.0,0.0,334.0,78.0,10.0,5.0,1,1067,128,21625,3049,241838,263463,11/20/2020
2020-08-27,91,31151,8565,482438,513589,6.0,2507.0,14.0,2103.0,1.0,335.0,69.0,7.0,5.0,2,1069,70,21695,3104,244942,266637,11/20/2020
2020-08-28,113,31264,7994,490432,521696,14.0,2521.0,4.0,2107.0,0.0,335.0,79.0,10.0,7.0,2,1071,87,21782,2396,247338,269120,11/20/2020
2020-08-29,65,31329,5374,495806,527135,6.0,2527.0,8.0,2115.0,1.0,336.0,76.0,11.0,6.0,2,1073,51,21833,1896,249234,271067,11/20/2020
2020-08-30,66,31395,4323,500129,531524,7.0,2534.0,4.0,2119.0,0.0,336.0,79.0,9.0,5.0,2,1075,48,21881,1957,251191,273072,11/20/2020
2020-08-31,105,31500,4863,504992,536492,12.0,2546.0,16.0,2135.0,0.0,336.0,75.0,8.0,4.0,1,1076,81,21962,2159,253350,275312,11/20/2020
2020-09-01,98,31598,7109,512101,543699,6.0,2552.0,9.0,2144.0,1.0,337.0,71.0,7.0,4.0,2,1078,66,22028,2346,255696,277724,11/20/2020
2020-09-02,125,31723,10529,522630,554353,9.0,2561.0,10.0,2154.0,1.0,338.0,69.0,8.0,4.0,2,1080,104,22132,3011,258707,280839,11/20/2020
2020-09-03,90,31813,11079,533709,565522,8.0,2569.0,8.0,2162.0,0.0,338.0,69.0,9.0,4.0,3,1083,73,22205,2548,261255,283460,11/20/2020
2020-09-04,103,31916,8963,542672,574588,11.0,2580.0,4.0,2166.0,0.0,338.0,76.0,9.0,4.0,1,1084,83,22288,2344,263599,285887,11/20/2020
2020-09-05,52,31968,6309,548981,580949,6.0,2586.0,9.0,2175.0,0.0,338.0,73.0,8.0,3.0,1,1085,42,22330,1579,265178,287508,11/20/2020
2020-09-06,88,32056,4325,553306,585362,4.0,2590.0,8.0,2183.0,1.0,339.0,68.0,6.0,3.0,1,1086,65,22395,1925,267103,289498,11/20/2020
2020-09-07,35,32091,3002,556308,588399,11.0,2601.0,3.0,2186.0,0.0,339.0,76.0,5.0,3.0,1,1087,26,22421,633,267736,290157,11/20/2020
2020-09-08,74,32165,6381,562689,594854,6.0,2607.0,12.0,2198.0,1.0,340.0,69.0,6.0,3.0,2,1089,66,22487,1572,269308,291795,11/20/2020
2020-09-09,118,32283,8650,571339,603622,10.0,2617.0,5.0,2203.0,1.0,341.0,73.0,9.0,3.0,1,1090,102,22589,2111,271419,294008,11/20/2020
2020-09-10,164,32447,11334,582673,615120,9.0,2626.0,8.0,2211.0,0.0,341.0,74.0,10.0,3.0,1,1091,111,22700,2239,273658,296358,11/20/2020
2020-09-11,120,32567,9454,592127,624694,11.0,2637.0,11.0,2222.0,0.0,341.0,74.0,10.0,5.0,0,1091,97,22797,1946,275604,298401,11/20/2020
2020-09-12,110,32677,6173,598300,630977,8.0,2645.0,5.0,2227.0,2.0,343.0,75.0,9.0,5.0,3,1094,97,22894,1495,277099,299993,11/20/2020
2020-09-13,58,32735,2716,601016,633751,4.0,2649.0,3.0,2230.0,0.0,343.0,76.0,10.0,5.0,0,1094,54,22948,850,277949,300897,11/20/2020
2020-09-14,104,32839,6446,607462,640301,6.0,2655.0,3.0,2233.0,2.0,345.0,77.0,10.0,5.0,2,1096,95,23043,1711,279660,302703,11/20/2020
2020-09-15,122,32961,8466,615928,648889,7.0,2662.0,2.0,2235.0,1.0,346.0,81.0,10.0,5.0,2,1098,124,23167,2164,281824,304991,11/20/2020
2020-09-16,137,33098,9715,625643,658741,7.0,2669.0,7.0,2242.0,2.0,348.0,79.0,9.0,6.0,5,1103,118,23285,1952,283776,307061,11/20/2020
2020-09-17,125,33223,9239,634882,668105,7.0,2676.0,15.0,2257.0,0.0,348.0,71.0,8.0,4.0,0,1103,154,23439,1928,285704,309143,11/20/2020
2020-09-18,132,33355,10045,644927,678282,7.0,2683.0,7.0,2264.0,1.0,349.0,70.0,11.0,6.0,2,1105,132,23571,1907,287611,311182,11/20/2020
2020-09-19,115,33470,8297,653224,686694,7.0,2690.0,3.0,2267.0,0.0,349.0,74.0,10.0,6.0,4,1109,112,23683,1679,289290,312973,11/20/2020
2020-09-20,60,33530,3676,656900,690430,7.0,2697.0,6.0,2273.0,2.0,351.0,73.0,9.0,8.0,4,1113,49,23732,1307,290597,314329,11/20/2020
2020-09-21,102,33632,7018,663918,697550,12.0,2709.0,3.0,2276.0,2.0,353.0,80.0,8.0,6.0,2,1115,94,23826,2388,292985,316811,11/20/2020
2020-09-22,154,33786,9287,673205,706991,12.0,2721.0,3.0,2279.0,1.0,354.0,88.0,7.0,5.0,1,1116,124,23950,2182,295167,319117,11/20/2020
2020-09-23,136,33922,10650,683855,717777,12.0,2733.0,7.0,2286.0,0.0,354.0,93.0,6.0,5.0,0,1116,127,24077,2194,297361,321438,11/20/2020
2020-09-24,120,34042,12479,696334,730376,7.0,2740.0,9.0,2295.0,1.0,355.0,90.0,7.0,5.0,1,1117,121,24198,3134,300495,324693,11/20/2020
2020-09-25,149,34191,10553,706887,741078,9.0,2749.0,10.0,2305.0,0.0,355.0,89.0,6.0,5.0,1,1118,142,24340,2976,303471,327811,11/20/2020
2020-09-26,146,34337,10559,717446,751783,12.0,2761.0,9.0,2314.0,0.0,355.0,92.0,6.0,5.0,1,1119,119,24459,2406,305877,330336,11/20/2020
2020-09-27,43,34380,2764,720210,754590,7.0,2768.0,5.0,2319.0,0.0,355.0,94.0,9.0,5.0,0,1119,34,24493,837,306714,331207,11/20/2020
2020-09-28,152,34532,7308,727518,762050,7.0,2775.0,7.0,2326.0,2.0,357.0,92.0,7.0,5.0,2,1121,134,24627,2243,308957,333584,11/20/2020
2020-09-29,208,34740,11046,738564,773304,12.0,2787.0,18.0,2344.0,1.0,358.0,85.0,6.0,6.0,1,1122,190,24817,2800,311757,336574,11/20/2020
2020-09-30,221,34961,12230,750794,785755,6.0,2793.0,6.0,2350.0,0.0,358.0,85.0,6.0,6.0,1,1123,187,25004,2561,314318,339322,11/20/2020
2020-10-01,185,35146,12503,763297,798443,17.0,2810.0,13.0,2363.0,1.0,359.0,88.0,6.0,4.0,2,1125,167,25171,2387,316705,341876,11/20/2020
2020-10-02,210,35356,12153,775450,810806,14.0,2824.0,13.0,2376.0,1.0,360.0,88.0,8.0,5.0,2,1127,182,25353,2472,319177,344530,11/20/2020
2020-10-03,157,35513,9312,784762,820275,9.0,2833.0,9.0,2385.0,2.0,362.0,86.0,9.0,4.0,2,1129,131,25484,2004,321181,346665,11/20/2020
2020-10-04,81,35594,2369,787131,822725,11.0,2844.0,9.0,2394.0,1.0,363.0,87.0,8.0,5.0,2,1131,78,25562,948,322129,347691,11/20/2020
2020-10-05,174,35768,8983,796114,831882,30.0,2874.0,10.0,2404.0,2.0,365.0,105.0,9.0,6.0,4,1135,160,25722,3003,325132,350854,11/20/2020
2020-10-06,177,35945,11186,807300,843245,11.0,2885.0,4.0,2408.0,0.0,365.0,112.0,11.0,7.0,0,1135,186,25908,2880,328012,353920,11/20/2020
2020-10-07,231,36176,12441,819741,855917,13.0,2898.0,14.0,2422.0,2.0,367.0,109.0,9.0,7.0,2,1137,243,26151,3509,331521,357672,11/20/2020
2020-10-08,262,36438,15230,834971,871409,17.0,2915.0,13.0,2435.0,2.0,369.0,111.0,7.0,5.0,4,1141,273,26424,4183,335704,362128,11/20/2020
2020-10-09,217,36655,13745,848716,885371,21.0,2936.0,12.0,2447.0,0.0,369.0,120.0,10.0,7.0,3,1144,199,26623,4291,339995,366618,11/20/2020
2020-10-10,229,36884,13832,862548,899432,19.0,2955.0,10.0,2457.0,1.0,370.0,128.0,13.0,7.0,2,1146,194,26817,3766,343761,370578,11/20/2020
2020-10-11,97,36981,3263,865811,902792,12.0,2967.0,9.0,2466.0,1.0,371.0,130.0,14.0,5.0,6,1152,88,26905,1161,344922,371827,11/20/2020
2020-10-12,169,37150,6440,872251,909401,19.0,2986.0,15.0,2481.0,2.0,373.0,132.0,14.0,5.0,4,1156,159,27064,1719,346641,373705,11/20/2020
2020-10-13,213,37363,8521,880772,918135,15.0,3001.0,13.0,2494.0,4.0,377.0,130.0,13.0,5.0,7,1163,207,27271,2294,348935,376206,11/20/2020
2020-10-14,322,37685,15038,895810,933495,17.0,3018.0,7.0,2501.0,0.0,377.0,140.0,15.0,5.0,2,1165,301,27572,4011,352946,380518,11/20/2020
2020-10-15,262,37947,14639,910449,948396,12.0,3030.0,16.0,2517.0,1.0,378.0,135.0,13.0,5.0,2,1167,254,27826,3561,356507,384333,11/20/2020
2020-10-16,279,38226,15011,925460,963686,12.0,3042.0,18.0,2535.0,1.0,379.0,128.0,13.0,4.0,2,1169,275,28101,3364,359871,387972,11/20/2020
2020-10-17,354,38580,14068,939528,978108,19.0,3061.0,11.0,2546.0,1.0,380.0,135.0,17.0,4.0,2,1171,311,28412,3249,363120,391532,11/20/2020
2020-10-18,155,38735,4039,943567,982302,18.0,3079.0,11.0,2557.0,0.0,380.0,142.0,17.0,6.0,2,1173,128,28540,1313,364433,392973,11/20/2020
2020-10-19,388,39123,8491,952058,991181,21.0,3100.0,22.0,2579.0,2.0,382.0,139.0,15.0,6.0,1,1174,325,28865,2550,366983,395848,11/20/2020
2020-10-20,439,39562,13241,965299,1004861,22.0,3122.0,16.0,2595.0,0.0,382.0,145.0,14.0,8.0,3,1177,386,29251,2990,369973,399224,11/20/2020
2020-10-21,544,40106,17462,982761,1022867,21.0,3143.0,8.0,2603.0,2.0,384.0,156.0,15.0,9.0,3,1180,471,29722,3501,373474,403196,11/20/2020
2020-10-22,538,40644,15863,998624,1039268,24.0,3167.0,20.0,2623.0,3.0,387.0,157.0,14.0,9.0,3,1183,489,30211,3178,376652,406863,11/20/2020
2020-10-23,514,41158,16634,1015258,1056416,22.0,3189.0,22.0,2645.0,1.0,388.0,156.0,15.0,9.0,3,1186,460,30671,2868,379520,410191,11/20/2020
2020-10-24,359,41517,10248,1025506,1067023,17.0,3206.0,11.0,2656.0,0.0,388.0,162.0,14.0,8.0,1,1187,338,31009,2255,381775,412784,11/20/2020
2020-10-25,233,41750,4760,1030266,1072016,16.0,3222.0,15.0,2671.0,1.0,389.0,162.0,15.0,8.0,2,1189,210,31219,1456,383231,414450,11/20/2020
2020-10-26,454,42204,9174,1039440,1081644,26.0,3248.0,15.0,2686.0,2.0,391.0,171.0,18.0,8.0,3,1192,403,31622,2962,386193,417815,11/20/2020
2020-10-27,517,42721,13994,1053434,1096155,28.0,3276.0,15.0,2701.0,2.0,393.0,182.0,18.0,9.0,4,1196,453,32075,2376,388569,420644,11/20/2020
2020-10-28,469,43190,15229,1068663,1111853,25.0,3301.0,26.0,2727.0,1.0,394.0,180.0,17.0,9.0,3,1199,409,32484,2689,391258,423742,11/20/2020
2020-10-29,609,43799,16234,1084897,1128696,20.0,3321.0,22.0,2749.0,3.0,397.0,175.0,20.0,11.0,4,1203,529,33013,3113,394371,427384,11/20/2020
2020-10-30,544,44343,14319,1099216,1143559,21.0,3342.0,21.0,2770.0,5.0,402.0,170.0,20.0,9.0,4,1207,466,33479,2935,397306,430785,11/20/2020
2020-10-31,585,44928,11843,1111059,1155987,31.0,3373.0,13.0,2783.0,1.0,403.0,187.0,23.0,9.0,3,1210,488,33967,2407,399713,433680,11/20/2020
2020-11-01,330,45258,5078,1116137,1161395,20.0,3393.0,15.0,2798.0,1.0,404.0,191.0,27.0,12.0,4,1214,273,34240,1257,400970,435210,11/20/2020
2020-11-02,520,45778,9919,1126056,1171834,36.0,3429.0,27.0,2825.0,3.0,407.0,197.0,24.0,11.0,5,1219,453,34693,2918,403888,438581,11/20/2020
2020-11-03,603,46381,13062,1139118,1185499,32.0,3461.0,25.0,2850.0,1.0,408.0,203.0,23.0,11.0,1,1220,527,35220,2512,406400,441620,11/20/2020
2020-11-04,680,47061,16119,1155237,1202298,34.0,3495.0,27.0,2877.0,2.0,410.0,208.0,23.0,11.0,4,1224,625,35845,2922,409322,445167,11/20/2020
2020-11-05,760,47821,18887,1174124,1221945,46.0,3541.0,35.0,2912.0,1.0,411.0,218.0,22.0,13.0,3,1227,673,36518,5152,414474,450992,11/20/2020
2020-11-06,777,48598,17301,1191425,1240023,42.0,3583.0,31.0,2943.0,1.0,412.0,228.0,27.0,16.0,5,1232,700,37218,4323,418797,456015,11/20/2020
2020-11-07,608,49206,13649,1205074,1254280,34.0,3617.0,25.0,2968.0,1.0,413.0,236.0,30.0,17.0,1,1233,579,37797,2466,421263,459060,11/20/2020
2020-11-08,338,49544,4160,1209234,1258778,30.0,3647.0,26.0,2994.0,1.0,414.0,239.0,29.0,18.0,4,1237,322,38119,1282,422545,460664,11/20/2020
2020-11-09,807,50351,9038,1218272,1268623,38.0,3685.0,33.0,3027.0,2.0,416.0,242.0,27.0,17.0,3,1240,760,38879,2314,424859,463738,11/20/2020
2020-11-10,1061,51412,12983,1231255,1282667,45.0,3730.0,37.0,3064.0,0.0,416.0,250.0,30.0,17.0,6,1246,982,39861,2895,427754,467615,11/20/2020
2020-11-11,1088,52500,19742,1250997,1303497,39.0,3769.0,23.0,3087.0,5.0,421.0,261.0,29.0,14.0,6,1252,1004,40865,2701,430455,471320,11/20/2020
2020-11-12,890,53390,13893,1264890,1318280,37.0,3806.0,31.0,3118.0,3.0,424.0,264.0,27.0,14.0,5,1257,810,41675,2214,432669,474344,11/20/2020
2020-11-13,1154,54544,16383,1281273,1335817,33.0,3839.0,31.0,3149.0,0.0,424.0,266.0,25.0,14.0,2,1259,1096,42771,3124,435793,478564,11/20/2020
2020-11-14,780,55324,13153,1294426,1349750,37.0,3876.0,26.0,3175.0,5.0,429.0,272.0,23.0,12.0,10,1269,739,43510,2482,438275,481785,11/20/2020
2020-11-15,574,55898,5880,1300306,1356204,39.0,3915.0,21.0,3196.0,5.0,434.0,285.0,24.0,11.0,7,1276,482,43992,1442,439717,483709,11/20/2020
2020-11-16,729,56627,9289,1309595,1366222,48.0,3963.0,38.0,3234.0,3.0,437.0,292.0,24.0,13.0,5,1281,659,44651,2632,442349,487000,11/20/2020
2020-11-17,1539,58166,17788,1327383,1385549,55.0,4018.0,44.0,3278.0,2.0,439.0,301.0,27.0,12.0,4,1285,1409,46060,4165,446514,492574,11/20/2020
2020-11-18,1117,59283,15601,1342984,1402267,28.0,4046.0,36.0,3314.0,5.0,444.0,288.0,24.0,14.0,7,1292,980,47040,3164,449678,496718,11/20/2020
2020-11-19,1088,60371,12673,1355657,1416028,,,,,,,,,,2,1294,961,48001,3253,452931,500932,11/20/2020
2020-02-27,0,0,0,0,0,1.0,1.0,0.0,0.0,0.0,0.0,1.0,0.0,0.0,0,0,0,0,0,0,0,11/23/2020
2020-02-28,0,0,0,0,0,0.0,1.0,0.0,0.0,0.0,0.0,1.0,1.0,0.0,0,0,0,0,0,0,0,11/23/2020
2020-02-29,0,0,0,0,0,0.0,1.0,0.0,0.0,0.0,0.0,1.0,1.0,0.0,0,0,0,0,0,0,0,11/23/2020
2020-03-01,2,2,2,2,4,0.0,1.0,0.0,0.0,0.0,0.0,1.0,1.0,1.0,0,0,2,2,2,2,4,11/23/2020
2020-03-02,0,2,1,3,5,1.0,2.0,0.0,0.0,0.0,0.0,2.0,2.0,2.0,0,0,0,2,0,2,4,11/23/2020
2020-03-03,0,2,2,5,7,0.0,2.0,0.0,0.0,0.0,0.0,2.0,2.0,2.0,0,0,0,2,1,3,5,11/23/2020
2020-03-04,0,2,12,17,19,1.0,3.0,0.0,0.0,0.0,0.0,3.0,2.0,2.0,0,0,0,2,10,13,15,11/23/2020
2020-03-05,0,2,4,21,23,0.0,3.0,0.0,0.0,0.0,0.0,3.0,2.0,2.0,0,0,1,3,4,17,20,11/23/2020
2020-03-06,1,3,12,33,36,0.0,3.0,0.0,0.0,0.0,0.0,3.0,2.0,2.0,0,0,0,3,11,28,31,11/23/2020
2020-03-07,0,3,19,52,55,0.0,3.0,0.0,0.0,0.0,0.0,3.0,2.0,1.0,0,0,0,3,19,47,50,11/23/2020
2020-03-08,0,3,18,70,73,0.0,3.0,0.0,0.0,0.0,0.0,3.0,2.0,1.0,0,0,0,3,18,65,68,11/23/2020
2020-03-09,1,4,15,85,89,0.0,3.0,0.0,0.0,0.0,0.0,3.0,2.0,1.0,0,0,1,4,14,79,83,11/23/2020
2020-03-10,2,6,25,110,116,0.0,3.0,0.0,0.0,0.0,0.0,3.0,2.0,1.0,0,0,1,5,23,102,107,11/23/2020
2020-03-11,0,6,34,144,150,1.0,4.0,0.0,0.0,0.0,0.0,4.0,1.0,1.0,0,0,0,5,34,136,141,11/23/2020
2020-03-12,9,15,41,185,200,1.0,5.0,0.0,0.0,0.0,0.0,5.0,1.0,1.0,0,0,8,13,38,174,187,11/23/2020
2020-03-13,6,21,50,235,256,4.0,9.0,1.0,1.0,0.0,0.0,8.0,1.0,1.0,0,0,6,19,47,221,240,11/23/2020
2020-03-14,0,21,90,325,346,0.0,9.0,0.0,1.0,0.0,0.0,8.0,1.0,1.0,0,0,0,19,83,304,323,11/23/2020
2020-03-15,1,22,54,379,401,1.0,10.0,0.0,1.0,0.0,0.0,9.0,2.0,1.0,0,0,1,20,53,357,377,11/23/2020
2020-03-16,2,24,95,474,498,2.0,12.0,0.0,1.0,0.0,0.0,11.0,2.0,0.0,0,0,2,22,91,448,470,11/23/2020
2020-03-17,12,36,162,636,672,6.0,18.0,0.0,1.0,0.0,0.0,17.0,2.0,0.0,0,0,11,33,147,595,628,11/23/2020
2020-03-18,9,45,116,752,797,3.0,21.0,0.0,1.0,0.0,0.0,20.0,2.0,0.0,0,0,11,44,108,703,747,11/23/2020
2020-03-19,15,60,262,1014,1074,2.0,23.0,1.0,2.0,0.0,0.0,21.0,3.0,0.0,1,1,17,61,246,949,1010,11/23/2020
2020-03-20,13,73,197,1211,1284,5.0,28.0,0.0,2.0,0.0,0.0,26.0,4.0,0.0,0,1,13,74,186,1135,1209,11/23/2020
2020-03-21,12,85,126,1337,1422,3.0,31.0,2.0,4.0,0.0,0.0,27.0,5.0,0.0,0,1,14,88,121,1256,1344,11/23/2020
2020-03-22,27,112,282,1619,1731,2.0,33.0,0.0,4.0,0.0,0.0,29.0,5.0,0.0,0,1,25,113,256,1512,1625,11/23/2020
2020-03-23,14,126,169,1788,1914,15.0,48.0,1.0,5.0,0.0,0.0,43.0,9.0,3.0,0,1,16,129,160,1672,1801,11/23/2020
2020-03-24,20,146,242,2030,2176,8.0,56.0,0.0,5.0,0.0,0.0,51.0,10.0,5.0,0,1,19,148,227,1899,2047,11/23/2020
2020-03-25,26,172,182,2212,2384,5.0,61.0,2.0,7.0,0.0,0.0,54.0,11.0,3.0,0,1,28,176,161,2060,2236,11/23/2020
2020-03-26,35,207,181,2393,2600,9.0,70.0,5.0,12.0,0.0,0.0,58.0,14.0,5.0,0,1,41,217,168,2228,2445,11/23/2020
2020-03-27,27,234,214,2607,2841,9.0,79.0,1.0,13.0,1.0,1.0,65.0,16.0,6.0,2,3,31,248,191,2419,2667,11/23/2020
2020-03-28,59,293,260,2867,3160,11.0,90.0,2.0,15.0,1.0,2.0,73.0,15.0,6.0,1,4,64,312,239,2658,2970,11/23/2020
2020-03-29,100,393,350,3217,3610,8.0,98.0,3.0,18.0,1.0,3.0,77.0,18.0,8.0,2,6,105,417,309,2967,3384,11/23/2020
2020-03-30,62,455,222,3439,3894,19.0,117.0,5.0,23.0,0.0,3.0,91.0,19.0,11.0,3,9,78,495,180,3147,3642,11/23/2020
2020-03-31,71,526,369,3808,4334,11.0,128.0,7.0,30.0,1.0,4.0,94.0,21.0,13.0,2,11,73,568,293,3440,4008,11/23/2020
2020-04-01,99,625,698,4506,5131,18.0,146.0,7.0,37.0,0.0,4.0,105.0,29.0,15.0,1,12,100,668,616,4056,4724,11/23/2020
2020-04-02,52,677,477,4983,5660,22.0,168.0,6.0,43.0,2.0,6.0,119.0,35.0,21.0,4,16,62,730,421,4477,5207,11/23/2020
2020-04-03,108,785,774,5757,6542,23.0,191.0,7.0,50.0,0.0,6.0,135.0,42.0,25.0,3,19,100,830,684,5161,5991,11/23/2020
2020-04-04,143,928,660,6417,7345,22.0,213.0,4.0,54.0,5.0,11.0,148.0,40.0,29.0,9,28,138,968,594,5755,6723,11/23/2020
2020-04-05,187,1115,1156,7573,8688,20.0,233.0,9.0,63.0,1.0,12.0,158.0,43.0,35.0,2,30,181,1149,1019,6774,7923,11/23/2020
2020-04-06,218,1333,1706,9279,10612,26.0,259.0,7.0,70.0,0.0,12.0,177.0,47.0,39.0,7,37,207,1356,1499,8273,9629,11/23/2020
2020-04-07,284,1617,1629,10908,12525,20.0,279.0,4.0,74.0,2.0,14.0,191.0,49.0,41.0,5,42,261,1617,1442,9715,11332,11/23/2020
2020-04-08,290,1907,1720,12628,14535,19.0,298.0,8.0,82.0,5.0,19.0,197.0,49.0,37.0,10,52,271,1888,1503,11218,13106,11/23/2020
2020-04-09,283,2190,1516,14144,16334,32.0,330.0,8.0,90.0,4.0,23.0,217.0,53.0,40.0,7,59,277,2165,1312,12530,14695,11/23/2020
2020-04-10,419,2609,2574,16718,19327,29.0,359.0,17.0,107.0,5.0,28.0,224.0,59.0,41.0,11,70,400,2565,2286,14816,17381,11/23/2020
2020-04-11,297,2906,1905,18623,21529,29.0,388.0,11.0,118.0,2.0,30.0,240.0,61.0,48.0,12,82,281,2846,1667,16483,19329,11/23/2020
2020-04-12,314,3220,1670,20293,23513,35.0,423.0,13.0,131.0,5.0,35.0,257.0,59.0,49.0,9,91,286,3132,1376,17859,20991,11/23/2020
2020-04-13,161,3381,935,21228,24609,35.0,458.0,13.0,144.0,3.0,38.0,276.0,64.0,54.0,9,100,187,3319,816,18675,21994,11/23/2020
2020-04-14,289,3670,1787,23015,26685,27.0,485.0,18.0,162.0,5.0,43.0,280.0,72.0,53.0,8,108,262,3581,1470,20145,23726,11/23/2020
2020-04-15,351,4021,1799,24814,28835,31.0,516.0,20.0,182.0,3.0,46.0,288.0,72.0,54.0,17,125,306,3887,1479,21624,25511,11/23/2020
2020-04-16,447,4468,2494,27308,31776,36.0,552.0,25.0,207.0,6.0,52.0,293.0,72.0,53.0,14,139,387,4274,1986,23610,27884,11/23/2020
2020-04-17,304,4772,1821,29129,33901,32.0,584.0,20.0,227.0,7.0,59.0,298.0,66.0,45.0,21,160,290,4564,1392,25002,29566,11/23/2020
2020-04-18,321,5093,1725,30854,35947,26.0,610.0,18.0,245.0,4.0,63.0,302.0,63.0,49.0,15,175,284,4848,1276,26278,31126,11/23/2020
2020-04-19,381,5474,2047,32901,38375,23.0,633.0,26.0,271.0,1.0,64.0,298.0,65.0,55.0,11,186,337,5185,1680,27958,33143,11/23/2020
2020-04-20,394,5868,1907,34808,40676,46.0,679.0,29.0,300.0,2.0,66.0,313.0,75.0,56.0,10,196,376,5561,1532,29490,35051,11/23/2020
2020-04-21,444,6312,2110,36918,43230,45.0,724.0,32.0,332.0,5.0,71.0,321.0,72.0,56.0,18,214,383,5944,1653,31143,37087,11/23/2020
2020-04-22,418,6730,2390,39308,46038,41.0,765.0,32.0,364.0,5.0,76.0,325.0,73.0,58.0,18,232,379,6323,1852,32995,39318,11/23/2020
2020-04-23,479,7209,2469,41777,48986,32.0,797.0,28.0,392.0,5.0,81.0,324.0,76.0,62.0,15,247,412,6735,1798,34793,41528,11/23/2020
2020-04-24,491,7700,3284,45061,52761,35.0,832.0,26.0,418.0,4.0,85.0,329.0,85.0,63.0,15,262,407,7142,2533,37326,44468,11/23/2020
2020-04-25,393,8093,2206,47267,55360,34.0,866.0,17.0,435.0,5.0,90.0,341.0,85.0,62.0,14,276,299,7441,1701,39027,46468,11/23/2020
2020-04-26,316,8409,2309,49576,57985,33.0,899.0,15.0,450.0,3.0,93.0,356.0,86.0,59.0,14,290,274,7715,1808,40835,48550,11/23/2020
2020-04-27,249,8658,1620,51196,59854,29.0,928.0,21.0,471.0,4.0,97.0,360.0,86.0,61.0,10,300,206,7921,1110,41945,49866,11/23/2020
2020-04-28,410,9068,2263,53459,62527,44.0,972.0,24.0,495.0,3.0,100.0,377.0,88.0,59.0,22,322,332,8253,1650,43595,51848,11/23/2020
2020-04-29,476,9544,3343,56802,66346,36.0,1008.0,38.0,533.0,11.0,111.0,364.0,78.0,53.0,18,340,370,8623,2303,45898,54521,11/23/2020
2020-04-30,432,9976,2769,59571,69547,33.0,1041.0,38.0,571.0,6.0,117.0,353.0,83.0,57.0,24,364,350,8973,1820,47718,56691,11/23/2020
2020-05-01,454,10430,3086,62657,73087,52.0,1093.0,39.0,610.0,3.0,120.0,363.0,84.0,58.0,14,378,323,9296,2045,49763,59059,11/23/2020
2020-05-02,257,10687,1926,64583,75270,36.0,1129.0,38.0,648.0,5.0,125.0,356.0,93.0,63.0,24,402,192,9488,1233,50996,60484,11/23/2020
2020-05-03,283,10970,2160,66743,77713,31.0,1160.0,26.0,674.0,8.0,133.0,353.0,91.0,61.0,21,423,183,9671,1503,52499,62170,11/23/2020
2020-05-04,387,11357,2098,68841,80198,30.0,1190.0,31.0,705.0,6.0,139.0,346.0,89.0,58.0,18,441,290,9961,1510,54009,63970,11/23/2020
2020-05-05,433,11790,2873,71714,83504,29.0,1219.0,32.0,737.0,6.0,145.0,337.0,83.0,55.0,16,457,300,10261,1888,55897,66158,11/23/2020
2020-05-06,488,12278,2830,74544,86822,28.0,1247.0,44.0,781.0,9.0,154.0,312.0,80.0,55.0,21,478,340,10601,1858,57755,68356,11/23/2020
2020-05-07,425,12703,2969,77513,90216,36.0,1283.0,44.0,825.0,5.0,159.0,299.0,72.0,53.0,21,499,269,10870,1896,59651,70521,11/23/2020
2020-05-08,359,13062,2598,80111,93173,30.0,1313.0,29.0,854.0,5.0,164.0,295.0,72.0,54.0,22,521,229,11099,1674,61325,72424,11/23/2020
2020-05-09,467,13529,3346,83457,96986,22.0,1335.0,21.0,875.0,4.0,168.0,292.0,70.0,52.0,15,536,290,11389,2171,63496,74885,11/23/2020
2020-05-10,285,13814,2117,85574,99388,20.0,1355.0,23.0,898.0,6.0,174.0,283.0,71.0,50.0,14,550,189,11578,1458,64954,76532,11/23/2020
2020-05-11,257,14071,1857,87431,101502,31.0,1386.0,16.0,914.0,6.0,180.0,292.0,72.0,50.0,15,565,174,11752,1252,66206,77958,11/23/2020
2020-05-12,387,14458,2611,90042,104500,23.0,1409.0,18.0,932.0,4.0,184.0,293.0,70.0,49.0,22,587,224,11976,1611,67817,79793,11/23/2020
2020-05-13,351,14809,3630,93672,108481,23.0,1432.0,25.0,957.0,1.0,185.0,290.0,70.0,50.0,13,600,199,12175,1880,69697,81872,11/23/2020
2020-05-14,329,15138,3408,97080,112218,19.0,1451.0,27.0,984.0,3.0,188.0,279.0,65.0,46.0,15,615,232,12407,1911,71608,84015,11/23/2020
2020-05-15,381,15519,3458,100538,116057,24.0,1475.0,41.0,1025.0,5.0,193.0,257.0,63.0,46.0,14,629,232,12639,1752,73360,85999,11/23/2020
2020-05-16,449,15968,4156,104694,120662,25.0,1500.0,15.0,1040.0,5.0,198.0,262.0,62.0,47.0,15,644,247,12886,1876,75236,88122,11/23/2020
2020-05-17,240,16208,2768,107462,123670,17.0,1517.0,9.0,1049.0,5.0,203.0,265.0,60.0,46.0,10,654,126,13012,1495,76731,89743,11/23/2020
2020-05-18,250,16458,2001,109463,125921,19.0,1536.0,16.0,1065.0,5.0,208.0,263.0,58.0,41.0,18,672,135,13147,1325,78056,91203,11/23/2020
2020-05-19,415,16873,3168,112631,129504,23.0,1559.0,33.0,1098.0,5.0,213.0,248.0,57.0,39.0,11,683,215,13362,1881,79937,93299,11/23/2020
2020-05-20,326,17199,2771,115402,132601,19.0,1578.0,23.0,1121.0,7.0,220.0,237.0,53.0,34.0,22,705,184,13546,1489,81426,94972,11/23/2020
2020-05-21,374,17573,3757,119159,136732,25.0,1603.0,15.0,1136.0,3.0,223.0,244.0,54.0,30.0,20,725,168,13714,1887,83313,97027,11/23/2020
2020-05-22,351,17924,3161,122320,140244,20.0,1623.0,28.0,1164.0,5.0,228.0,231.0,53.0,30.0,11,736,206,13920,1557,84870,98790,11/23/2020
2020-05-23,253,18177,2742,125062,143239,19.0,1642.0,11.0,1175.0,3.0,231.0,236.0,53.0,33.0,13,749,109,14029,1237,86107,100136,11/23/2020
2020-05-24,163,18340,1370,126432,144772,13.0,1655.0,14.0,1189.0,2.0,233.0,233.0,54.0,36.0,8,757,83,14112,757,86864,100976,11/23/2020
2020-05-25,147,18487,1385,127817,146304,14.0,1669.0,14.0,1203.0,0.0,233.0,233.0,54.0,34.0,10,767,76,14188,726,87590,101778,11/23/2020
2020-05-26,285,18772,2620,130437,149209,24.0,1693.0,21.0,1224.0,5.0,238.0,231.0,49.0,33.0,15,782,158,14346,1659,89249,103595,11/23/2020
2020-05-27,276,19048,2057,132494,151542,20.0,1713.0,18.0,1242.0,3.0,241.0,230.0,51.0,33.0,10,792,132,14478,1111,90360,104838,11/23/2020
2020-05-28,348,19396,3359,135853,155249,17.0,1730.0,29.0,1271.0,4.0,245.0,214.0,47.0,32.0,8,800,130,14608,1092,91452,106060,11/23/2020
2020-05-29,410,19806,3915,139768,159574,19.0,1749.0,26.0,1297.0,7.0,252.0,200.0,43.0,31.0,12,812,174,14782,1518,92970,107752,11/23/2020
2020-05-30,225,20031,3915,143683,163714,16.0,1765.0,19.0,1316.0,4.0,256.0,193.0,41.0,29.0,12,824,109,14891,1717,94687,109578,11/23/2020
2020-05-31,155,20186,1690,145373,165559,11.0,1776.0,11.0,1327.0,1.0,257.0,192.0,44.0,26.0,3,827,78,14969,819,95506,110475,11/23/2020
2020-06-01,212,20398,2792,148165,168563,8.0,1784.0,14.0,1341.0,1.0,258.0,185.0,45.0,29.0,5,832,93,15062,1345,96851,111913,11/23/2020
2020-06-02,273,20671,3022,151187,171858,8.0,1792.0,9.0,1350.0,3.0,261.0,181.0,38.0,25.0,10,842,98,15160,1398,98249,113409,11/23/2020
2020-06-03,254,20925,3486,154673,175598,14.0,1806.0,18.0,1368.0,6.0,267.0,171.0,34.0,25.0,11,853,99,15259,1618,99867,115126,11/23/2020
2020-06-04,276,21201,4471,159144,180345,7.0,1813.0,26.0,1394.0,4.0,271.0,148.0,31.0,24.0,12,865,107,15366,1971,101838,117204,11/23/2020
2020-06-05,215,21416,3513,162657,184073,15.0,1828.0,13.0,1407.0,6.0,277.0,144.0,27.0,21.0,11,876,99,15465,1510,103348,118813,11/23/2020
2020-06-06,201,21617,2616,165273,186890,10.0,1838.0,7.0,1414.0,2.0,279.0,145.0,29.0,19.0,6,882,67,15532,1090,104438,119970,11/23/2020
2020-06-07,83,21700,1625,166898,188598,11.0,1849.0,7.0,1421.0,1.0,280.0,148.0,25.0,17.0,4,886,51,15583,773,105211,120794,11/23/2020
2020-06-08,119,21819,1849,168747,190566,15.0,1864.0,13.0,1434.0,2.0,282.0,148.0,27.0,18.0,4,890,45,15628,931,106142,121770,11/23/2020
2020-06-09,223,22042,2673,171420,193462,10.0,1874.0,19.0,1453.0,0.0,282.0,139.0,28.0,21.0,1,891,64,15692,1230,107372,123064,11/23/2020
2020-06-10,209,22251,2987,174407,196658,13.0,1887.0,12.0,1465.0,2.0,284.0,138.0,24.0,17.0,4,895,100,15792,1433,108805,124597,11/23/2020
2020-06-11,195,22446,3513,177920,200366,7.0,1894.0,15.0,1480.0,1.0,285.0,129.0,25.0,16.0,6,901,88,15880,1497,110302,126182,11/23/2020
2020-06-12,209,22655,4601,182521,205176,9.0,1903.0,16.0,1496.0,1.0,286.0,121.0,24.0,16.0,2,903,78,15958,2127,112429,128387,11/23/2020
2020-06-13,113,22768,3036,185557,208325,6.0,1909.0,5.0,1501.0,0.0,286.0,122.0,20.0,15.0,3,906,49,16007,1343,113772,129779,11/23/2020
2020-06-14,81,22849,2046,187603,210452,7.0,1916.0,8.0,1509.0,1.0,287.0,120.0,20.0,14.0,3,909,33,16040,948,114720,130760,11/23/2020
2020-06-15,188,23037,3108,190711,213748,14.0,1930.0,19.0,1528.0,0.0,287.0,115.0,20.0,16.0,5,914,75,16115,1744,116464,132579,11/23/2020
2020-06-16,110,23147,3017,193728,216875,11.0,1941.0,9.0,1537.0,1.0,288.0,116.0,22.0,16.0,8,922,50,16165,1506,117970,134135,11/23/2020
2020-06-17,127,23274,2835,196563,219837,15.0,1956.0,20.0,1557.0,4.0,292.0,107.0,18.0,14.0,6,928,51,16216,1285,119255,135471,11/23/2020
2020-06-18,149,23423,3048,199611,223034,9.0,1965.0,15.0,1572.0,1.0,293.0,100.0,19.0,16.0,7,935,70,16286,1289,120544,136830,11/23/2020
2020-06-19,141,23564,3769,203380,226944,12.0,1977.0,12.0,1584.0,1.0,294.0,99.0,20.0,17.0,3,938,59,16345,1327,121871,138216,11/23/2020
2020-06-20,84,23648,1891,205271,228919,9.0,1986.0,12.0,1596.0,0.0,294.0,96.0,20.0,18.0,4,942,36,16381,804,122675,139056,11/23/2020
2020-06-21,37,23685,1064,206335,230020,8.0,1994.0,5.0,1601.0,0.0,294.0,99.0,20.0,18.0,2,944,30,16411,678,123353,139764,11/23/2020
2020-06-22,138,23823,3730,210065,233888,12.0,2006.0,17.0,1618.0,0.0,294.0,94.0,19.0,18.0,2,946,65,16476,1672,125025,141501,11/23/2020
2020-06-23,163,23986,3831,213896,237882,3.0,2009.0,13.0,1631.0,3.0,297.0,81.0,18.0,18.0,7,953,81,16557,1747,126772,143329,11/23/2020
2020-06-24,120,24106,3502,217398,241504,9.0,2018.0,10.0,1641.0,1.0,298.0,79.0,18.0,18.0,5,958,44,16601,1653,128425,145026,11/23/2020
2020-06-25,103,24209,2883,220281,244490,6.0,2024.0,14.0,1655.0,1.0,299.0,70.0,17.0,17.0,1,959,50,16651,1471,129896,146547,11/23/2020
2020-06-26,94,24303,2488,222769,247072,2.0,2026.0,10.0,1665.0,0.0,299.0,62.0,18.0,18.0,1,960,60,16711,1303,131199,147910,11/23/2020
2020-06-27,84,24387,3216,225985,250372,5.0,2031.0,3.0,1668.0,1.0,300.0,63.0,17.0,17.0,5,965,37,16748,1185,132384,149132,11/23/2020
2020-06-28,39,24426,1469,227454,251880,4.0,2035.0,4.0,1672.0,4.0,304.0,59.0,15.0,14.0,6,971,17,16765,583,132967,149732,11/23/2020
2020-06-29,85,24511,3697,231151,255662,4.0,2039.0,5.0,1677.0,0.0,304.0,58.0,14.0,14.0,1,972,39,16804,1330,134297,151101,11/23/2020
2020-06-30,57,24568,1958,233109,257677,1.0,2040.0,5.0,1682.0,1.0,305.0,53.0,12.0,11.0,4,976,33,16837,979,135276,152113,11/23/2020
2020-07-01,144,24712,4098,237207,261919,8.0,2048.0,10.0,1692.0,0.0,305.0,51.0,11.0,11.0,1,977,79,16916,1890,137166,154082,11/23/2020
2020-07-02,103,24815,2803,240010,264825,5.0,2053.0,5.0,1697.0,1.0,306.0,50.0,10.0,10.0,3,980,59,16975,1061,138227,155202,11/23/2020
2020-07-03,50,24865,2079,242089,266954,9.0,2062.0,6.0,1703.0,0.0,306.0,53.0,9.0,9.0,3,983,25,17000,772,138999,155999,11/23/2020
2020-07-04,57,24922,2345,244434,269356,2.0,2064.0,4.0,1707.0,1.0,307.0,50.0,10.0,9.0,2,985,33,17033,982,139981,157014,11/23/2020
2020-07-05,49,24971,2932,247366,272337,1.0,2065.0,2.0,1709.0,1.0,308.0,48.0,8.0,8.0,2,987,26,17059,1401,141382,158441,11/23/2020
2020-07-06,101,25072,2814,250180,275252,6.0,2071.0,6.0,1715.0,0.0,308.0,48.0,9.0,9.0,4,991,57,17116,1522,142904,160020,11/23/2020
2020-07-07,81,25153,3457,253637,278790,5.0,2076.0,7.0,1722.0,0.0,308.0,46.0,8.0,8.0,2,993,47,17163,1513,144417,161580,11/23/2020
2020-07-08,105,25258,3409,257046,282304,4.0,2080.0,2.0,1724.0,0.0,308.0,48.0,9.0,8.0,0,993,64,17227,1381,145798,163025,11/23/2020
2020-07-09,94,25352,3714,260760,286112,9.0,2089.0,3.0,1727.0,0.0,308.0,54.0,9.0,8.0,0,993,50,17277,1583,147381,164658,11/23/2020
2020-07-10,132,25484,4437,265197,290681,6.0,2095.0,3.0,1730.0,2.0,310.0,55.0,7.0,7.0,3,996,80,17357,2030,149411,166768,11/23/2020
2020-07-11,63,25547,2938,268135,293682,6.0,2101.0,3.0,1733.0,1.0,311.0,57.0,6.0,6.0,3,999,36,17393,1294,150705,168098,11/23/2020
2020-07-12,47,25594,1838,269973,295567,1.0,2102.0,3.0,1736.0,1.0,312.0,54.0,6.0,5.0,3,1002,34,17427,928,151633,169060,11/23/2020
2020-07-13,84,25678,3209,273182,298860,8.0,2110.0,10.0,1746.0,0.0,312.0,52.0,6.0,5.0,1,1003,61,17488,1475,153108,170596,11/23/2020
2020-07-14,74,25752,3298,276480,302232,7.0,2117.0,4.0,1750.0,0.0,312.0,55.0,5.0,5.0,1,1004,44,17532,1358,154466,171998,11/23/2020
2020-07-15,130,25882,4181,280661,306543,5.0,2122.0,7.0,1757.0,0.0,312.0,53.0,5.0,4.0,0,1004,100,17632,1717,156183,173815,11/23/2020
2020-07-16,103,25985,3740,284401,310386,6.0,2128.0,9.0,1766.0,0.0,312.0,50.0,6.0,5.0,1,1005,76,17708,1586,157769,175477,11/23/2020
2020-07-17,156,26141,4239,288640,314781,14.0,2142.0,3.0,1769.0,1.0,313.0,60.0,5.0,5.0,2,1007,79,17787,1812,159581,177368,11/23/2020
2020-07-18,85,26226,3272,291912,318138,5.0,2147.0,9.0,1778.0,1.0,314.0,55.0,5.0,4.0,4,1011,70,17857,1372,160953,178810,11/23/2020
2020-07-19,82,26308,2696,294608,320916,7.0,2154.0,3.0,1781.0,0.0,314.0,59.0,6.0,4.0,2,1013,57,17914,1128,162081,179995,11/23/2020
2020-07-20,71,26379,2666,297274,323653,9.0,2163.0,7.0,1788.0,0.0,314.0,61.0,7.0,5.0,2,1015,68,17982,1430,163511,181493,11/23/2020
2020-07-21,130,26509,4304,301578,328087,9.0,2172.0,11.0,1799.0,0.0,314.0,59.0,9.0,6.0,1,1016,108,18090,1890,165401,183491,11/23/2020
2020-07-22,130,26639,3928,305506,332145,7.0,2179.0,8.0,1807.0,1.0,315.0,57.0,7.0,6.0,1,1017,86,18176,1643,167044,185220,11/23/2020
2020-07-23,141,26780,4415,309921,336701,8.0,2187.0,6.0,1813.0,0.0,315.0,59.0,8.0,7.0,0,1017,115,18291,1933,168977,187268,11/23/2020
2020-07-24,172,26952,5966,315887,342839,15.0,2202.0,12.0,1825.0,0.0,315.0,62.0,9.0,7.0,0,1017,119,18410,2263,171240,189650,11/23/2020
2020-07-25,134,27086,4398,320285,347371,7.0,2209.0,7.0,1832.0,0.0,315.0,62.0,10.0,8.0,3,1020,108,18518,2060,173300,191818,11/23/2020
2020-07-26,62,27148,3033,323318,350466,8.0,2217.0,9.0,1841.0,0.0,315.0,61.0,11.0,7.0,1,1021,54,18572,1317,174617,193189,11/23/2020
2020-07-27,188,27336,4191,327509,354845,12.0,2229.0,7.0,1848.0,0.0,315.0,66.0,13.0,8.0,1,1022,138,18710,2300,176917,195627,11/23/2020
2020-07-28,105,27441,3840,331349,358790,5.0,2234.0,5.0,1853.0,0.0,315.0,66.0,14.0,7.0,1,1023,95,18805,1605,178522,197327,11/23/2020
2020-07-29,190,27631,5139,336488,364119,9.0,2243.0,10.0,1863.0,0.0,315.0,65.0,15.0,7.0,0,1023,154,18959,2262,180784,199743,11/23/2020
2020-07-30,121,27752,4345,340833,368585,6.0,2249.0,2.0,1865.0,1.0,316.0,68.0,15.0,6.0,1,1024,97,19056,1608,182392,201448,11/23/2020
2020-07-31,131,27883,5512,346345,374228,7.0,2256.0,9.0,1874.0,0.0,316.0,66.0,15.0,7.0,1,1025,89,19145,1808,184200,203345,11/23/2020
2020-08-01,109,27992,4294,350639,378631,7.0,2263.0,2.0,1876.0,0.0,316.0,71.0,14.0,7.0,1,1026,89,19234,1530,185730,204964,11/23/2020
2020-08-02,84,28076,2804,353443,381519,12.0,2275.0,12.0,1888.0,2.0,318.0,69.0,14.0,8.0,2,1028,62,19296,1248,186978,206274,11/23/2020
2020-08-03,188,28264,5248,358691,386955,11.0,2286.0,10.0,1898.0,0.0,318.0,70.0,16.0,7.0,1,1029,150,19446,2167,189145,208591,11/23/2020
2020-08-04,125,28389,3691,362382,390771,8.0,2294.0,5.0,1903.0,1.0,319.0,72.0,12.0,5.0,2,1031,99,19545,1742,190887,210432,11/23/2020
2020-08-05,147,28536,5935,368317,396853,11.0,2305.0,9.0,1912.0,1.0,320.0,73.0,10.0,5.0,2,1033,119,19664,2420,193307,212971,11/23/2020
2020-08-06,169,28705,5546,373863,402568,7.0,2312.0,9.0,1921.0,0.0,320.0,71.0,9.0,4.0,0,1033,120,19784,2351,195658,215442,11/23/2020
2020-08-07,123,28828,4851,378714,407542,12.0,2324.0,9.0,1930.0,1.0,321.0,73.0,9.0,3.0,2,1035,87,19871,2101,197759,217630,11/23/2020
2020-08-08,123,28951,4112,382826,411777,19.0,2343.0,6.0,1936.0,1.0,322.0,85.0,8.0,3.0,1,1036,91,19962,1756,199515,219477,11/23/2020
2020-08-09,42,28993,1727,384553,413546,6.0,2349.0,8.0,1944.0,0.0,322.0,83.0,9.0,4.0,0,1036,35,19997,1053,200568,220565,11/23/2020
2020-08-10,149,29142,4587,389140,418282,8.0,2357.0,9.0,1953.0,0.0,322.0,82.0,9.0,4.0,1,1037,113,20110,1988,202556,222666,11/23/2020
2020-08-11,106,29248,4334,393474,422722,5.0,2362.0,13.0,1966.0,0.0,322.0,74.0,10.0,4.0,3,1040,92,20202,2229,204785,224987,11/23/2020
2020-08-12,121,29369,5188,398662,428031,8.0,2370.0,11.0,1977.0,0.0,322.0,71.0,9.0,3.0,1,1041,101,20303,2574,207359,227662,11/23/2020
2020-08-13,135,29504,4196,402858,432362,13.0,2383.0,12.0,1989.0,0.0,322.0,72.0,11.0,3.0,0,1041,95,20398,1875,209234,229632,11/23/2020
2020-08-14,145,29649,5498,408356,438005,13.0,2396.0,11.0,2000.0,0.0,322.0,74.0,11.0,4.0,3,1044,98,20496,1944,211178,231674,11/23/2020
2020-08-15,106,29755,4534,412890,442645,9.0,2405.0,11.0,2011.0,1.0,323.0,71.0,11.0,5.0,0,1044,88,20584,1656,212834,233418,11/23/2020
2020-08-16,83,29838,2477,415367,445205,6.0,2411.0,5.0,2016.0,4.0,327.0,68.0,8.0,4.0,6,1050,70,20654,939,213773,234427,11/23/2020
2020-08-17,106,29944,4575,419942,449886,8.0,2419.0,6.0,2022.0,0.0,327.0,70.0,8.0,5.0,2,1052,87,20741,2348,216121,236862,11/23/2020
2020-08-18,128,30072,4911,424853,454925,11.0,2430.0,8.0,2030.0,1.0,328.0,72.0,8.0,4.0,5,1057,94,20835,2701,218822,239657,11/23/2020
2020-08-19,113,30185,5077,429930,460115,8.0,2438.0,9.0,2039.0,1.0,329.0,70.0,9.0,5.0,0,1057,90,20925,2589,221411,242336,11/23/2020
2020-08-20,173,30358,7411,437341,467699,12.0,2450.0,6.0,2045.0,2.0,331.0,74.0,10.0,5.0,3,1060,139,21064,3464,224875,245939,11/23/2020
2020-08-21,152,30510,6577,443918,474428,8.0,2458.0,5.0,2050.0,1.0,332.0,76.0,9.0,4.0,2,1062,125,21189,2887,227762,248951,11/23/2020
2020-08-22,96,30606,5550,449468,480074,11.0,2469.0,12.0,2062.0,0.0,332.0,75.0,11.0,4.0,1,1063,84,21273,2556,230318,251591,11/23/2020
2020-08-23,72,30678,4375,453843,484521,11.0,2480.0,6.0,2068.0,0.0,332.0,80.0,12.0,2.0,1,1064,56,21329,2441,232759,254088,11/23/2020
2020-08-24,105,30783,5784,459627,490410,7.0,2487.0,10.0,2078.0,1.0,333.0,76.0,14.0,4.0,1,1065,77,21406,3096,235855,257261,11/23/2020
2020-08-25,108,30891,4764,464391,495282,10.0,2497.0,4.0,2082.0,1.0,334.0,81.0,12.0,4.0,1,1066,92,21498,2260,238115,259613,11/23/2020
2020-08-26,170,31061,9482,473873,504934,4.0,2501.0,8.0,2090.0,0.0,334.0,77.0,10.0,5.0,1,1067,128,21626,3047,241162,262788,11/23/2020
2020-08-27,91,31152,8565,482438,513590,6.0,2507.0,13.0,2103.0,1.0,335.0,69.0,7.0,5.0,2,1069,70,21696,3099,244261,265957,11/23/2020
2020-08-28,113,31265,7994,490432,521697,14.0,2521.0,4.0,2107.0,0.0,335.0,79.0,10.0,7.0,2,1071,87,21783,2395,246656,268439,11/23/2020
2020-08-29,65,31330,5374,495806,527136,6.0,2527.0,8.0,2115.0,1.0,336.0,76.0,11.0,6.0,2,1073,51,21834,1893,248549,270383,11/23/2020
2020-08-30,66,31396,4323,500129,531525,7.0,2534.0,4.0,2119.0,0.0,336.0,79.0,9.0,5.0,2,1075,48,21882,1954,250503,272385,11/23/2020
2020-08-31,105,31501,4863,504992,536493,12.0,2546.0,16.0,2135.0,0.0,336.0,75.0,8.0,4.0,1,1076,81,21963,2156,252659,274622,11/23/2020
2020-09-01,98,31599,7109,512101,543700,6.0,2552.0,9.0,2144.0,1.0,337.0,71.0,7.0,4.0,2,1078,66,22029,2342,255001,277030,11/23/2020
2020-09-02,125,31724,10529,522630,554354,9.0,2561.0,10.0,2154.0,1.0,338.0,69.0,8.0,4.0,2,1080,104,22133,3004,258005,280138,11/23/2020
2020-09-03,90,31814,11080,533710,565524,8.0,2569.0,8.0,2162.0,0.0,338.0,69.0,9.0,4.0,3,1083,73,22206,2540,260545,282751,11/23/2020
2020-09-04,103,31917,8963,542673,574590,11.0,2580.0,4.0,2166.0,0.0,338.0,76.0,9.0,4.0,1,1084,83,22289,2336,262881,285170,11/23/2020
2020-09-05,52,31969,6309,548982,580951,6.0,2586.0,9.0,2175.0,0.0,338.0,73.0,8.0,3.0,1,1085,42,22331,1573,264454,286785,11/23/2020
2020-09-06,88,32057,4325,553307,585364,4.0,2590.0,8.0,2183.0,1.0,339.0,68.0,6.0,3.0,1,1086,65,22396,1918,266372,288768,11/23/2020
2020-09-07,35,32092,3002,556309,588401,11.0,2601.0,3.0,2186.0,0.0,339.0,76.0,5.0,3.0,1,1087,26,22422,632,267004,289426,11/23/2020
2020-09-08,74,32166,6381,562690,594856,6.0,2607.0,12.0,2198.0,1.0,340.0,69.0,6.0,3.0,2,1089,66,22488,1569,268573,291061,11/23/2020
2020-09-09,118,32284,8650,571340,603624,10.0,2617.0,5.0,2203.0,1.0,341.0,73.0,9.0,3.0,1,1090,102,22590,2106,270679,293269,11/23/2020
2020-09-10,164,32448,11334,582674,615122,9.0,2626.0,8.0,2211.0,0.0,341.0,74.0,10.0,3.0,1,1091,111,22701,2235,272914,295615,11/23/2020
2020-09-11,120,32568,9454,592128,624696,11.0,2637.0,11.0,2222.0,0.0,341.0,74.0,10.0,5.0,0,1091,97,22798,1944,274858,297656,11/23/2020
2020-09-12,110,32678,6174,598302,630980,8.0,2645.0,5.0,2227.0,2.0,343.0,75.0,9.0,5.0,3,1094,97,22895,1493,276351,299246,11/23/2020
2020-09-13,58,32736,2717,601019,633755,4.0,2649.0,3.0,2230.0,0.0,343.0,76.0,10.0,5.0,0,1094,54,22949,848,277199,300148,11/23/2020
2020-09-14,104,32840,6446,607465,640305,6.0,2655.0,3.0,2233.0,2.0,345.0,77.0,10.0,5.0,2,1096,95,23044,1707,278906,301950,11/23/2020
2020-09-15,122,32962,8470,615935,648897,7.0,2662.0,2.0,2235.0,1.0,346.0,81.0,10.0,5.0,2,1098,124,23168,2159,281065,304233,11/23/2020
2020-09-16,137,33099,9716,625651,658750,7.0,2669.0,7.0,2242.0,2.0,348.0,79.0,9.0,6.0,5,1103,118,23286,1949,283014,306300,11/23/2020
2020-09-17,125,33224,9239,634890,668114,7.0,2676.0,15.0,2257.0,0.0,348.0,71.0,8.0,4.0,0,1103,154,23440,1917,284931,308371,11/23/2020
2020-09-18,132,33356,10045,644935,678291,7.0,2683.0,7.0,2264.0,1.0,349.0,70.0,11.0,6.0,2,1105,132,23572,1904,286835,310407,11/23/2020
2020-09-19,115,33471,8297,653232,686703,7.0,2690.0,3.0,2267.0,0.0,349.0,74.0,10.0,6.0,4,1109,112,23684,1678,288513,312197,11/23/2020
2020-09-20,60,33531,3676,656908,690439,7.0,2697.0,6.0,2273.0,2.0,351.0,73.0,9.0,8.0,4,1113,49,23733,1302,289815,313548,11/23/2020
2020-09-21,102,33633,7018,663926,697559,12.0,2709.0,3.0,2276.0,2.0,353.0,80.0,8.0,6.0,2,1115,94,23827,2379,292194,316021,11/23/2020
2020-09-22,154,33787,9287,673213,707000,12.0,2721.0,3.0,2279.0,1.0,354.0,88.0,7.0,5.0,1,1116,124,23951,2178,294372,318323,11/23/2020
2020-09-23,136,33923,10651,683864,717787,12.0,2733.0,7.0,2286.0,0.0,354.0,93.0,6.0,5.0,0,1116,127,24078,2187,296559,320637,11/23/2020
2020-09-24,120,34043,12480,696344,730387,7.0,2740.0,9.0,2295.0,1.0,355.0,90.0,7.0,5.0,1,1117,121,24199,3128,299687,323886,11/23/2020
2020-09-25,149,34192,10553,706897,741089,9.0,2749.0,10.0,2305.0,0.0,355.0,89.0,6.0,5.0,1,1118,142,24341,2967,302654,326995,11/23/2020
2020-09-26,146,34338,10559,717456,751794,12.0,2761.0,9.0,2314.0,0.0,355.0,92.0,6.0,5.0,1,1119,119,24460,2401,305055,329515,11/23/2020
2020-09-27,43,34381,2764,720220,754601,7.0,2768.0,5.0,2319.0,0.0,355.0,94.0,9.0,5.0,0,1119,34,24494,835,305890,330384,11/23/2020
2020-09-28,152,34533,7308,727528,762061,7.0,2775.0,7.0,2326.0,2.0,357.0,92.0,7.0,5.0,2,1121,134,24628,2236,308126,332754,11/23/2020
2020-09-29,208,34741,11046,738574,773315,12.0,2787.0,18.0,2344.0,1.0,358.0,85.0,6.0,6.0,1,1122,190,24818,2796,310922,335740,11/23/2020
2020-09-30,221,34962,12230,750804,785766,6.0,2793.0,6.0,2350.0,0.0,358.0,85.0,6.0,6.0,1,1123,187,25005,2552,313474,338479,11/23/2020
2020-10-01,185,35147,12503,763307,798454,17.0,2810.0,13.0,2363.0,1.0,359.0,88.0,6.0,4.0,2,1125,166,25171,2382,315856,341027,11/23/2020
2020-10-02,210,35357,12153,775460,810817,14.0,2824.0,13.0,2376.0,1.0,360.0,88.0,8.0,5.0,2,1127,182,25353,2464,318320,343673,11/23/2020
2020-10-03,157,35514,9313,784773,820287,9.0,2833.0,9.0,2385.0,2.0,362.0,86.0,9.0,4.0,2,1129,131,25484,2001,320321,345805,11/23/2020
2020-10-04,81,35595,2369,787142,822737,11.0,2844.0,9.0,2394.0,1.0,363.0,87.0,8.0,5.0,2,1131,78,25562,946,321267,346829,11/23/2020
2020-10-05,174,35769,8983,796125,831894,30.0,2874.0,10.0,2404.0,2.0,365.0,105.0,9.0,6.0,4,1135,160,25722,3000,324267,349989,11/23/2020
2020-10-06,177,35946,11186,807311,843257,11.0,2885.0,4.0,2408.0,0.0,365.0,112.0,11.0,7.0,0,1135,186,25908,2871,327138,353046,11/23/2020
2020-10-07,231,36177,12441,819752,855929,13.0,2898.0,14.0,2422.0,2.0,367.0,109.0,9.0,7.0,2,1137,243,26151,3504,330642,356793,11/23/2020
2020-10-08,262,36439,15230,834982,871421,17.0,2915.0,13.0,2435.0,2.0,369.0,111.0,7.0,5.0,4,1141,272,26423,4170,334812,361235,11/23/2020
2020-10-09,217,36656,13745,848727,885383,21.0,2936.0,12.0,2447.0,0.0,369.0,120.0,10.0,7.0,3,1144,199,26622,4284,339096,365718,11/23/2020
2020-10-10,229,36885,13832,862559,899444,19.0,2955.0,10.0,2457.0,1.0,370.0,128.0,13.0,7.0,2,1146,194,26816,3759,342855,369671,11/23/2020
2020-10-11,97,36982,3263,865822,902804,12.0,2967.0,9.0,2466.0,1.0,371.0,130.0,14.0,5.0,6,1152,88,26904,1156,344011,370915,11/23/2020
2020-10-12,169,37151,6440,872262,909413,19.0,2986.0,15.0,2481.0,2.0,373.0,132.0,14.0,5.0,4,1156,159,27063,1711,345722,372785,11/23/2020
2020-10-13,213,37364,8521,880783,918147,15.0,3001.0,13.0,2494.0,4.0,377.0,130.0,13.0,5.0,7,1163,207,27270,2292,348014,375284,11/23/2020
2020-10-14,322,37686,15038,895821,933507,17.0,3018.0,7.0,2501.0,0.0,377.0,140.0,15.0,5.0,2,1165,301,27571,4000,352014,379585,11/23/2020
2020-10-15,262,37948,14639,910460,948408,12.0,3030.0,16.0,2517.0,1.0,378.0,135.0,13.0,5.0,2,1167,254,27825,3547,355561,383386,11/23/2020
2020-10-16,279,38227,15011,925471,963698,13.0,3043.0,18.0,2535.0,1.0,379.0,129.0,13.0,4.0,2,1169,275,28100,3353,358914,387014,11/23/2020
2020-10-17,354,38581,14068,939539,978120,19.0,3062.0,11.0,2546.0,1.0,380.0,136.0,17.0,4.0,2,1171,311,28411,3236,362150,390561,11/23/2020
2020-10-18,155,38736,4039,943578,982314,18.0,3080.0,11.0,2557.0,0.0,380.0,143.0,17.0,6.0,2,1173,129,28540,1306,363456,391996,11/23/2020
2020-10-19,388,39124,8491,952069,991193,21.0,3101.0,22.0,2579.0,2.0,382.0,140.0,15.0,6.0,1,1174,325,28865,2540,365996,394861,11/23/2020
2020-10-20,439,39563,13242,965311,1004874,22.0,3123.0,17.0,2596.0,0.0,382.0,145.0,14.0,8.0,3,1177,387,29252,2983,368979,398231,11/23/2020
2020-10-21,544,40107,17462,982773,1022880,21.0,3144.0,8.0,2604.0,2.0,384.0,156.0,15.0,9.0,3,1180,472,29724,3493,372472,402196,11/23/2020
2020-10-22,538,40645,15863,998636,1039281,24.0,3168.0,20.0,2624.0,3.0,387.0,157.0,14.0,9.0,3,1183,489,30213,3167,375639,405852,11/23/2020
2020-10-23,514,41159,16634,1015270,1056429,22.0,3190.0,22.0,2646.0,1.0,388.0,156.0,15.0,9.0,3,1186,460,30673,2858,378497,409170,11/23/2020
2020-10-24,359,41518,10249,1025519,1067037,17.0,3207.0,11.0,2657.0,0.0,388.0,162.0,14.0,8.0,1,1187,338,31011,2250,380747,411758,11/23/2020
2020-10-25,233,41751,4760,1030279,1072030,16.0,3223.0,15.0,2672.0,1.0,389.0,162.0,15.0,8.0,2,1189,209,31220,1451,382198,413418,11/23/2020
2020-10-26,454,42205,9174,1039453,1081658,26.0,3249.0,15.0,2687.0,2.0,391.0,171.0,18.0,8.0,3,1192,403,31623,2956,385154,416777,11/23/2020
2020-10-27,517,42722,13994,1053447,1096169,29.0,3278.0,15.0,2702.0,2.0,393.0,183.0,18.0,9.0,4,1196,453,32076,2370,387524,419600,11/23/2020
2020-10-28,469,43191,15229,1068676,1111867,25.0,3303.0,26.0,2728.0,1.0,394.0,181.0,17.0,9.0,3,1199,409,32485,2683,390207,422692,11/23/2020
2020-10-29,609,43800,16258,1084934,1128734,20.0,3323.0,22.0,2750.0,3.0,397.0,176.0,19.0,11.0,4,1203,529,33014,3108,393315,426329,11/23/2020
2020-10-30,565,44365,14861,1099795,1144160,21.0,3344.0,21.0,2771.0,5.0,402.0,171.0,19.0,9.0,4,1207,467,33481,2928,396243,429724,11/23/2020
2020-10-31,599,44964,11820,1111615,1156579,31.0,3375.0,13.0,2784.0,1.0,403.0,188.0,22.0,9.0,3,1210,487,33968,2402,398645,432613,11/23/2020
2020-11-01,330,45294,5091,1116706,1162000,20.0,3395.0,15.0,2799.0,1.0,404.0,192.0,26.0,12.0,4,1214,273,34241,1257,399902,434143,11/23/2020
2020-11-02,521,45815,9931,1126637,1172452,36.0,3431.0,27.0,2826.0,3.0,407.0,198.0,24.0,11.0,5,1219,453,34694,2915,402817,437511,11/23/2020
2020-11-03,602,46417,13040,1139677,1186094,32.0,3463.0,25.0,2851.0,1.0,408.0,204.0,23.0,11.0,1,1220,527,35221,2509,405326,440547,11/23/2020
2020-11-04,679,47096,16100,1155777,1202873,34.0,3497.0,27.0,2878.0,2.0,410.0,209.0,23.0,11.0,4,1224,624,35845,2915,408241,444086,11/23/2020
2020-11-05,760,47856,18887,1174664,1222520,46.0,3543.0,35.0,2913.0,1.0,411.0,219.0,22.0,13.0,3,1227,673,36518,5140,413381,449899,11/23/2020
2020-11-06,777,48633,17301,1191965,1240598,43.0,3586.0,31.0,2944.0,1.0,412.0,230.0,27.0,16.0,5,1232,700,37218,4314,417695,454913,11/23/2020
2020-11-07,608,49241,13649,1205614,1254855,34.0,3620.0,25.0,2969.0,1.0,413.0,238.0,30.0,17.0,1,1233,580,37798,2461,420156,457954,11/23/2020
2020-11-08,338,49579,4161,1209775,1259354,31.0,3651.0,26.0,2995.0,1.0,414.0,242.0,29.0,18.0,4,1237,322,38120,1277,421433,459553,11/23/2020
2020-11-09,807,50386,9038,1218813,1269199,38.0,3689.0,33.0,3028.0,2.0,416.0,245.0,27.0,17.0,3,1240,760,38880,2307,423740,462620,11/23/2020
2020-11-10,1061,51447,12983,1231796,1283243,45.0,3734.0,37.0,3065.0,0.0,416.0,253.0,30.0,17.0,6,1246,986,39866,2886,426626,466492,11/23/2020
2020-11-11,1088,52535,19742,1251538,1304073,39.0,3773.0,23.0,3088.0,5.0,421.0,264.0,29.0,14.0,6,1252,1005,40871,2690,429316,470187,11/23/2020
2020-11-12,890,53425,13901,1265439,1318864,37.0,3810.0,31.0,3119.0,3.0,424.0,267.0,27.0,14.0,5,1257,808,41679,2209,431525,473204,11/23/2020
2020-11-13,1154,54579,16389,1281828,1336407,36.0,3846.0,31.0,3150.0,0.0,424.0,272.0,26.0,14.0,2,1259,1100,42779,3118,434643,477422,11/23/2020
2020-11-14,781,55360,13517,1295345,1350705,37.0,3883.0,26.0,3176.0,5.0,429.0,278.0,24.0,12.0,10,1269,738,43517,2473,437116,480633,11/23/2020
2020-11-15,578,55938,6173,1301518,1357456,41.0,3924.0,21.0,3197.0,5.0,434.0,293.0,26.0,11.0,7,1276,488,44005,1441,438557,482562,11/23/2020
2020-11-16,731,56669,9614,1311132,1367801,49.0,3973.0,38.0,3235.0,3.0,437.0,301.0,25.0,13.0,5,1281,661,44666,2626,441183,485849,11/23/2020
2020-11-17,1541,58210,18146,1329278,1387488,55.0,4028.0,44.0,3279.0,2.0,439.0,310.0,28.0,13.0,4,1285,1403,46069,4163,445346,491415,11/23/2020
2020-11-18,1129,59339,16002,1345280,1404619,34.0,4062.0,38.0,3317.0,5.0,444.0,301.0,25.0,15.0,7,1292,1016,47085,3202,448548,495633,11/23/2020
2020-11-19,1132,60471,13095,1358375,1418846,41.0,4103.0,41.0,3358.0,4.0,448.0,297.0,25.0,17.0,2,1294,1034,48119,3419,451967,500086,11/23/2020
2020-11-20,1428,61899,22076,1380451,1442350,43.0,4146.0,44.0,3402.0,3.0,451.0,293.0,28.0,14.0,6,1300,1287,49406,4289,456256,505662,11/23/2020
2020-11-21,841,62740,17212,1397663,1460403,31.0,4177.0,34.0,3436.0,5.0,456.0,285.0,30.0,14.0,3,1303,738,50144,3156,459412,509556,11/23/2020
2020-11-22,519,63259,7160,1404823,1468082,,,,,,,,,,6,1309,429,50573,1680,461092,511665,11/23/2020
2020-02-27,0,0,0,0,0,1.0,1.0,0.0,0.0,0.0,0.0,1.0,0.0,0.0,0,0,0,0,0,0,0,11/24/2020
2020-02-28,0,0,0,0,0,0.0,1.0,0.0,0.0,0.0,0.0,1.0,1.0,0.0,0,0,0,0,0,0,0,11/24/2020
2020-02-29,0,0,0,0,0,0.0,1.0,0.0,0.0,0.0,0.0,1.0,1.0,0.0,0,0,0,0,0,0,0,11/24/2020
2020-03-01,2,2,2,2,4,0.0,1.0,0.0,0.0,0.0,0.0,1.0,1.0,1.0,0,0,2,2,2,2,4,11/24/2020
2020-03-02,0,2,1,3,5,1.0,2.0,0.0,0.0,0.0,0.0,2.0,2.0,2.0,0,0,0,2,0,2,4,11/24/2020
2020-03-03,0,2,2,5,7,0.0,2.0,0.0,0.0,0.0,0.0,2.0,2.0,2.0,0,0,0,2,1,3,5,11/24/2020
2020-03-04,0,2,12,17,19,1.0,3.0,0.0,0.0,0.0,0.0,3.0,2.0,2.0,0,0,0,2,10,13,15,11/24/2020
2020-03-05,0,2,4,21,23,0.0,3.0,0.0,0.0,0.0,0.0,3.0,2.0,2.0,0,0,1,3,4,17,20,11/24/2020
2020-03-06,1,3,12,33,36,0.0,3.0,0.0,0.0,0.0,0.0,3.0,2.0,2.0,0,0,0,3,11,28,31,11/24/2020
2020-03-07,0,3,19,52,55,0.0,3.0,0.0,0.0,0.0,0.0,3.0,2.0,1.0,0,0,0,3,19,47,50,11/24/2020
2020-03-08,0,3,18,70,73,0.0,3.0,0.0,0.0,0.0,0.0,3.0,2.0,1.0,0,0,0,3,18,65,68,11/24/2020
2020-03-09,1,4,15,85,89,0.0,3.0,0.0,0.0,0.0,0.0,3.0,2.0,1.0,0,0,1,4,14,79,83,11/24/2020
2020-03-10,2,6,25,110,116,0.0,3.0,0.0,0.0,0.0,0.0,3.0,2.0,1.0,0,0,1,5,23,102,107,11/24/2020
2020-03-11,0,6,34,144,150,1.0,4.0,0.0,0.0,0.0,0.0,4.0,1.0,1.0,0,0,0,5,34,136,141,11/24/2020
2020-03-12,9,15,41,185,200,1.0,5.0,0.0,0.0,0.0,0.0,5.0,1.0,1.0,0,0,8,13,38,174,187,11/24/2020
2020-03-13,6,21,50,235,256,4.0,9.0,1.0,1.0,0.0,0.0,8.0,1.0,1.0,0,0,6,19,47,221,240,11/24/2020
2020-03-14,0,21,90,325,346,0.0,9.0,0.0,1.0,0.0,0.0,8.0,1.0,1.0,0,0,0,19,83,304,323,11/24/2020
2020-03-15,1,22,54,379,401,1.0,10.0,0.0,1.0,0.0,0.0,9.0,2.0,1.0,0,0,1,20,53,357,377,11/24/2020
2020-03-16,2,24,95,474,498,2.0,12.0,0.0,1.0,0.0,0.0,11.0,2.0,0.0,0,0,2,22,91,448,470,11/24/2020
2020-03-17,12,36,162,636,672,6.0,18.0,0.0,1.0,0.0,0.0,17.0,2.0,0.0,0,0,11,33,147,595,628,11/24/2020
2020-03-18,9,45,116,752,797,3.0,21.0,0.0,1.0,0.0,0.0,20.0,2.0,0.0,0,0,11,44,108,703,747,11/24/2020
2020-03-19,15,60,262,1014,1074,2.0,23.0,1.0,2.0,0.0,0.0,21.0,3.0,0.0,1,1,17,61,246,949,1010,11/24/2020
2020-03-20,13,73,197,1211,1284,5.0,28.0,0.0,2.0,0.0,0.0,26.0,4.0,0.0,0,1,13,74,186,1135,1209,11/24/2020
2020-03-21,12,85,126,1337,1422,3.0,31.0,2.0,4.0,0.0,0.0,27.0,5.0,0.0,0,1,14,88,121,1256,1344,11/24/2020
2020-03-22,27,112,282,1619,1731,2.0,33.0,0.0,4.0,0.0,0.0,29.0,5.0,0.0,0,1,25,113,256,1512,1625,11/24/2020
2020-03-23,14,126,169,1788,1914,15.0,48.0,1.0,5.0,0.0,0.0,43.0,9.0,3.0,0,1,16,129,160,1672,1801,11/24/2020
2020-03-24,20,146,242,2030,2176,8.0,56.0,0.0,5.0,0.0,0.0,51.0,10.0,5.0,0,1,19,148,227,1899,2047,11/24/2020
2020-03-25,26,172,182,2212,2384,5.0,61.0,2.0,7.0,0.0,0.0,54.0,11.0,3.0,0,1,28,176,161,2060,2236,11/24/2020
2020-03-26,35,207,181,2393,2600,9.0,70.0,5.0,12.0,0.0,0.0,58.0,14.0,5.0,0,1,41,217,168,2228,2445,11/24/2020
2020-03-27,27,234,214,2607,2841,9.0,79.0,1.0,13.0,1.0,1.0,65.0,16.0,6.0,2,3,31,248,190,2418,2666,11/24/2020
2020-03-28,59,293,260,2867,3160,11.0,90.0,2.0,15.0,1.0,2.0,73.0,15.0,6.0,1,4,64,312,239,2657,2969,11/24/2020
2020-03-29,100,393,350,3217,3610,8.0,98.0,3.0,18.0,1.0,3.0,77.0,18.0,8.0,2,6,105,417,308,2965,3382,11/24/2020
2020-03-30,62,455,222,3439,3894,19.0,117.0,5.0,23.0,0.0,3.0,91.0,19.0,11.0,3,9,78,495,180,3145,3640,11/24/2020
2020-03-31,71,526,369,3808,4334,11.0,128.0,7.0,30.0,1.0,4.0,94.0,21.0,13.0,2,11,73,568,293,3438,4006,11/24/2020
2020-04-01,99,625,698,4506,5131,18.0,146.0,7.0,37.0,0.0,4.0,105.0,29.0,15.0,1,12,100,668,615,4053,4721,11/24/2020
2020-04-02,52,677,477,4983,5660,22.0,168.0,6.0,43.0,2.0,6.0,119.0,35.0,21.0,4,16,62,730,421,4474,5204,11/24/2020
2020-04-03,108,785,774,5757,6542,23.0,191.0,7.0,50.0,0.0,6.0,135.0,42.0,25.0,3,19,100,830,684,5158,5988,11/24/2020
2020-04-04,143,928,660,6417,7345,22.0,213.0,4.0,54.0,5.0,11.0,148.0,40.0,29.0,9,28,138,968,591,5749,6717,11/24/2020
2020-04-05,187,1115,1156,7573,8688,20.0,233.0,9.0,63.0,1.0,12.0,158.0,43.0,35.0,2,30,181,1149,1019,6768,7917,11/24/2020
2020-04-06,218,1333,1706,9279,10612,26.0,259.0,7.0,70.0,0.0,12.0,177.0,47.0,39.0,7,37,207,1356,1498,8266,9622,11/24/2020
2020-04-07,284,1617,1629,10908,12525,20.0,279.0,4.0,74.0,2.0,14.0,191.0,49.0,41.0,5,42,261,1617,1440,9706,11323,11/24/2020
2020-04-08,290,1907,1720,12628,14535,19.0,298.0,8.0,82.0,5.0,19.0,197.0,49.0,37.0,10,52,271,1888,1502,11208,13096,11/24/2020
2020-04-09,283,2190,1516,14144,16334,32.0,330.0,8.0,90.0,4.0,23.0,217.0,53.0,40.0,7,59,277,2165,1310,12518,14683,11/24/2020
2020-04-10,419,2609,2574,16718,19327,29.0,359.0,17.0,107.0,5.0,28.0,224.0,59.0,41.0,11,70,400,2565,2286,14804,17369,11/24/2020
2020-04-11,297,2906,1905,18623,21529,29.0,388.0,11.0,118.0,2.0,30.0,240.0,61.0,48.0,12,82,281,2846,1667,16471,19317,11/24/2020
2020-04-12,314,3220,1670,20293,23513,35.0,423.0,13.0,131.0,5.0,35.0,257.0,59.0,49.0,9,91,286,3132,1374,17845,20977,11/24/2020
2020-04-13,161,3381,935,21228,24609,35.0,458.0,13.0,144.0,3.0,38.0,276.0,64.0,54.0,9,100,187,3319,816,18661,21980,11/24/2020
2020-04-14,289,3670,1787,23015,26685,27.0,485.0,18.0,162.0,5.0,43.0,280.0,72.0,53.0,8,108,262,3581,1469,20130,23711,11/24/2020
2020-04-15,351,4021,1799,24814,28835,31.0,516.0,20.0,182.0,3.0,46.0,288.0,72.0,54.0,17,125,306,3887,1475,21605,25492,11/24/2020
2020-04-16,447,4468,2494,27308,31776,36.0,552.0,25.0,207.0,6.0,52.0,293.0,72.0,53.0,14,139,387,4274,1980,23585,27859,11/24/2020
2020-04-17,304,4772,1821,29129,33901,32.0,584.0,20.0,227.0,7.0,59.0,298.0,66.0,45.0,21,160,290,4564,1391,24976,29540,11/24/2020
2020-04-18,321,5093,1725,30854,35947,26.0,610.0,18.0,245.0,4.0,63.0,302.0,63.0,49.0,15,175,284,4848,1275,26251,31099,11/24/2020
2020-04-19,381,5474,2047,32901,38375,23.0,633.0,26.0,271.0,1.0,64.0,298.0,65.0,55.0,11,186,337,5185,1679,27930,33115,11/24/2020
2020-04-20,394,5868,1907,34808,40676,46.0,679.0,29.0,300.0,2.0,66.0,313.0,75.0,56.0,10,196,376,5561,1531,29461,35022,11/24/2020
2020-04-21,444,6312,2110,36918,43230,45.0,724.0,32.0,332.0,5.0,71.0,321.0,72.0,56.0,18,214,383,5944,1652,31113,37057,11/24/2020
2020-04-22,418,6730,2390,39308,46038,41.0,765.0,32.0,364.0,5.0,76.0,325.0,73.0,58.0,18,232,379,6323,1852,32965,39288,11/24/2020
2020-04-23,479,7209,2469,41777,48986,32.0,797.0,28.0,392.0,5.0,81.0,324.0,76.0,62.0,15,247,412,6735,1792,34757,41492,11/24/2020
2020-04-24,491,7700,3284,45061,52761,35.0,832.0,26.0,418.0,4.0,85.0,329.0,85.0,63.0,15,262,407,7142,2532,37289,44431,11/24/2020
2020-04-25,393,8093,2206,47267,55360,34.0,866.0,17.0,435.0,5.0,90.0,341.0,85.0,62.0,14,276,299,7441,1699,38988,46429,11/24/2020
2020-04-26,316,8409,2309,49576,57985,33.0,899.0,15.0,450.0,3.0,93.0,356.0,86.0,59.0,14,290,274,7715,1807,40795,48510,11/24/2020
2020-04-27,249,8658,1620,51196,59854,29.0,928.0,21.0,471.0,4.0,97.0,360.0,86.0,61.0,10,300,206,7921,1110,41905,49826,11/24/2020
2020-04-28,410,9068,2263,53459,62527,44.0,972.0,24.0,495.0,3.0,100.0,377.0,88.0,59.0,22,322,332,8253,1649,43554,51807,11/24/2020
2020-04-29,476,9544,3343,56802,66346,36.0,1008.0,38.0,533.0,11.0,111.0,364.0,78.0,53.0,18,340,370,8623,2302,45856,54479,11/24/2020
2020-04-30,432,9976,2769,59571,69547,33.0,1041.0,38.0,571.0,6.0,117.0,353.0,83.0,57.0,24,364,350,8973,1806,47662,56635,11/24/2020
2020-05-01,454,10430,3086,62657,73087,52.0,1093.0,38.0,609.0,3.0,120.0,364.0,84.0,58.0,14,378,323,9296,2044,49706,59002,11/24/2020
2020-05-02,257,10687,1926,64583,75270,36.0,1129.0,39.0,648.0,5.0,125.0,356.0,93.0,63.0,24,402,192,9488,1231,50937,60425,11/24/2020
2020-05-03,283,10970,2160,66743,77713,31.0,1160.0,26.0,674.0,8.0,133.0,353.0,91.0,61.0,21,423,183,9671,1500,52437,62108,11/24/2020
2020-05-04,387,11357,2098,68841,80198,30.0,1190.0,31.0,705.0,6.0,139.0,346.0,89.0,58.0,18,441,290,9961,1509,53946,63907,11/24/2020
2020-05-05,433,11790,2873,71714,83504,29.0,1219.0,32.0,737.0,6.0,145.0,337.0,83.0,55.0,16,457,300,10261,1883,55829,66090,11/24/2020
2020-05-06,488,12278,2830,74544,86822,28.0,1247.0,44.0,781.0,9.0,154.0,312.0,80.0,55.0,21,478,340,10601,1857,57686,68287,11/24/2020
2020-05-07,425,12703,2969,77513,90216,36.0,1283.0,44.0,825.0,5.0,159.0,299.0,72.0,53.0,21,499,269,10870,1893,59579,70449,11/24/2020
2020-05-08,359,13062,2598,80111,93173,30.0,1313.0,29.0,854.0,5.0,164.0,295.0,72.0,54.0,22,521,229,11099,1672,61251,72350,11/24/2020
2020-05-09,467,13529,3346,83457,96986,22.0,1335.0,21.0,875.0,4.0,168.0,292.0,70.0,52.0,15,536,290,11389,2168,63419,74808,11/24/2020
2020-05-10,285,13814,2117,85574,99388,20.0,1355.0,23.0,898.0,6.0,174.0,283.0,71.0,50.0,14,550,189,11578,1457,64876,76454,11/24/2020
2020-05-11,257,14071,1857,87431,101502,31.0,1386.0,16.0,914.0,6.0,180.0,292.0,72.0,50.0,15,565,174,11752,1250,66126,77878,11/24/2020
2020-05-12,387,14458,2611,90042,104500,23.0,1409.0,18.0,932.0,4.0,184.0,293.0,70.0,49.0,22,587,224,11976,1608,67734,79710,11/24/2020
2020-05-13,351,14809,3630,93672,108481,23.0,1432.0,25.0,957.0,1.0,185.0,290.0,70.0,50.0,13,600,199,12175,1877,69611,81786,11/24/2020
2020-05-14,329,15138,3408,97080,112218,19.0,1451.0,27.0,984.0,3.0,188.0,279.0,65.0,46.0,15,615,232,12407,1908,71519,83926,11/24/2020
2020-05-15,381,15519,3458,100538,116057,24.0,1475.0,41.0,1025.0,5.0,193.0,257.0,63.0,46.0,14,629,232,12639,1752,73271,85910,11/24/2020
2020-05-16,449,15968,4156,104694,120662,25.0,1500.0,15.0,1040.0,5.0,198.0,262.0,62.0,47.0,15,644,247,12886,1874,75145,88031,11/24/2020
2020-05-17,240,16208,2768,107462,123670,17.0,1517.0,9.0,1049.0,5.0,203.0,265.0,60.0,46.0,10,654,126,13012,1493,76638,89650,11/24/2020
2020-05-18,250,16458,2001,109463,125921,19.0,1536.0,16.0,1065.0,5.0,208.0,263.0,58.0,41.0,18,672,135,13147,1323,77961,91108,11/24/2020
2020-05-19,415,16873,3168,112631,129504,23.0,1559.0,33.0,1098.0,5.0,213.0,248.0,57.0,39.0,11,683,215,13362,1879,79840,93202,11/24/2020
2020-05-20,326,17199,2771,115402,132601,19.0,1578.0,23.0,1121.0,7.0,220.0,237.0,53.0,34.0,22,705,184,13546,1488,81328,94874,11/24/2020
2020-05-21,374,17573,3757,119159,136732,25.0,1603.0,15.0,1136.0,3.0,223.0,244.0,54.0,30.0,20,725,168,13714,1886,83214,96928,11/24/2020
2020-05-22,351,17924,3161,122320,140244,20.0,1623.0,28.0,1164.0,5.0,228.0,231.0,53.0,30.0,11,736,206,13920,1555,84769,98689,11/24/2020
2020-05-23,253,18177,2742,125062,143239,19.0,1642.0,11.0,1175.0,3.0,231.0,236.0,53.0,33.0,13,749,109,14029,1237,86006,100035,11/24/2020
2020-05-24,163,18340,1370,126432,144772,13.0,1655.0,14.0,1189.0,2.0,233.0,233.0,54.0,36.0,8,757,83,14112,755,86761,100873,11/24/2020
2020-05-25,147,18487,1385,127817,146304,14.0,1669.0,14.0,1203.0,0.0,233.0,233.0,54.0,34.0,10,767,76,14188,725,87486,101674,11/24/2020
2020-05-26,285,18772,2620,130437,149209,24.0,1693.0,21.0,1224.0,5.0,238.0,231.0,49.0,33.0,15,782,158,14346,1658,89144,103490,11/24/2020
2020-05-27,276,19048,2057,132494,151542,20.0,1713.0,18.0,1242.0,3.0,241.0,230.0,51.0,33.0,10,792,132,14478,1110,90254,104732,11/24/2020
2020-05-28,348,19396,3359,135853,155249,17.0,1730.0,29.0,1271.0,4.0,245.0,214.0,47.0,32.0,8,800,130,14608,1091,91345,105953,11/24/2020
2020-05-29,410,19806,3915,139768,159574,19.0,1749.0,26.0,1297.0,7.0,252.0,200.0,43.0,31.0,12,812,174,14782,1518,92863,107645,11/24/2020
2020-05-30,225,20031,3915,143683,163714,16.0,1765.0,19.0,1316.0,4.0,256.0,193.0,41.0,29.0,12,824,109,14891,1716,94579,109470,11/24/2020
2020-05-31,155,20186,1690,145373,165559,11.0,1776.0,11.0,1327.0,1.0,257.0,192.0,44.0,26.0,3,827,78,14969,818,95397,110366,11/24/2020
2020-06-01,212,20398,2792,148165,168563,8.0,1784.0,14.0,1341.0,1.0,258.0,185.0,45.0,29.0,5,832,93,15062,1345,96742,111804,11/24/2020
2020-06-02,273,20671,3022,151187,171858,8.0,1792.0,9.0,1350.0,3.0,261.0,181.0,38.0,25.0,10,842,98,15160,1397,98139,113299,11/24/2020
2020-06-03,254,20925,3486,154673,175598,14.0,1806.0,18.0,1368.0,6.0,267.0,171.0,34.0,25.0,11,853,99,15259,1613,99752,115011,11/24/2020
2020-06-04,276,21201,4471,159144,180345,7.0,1813.0,26.0,1394.0,4.0,271.0,148.0,31.0,24.0,12,865,107,15366,1971,101723,117089,11/24/2020
2020-06-05,215,21416,3513,162657,184073,15.0,1828.0,13.0,1407.0,6.0,277.0,144.0,27.0,21.0,11,876,99,15465,1510,103233,118698,11/24/2020
2020-06-06,201,21617,2616,165273,186890,10.0,1838.0,7.0,1414.0,2.0,279.0,145.0,29.0,19.0,6,882,67,15532,1088,104321,119853,11/24/2020
2020-06-07,83,21700,1625,166898,188598,11.0,1849.0,7.0,1421.0,1.0,280.0,148.0,25.0,17.0,4,886,51,15583,773,105094,120677,11/24/2020
2020-06-08,119,21819,1849,168747,190566,15.0,1864.0,13.0,1434.0,2.0,282.0,148.0,27.0,18.0,4,890,45,15628,931,106025,121653,11/24/2020
2020-06-09,223,22042,2673,171420,193462,10.0,1874.0,19.0,1453.0,0.0,282.0,139.0,28.0,21.0,1,891,64,15692,1230,107255,122947,11/24/2020
2020-06-10,209,22251,2987,174407,196658,13.0,1887.0,12.0,1465.0,2.0,284.0,138.0,24.0,17.0,4,895,100,15792,1431,108686,124478,11/24/2020
2020-06-11,195,22446,3513,177920,200366,7.0,1894.0,15.0,1480.0,1.0,285.0,129.0,25.0,16.0,6,901,88,15880,1497,110183,126063,11/24/2020
2020-06-12,209,22655,4601,182521,205176,9.0,1903.0,16.0,1496.0,1.0,286.0,121.0,24.0,16.0,2,903,78,15958,2127,112310,128268,11/24/2020
2020-06-13,113,22768,3036,185557,208325,6.0,1909.0,5.0,1501.0,0.0,286.0,122.0,20.0,15.0,3,906,49,16007,1341,113651,129658,11/24/2020
2020-06-14,81,22849,2046,187603,210452,7.0,1916.0,8.0,1509.0,1.0,287.0,120.0,20.0,14.0,3,909,33,16040,947,114598,130638,11/24/2020
2020-06-15,188,23037,3108,190711,213748,14.0,1930.0,19.0,1528.0,0.0,287.0,115.0,20.0,16.0,5,914,75,16115,1743,116341,132456,11/24/2020
2020-06-16,110,23147,3017,193728,216875,11.0,1941.0,9.0,1537.0,1.0,288.0,116.0,22.0,16.0,8,922,50,16165,1506,117847,134012,11/24/2020
2020-06-17,127,23274,2835,196563,219837,15.0,1956.0,20.0,1557.0,4.0,292.0,107.0,18.0,14.0,6,928,51,16216,1285,119132,135348,11/24/2020
2020-06-18,149,23423,3048,199611,223034,9.0,1965.0,15.0,1572.0,1.0,293.0,100.0,19.0,16.0,7,935,70,16286,1288,120420,136706,11/24/2020
2020-06-19,141,23564,3769,203380,226944,12.0,1977.0,12.0,1584.0,1.0,294.0,99.0,20.0,17.0,3,938,59,16345,1327,121747,138092,11/24/2020
2020-06-20,84,23648,1891,205271,228919,9.0,1986.0,12.0,1596.0,0.0,294.0,96.0,20.0,18.0,4,942,36,16381,804,122551,138932,11/24/2020
2020-06-21,37,23685,1064,206335,230020,8.0,1994.0,5.0,1601.0,0.0,294.0,99.0,20.0,18.0,2,944,30,16411,678,123229,139640,11/24/2020
2020-06-22,138,23823,3730,210065,233888,12.0,2006.0,17.0,1618.0,0.0,294.0,94.0,19.0,18.0,2,946,65,16476,1671,124900,141376,11/24/2020
2020-06-23,163,23986,3831,213896,237882,3.0,2009.0,13.0,1631.0,3.0,297.0,81.0,18.0,18.0,7,953,81,16557,1747,126647,143204,11/24/2020
2020-06-24,120,24106,3502,217398,241504,9.0,2018.0,10.0,1641.0,1.0,298.0,79.0,18.0,18.0,5,958,44,16601,1652,128299,144900,11/24/2020
2020-06-25,103,24209,2883,220281,244490,6.0,2024.0,14.0,1655.0,1.0,299.0,70.0,17.0,17.0,1,959,50,16651,1471,129770,146421,11/24/2020
2020-06-26,94,24303,2488,222769,247072,2.0,2026.0,10.0,1665.0,0.0,299.0,62.0,18.0,18.0,1,960,60,16711,1303,131073,147784,11/24/2020
2020-06-27,84,24387,3216,225985,250372,5.0,2031.0,3.0,1668.0,1.0,300.0,63.0,17.0,17.0,5,965,37,16748,1182,132255,149003,11/24/2020
2020-06-28,39,24426,1469,227454,251880,4.0,2035.0,4.0,1672.0,4.0,304.0,59.0,15.0,14.0,6,971,17,16765,583,132838,149603,11/24/2020
2020-06-29,85,24511,3697,231151,255662,4.0,2039.0,5.0,1677.0,0.0,304.0,58.0,14.0,14.0,1,972,39,16804,1329,134167,150971,11/24/2020
2020-06-30,57,24568,1958,233109,257677,1.0,2040.0,5.0,1682.0,1.0,305.0,53.0,12.0,11.0,4,976,33,16837,979,135146,151983,11/24/2020
2020-07-01,144,24712,4098,237207,261919,8.0,2048.0,10.0,1692.0,0.0,305.0,51.0,11.0,11.0,1,977,79,16916,1887,137033,153949,11/24/2020
2020-07-02,103,24815,2803,240010,264825,5.0,2053.0,5.0,1697.0,1.0,306.0,50.0,10.0,10.0,3,980,59,16975,1059,138092,155067,11/24/2020
2020-07-03,50,24865,2079,242089,266954,9.0,2062.0,6.0,1703.0,0.0,306.0,53.0,9.0,9.0,3,983,25,17000,772,138864,155864,11/24/2020
2020-07-04,57,24922,2345,244434,269356,2.0,2064.0,4.0,1707.0,1.0,307.0,50.0,10.0,9.0,2,985,33,17033,982,139846,156879,11/24/2020
2020-07-05,49,24971,2932,247366,272337,1.0,2065.0,2.0,1709.0,1.0,308.0,48.0,8.0,8.0,2,987,26,17059,1401,141247,158306,11/24/2020
2020-07-06,101,25072,2814,250180,275252,6.0,2071.0,6.0,1715.0,0.0,308.0,48.0,9.0,9.0,4,991,57,17116,1520,142767,159883,11/24/2020
2020-07-07,81,25153,3457,253637,278790,5.0,2076.0,7.0,1722.0,0.0,308.0,46.0,8.0,8.0,2,993,47,17163,1510,144277,161440,11/24/2020
2020-07-08,105,25258,3409,257046,282304,4.0,2080.0,2.0,1724.0,0.0,308.0,48.0,9.0,8.0,0,993,64,17227,1379,145656,162883,11/24/2020
2020-07-09,94,25352,3714,260760,286112,9.0,2089.0,3.0,1727.0,0.0,308.0,54.0,9.0,8.0,0,993,50,17277,1582,147238,164515,11/24/2020
2020-07-10,132,25484,4437,265197,290681,6.0,2095.0,3.0,1730.0,2.0,310.0,55.0,7.0,7.0,3,996,80,17357,2027,149265,166622,11/24/2020
2020-07-11,63,25547,2938,268135,293682,6.0,2101.0,3.0,1733.0,1.0,311.0,57.0,6.0,6.0,3,999,36,17393,1294,150559,167952,11/24/2020
2020-07-12,47,25594,1838,269973,295567,1.0,2102.0,3.0,1736.0,1.0,312.0,54.0,6.0,5.0,3,1002,34,17427,927,151486,168913,11/24/2020
2020-07-13,84,25678,3209,273182,298860,8.0,2110.0,10.0,1746.0,0.0,312.0,52.0,6.0,5.0,1,1003,61,17488,1475,152961,170449,11/24/2020
2020-07-14,74,25752,3298,276480,302232,7.0,2117.0,4.0,1750.0,0.0,312.0,55.0,5.0,5.0,1,1004,44,17532,1356,154317,171849,11/24/2020
2020-07-15,130,25882,4181,280661,306543,5.0,2122.0,7.0,1757.0,0.0,312.0,53.0,5.0,4.0,0,1004,100,17632,1716,156033,173665,11/24/2020
2020-07-16,103,25985,3740,284401,310386,6.0,2128.0,9.0,1766.0,0.0,312.0,50.0,6.0,5.0,1,1005,76,17708,1585,157618,175326,11/24/2020
2020-07-17,156,26141,4239,288640,314781,14.0,2142.0,3.0,1769.0,1.0,313.0,60.0,5.0,5.0,2,1007,79,17787,1811,159429,177216,11/24/2020
2020-07-18,85,26226,3272,291912,318138,5.0,2147.0,9.0,1778.0,1.0,314.0,55.0,5.0,4.0,4,1011,70,17857,1371,160800,178657,11/24/2020
2020-07-19,82,26308,2696,294608,320916,7.0,2154.0,3.0,1781.0,0.0,314.0,59.0,6.0,4.0,2,1013,57,17914,1128,161928,179842,11/24/2020
2020-07-20,71,26379,2666,297274,323653,9.0,2163.0,7.0,1788.0,0.0,314.0,61.0,7.0,5.0,2,1015,68,17982,1429,163357,181339,11/24/2020
2020-07-21,130,26509,4304,301578,328087,9.0,2172.0,11.0,1799.0,0.0,314.0,59.0,9.0,6.0,1,1016,108,18090,1888,165245,183335,11/24/2020
2020-07-22,130,26639,3928,305506,332145,7.0,2179.0,8.0,1807.0,1.0,315.0,57.0,7.0,6.0,1,1017,86,18176,1640,166885,185061,11/24/2020
2020-07-23,141,26780,4415,309921,336701,8.0,2187.0,6.0,1813.0,0.0,315.0,59.0,8.0,7.0,0,1017,115,18291,1933,168818,187109,11/24/2020
2020-07-24,172,26952,5966,315887,342839,15.0,2202.0,12.0,1825.0,0.0,315.0,62.0,9.0,7.0,0,1017,119,18410,2261,171079,189489,11/24/2020
2020-07-25,134,27086,4398,320285,347371,7.0,2209.0,7.0,1832.0,0.0,315.0,62.0,10.0,8.0,3,1020,108,18518,2059,173138,191656,11/24/2020
2020-07-26,62,27148,3033,323318,350466,8.0,2217.0,9.0,1841.0,0.0,315.0,61.0,11.0,7.0,1,1021,54,18572,1316,174454,193026,11/24/2020
2020-07-27,188,27336,4191,327509,354845,12.0,2229.0,7.0,1848.0,0.0,315.0,66.0,13.0,8.0,1,1022,138,18710,2297,176751,195461,11/24/2020
2020-07-28,105,27441,3840,331349,358790,5.0,2234.0,5.0,1853.0,0.0,315.0,66.0,14.0,7.0,1,1023,95,18805,1605,178356,197161,11/24/2020
2020-07-29,190,27631,5139,336488,364119,9.0,2243.0,10.0,1863.0,0.0,315.0,65.0,15.0,7.0,0,1023,154,18959,2261,180617,199576,11/24/2020
2020-07-30,121,27752,4345,340833,368585,6.0,2249.0,2.0,1865.0,1.0,316.0,68.0,15.0,6.0,1,1024,97,19056,1608,182225,201281,11/24/2020
2020-07-31,131,27883,5512,346345,374228,7.0,2256.0,9.0,1874.0,0.0,316.0,66.0,15.0,7.0,1,1025,89,19145,1806,184031,203176,11/24/2020
2020-08-01,109,27992,4294,350639,378631,7.0,2263.0,2.0,1876.0,0.0,316.0,71.0,14.0,7.0,1,1026,89,19234,1530,185561,204795,11/24/2020
2020-08-02,84,28076,2804,353443,381519,12.0,2275.0,12.0,1888.0,2.0,318.0,69.0,14.0,8.0,2,1028,62,19296,1247,186808,206104,11/24/2020
2020-08-03,188,28264,5248,358691,386955,11.0,2286.0,10.0,1898.0,0.0,318.0,70.0,16.0,7.0,1,1029,150,19446,2165,188973,208419,11/24/2020
2020-08-04,125,28389,3691,362382,390771,8.0,2294.0,5.0,1903.0,1.0,319.0,72.0,12.0,5.0,2,1031,99,19545,1742,190715,210260,11/24/2020
2020-08-05,147,28536,5935,368317,396853,11.0,2305.0,9.0,1912.0,1.0,320.0,73.0,10.0,5.0,2,1033,119,19664,2417,193132,212796,11/24/2020
2020-08-06,169,28705,5546,373863,402568,7.0,2312.0,9.0,1921.0,0.0,320.0,71.0,9.0,4.0,0,1033,120,19784,2347,195479,215263,11/24/2020
2020-08-07,123,28828,4851,378714,407542,12.0,2324.0,9.0,1930.0,1.0,321.0,73.0,9.0,3.0,2,1035,87,19871,2099,197578,217449,11/24/2020
2020-08-08,123,28951,4112,382826,411777,19.0,2343.0,6.0,1936.0,1.0,322.0,85.0,8.0,3.0,1,1036,91,19962,1752,199330,219292,11/24/2020
2020-08-09,42,28993,1727,384553,413546,6.0,2349.0,8.0,1944.0,0.0,322.0,83.0,9.0,4.0,0,1036,35,19997,1053,200383,220380,11/24/2020
2020-08-10,149,29142,4587,389140,418282,8.0,2357.0,9.0,1953.0,0.0,322.0,82.0,9.0,4.0,1,1037,113,20110,1987,202370,222480,11/24/2020
2020-08-11,106,29248,4334,393474,422722,5.0,2362.0,13.0,1966.0,0.0,322.0,74.0,10.0,4.0,3,1040,92,20202,2226,204596,224798,11/24/2020
2020-08-12,121,29369,5188,398662,428031,8.0,2370.0,11.0,1977.0,0.0,322.0,71.0,9.0,3.0,1,1041,101,20303,2571,207167,227470,11/24/2020
2020-08-13,135,29504,4196,402858,432362,13.0,2383.0,12.0,1989.0,0.0,322.0,72.0,11.0,3.0,0,1041,95,20398,1874,209041,229439,11/24/2020
2020-08-14,145,29649,5498,408356,438005,13.0,2396.0,11.0,2000.0,0.0,322.0,74.0,11.0,4.0,3,1044,98,20496,1943,210984,231480,11/24/2020
2020-08-15,106,29755,4534,412890,442645,9.0,2405.0,11.0,2011.0,1.0,323.0,71.0,11.0,5.0,0,1044,88,20584,1655,212639,233223,11/24/2020
2020-08-16,83,29838,2477,415367,445205,6.0,2411.0,5.0,2016.0,4.0,327.0,68.0,8.0,4.0,6,1050,70,20654,939,213578,234232,11/24/2020
2020-08-17,106,29944,4575,419942,449886,8.0,2419.0,6.0,2022.0,0.0,327.0,70.0,8.0,5.0,2,1052,87,20741,2347,215925,236666,11/24/2020
2020-08-18,128,30072,4911,424853,454925,11.0,2430.0,8.0,2030.0,1.0,328.0,72.0,8.0,4.0,5,1057,94,20835,2699,218624,239459,11/24/2020
2020-08-19,113,30185,5077,429930,460115,8.0,2438.0,9.0,2039.0,1.0,329.0,70.0,9.0,5.0,0,1057,90,20925,2587,221211,242136,11/24/2020
2020-08-20,173,30358,7411,437341,467699,12.0,2450.0,6.0,2045.0,2.0,331.0,74.0,10.0,5.0,3,1060,139,21064,3461,224672,245736,11/24/2020
2020-08-21,152,30510,6577,443918,474428,8.0,2458.0,5.0,2050.0,1.0,332.0,76.0,9.0,4.0,2,1062,125,21189,2887,227559,248748,11/24/2020
2020-08-22,96,30606,5550,449468,480074,11.0,2469.0,12.0,2062.0,0.0,332.0,75.0,11.0,4.0,1,1063,84,21273,2555,230114,251387,11/24/2020
2020-08-23,72,30678,4375,453843,484521,11.0,2480.0,6.0,2068.0,0.0,332.0,80.0,12.0,2.0,1,1064,56,21329,2439,232553,253882,11/24/2020
2020-08-24,105,30783,5784,459627,490410,7.0,2487.0,10.0,2078.0,1.0,333.0,76.0,14.0,4.0,1,1065,77,21406,3092,235645,257051,11/24/2020
2020-08-25,108,30891,4764,464391,495282,10.0,2497.0,4.0,2082.0,1.0,334.0,81.0,12.0,4.0,1,1066,92,21498,2257,237902,259400,11/24/2020
2020-08-26,170,31061,9482,473873,504934,4.0,2501.0,8.0,2090.0,0.0,334.0,77.0,10.0,5.0,1,1067,128,21626,3046,240948,262574,11/24/2020
2020-08-27,91,31152,8565,482438,513590,6.0,2507.0,13.0,2103.0,1.0,335.0,69.0,7.0,5.0,2,1069,70,21696,3098,244046,265742,11/24/2020
2020-08-28,113,31265,7994,490432,521697,14.0,2521.0,4.0,2107.0,0.0,335.0,79.0,10.0,7.0,2,1071,87,21783,2393,246439,268222,11/24/2020
2020-08-29,65,31330,5374,495806,527136,6.0,2527.0,8.0,2115.0,1.0,336.0,76.0,11.0,6.0,2,1073,51,21834,1893,248332,270166,11/24/2020
2020-08-30,66,31396,4323,500129,531525,7.0,2534.0,4.0,2119.0,0.0,336.0,79.0,9.0,5.0,2,1075,48,21882,1954,250286,272168,11/24/2020
2020-08-31,105,31501,4863,504992,536493,12.0,2546.0,16.0,2135.0,0.0,336.0,75.0,8.0,4.0,1,1076,81,21963,2155,252441,274404,11/24/2020
2020-09-01,99,31600,7109,512101,543701,6.0,2552.0,9.0,2144.0,1.0,337.0,71.0,7.0,4.0,2,1078,66,22029,2341,254782,276811,11/24/2020
2020-09-02,125,31725,10529,522630,554355,9.0,2561.0,10.0,2154.0,1.0,338.0,69.0,8.0,4.0,2,1080,104,22133,3003,257785,279918,11/24/2020
2020-09-03,90,31815,11080,533710,565525,8.0,2569.0,8.0,2162.0,0.0,338.0,69.0,9.0,4.0,3,1083,73,22206,2536,260321,282527,11/24/2020
2020-09-04,103,31918,8963,542673,574591,11.0,2580.0,4.0,2166.0,0.0,338.0,76.0,9.0,4.0,1,1084,83,22289,2335,262656,284945,11/24/2020
2020-09-05,52,31970,6309,548982,580952,6.0,2586.0,9.0,2175.0,0.0,338.0,73.0,8.0,3.0,1,1085,42,22331,1571,264227,286558,11/24/2020
2020-09-06,88,32058,4325,553307,585365,4.0,2590.0,8.0,2183.0,1.0,339.0,68.0,6.0,3.0,1,1086,65,22396,1917,266144,288540,11/24/2020
2020-09-07,35,32093,3002,556309,588402,11.0,2601.0,3.0,2186.0,0.0,339.0,76.0,5.0,3.0,1,1087,26,22422,632,266776,289198,11/24/2020
2020-09-08,74,32167,6381,562690,594857,6.0,2607.0,12.0,2198.0,1.0,340.0,69.0,6.0,3.0,2,1089,66,22488,1567,268343,290831,11/24/2020
2020-09-09,118,32285,8650,571340,603625,10.0,2617.0,5.0,2203.0,1.0,341.0,73.0,9.0,3.0,1,1090,102,22590,2102,270445,293035,11/24/2020
2020-09-10,164,32449,11334,582674,615123,9.0,2626.0,8.0,2211.0,0.0,341.0,74.0,10.0,3.0,1,1091,111,22701,2234,272679,295380,11/24/2020
2020-09-11,120,32569,9454,592128,624697,11.0,2637.0,11.0,2222.0,0.0,341.0,74.0,10.0,5.0,0,1091,97,22798,1941,274620,297418,11/24/2020
2020-09-12,110,32679,6174,598302,630981,8.0,2645.0,5.0,2227.0,2.0,343.0,75.0,9.0,5.0,3,1094,97,22895,1492,276112,299007,11/24/2020
2020-09-13,58,32737,2717,601019,633756,4.0,2649.0,3.0,2230.0,0.0,343.0,76.0,10.0,5.0,0,1094,54,22949,847,276959,299908,11/24/2020
2020-09-14,104,32841,6446,607465,640306,6.0,2655.0,3.0,2233.0,2.0,345.0,77.0,10.0,5.0,2,1096,95,23044,1705,278664,301708,11/24/2020
2020-09-15,122,32963,8470,615935,648898,7.0,2662.0,2.0,2235.0,1.0,346.0,81.0,10.0,5.0,2,1098,124,23168,2158,280822,303990,11/24/2020
2020-09-16,137,33100,9716,625651,658751,7.0,2669.0,7.0,2242.0,2.0,348.0,79.0,9.0,6.0,5,1103,118,23286,1948,282770,306056,11/24/2020
2020-09-17,125,33225,9239,634890,668115,7.0,2676.0,15.0,2257.0,0.0,348.0,71.0,8.0,4.0,0,1103,154,23440,1916,284686,308126,11/24/2020
2020-09-18,132,33357,10045,644935,678292,7.0,2683.0,7.0,2264.0,1.0,349.0,70.0,11.0,6.0,2,1105,132,23572,1900,286586,310158,11/24/2020
2020-09-19,115,33472,8297,653232,686704,7.0,2690.0,3.0,2267.0,0.0,349.0,74.0,10.0,6.0,4,1109,112,23684,1677,288263,311947,11/24/2020
2020-09-20,60,33532,3676,656908,690440,7.0,2697.0,6.0,2273.0,2.0,351.0,73.0,9.0,8.0,4,1113,49,23733,1302,289565,313298,11/24/2020
2020-09-21,102,33634,7018,663926,697560,12.0,2709.0,3.0,2276.0,2.0,353.0,80.0,8.0,6.0,2,1115,94,23827,2376,291941,315768,11/24/2020
2020-09-22,154,33788,9287,673213,707001,12.0,2721.0,3.0,2279.0,1.0,354.0,88.0,7.0,5.0,1,1116,124,23951,2174,294115,318066,11/24/2020
2020-09-23,136,33924,10651,683864,717788,12.0,2733.0,7.0,2286.0,0.0,354.0,93.0,6.0,5.0,0,1116,127,24078,2184,296299,320377,11/24/2020
2020-09-24,120,34044,12480,696344,730388,7.0,2740.0,9.0,2295.0,1.0,355.0,90.0,7.0,5.0,1,1117,121,24199,3125,299424,323623,11/24/2020
2020-09-25,149,34193,10553,706897,741090,9.0,2749.0,10.0,2305.0,0.0,355.0,89.0,6.0,5.0,1,1118,142,24341,2965,302389,326730,11/24/2020
2020-09-26,146,34339,10559,717456,751795,12.0,2761.0,9.0,2314.0,0.0,355.0,92.0,6.0,5.0,1,1119,119,24460,2400,304789,329249,11/24/2020
2020-09-27,43,34382,2764,720220,754602,7.0,2768.0,5.0,2319.0,0.0,355.0,94.0,9.0,5.0,0,1119,34,24494,834,305623,330117,11/24/2020
2020-09-28,152,34534,7308,727528,762062,7.0,2775.0,7.0,2326.0,2.0,357.0,92.0,7.0,5.0,2,1121,134,24628,2233,307856,332484,11/24/2020
2020-09-29,208,34742,11046,738574,773316,12.0,2787.0,18.0,2344.0,1.0,358.0,85.0,6.0,6.0,1,1122,190,24818,2793,310649,335467,11/24/2020
2020-09-30,221,34963,12230,750804,785767,6.0,2793.0,6.0,2350.0,0.0,358.0,85.0,6.0,6.0,1,1123,187,25005,2547,313196,338201,11/24/2020
2020-10-01,185,35148,12503,763307,798455,17.0,2810.0,13.0,2363.0,1.0,359.0,88.0,6.0,4.0,2,1125,166,25171,2381,315577,340748,11/24/2020
2020-10-02,210,35358,12153,775460,810818,14.0,2824.0,13.0,2376.0,1.0,360.0,88.0,8.0,5.0,2,1127,182,25353,2464,318041,343394,11/24/2020
2020-10-03,157,35515,9313,784773,820288,9.0,2833.0,9.0,2385.0,2.0,362.0,86.0,9.0,4.0,2,1129,131,25484,1999,320040,345524,11/24/2020
2020-10-04,81,35596,2369,787142,822738,11.0,2844.0,9.0,2394.0,1.0,363.0,87.0,8.0,5.0,2,1131,78,25562,943,320983,346545,11/24/2020
2020-10-05,174,35770,8983,796125,831895,30.0,2874.0,10.0,2404.0,2.0,365.0,105.0,9.0,6.0,4,1135,160,25722,2999,323982,349704,11/24/2020
2020-10-06,177,35947,11186,807311,843258,11.0,2885.0,4.0,2408.0,0.0,365.0,112.0,11.0,7.0,0,1135,186,25908,2870,326852,352760,11/24/2020
2020-10-07,231,36178,12441,819752,855930,13.0,2898.0,14.0,2422.0,2.0,367.0,109.0,9.0,7.0,2,1137,243,26151,3503,330355,356506,11/24/2020
2020-10-08,262,36440,15230,834982,871422,17.0,2915.0,13.0,2435.0,2.0,369.0,111.0,7.0,5.0,4,1141,272,26423,4168,334523,360946,11/24/2020
2020-10-09,217,36657,13745,848727,885384,21.0,2936.0,12.0,2447.0,0.0,369.0,120.0,10.0,7.0,3,1144,199,26622,4279,338802,365424,11/24/2020
2020-10-10,229,36886,13832,862559,899445,19.0,2955.0,10.0,2457.0,1.0,370.0,128.0,13.0,7.0,2,1146,194,26816,3755,342557,369373,11/24/2020
2020-10-11,97,36983,3263,865822,902805,12.0,2967.0,9.0,2466.0,1.0,371.0,130.0,14.0,5.0,6,1152,88,26904,1155,343712,370616,11/24/2020
2020-10-12,169,37152,6440,872262,909414,19.0,2986.0,15.0,2481.0,2.0,373.0,132.0,14.0,5.0,4,1156,159,27063,1707,345419,372482,11/24/2020
2020-10-13,213,37365,8521,880783,918148,15.0,3001.0,13.0,2494.0,4.0,377.0,130.0,13.0,5.0,7,1163,207,27270,2291,347710,374980,11/24/2020
2020-10-14,322,37687,15038,895821,933508,17.0,3018.0,7.0,2501.0,0.0,377.0,140.0,15.0,5.0,2,1165,301,27571,3995,351705,379276,11/24/2020
2020-10-15,262,37949,14639,910460,948409,12.0,3030.0,16.0,2517.0,1.0,378.0,135.0,13.0,5.0,2,1167,254,27825,3545,355250,383075,11/24/2020
2020-10-16,279,38228,15011,925471,963699,13.0,3043.0,18.0,2535.0,1.0,379.0,129.0,13.0,4.0,2,1169,275,28100,3348,358598,386698,11/24/2020
2020-10-17,354,38582,14068,939539,978121,19.0,3062.0,11.0,2546.0,1.0,380.0,136.0,17.0,4.0,2,1171,311,28411,3232,361830,390241,11/24/2020
2020-10-18,155,38737,4039,943578,982315,18.0,3080.0,11.0,2557.0,0.0,380.0,143.0,17.0,6.0,2,1173,129,28540,1305,363135,391675,11/24/2020
2020-10-19,388,39125,8491,952069,991194,21.0,3101.0,22.0,2579.0,2.0,382.0,140.0,15.0,6.0,1,1174,325,28865,2539,365674,394539,11/24/2020
2020-10-20,439,39564,13242,965311,1004875,22.0,3123.0,17.0,2596.0,0.0,382.0,145.0,14.0,8.0,3,1177,387,29252,2977,368651,397903,11/24/2020
2020-10-21,544,40108,17462,982773,1022881,21.0,3144.0,8.0,2604.0,2.0,384.0,156.0,15.0,9.0,3,1180,472,29724,3491,372142,401866,11/24/2020
2020-10-22,538,40646,15863,998636,1039282,24.0,3168.0,20.0,2624.0,3.0,387.0,157.0,14.0,9.0,3,1183,489,30213,3166,375308,405521,11/24/2020
2020-10-23,514,41160,16634,1015270,1056430,22.0,3190.0,22.0,2646.0,1.0,388.0,156.0,15.0,9.0,3,1186,460,30673,2857,378165,408838,11/24/2020
2020-10-24,359,41519,10249,1025519,1067038,17.0,3207.0,11.0,2657.0,0.0,388.0,162.0,14.0,8.0,1,1187,338,31011,2249,380414,411425,11/24/2020
2020-10-25,233,41752,4760,1030279,1072031,16.0,3223.0,15.0,2672.0,1.0,389.0,162.0,15.0,8.0,2,1189,209,31220,1449,381863,413083,11/24/2020
2020-10-26,454,42206,9174,1039453,1081659,26.0,3249.0,15.0,2687.0,2.0,391.0,171.0,18.0,8.0,3,1192,403,31623,2952,384815,416438,11/24/2020
2020-10-27,517,42723,13994,1053447,1096170,29.0,3278.0,15.0,2702.0,2.0,393.0,183.0,18.0,9.0,4,1196,453,32076,2370,387185,419261,11/24/2020
2020-10-28,469,43192,15229,1068676,1111868,25.0,3303.0,26.0,2728.0,1.0,394.0,181.0,17.0,9.0,3,1199,409,32485,2682,389867,422352,11/24/2020
2020-10-29,609,43801,16258,1084934,1128735,20.0,3323.0,22.0,2750.0,3.0,397.0,176.0,19.0,11.0,4,1203,529,33014,3108,392975,425989,11/24/2020
2020-10-30,565,44366,14861,1099795,1144161,21.0,3344.0,21.0,2771.0,5.0,402.0,171.0,19.0,9.0,4,1207,467,33481,2924,395899,429380,11/24/2020
2020-10-31,599,44965,11820,1111615,1156580,31.0,3375.0,13.0,2784.0,1.0,403.0,188.0,22.0,9.0,3,1210,487,33968,2401,398300,432268,11/24/2020
2020-11-01,330,45295,5091,1116706,1162001,20.0,3395.0,15.0,2799.0,1.0,404.0,192.0,26.0,12.0,4,1214,273,34241,1257,399557,433798,11/24/2020
2020-11-02,521,45816,9931,1126637,1172453,36.0,3431.0,27.0,2826.0,3.0,407.0,198.0,24.0,11.0,5,1219,454,34695,2913,402470,437165,11/24/2020
2020-11-03,602,46418,13040,1139677,1186095,32.0,3463.0,25.0,2851.0,1.0,408.0,204.0,23.0,11.0,1,1220,527,35222,2507,404977,440199,11/24/2020
2020-11-04,679,47097,16100,1155777,1202874,34.0,3497.0,27.0,2878.0,2.0,410.0,209.0,23.0,11.0,4,1224,626,35848,2912,407889,443737,11/24/2020
2020-11-05,760,47857,18887,1174664,1222521,46.0,3543.0,35.0,2913.0,1.0,411.0,219.0,22.0,13.0,3,1227,673,36521,5137,413026,449547,11/24/2020
2020-11-06,777,48634,17301,1191965,1240599,43.0,3586.0,31.0,2944.0,1.0,412.0,230.0,27.0,16.0,5,1232,700,37221,4313,417339,454560,11/24/2020
2020-11-07,608,49242,13649,1205614,1254856,34.0,3620.0,25.0,2969.0,1.0,413.0,238.0,30.0,17.0,1,1233,580,37801,2458,419797,457598,11/24/2020
2020-11-08,338,49580,4161,1209775,1259355,31.0,3651.0,26.0,2995.0,1.0,414.0,242.0,29.0,18.0,4,1237,322,38123,1275,421072,459195,11/24/2020
2020-11-09,807,50387,9039,1218814,1269201,39.0,3690.0,33.0,3028.0,2.0,416.0,246.0,27.0,17.0,3,1240,762,38885,2304,423376,462261,11/24/2020
2020-11-10,1061,51448,12983,1231797,1283245,45.0,3735.0,37.0,3065.0,0.0,416.0,254.0,30.0,17.0,6,1246,985,39870,2883,426259,466129,11/24/2020
2020-11-11,1088,52536,19741,1251538,1304074,40.0,3775.0,24.0,3089.0,5.0,421.0,265.0,29.0,14.0,6,1252,1005,40875,2689,428948,469823,11/24/2020
2020-11-12,890,53426,13901,1265439,1318865,37.0,3812.0,31.0,3120.0,3.0,424.0,268.0,27.0,14.0,5,1257,808,41683,2206,431154,472837,11/24/2020
2020-11-13,1154,54580,16389,1281828,1336408,36.0,3848.0,31.0,3151.0,0.0,424.0,273.0,26.0,14.0,2,1259,1099,42782,3112,434266,477048,11/24/2020
2020-11-14,781,55361,13517,1295345,1350706,38.0,3886.0,26.0,3177.0,5.0,429.0,280.0,24.0,12.0,10,1269,737,43519,2470,436736,480255,11/24/2020
2020-11-15,578,55939,6173,1301518,1357457,41.0,3927.0,21.0,3198.0,5.0,434.0,295.0,26.0,11.0,7,1276,490,44009,1437,438173,482182,11/24/2020
2020-11-16,731,56670,9614,1311132,1367802,53.0,3980.0,38.0,3236.0,3.0,437.0,307.0,25.0,13.0,5,1281,663,44672,2625,440798,485470,11/24/2020
2020-11-17,1541,58211,18171,1329303,1387514,57.0,4037.0,44.0,3280.0,2.0,439.0,318.0,28.0,13.0,5,1286,1401,46073,4175,444973,491046,11/24/2020
2020-11-18,1129,59340,16025,1345328,1404668,35.0,4072.0,38.0,3318.0,5.0,444.0,310.0,27.0,15.0,7,1293,1015,47088,3209,448182,495270,11/24/2020
2020-11-19,1132,60472,13137,1358465,1418937,42.0,4114.0,42.0,3360.0,4.0,448.0,306.0,27.0,18.0,2,1295,1035,48123,3437,451619,499742,11/24/2020
2020-11-20,1430,61902,22149,1380614,1442516,46.0,4160.0,48.0,3408.0,3.0,451.0,301.0,30.0,14.0,6,1301,1287,49410,4327,455946,505356,11/24/2020
2020-11-21,843,62745,17284,1397898,1460643,39.0,4199.0,34.0,3442.0,5.0,456.0,301.0,32.0,14.0,6,1307,746,50156,3174,459120,509276,11/24/2020
2020-11-22,547,63292,7387,1405285,1468577,53.0,4252.0,27.0,3469.0,4.0,460.0,323.0,30.0,16.0,10,1317,456,50612,1756,460876,511488,11/24/2020
2020-11-23,915,64207,10353,1415638,1479845,,,,,,,,,,8,1325,812,51424,3343,464219,515643,11/24/2020
2020-02-27,0,0,0,0,0,1.0,1.0,0.0,0.0,0.0,0.0,1.0,0.0,0.0,0,0,0,0,0,0,0,11/25/2020
2020-02-28,0,0,0,0,0,0.0,1.0,0.0,0.0,0.0,0.0,1.0,1.0,0.0,0,0,0,0,0,0,0,11/25/2020
2020-02-29,0,0,0,0,0,0.0,1.0,0.0,0.0,0.0,0.0,1.0,1.0,0.0,0,0,0,0,0,0,0,11/25/2020
2020-03-01,2,2,2,2,4,0.0,1.0,0.0,0.0,0.0,0.0,1.0,1.0,1.0,0,0,2,2,2,2,4,11/25/2020
2020-03-02,0,2,1,3,5,1.0,2.0,0.0,0.0,0.0,0.0,2.0,2.0,2.0,0,0,0,2,0,2,4,11/25/2020
2020-03-03,0,2,2,5,7,0.0,2.0,0.0,0.0,0.0,0.0,2.0,2.0,2.0,0,0,0,2,1,3,5,11/25/2020
2020-03-04,0,2,12,17,19,1.0,3.0,0.0,0.0,0.0,0.0,3.0,2.0,2.0,0,0,0,2,10,13,15,11/25/2020
2020-03-05,0,2,4,21,23,0.0,3.0,0.0,0.0,0.0,0.0,3.0,2.0,2.0,0,0,1,3,4,17,20,11/25/2020
2020-03-06,1,3,12,33,36,0.0,3.0,0.0,0.0,0.0,0.0,3.0,2.0,2.0,0,0,0,3,11,28,31,11/25/2020
2020-03-07,0,3,19,52,55,0.0,3.0,0.0,0.0,0.0,0.0,3.0,2.0,1.0,0,0,0,3,19,47,50,11/25/2020
2020-03-08,0,3,18,70,73,0.0,3.0,0.0,0.0,0.0,0.0,3.0,2.0,1.0,0,0,0,3,18,65,68,11/25/2020
2020-03-09,1,4,15,85,89,0.0,3.0,0.0,0.0,0.0,0.0,3.0,2.0,1.0,0,0,1,4,14,79,83,11/25/2020
2020-03-10,2,6,25,110,116,0.0,3.0,0.0,0.0,0.0,0.0,3.0,2.0,1.0,0,0,1,5,23,102,107,11/25/2020
2020-03-11,0,6,34,144,150,1.0,4.0,0.0,0.0,0.0,0.0,4.0,1.0,1.0,0,0,0,5,34,136,141,11/25/2020
2020-03-12,9,15,41,185,200,1.0,5.0,0.0,0.0,0.0,0.0,5.0,1.0,1.0,0,0,8,13,38,174,187,11/25/2020
2020-03-13,6,21,50,235,256,4.0,9.0,1.0,1.0,0.0,0.0,8.0,1.0,1.0,0,0,6,19,47,221,240,11/25/2020
2020-03-14,0,21,90,325,346,0.0,9.0,0.0,1.0,0.0,0.0,8.0,1.0,1.0,0,0,0,19,83,304,323,11/25/2020
2020-03-15,1,22,54,379,401,1.0,10.0,0.0,1.0,0.0,0.0,9.0,2.0,1.0,0,0,1,20,53,357,377,11/25/2020
2020-03-16,2,24,95,474,498,2.0,12.0,0.0,1.0,0.0,0.0,11.0,2.0,0.0,0,0,2,22,91,448,470,11/25/2020
2020-03-17,12,36,162,636,672,6.0,18.0,0.0,1.0,0.0,0.0,17.0,2.0,0.0,0,0,11,33,147,595,628,11/25/2020
2020-03-18,9,45,116,752,797,3.0,21.0,0.0,1.0,0.0,0.0,20.0,2.0,0.0,0,0,11,44,108,703,747,11/25/2020
2020-03-19,15,60,262,1014,1074,2.0,23.0,1.0,2.0,0.0,0.0,21.0,3.0,0.0,1,1,17,61,246,949,1010,11/25/2020
2020-03-20,13,73,197,1211,1284,5.0,28.0,0.0,2.0,0.0,0.0,26.0,4.0,0.0,0,1,13,74,186,1135,1209,11/25/2020
2020-03-21,12,85,126,1337,1422,3.0,31.0,2.0,4.0,0.0,0.0,27.0,5.0,0.0,0,1,14,88,121,1256,1344,11/25/2020
2020-03-22,27,112,282,1619,1731,2.0,33.0,0.0,4.0,0.0,0.0,29.0,5.0,0.0,0,1,25,113,256,1512,1625,11/25/2020
2020-03-23,14,126,169,1788,1914,15.0,48.0,1.0,5.0,0.0,0.0,43.0,9.0,3.0,0,1,16,129,159,1671,1800,11/25/2020
2020-03-24,20,146,242,2030,2176,8.0,56.0,0.0,5.0,0.0,0.0,51.0,10.0,5.0,0,1,19,148,227,1898,2046,11/25/2020
2020-03-25,26,172,182,2212,2384,5.0,61.0,2.0,7.0,0.0,0.0,54.0,11.0,3.0,0,1,28,176,161,2059,2235,11/25/2020
2020-03-26,35,207,181,2393,2600,9.0,70.0,5.0,12.0,0.0,0.0,58.0,14.0,5.0,0,1,41,217,168,2227,2444,11/25/2020
2020-03-27,27,234,214,2607,2841,9.0,79.0,1.0,13.0,1.0,1.0,65.0,16.0,6.0,2,3,31,248,189,2416,2664,11/25/2020
2020-03-28,59,293,260,2867,3160,11.0,90.0,2.0,15.0,1.0,2.0,73.0,15.0,6.0,1,4,64,312,239,2655,2967,11/25/2020
2020-03-29,100,393,350,3217,3610,8.0,98.0,3.0,18.0,1.0,3.0,77.0,18.0,8.0,2,6,105,417,306,2961,3378,11/25/2020
2020-03-30,62,455,222,3439,3894,19.0,117.0,5.0,23.0,0.0,3.0,91.0,19.0,11.0,3,9,78,495,180,3141,3636,11/25/2020
2020-03-31,71,526,369,3808,4334,11.0,128.0,7.0,30.0,1.0,4.0,94.0,21.0,13.0,2,11,73,568,293,3434,4002,11/25/2020
2020-04-01,99,625,698,4506,5131,18.0,146.0,7.0,37.0,0.0,4.0,105.0,29.0,15.0,1,12,100,668,614,4048,4716,11/25/2020
2020-04-02,52,677,477,4983,5660,22.0,168.0,6.0,43.0,2.0,6.0,119.0,35.0,21.0,4,16,62,730,421,4469,5199,11/25/2020
2020-04-03,108,785,774,5757,6542,23.0,191.0,7.0,50.0,0.0,6.0,135.0,42.0,25.0,3,19,100,830,683,5152,5982,11/25/2020
2020-04-04,143,928,660,6417,7345,22.0,213.0,4.0,54.0,5.0,11.0,148.0,40.0,29.0,9,28,138,968,591,5743,6711,11/25/2020
2020-04-05,187,1115,1156,7573,8688,20.0,233.0,9.0,63.0,1.0,12.0,158.0,43.0,35.0,2,30,181,1149,1017,6760,7909,11/25/2020
2020-04-06,218,1333,1706,9279,10612,26.0,259.0,7.0,70.0,0.0,12.0,177.0,47.0,39.0,7,37,207,1356,1498,8258,9614,11/25/2020
2020-04-07,284,1617,1629,10908,12525,20.0,279.0,4.0,74.0,2.0,14.0,191.0,49.0,41.0,5,42,261,1617,1437,9695,11312,11/25/2020
2020-04-08,290,1907,1720,12628,14535,19.0,298.0,8.0,82.0,5.0,19.0,197.0,49.0,37.0,10,52,271,1888,1499,11194,13082,11/25/2020
2020-04-09,283,2190,1516,14144,16334,32.0,330.0,8.0,90.0,4.0,23.0,217.0,53.0,40.0,7,59,277,2165,1309,12503,14668,11/25/2020
2020-04-10,419,2609,2574,16718,19327,29.0,359.0,17.0,107.0,5.0,28.0,224.0,59.0,41.0,11,70,400,2565,2280,14783,17348,11/25/2020
2020-04-11,297,2906,1905,18623,21529,29.0,388.0,11.0,118.0,2.0,30.0,240.0,61.0,48.0,12,82,281,2846,1666,16449,19295,11/25/2020
2020-04-12,314,3220,1670,20293,23513,35.0,423.0,13.0,131.0,5.0,35.0,257.0,59.0,49.0,9,91,286,3132,1369,17818,20950,11/25/2020
2020-04-13,161,3381,935,21228,24609,35.0,458.0,13.0,144.0,3.0,38.0,276.0,64.0,54.0,9,100,187,3319,815,18633,21952,11/25/2020
2020-04-14,289,3670,1787,23015,26685,27.0,485.0,18.0,162.0,5.0,43.0,280.0,72.0,53.0,8,108,262,3581,1468,20101,23682,11/25/2020
2020-04-15,351,4021,1799,24814,28835,31.0,516.0,20.0,182.0,3.0,46.0,288.0,72.0,54.0,17,125,306,3887,1473,21574,25461,11/25/2020
2020-04-16,447,4468,2494,27308,31776,36.0,552.0,25.0,207.0,6.0,52.0,293.0,72.0,53.0,14,139,387,4274,1973,23547,27821,11/25/2020
2020-04-17,304,4772,1821,29129,33901,32.0,584.0,20.0,227.0,7.0,59.0,298.0,66.0,45.0,21,160,290,4564,1388,24935,29499,11/25/2020
2020-04-18,321,5093,1725,30854,35947,26.0,610.0,18.0,245.0,4.0,63.0,302.0,63.0,49.0,15,175,284,4848,1273,26208,31056,11/25/2020
2020-04-19,381,5474,2047,32901,38375,23.0,633.0,26.0,271.0,1.0,64.0,298.0,65.0,55.0,11,186,337,5185,1677,27885,33070,11/25/2020
2020-04-20,394,5868,1907,34808,40676,46.0,679.0,29.0,300.0,2.0,66.0,313.0,75.0,56.0,10,196,376,5561,1531,29416,34977,11/25/2020
2020-04-21,444,6312,2110,36918,43230,45.0,724.0,32.0,332.0,5.0,71.0,321.0,72.0,56.0,18,214,383,5944,1649,31065,37009,11/25/2020
2020-04-22,418,6730,2390,39308,46038,41.0,765.0,32.0,364.0,5.0,76.0,325.0,73.0,58.0,18,232,379,6323,1849,32914,39237,11/25/2020
2020-04-23,479,7209,2469,41777,48986,32.0,797.0,28.0,392.0,5.0,81.0,324.0,76.0,62.0,15,247,412,6735,1788,34702,41437,11/25/2020
2020-04-24,491,7700,3284,45061,52761,35.0,832.0,26.0,418.0,4.0,85.0,329.0,85.0,63.0,15,262,407,7142,2529,37231,44373,11/25/2020
2020-04-25,393,8093,2206,47267,55360,34.0,866.0,17.0,435.0,5.0,90.0,341.0,85.0,62.0,14,276,299,7441,1697,38928,46369,11/25/2020
2020-04-26,316,8409,2309,49576,57985,33.0,899.0,15.0,450.0,3.0,93.0,356.0,86.0,59.0,14,290,274,7715,1799,40727,48442,11/25/2020
2020-04-27,249,8658,1620,51196,59854,29.0,928.0,21.0,471.0,4.0,97.0,360.0,86.0,61.0,10,300,206,7921,1109,41836,49757,11/25/2020
2020-04-28,410,9068,2263,53459,62527,44.0,972.0,24.0,495.0,3.0,100.0,377.0,88.0,59.0,22,322,332,8253,1648,43484,51737,11/25/2020
2020-04-29,476,9544,3343,56802,66346,36.0,1008.0,38.0,533.0,11.0,111.0,364.0,78.0,53.0,18,340,370,8623,2293,45777,54400,11/25/2020
2020-04-30,432,9976,2769,59571,69547,33.0,1041.0,38.0,571.0,6.0,117.0,353.0,83.0,57.0,24,364,350,8973,1798,47575,56548,11/25/2020
2020-05-01,454,10430,3086,62657,73087,52.0,1093.0,39.0,610.0,3.0,120.0,363.0,84.0,58.0,14,378,323,9296,2038,49613,58909,11/25/2020
2020-05-02,257,10687,1926,64583,75270,36.0,1129.0,38.0,648.0,5.0,125.0,356.0,93.0,63.0,24,402,192,9488,1228,50841,60329,11/25/2020
2020-05-03,283,10970,2160,66743,77713,31.0,1160.0,27.0,675.0,8.0,133.0,352.0,91.0,61.0,21,423,183,9671,1498,52339,62010,11/25/2020
2020-05-04,387,11357,2098,68841,80198,30.0,1190.0,31.0,706.0,5.0,138.0,346.0,89.0,58.0,18,441,290,9961,1507,53846,63807,11/25/2020
2020-05-05,433,11790,2873,71714,83504,29.0,1219.0,32.0,738.0,6.0,144.0,337.0,83.0,55.0,16,457,300,10261,1881,55727,65988,11/25/2020
2020-05-06,488,12278,2830,74544,86822,28.0,1247.0,44.0,782.0,9.0,153.0,312.0,80.0,55.0,21,478,340,10601,1855,57582,68183,11/25/2020
2020-05-07,425,12703,2969,77513,90216,36.0,1283.0,44.0,826.0,5.0,158.0,299.0,72.0,53.0,21,499,269,10870,1893,59475,70345,11/25/2020
2020-05-08,359,13062,2598,80111,93173,30.0,1313.0,29.0,855.0,5.0,163.0,295.0,72.0,54.0,22,521,229,11099,1671,61146,72245,11/25/2020
2020-05-09,467,13529,3346,83457,96986,22.0,1335.0,21.0,876.0,4.0,167.0,292.0,70.0,52.0,15,536,290,11389,2160,63306,74695,11/25/2020
2020-05-10,285,13814,2117,85574,99388,20.0,1355.0,23.0,899.0,6.0,173.0,283.0,71.0,50.0,14,550,189,11578,1448,64754,76332,11/25/2020
2020-05-11,257,14071,1857,87431,101502,31.0,1386.0,16.0,915.0,6.0,179.0,292.0,72.0,50.0,15,565,174,11752,1247,66001,77753,11/25/2020
2020-05-12,387,14458,2611,90042,104500,23.0,1409.0,18.0,933.0,4.0,183.0,293.0,70.0,49.0,22,587,224,11976,1606,67607,79583,11/25/2020
2020-05-13,351,14809,3630,93672,108481,23.0,1432.0,25.0,958.0,1.0,184.0,290.0,70.0,50.0,13,600,199,12175,1872,69479,81654,11/25/2020
2020-05-14,329,15138,3408,97080,112218,19.0,1451.0,27.0,985.0,3.0,187.0,279.0,65.0,46.0,15,615,232,12407,1906,71385,83792,11/25/2020
2020-05-15,381,15519,3458,100538,116057,24.0,1475.0,41.0,1026.0,5.0,192.0,257.0,63.0,46.0,14,629,232,12639,1751,73136,85775,11/25/2020
2020-05-16,449,15968,4156,104694,120662,25.0,1500.0,15.0,1041.0,5.0,197.0,262.0,62.0,47.0,15,644,247,12886,1869,75005,87891,11/25/2020
2020-05-17,240,16208,2768,107462,123670,17.0,1517.0,9.0,1050.0,5.0,202.0,265.0,60.0,46.0,10,654,126,13012,1489,76494,89506,11/25/2020
2020-05-18,250,16458,2001,109463,125921,19.0,1536.0,16.0,1066.0,5.0,207.0,263.0,58.0,41.0,18,672,135,13147,1321,77815,90962,11/25/2020
2020-05-19,415,16873,3168,112631,129504,23.0,1559.0,33.0,1099.0,5.0,212.0,248.0,57.0,39.0,11,683,215,13362,1875,79690,93052,11/25/2020
2020-05-20,326,17199,2771,115402,132601,19.0,1578.0,23.0,1122.0,7.0,219.0,237.0,53.0,34.0,22,705,184,13546,1484,81174,94720,11/25/2020
2020-05-21,374,17573,3757,119159,136732,25.0,1603.0,15.0,1137.0,3.0,222.0,244.0,54.0,30.0,20,725,168,13714,1881,83055,96769,11/25/2020
2020-05-22,351,17924,3161,122320,140244,20.0,1623.0,28.0,1165.0,5.0,227.0,231.0,53.0,30.0,11,736,206,13920,1550,84605,98525,11/25/2020
2020-05-23,253,18177,2742,125062,143239,19.0,1642.0,11.0,1176.0,3.0,230.0,236.0,53.0,33.0,13,749,109,14029,1233,85838,99867,11/25/2020
2020-05-24,163,18340,1370,126432,144772,13.0,1655.0,14.0,1190.0,2.0,232.0,233.0,54.0,36.0,8,757,83,14112,754,86592,100704,11/25/2020
2020-05-25,147,18487,1385,127817,146304,14.0,1669.0,14.0,1204.0,0.0,232.0,233.0,54.0,34.0,10,767,76,14188,713,87305,101493,11/25/2020
2020-05-26,285,18772,2620,130437,149209,24.0,1693.0,21.0,1225.0,5.0,237.0,231.0,49.0,33.0,15,782,158,14346,1613,88918,103264,11/25/2020
2020-05-27,276,19048,2057,132494,151542,20.0,1713.0,18.0,1243.0,3.0,240.0,230.0,51.0,33.0,10,792,132,14478,1105,90023,104501,11/25/2020
2020-05-28,348,19396,3359,135853,155249,17.0,1730.0,29.0,1272.0,4.0,244.0,214.0,47.0,32.0,8,800,130,14608,1089,91112,105720,11/25/2020
2020-05-29,410,19806,3915,139768,159574,19.0,1749.0,26.0,1298.0,7.0,251.0,200.0,43.0,31.0,12,812,174,14782,1506,92618,107400,11/25/2020
2020-05-30,225,20031,3915,143683,163714,16.0,1765.0,19.0,1317.0,4.0,255.0,193.0,41.0,29.0,12,824,109,14891,1683,94301,109192,11/25/2020
2020-05-31,155,20186,1690,145373,165559,11.0,1776.0,11.0,1328.0,1.0,256.0,192.0,44.0,26.0,3,827,78,14969,802,95103,110072,11/25/2020
2020-06-01,212,20398,2792,148165,168563,8.0,1784.0,14.0,1342.0,1.0,257.0,185.0,45.0,29.0,5,832,93,15062,1338,96441,111503,11/25/2020
2020-06-02,273,20671,3022,151187,171858,8.0,1792.0,9.0,1351.0,3.0,260.0,181.0,38.0,25.0,10,842,98,15160,1392,97833,112993,11/25/2020
2020-06-03,254,20925,3486,154673,175598,14.0,1806.0,18.0,1369.0,6.0,266.0,171.0,34.0,25.0,11,853,99,15259,1609,99442,114701,11/25/2020
2020-06-04,276,21201,4471,159144,180345,7.0,1813.0,26.0,1395.0,4.0,270.0,148.0,31.0,24.0,12,865,107,15366,1966,101408,116774,11/25/2020
2020-06-05,215,21416,3513,162657,184073,15.0,1828.0,13.0,1408.0,6.0,276.0,144.0,27.0,21.0,11,876,99,15465,1508,102916,118381,11/25/2020
2020-06-06,201,21617,2616,165273,186890,10.0,1838.0,7.0,1415.0,2.0,278.0,145.0,29.0,19.0,6,882,67,15532,1088,104004,119536,11/25/2020
2020-06-07,83,21700,1625,166898,188598,11.0,1849.0,7.0,1422.0,1.0,279.0,148.0,25.0,17.0,4,886,51,15583,772,104776,120359,11/25/2020
2020-06-08,119,21819,1849,168747,190566,15.0,1864.0,13.0,1435.0,2.0,281.0,148.0,27.0,18.0,4,890,45,15628,930,105706,121334,11/25/2020
2020-06-09,223,22042,2673,171420,193462,10.0,1874.0,19.0,1454.0,0.0,281.0,139.0,28.0,21.0,1,891,64,15692,1229,106935,122627,11/25/2020
2020-06-10,209,22251,2987,174407,196658,13.0,1887.0,12.0,1466.0,2.0,283.0,138.0,24.0,17.0,4,895,100,15792,1428,108363,124155,11/25/2020
2020-06-11,195,22446,3513,177920,200366,7.0,1894.0,15.0,1481.0,1.0,284.0,129.0,25.0,16.0,6,901,88,15880,1494,109857,125737,11/25/2020
2020-06-12,209,22655,4601,182521,205176,9.0,1903.0,16.0,1497.0,1.0,285.0,121.0,24.0,16.0,2,903,78,15958,2125,111982,127940,11/25/2020
2020-06-13,113,22768,3036,185557,208325,6.0,1909.0,5.0,1502.0,0.0,285.0,122.0,20.0,15.0,3,906,49,16007,1340,113322,129329,11/25/2020
2020-06-14,81,22849,2046,187603,210452,7.0,1916.0,8.0,1510.0,1.0,286.0,120.0,20.0,14.0,3,909,33,16040,947,114269,130309,11/25/2020
2020-06-15,188,23037,3108,190711,213748,14.0,1930.0,19.0,1529.0,0.0,286.0,115.0,20.0,16.0,5,914,75,16115,1742,116011,132126,11/25/2020
2020-06-16,110,23147,3017,193728,216875,11.0,1941.0,9.0,1538.0,1.0,287.0,116.0,22.0,16.0,8,922,50,16165,1503,117514,133679,11/25/2020
2020-06-17,127,23274,2835,196563,219837,15.0,1956.0,20.0,1558.0,4.0,291.0,107.0,18.0,14.0,6,928,51,16216,1283,118797,135013,11/25/2020
2020-06-18,149,23423,3048,199611,223034,9.0,1965.0,15.0,1573.0,1.0,292.0,100.0,19.0,16.0,7,935,70,16286,1288,120085,136371,11/25/2020
2020-06-19,141,23564,3769,203380,226944,12.0,1977.0,12.0,1585.0,1.0,293.0,99.0,20.0,17.0,3,938,59,16345,1325,121410,137755,11/25/2020
2020-06-20,84,23648,1891,205271,228919,9.0,1986.0,12.0,1597.0,0.0,293.0,96.0,20.0,18.0,4,942,36,16381,804,122214,138595,11/25/2020
2020-06-21,37,23685,1064,206335,230020,8.0,1994.0,5.0,1602.0,0.0,293.0,99.0,20.0,18.0,2,944,30,16411,678,122892,139303,11/25/2020
2020-06-22,138,23823,3730,210065,233888,12.0,2006.0,17.0,1619.0,0.0,293.0,94.0,19.0,18.0,2,946,65,16476,1668,124560,141036,11/25/2020
2020-06-23,163,23986,3831,213896,237882,3.0,2009.0,13.0,1632.0,3.0,296.0,81.0,18.0,18.0,7,953,81,16557,1747,126307,142864,11/25/2020
2020-06-24,120,24106,3502,217398,241504,9.0,2018.0,10.0,1642.0,1.0,297.0,79.0,18.0,18.0,5,958,44,16601,1650,127957,144558,11/25/2020
2020-06-25,103,24209,2883,220281,244490,6.0,2024.0,14.0,1656.0,1.0,298.0,70.0,17.0,17.0,1,959,50,16651,1470,129427,146078,11/25/2020
2020-06-26,94,24303,2488,222769,247072,2.0,2026.0,10.0,1666.0,0.0,298.0,62.0,18.0,18.0,1,960,60,16711,1298,130725,147436,11/25/2020
2020-06-27,84,24387,3216,225985,250372,5.0,2031.0,3.0,1669.0,1.0,299.0,63.0,17.0,17.0,5,965,37,16748,1182,131907,148655,11/25/2020
2020-06-28,39,24426,1469,227454,251880,4.0,2035.0,4.0,1673.0,4.0,303.0,59.0,15.0,14.0,6,971,17,16765,581,132488,149253,11/25/2020
2020-06-29,85,24511,3697,231151,255662,4.0,2039.0,5.0,1678.0,0.0,303.0,58.0,14.0,14.0,1,972,39,16804,1328,133816,150620,11/25/2020
2020-06-30,57,24568,1958,233109,257677,1.0,2040.0,5.0,1683.0,1.0,304.0,53.0,12.0,11.0,4,976,32,16836,979,134795,151631,11/25/2020
2020-07-01,144,24712,4098,237207,261919,8.0,2048.0,10.0,1693.0,0.0,304.0,51.0,11.0,11.0,1,977,79,16915,1882,136677,153592,11/25/2020
2020-07-02,103,24815,2803,240010,264825,5.0,2053.0,5.0,1698.0,1.0,305.0,50.0,10.0,10.0,3,980,59,16974,1057,137734,154708,11/25/2020
2020-07-03,50,24865,2079,242089,266954,9.0,2062.0,6.0,1704.0,0.0,305.0,53.0,9.0,9.0,3,983,25,16999,772,138506,155505,11/25/2020
2020-07-04,57,24922,2345,244434,269356,2.0,2064.0,4.0,1708.0,1.0,306.0,50.0,10.0,9.0,2,985,33,17032,981,139487,156519,11/25/2020
2020-07-05,49,24971,2932,247366,272337,1.0,2065.0,2.0,1710.0,1.0,307.0,48.0,8.0,8.0,2,987,26,17058,1399,140886,157944,11/25/2020
2020-07-06,101,25072,2814,250180,275252,6.0,2071.0,6.0,1716.0,0.0,307.0,48.0,9.0,9.0,4,991,57,17115,1519,142405,159520,11/25/2020
2020-07-07,81,25153,3457,253637,278790,5.0,2076.0,7.0,1723.0,0.0,307.0,46.0,8.0,8.0,2,993,47,17162,1510,143915,161077,11/25/2020
2020-07-08,105,25258,3409,257046,282304,4.0,2080.0,2.0,1725.0,0.0,307.0,48.0,9.0,8.0,0,993,64,17226,1378,145293,162519,11/25/2020
2020-07-09,94,25352,3714,260760,286112,9.0,2089.0,3.0,1728.0,0.0,307.0,54.0,9.0,8.0,0,993,50,17276,1581,146874,164150,11/25/2020
2020-07-10,132,25484,4437,265197,290681,6.0,2095.0,3.0,1731.0,2.0,309.0,55.0,7.0,7.0,3,996,80,17356,2023,148897,166253,11/25/2020
2020-07-11,63,25547,2938,268135,293682,6.0,2101.0,3.0,1734.0,1.0,310.0,57.0,6.0,6.0,3,999,36,17392,1294,150191,167583,11/25/2020
2020-07-12,47,25594,1838,269973,295567,1.0,2102.0,3.0,1737.0,1.0,311.0,54.0,6.0,5.0,3,1002,34,17426,924,151115,168541,11/25/2020
2020-07-13,84,25678,3209,273182,298860,8.0,2110.0,10.0,1747.0,0.0,311.0,52.0,6.0,5.0,1,1003,61,17487,1475,152590,170077,11/25/2020
2020-07-14,74,25752,3298,276480,302232,7.0,2117.0,4.0,1751.0,0.0,311.0,55.0,5.0,5.0,1,1004,44,17531,1355,153945,171476,11/25/2020
2020-07-15,130,25882,4181,280661,306543,5.0,2122.0,7.0,1758.0,0.0,311.0,53.0,5.0,4.0,0,1004,100,17631,1715,155660,173291,11/25/2020
2020-07-16,103,25985,3740,284401,310386,6.0,2128.0,9.0,1767.0,0.0,311.0,50.0,6.0,5.0,1,1005,76,17707,1583,157243,174950,11/25/2020
2020-07-17,156,26141,4239,288640,314781,14.0,2142.0,3.0,1770.0,1.0,312.0,60.0,5.0,5.0,2,1007,79,17786,1810,159053,176839,11/25/2020
2020-07-18,85,26226,3272,291912,318138,5.0,2147.0,9.0,1779.0,1.0,313.0,55.0,5.0,4.0,4,1011,70,17856,1370,160423,178279,11/25/2020
2020-07-19,82,26308,2696,294608,320916,7.0,2154.0,3.0,1782.0,0.0,313.0,59.0,6.0,4.0,2,1013,57,17913,1126,161549,179462,11/25/2020
2020-07-20,71,26379,2666,297274,323653,9.0,2163.0,7.0,1789.0,0.0,313.0,61.0,7.0,5.0,2,1015,68,17981,1429,162978,180959,11/25/2020
2020-07-21,130,26509,4304,301578,328087,9.0,2172.0,11.0,1800.0,0.0,313.0,59.0,9.0,6.0,1,1016,108,18089,1887,164865,182954,11/25/2020
2020-07-22,130,26639,3928,305506,332145,7.0,2179.0,8.0,1808.0,1.0,314.0,57.0,7.0,6.0,1,1017,86,18175,1637,166502,184677,11/25/2020
2020-07-23,141,26780,4415,309921,336701,8.0,2187.0,6.0,1814.0,0.0,314.0,59.0,8.0,7.0,0,1017,115,18290,1933,168435,186725,11/25/2020
2020-07-24,172,26952,5966,315887,342839,15.0,2202.0,12.0,1826.0,0.0,314.0,62.0,9.0,7.0,0,1017,119,18409,2260,170695,189104,11/25/2020
2020-07-25,134,27086,4398,320285,347371,7.0,2209.0,7.0,1833.0,0.0,314.0,62.0,10.0,8.0,3,1020,108,18517,2056,172751,191268,11/25/2020
2020-07-26,62,27148,3033,323318,350466,8.0,2217.0,9.0,1842.0,0.0,314.0,61.0,11.0,7.0,1,1021,54,18571,1315,174066,192637,11/25/2020
2020-07-27,188,27336,4191,327509,354845,12.0,2229.0,7.0,1849.0,0.0,314.0,66.0,13.0,8.0,1,1022,138,18709,2295,176361,195070,11/25/2020
2020-07-28,105,27441,3840,331349,358790,5.0,2234.0,5.0,1854.0,0.0,314.0,66.0,14.0,7.0,1,1023,95,18804,1605,177966,196770,11/25/2020
2020-07-29,190,27631,5139,336488,364119,9.0,2243.0,10.0,1864.0,0.0,314.0,65.0,15.0,7.0,0,1023,154,18958,2261,180227,199185,11/25/2020
2020-07-30,121,27752,4345,340833,368585,6.0,2249.0,2.0,1866.0,1.0,315.0,68.0,15.0,6.0,1,1024,97,19055,1607,181834,200889,11/25/2020
2020-07-31,131,27883,5512,346345,374228,7.0,2256.0,9.0,1875.0,0.0,315.0,66.0,15.0,7.0,1,1025,89,19144,1806,183640,202784,11/25/2020
2020-08-01,109,27992,4294,350639,378631,7.0,2263.0,2.0,1877.0,0.0,315.0,71.0,14.0,7.0,1,1026,89,19233,1530,185170,204403,11/25/2020
2020-08-02,84,28076,2804,353443,381519,12.0,2275.0,12.0,1889.0,2.0,317.0,69.0,14.0,8.0,2,1028,62,19295,1247,186417,205712,11/25/2020
2020-08-03,188,28264,5248,358691,386955,11.0,2286.0,10.0,1899.0,0.0,317.0,70.0,16.0,7.0,1,1029,150,19445,2165,188582,208027,11/25/2020
2020-08-04,125,28389,3691,362382,390771,8.0,2294.0,5.0,1904.0,1.0,318.0,72.0,12.0,5.0,2,1031,99,19544,1741,190323,209867,11/25/2020
2020-08-05,147,28536,5935,368317,396853,11.0,2305.0,9.0,1913.0,1.0,319.0,73.0,10.0,5.0,2,1033,119,19663,2415,192738,212401,11/25/2020
2020-08-06,169,28705,5546,373863,402568,7.0,2312.0,9.0,1922.0,0.0,319.0,71.0,9.0,4.0,0,1033,120,19783,2345,195083,214866,11/25/2020
2020-08-07,123,28828,4851,378714,407542,12.0,2324.0,9.0,1931.0,1.0,320.0,73.0,9.0,3.0,2,1035,87,19870,2098,197181,217051,11/25/2020
2020-08-08,123,28951,4112,382826,411777,19.0,2343.0,6.0,1937.0,1.0,321.0,85.0,8.0,3.0,1,1036,91,19961,1750,198931,218892,11/25/2020
2020-08-09,42,28993,1727,384553,413546,6.0,2349.0,8.0,1945.0,0.0,321.0,83.0,9.0,4.0,0,1036,35,19996,1051,199982,219978,11/25/2020
2020-08-10,149,29142,4587,389140,418282,8.0,2357.0,9.0,1954.0,0.0,321.0,82.0,9.0,4.0,1,1037,113,20109,1985,201967,222076,11/25/2020
2020-08-11,106,29248,4334,393474,422722,5.0,2362.0,13.0,1967.0,0.0,321.0,74.0,10.0,4.0,3,1040,92,20201,2226,204193,224394,11/25/2020
2020-08-12,121,29369,5188,398662,428031,8.0,2370.0,11.0,1978.0,0.0,321.0,71.0,9.0,3.0,1,1041,101,20302,2570,206763,227065,11/25/2020
2020-08-13,135,29504,4196,402858,432362,13.0,2383.0,12.0,1990.0,0.0,321.0,72.0,11.0,3.0,0,1041,95,20397,1872,208635,229032,11/25/2020
2020-08-14,145,29649,5498,408356,438005,13.0,2396.0,11.0,2001.0,0.0,321.0,74.0,11.0,4.0,3,1044,98,20495,1942,210577,231072,11/25/2020
2020-08-15,106,29755,4534,412890,442645,9.0,2405.0,11.0,2012.0,1.0,322.0,71.0,11.0,5.0,0,1044,88,20583,1655,212232,232815,11/25/2020
2020-08-16,83,29838,2477,415367,445205,6.0,2411.0,5.0,2017.0,4.0,326.0,68.0,8.0,4.0,6,1050,70,20653,936,213168,233821,11/25/2020
2020-08-17,106,29944,4575,419942,449886,8.0,2419.0,6.0,2023.0,0.0,326.0,70.0,8.0,5.0,2,1052,87,20740,2347,215515,236255,11/25/2020
2020-08-18,128,30072,4911,424853,454925,11.0,2430.0,8.0,2031.0,1.0,327.0,72.0,8.0,4.0,5,1057,94,20834,2696,218211,239045,11/25/2020
2020-08-19,113,30185,5077,429930,460115,8.0,2438.0,9.0,2040.0,1.0,328.0,70.0,9.0,5.0,0,1057,90,20924,2586,220797,241721,11/25/2020
2020-08-20,173,30358,7411,437341,467699,12.0,2450.0,6.0,2046.0,2.0,330.0,74.0,10.0,5.0,3,1060,139,21063,3455,224252,245315,11/25/2020
2020-08-21,152,30510,6577,443918,474428,8.0,2458.0,5.0,2051.0,1.0,331.0,76.0,9.0,4.0,2,1062,125,21188,2883,227135,248323,11/25/2020
2020-08-22,96,30606,5550,449468,480074,11.0,2469.0,12.0,2063.0,0.0,331.0,75.0,11.0,4.0,1,1063,84,21272,2553,229688,250960,11/25/2020
2020-08-23,72,30678,4375,453843,484521,11.0,2480.0,5.0,2068.0,0.0,331.0,81.0,12.0,2.0,1,1064,56,21328,2437,232125,253453,11/25/2020
2020-08-24,105,30783,5784,459627,490410,7.0,2487.0,10.0,2078.0,1.0,332.0,77.0,14.0,4.0,1,1065,77,21405,3092,235217,256622,11/25/2020
2020-08-25,108,30891,4764,464391,495282,10.0,2497.0,4.0,2082.0,1.0,333.0,82.0,12.0,4.0,1,1066,92,21497,2254,237471,258968,11/25/2020
2020-08-26,170,31061,9482,473873,504934,4.0,2501.0,8.0,2090.0,0.0,333.0,78.0,10.0,5.0,1,1067,128,21625,3044,240515,262140,11/25/2020
2020-08-27,91,31152,8565,482438,513590,6.0,2507.0,14.0,2104.0,1.0,334.0,69.0,7.0,5.0,2,1069,70,21695,3095,243610,265305,11/25/2020
2020-08-28,113,31265,7994,490432,521697,14.0,2521.0,4.0,2108.0,0.0,334.0,79.0,10.0,7.0,2,1071,87,21782,2390,246000,267782,11/25/2020
2020-08-29,65,31330,5374,495806,527136,6.0,2527.0,8.0,2116.0,1.0,335.0,76.0,11.0,6.0,2,1073,51,21833,1891,247891,269724,11/25/2020
2020-08-30,66,31396,4323,500129,531525,7.0,2534.0,4.0,2120.0,0.0,335.0,79.0,9.0,5.0,2,1075,48,21881,1954,249845,271726,11/25/2020
2020-08-31,105,31501,4863,504992,536493,12.0,2546.0,16.0,2136.0,0.0,335.0,75.0,8.0,4.0,1,1076,81,21962,2154,251999,273961,11/25/2020
2020-09-01,99,31600,7109,512101,543701,6.0,2552.0,9.0,2145.0,1.0,336.0,71.0,7.0,4.0,2,1078,66,22028,2340,254339,276367,11/25/2020
2020-09-02,125,31725,10529,522630,554355,9.0,2561.0,10.0,2155.0,1.0,337.0,69.0,8.0,4.0,2,1080,104,22132,3002,257341,279473,11/25/2020
2020-09-03,90,31815,11080,533710,565525,8.0,2569.0,8.0,2163.0,0.0,337.0,69.0,9.0,4.0,3,1083,73,22205,2535,259876,282081,11/25/2020
2020-09-04,103,31918,8963,542673,574591,11.0,2580.0,4.0,2167.0,0.0,337.0,76.0,9.0,4.0,1,1084,83,22288,2333,262209,284497,11/25/2020
2020-09-05,52,31970,6309,548982,580952,6.0,2586.0,9.0,2176.0,0.0,337.0,73.0,8.0,3.0,1,1085,42,22330,1569,263778,286108,11/25/2020
2020-09-06,88,32058,4325,553307,585365,4.0,2590.0,8.0,2184.0,1.0,338.0,68.0,6.0,3.0,1,1086,65,22395,1916,265694,288089,11/25/2020
2020-09-07,35,32093,3002,556309,588402,11.0,2601.0,3.0,2187.0,0.0,338.0,76.0,5.0,3.0,1,1087,26,22421,632,266326,288747,11/25/2020
2020-09-08,74,32167,6381,562690,594857,6.0,2607.0,12.0,2199.0,1.0,339.0,69.0,6.0,3.0,2,1089,66,22487,1567,267893,290380,11/25/2020
2020-09-09,118,32285,8650,571340,603625,10.0,2617.0,5.0,2204.0,1.0,340.0,73.0,9.0,3.0,1,1090,102,22589,2099,269992,292581,11/25/2020
2020-09-10,164,32449,11334,582674,615123,9.0,2626.0,8.0,2212.0,0.0,340.0,74.0,10.0,3.0,1,1091,111,22700,2232,272224,294924,11/25/2020
2020-09-11,120,32569,9454,592128,624697,11.0,2637.0,11.0,2223.0,0.0,340.0,74.0,10.0,5.0,0,1091,97,22797,1939,274163,296960,11/25/2020
2020-09-12,110,32679,6174,598302,630981,8.0,2645.0,5.0,2228.0,2.0,342.0,75.0,9.0,5.0,3,1094,97,22894,1492,275655,298549,11/25/2020
2020-09-13,58,32737,2717,601019,633756,4.0,2649.0,3.0,2231.0,0.0,342.0,76.0,10.0,5.0,0,1094,54,22948,846,276501,299449,11/25/2020
2020-09-14,104,32841,6446,607465,640306,6.0,2655.0,3.0,2234.0,2.0,344.0,77.0,10.0,5.0,2,1096,95,23043,1703,278204,301247,11/25/2020
2020-09-15,122,32963,8470,615935,648898,7.0,2662.0,2.0,2236.0,1.0,345.0,81.0,10.0,5.0,2,1098,124,23167,2157,280361,303528,11/25/2020
2020-09-16,137,33100,9716,625651,658751,7.0,2669.0,7.0,2243.0,2.0,347.0,79.0,9.0,6.0,5,1103,118,23285,1946,282307,305592,11/25/2020
2020-09-17,125,33225,9239,634890,668115,7.0,2676.0,15.0,2258.0,0.0,347.0,71.0,8.0,4.0,0,1103,154,23439,1915,284222,307661,11/25/2020
2020-09-18,132,33357,10045,644935,678292,7.0,2683.0,7.0,2265.0,1.0,348.0,70.0,11.0,6.0,2,1105,132,23571,1897,286119,309690,11/25/2020
2020-09-19,115,33472,8297,653232,686704,7.0,2690.0,3.0,2268.0,0.0,348.0,74.0,10.0,6.0,4,1109,112,23683,1674,287793,311476,11/25/2020
2020-09-20,60,33532,3676,656908,690440,7.0,2697.0,6.0,2274.0,2.0,350.0,73.0,9.0,8.0,4,1113,49,23732,1302,289095,312827,11/25/2020
2020-09-21,102,33634,7018,663926,697560,12.0,2709.0,3.0,2277.0,2.0,352.0,80.0,8.0,6.0,2,1115,94,23826,2375,291470,315296,11/25/2020
2020-09-22,154,33788,9287,673213,707001,12.0,2721.0,3.0,2280.0,1.0,353.0,88.0,7.0,5.0,1,1116,124,23950,2173,293643,317593,11/25/2020
2020-09-23,136,33924,10651,683864,717788,12.0,2733.0,7.0,2287.0,0.0,353.0,93.0,6.0,5.0,0,1116,127,24077,2180,295823,319900,11/25/2020
2020-09-24,120,34044,12480,696344,730388,7.0,2740.0,9.0,2296.0,1.0,354.0,90.0,7.0,5.0,1,1117,121,24198,3123,298946,323144,11/25/2020
2020-09-25,149,34193,10553,706897,741090,9.0,2749.0,10.0,2306.0,0.0,354.0,89.0,6.0,5.0,1,1118,142,24340,2964,301910,326250,11/25/2020
2020-09-26,146,34339,10559,717456,751795,12.0,2761.0,9.0,2315.0,0.0,354.0,92.0,6.0,5.0,1,1119,119,24459,2399,304309,328768,11/25/2020
2020-09-27,43,34382,2764,720220,754602,7.0,2768.0,5.0,2320.0,0.0,354.0,94.0,9.0,5.0,0,1119,34,24493,833,305142,329635,11/25/2020
2020-09-28,152,34534,7308,727528,762062,7.0,2775.0,7.0,2327.0,2.0,356.0,92.0,7.0,5.0,2,1121,134,24627,2229,307371,331998,11/25/2020
2020-09-29,208,34742,11046,738574,773316,12.0,2787.0,18.0,2345.0,1.0,357.0,85.0,6.0,6.0,1,1122,190,24817,2792,310163,334980,11/25/2020
2020-09-30,221,34963,12230,750804,785767,6.0,2793.0,6.0,2351.0,0.0,357.0,85.0,6.0,6.0,1,1123,187,25004,2545,312708,337712,11/25/2020
2020-10-01,185,35148,12503,763307,798455,17.0,2810.0,13.0,2364.0,1.0,358.0,88.0,6.0,4.0,2,1125,166,25170,2380,315088,340258,11/25/2020
2020-10-02,210,35358,12153,775460,810818,14.0,2824.0,13.0,2377.0,1.0,359.0,88.0,8.0,5.0,2,1127,182,25352,2460,317548,342900,11/25/2020
2020-10-03,157,35515,9313,784773,820288,9.0,2833.0,9.0,2386.0,2.0,361.0,86.0,9.0,4.0,2,1129,131,25483,1994,319542,345025,11/25/2020
2020-10-04,81,35596,2369,787142,822738,11.0,2844.0,9.0,2395.0,1.0,362.0,87.0,8.0,5.0,2,1131,78,25561,943,320485,346046,11/25/2020
2020-10-05,174,35770,8983,796125,831895,30.0,2874.0,10.0,2405.0,2.0,364.0,105.0,9.0,6.0,4,1135,160,25721,2998,323483,349204,11/25/2020
2020-10-06,177,35947,11186,807311,843258,11.0,2885.0,4.0,2409.0,0.0,364.0,112.0,11.0,7.0,0,1135,186,25907,2868,326351,352258,11/25/2020
2020-10-07,231,36178,12441,819752,855930,13.0,2898.0,14.0,2423.0,2.0,366.0,109.0,9.0,7.0,2,1137,243,26150,3502,329853,356003,11/25/2020
2020-10-08,263,36441,15230,834982,871423,17.0,2915.0,13.0,2436.0,2.0,368.0,111.0,7.0,5.0,4,1141,272,26422,4167,334020,360442,11/25/2020
2020-10-09,217,36658,13745,848727,885385,21.0,2936.0,12.0,2448.0,0.0,368.0,120.0,10.0,7.0,3,1144,199,26621,4275,338295,364916,11/25/2020
2020-10-10,229,36887,13832,862559,899446,19.0,2955.0,10.0,2458.0,1.0,369.0,128.0,13.0,7.0,2,1146,194,26815,3752,342047,368862,11/25/2020
2020-10-11,97,36984,3263,865822,902806,12.0,2967.0,9.0,2467.0,1.0,370.0,130.0,14.0,5.0,6,1152,88,26903,1155,343202,370105,11/25/2020
2020-10-12,169,37153,6440,872262,909415,19.0,2986.0,15.0,2482.0,2.0,372.0,132.0,14.0,5.0,4,1156,159,27062,1707,344909,371971,11/25/2020
2020-10-13,213,37366,8521,880783,918149,15.0,3001.0,13.0,2495.0,4.0,376.0,130.0,13.0,5.0,7,1163,207,27269,2289,347198,374467,11/25/2020
2020-10-14,322,37688,15038,895821,933509,17.0,3018.0,7.0,2502.0,0.0,376.0,140.0,15.0,5.0,2,1165,301,27570,3989,351187,378757,11/25/2020
2020-10-15,262,37950,14639,910460,948410,12.0,3030.0,16.0,2518.0,1.0,377.0,135.0,13.0,5.0,2,1167,254,27824,3543,354730,382554,11/25/2020
2020-10-16,279,38229,15011,925471,963700,13.0,3043.0,18.0,2536.0,1.0,378.0,129.0,13.0,4.0,2,1169,275,28099,3345,358075,386174,11/25/2020
2020-10-17,354,38583,14069,939540,978123,19.0,3062.0,11.0,2547.0,1.0,379.0,136.0,17.0,4.0,2,1171,311,28410,3228,361303,389713,11/25/2020
2020-10-18,155,38738,4039,943579,982317,18.0,3080.0,11.0,2558.0,0.0,379.0,143.0,17.0,6.0,2,1173,128,28538,1305,362608,391146,11/25/2020
2020-10-19,388,39126,8491,952070,991196,21.0,3101.0,22.0,2580.0,2.0,381.0,140.0,15.0,6.0,1,1174,325,28863,2539,365147,394010,11/25/2020
2020-10-20,439,39565,13242,965312,1004877,22.0,3123.0,17.0,2597.0,0.0,381.0,145.0,14.0,8.0,3,1177,387,29250,2975,368122,397372,11/25/2020
2020-10-21,544,40109,17463,982775,1022884,22.0,3145.0,8.0,2605.0,2.0,383.0,157.0,15.0,9.0,3,1180,472,29722,3488,371610,401332,11/25/2020
2020-10-22,538,40647,15863,998638,1039285,24.0,3169.0,20.0,2625.0,3.0,386.0,158.0,14.0,9.0,3,1183,489,30211,3163,374773,404984,11/25/2020
2020-10-23,514,41161,16634,1015272,1056433,22.0,3191.0,22.0,2647.0,1.0,387.0,157.0,15.0,9.0,3,1186,460,30671,2851,377624,408295,11/25/2020
2020-10-24,359,41520,10249,1025521,1067041,17.0,3208.0,11.0,2658.0,0.0,387.0,163.0,14.0,8.0,1,1187,338,31009,2247,379871,410880,11/25/2020
2020-10-25,233,41753,4760,1030281,1072034,16.0,3224.0,15.0,2673.0,1.0,388.0,163.0,15.0,8.0,2,1189,209,31218,1447,381318,412536,11/25/2020
2020-10-26,454,42207,9174,1039455,1081662,26.0,3250.0,15.0,2688.0,2.0,390.0,172.0,18.0,8.0,3,1192,403,31621,2951,384269,415890,11/25/2020
2020-10-27,517,42724,13994,1053449,1096173,29.0,3279.0,15.0,2703.0,2.0,392.0,184.0,18.0,9.0,4,1196,453,32074,2368,386637,418711,11/25/2020
2020-10-28,469,43193,15229,1068678,1111871,25.0,3304.0,26.0,2729.0,1.0,393.0,182.0,17.0,9.0,3,1199,409,32483,2682,389319,421802,11/25/2020
2020-10-29,609,43802,16258,1084936,1128738,20.0,3324.0,22.0,2751.0,3.0,396.0,177.0,19.0,11.0,4,1203,529,33012,3102,392421,425433,11/25/2020
2020-10-30,565,44367,14862,1099798,1144165,21.0,3345.0,21.0,2772.0,5.0,401.0,172.0,19.0,9.0,4,1207,467,33479,2920,395341,428820,11/25/2020
2020-10-31,599,44966,11820,1111618,1156584,31.0,3376.0,13.0,2785.0,1.0,402.0,189.0,22.0,9.0,3,1210,487,33966,2401,397742,431708,11/25/2020
2020-11-01,330,45296,5091,1116709,1162005,20.0,3396.0,15.0,2800.0,1.0,403.0,193.0,26.0,12.0,4,1214,273,34239,1257,398999,433238,11/25/2020
2020-11-02,521,45817,9931,1126640,1172457,37.0,3433.0,27.0,2827.0,3.0,406.0,200.0,24.0,12.0,5,1219,454,34693,2912,401911,436604,11/25/2020
2020-11-03,602,46419,13040,1139680,1186099,32.0,3465.0,25.0,2852.0,1.0,407.0,206.0,24.0,12.0,1,1220,527,35220,2502,404413,439633,11/25/2020
2020-11-04,679,47098,16100,1155780,1202878,34.0,3499.0,27.0,2879.0,2.0,409.0,211.0,24.0,12.0,4,1224,626,35846,2912,407325,443171,11/25/2020
2020-11-05,756,47854,16592,1172372,1220226,46.0,3545.0,35.0,2914.0,1.0,410.0,221.0,23.0,14.0,3,1227,673,36519,2845,410170,446689,11/25/2020
2020-11-06,776,48630,16022,1188394,1237024,43.0,3588.0,31.0,2945.0,1.0,411.0,232.0,28.0,17.0,5,1232,699,37218,3033,413203,450421,11/25/2020
2020-11-07,608,49238,13650,1202044,1251282,34.0,3622.0,25.0,2970.0,1.0,412.0,240.0,31.0,18.0,1,1233,580,37798,2458,415661,453459,11/25/2020
2020-11-08,338,49576,4161,1206205,1255781,31.0,3653.0,26.0,2996.0,1.0,413.0,244.0,30.0,19.0,4,1237,322,38120,1272,416933,455053,11/25/2020
2020-11-09,807,50383,9039,1215244,1265627,39.0,3692.0,33.0,3029.0,2.0,415.0,248.0,28.0,18.0,3,1240,763,38883,2302,419235,458118,11/25/2020
2020-11-10,1061,51444,12982,1228226,1279670,46.0,3738.0,37.0,3066.0,0.0,415.0,257.0,31.0,18.0,6,1246,987,39870,2881,422116,461986,11/25/2020
2020-11-11,1088,52532,19741,1247967,1300499,40.0,3778.0,24.0,3090.0,5.0,420.0,268.0,30.0,15.0,7,1253,1003,40873,2683,424799,465672,11/25/2020
2020-11-12,890,53422,13902,1261869,1315291,38.0,3816.0,31.0,3121.0,3.0,423.0,272.0,28.0,15.0,5,1258,808,41681,2201,427000,468681,11/25/2020
2020-11-13,1154,54576,16389,1278258,1332834,35.0,3851.0,31.0,3152.0,0.0,423.0,276.0,27.0,15.0,2,1260,1105,42786,3109,430109,472895,11/25/2020
2020-11-14,781,55357,13517,1291775,1347132,39.0,3890.0,26.0,3178.0,5.0,428.0,284.0,25.0,13.0,10,1270,737,43523,2465,432574,476097,11/25/2020
2020-11-15,578,55935,6173,1297948,1353883,41.0,3931.0,21.0,3199.0,5.0,433.0,299.0,27.0,11.0,7,1277,490,44013,1430,434004,478017,11/25/2020
2020-11-16,731,56666,9614,1307562,1364228,53.0,3984.0,38.0,3237.0,3.0,436.0,311.0,25.0,13.0,5,1282,663,44676,2623,436627,481303,11/25/2020
2020-11-17,1541,58207,18172,1325734,1383941,57.0,4041.0,44.0,3281.0,2.0,438.0,322.0,28.0,13.0,5,1287,1400,46076,4170,440797,486873,11/25/2020
2020-11-18,1129,59336,16025,1341759,1401095,36.0,4077.0,37.0,3318.0,5.0,443.0,316.0,27.0,15.0,7,1294,1015,47091,3203,444000,491091,11/25/2020
2020-11-19,1132,60468,13154,1354913,1415381,44.0,4121.0,42.0,3360.0,4.0,447.0,314.0,27.0,18.0,2,1296,1038,48129,3435,447435,495564,11/25/2020
2020-11-20,1430,61898,22190,1377103,1439001,46.0,4167.0,48.0,3408.0,3.0,450.0,309.0,30.0,14.0,6,1302,1292,49421,4326,451761,501182,11/25/2020
2020-11-21,843,62741,17342,1394445,1457186,40.0,4207.0,34.0,3442.0,5.0,455.0,310.0,32.0,14.0,6,1308,745,50166,3173,454934,505100,11/25/2020
2020-11-22,566,63307,7517,1401962,1465269,61.0,4268.0,28.0,3470.0,4.0,459.0,339.0,30.0,15.0,10,1318,462,50628,1809,456743,507371,11/25/2020
2020-11-23,954,64261,10994,1412956,1477217,58.0,4326.0,40.0,3510.0,0.0,459.0,357.0,35.0,16.0,10,1328,844,51472,3439,460182,511654,11/25/2020
2020-11-24,948,65209,14030,1426986,1492195,,,,,,,,,,7,1335,845,52317,2607,462789,515106,11/25/2020
2020-02-27,0,0,0,0,0,1.0,1.0,0.0,0.0,0.0,0.0,1.0,0.0,0.0,0,0,0,0,0,0,0,11/27/2020
2020-02-28,0,0,0,0,0,0.0,1.0,0.0,0.0,0.0,0.0,1.0,1.0,0.0,0,0,0,0,0,0,0,11/27/2020
2020-02-29,0,0,0,0,0,0.0,1.0,0.0,0.0,0.0,0.0,1.0,1.0,0.0,0,0,0,0,0,0,0,11/27/2020
2020-03-01,2,2,2,2,4,0.0,1.0,0.0,0.0,0.0,0.0,1.0,1.0,1.0,0,0,2,2,2,2,4,11/27/2020
2020-03-02,0,2,1,3,5,1.0,2.0,0.0,0.0,0.0,0.0,2.0,2.0,2.0,0,0,0,2,0,2,4,11/27/2020
2020-03-03,0,2,2,5,7,0.0,2.0,0.0,0.0,0.0,0.0,2.0,2.0,2.0,0,0,0,2,1,3,5,11/27/2020
2020-03-04,0,2,12,17,19,1.0,3.0,0.0,0.0,0.0,0.0,3.0,2.0,2.0,0,0,0,2,10,13,15,11/27/2020
2020-03-05,0,2,4,21,23,0.0,3.0,0.0,0.0,0.0,0.0,3.0,2.0,2.0,0,0,1,3,4,17,20,11/27/2020
2020-03-06,1,3,12,33,36,0.0,3.0,0.0,0.0,0.0,0.0,3.0,2.0,2.0,0,0,0,3,11,28,31,11/27/2020
2020-03-07,0,3,19,52,55,0.0,3.0,0.0,0.0,0.0,0.0,3.0,2.0,1.0,0,0,0,3,19,47,50,11/27/2020
2020-03-08,0,3,18,70,73,0.0,3.0,0.0,0.0,0.0,0.0,3.0,2.0,1.0,0,0,0,3,18,65,68,11/27/2020
2020-03-09,1,4,15,85,89,0.0,3.0,0.0,0.0,0.0,0.0,3.0,2.0,1.0,0,0,1,4,14,79,83,11/27/2020
2020-03-10,2,6,25,110,116,0.0,3.0,0.0,0.0,0.0,0.0,3.0,2.0,1.0,0,0,1,5,23,102,107,11/27/2020
2020-03-11,0,6,34,144,150,1.0,4.0,0.0,0.0,0.0,0.0,4.0,1.0,1.0,0,0,0,5,34,136,141,11/27/2020
2020-03-12,9,15,41,185,200,1.0,5.0,0.0,0.0,0.0,0.0,5.0,1.0,1.0,0,0,8,13,38,174,187,11/27/2020
2020-03-13,6,21,50,235,256,4.0,9.0,1.0,1.0,0.0,0.0,8.0,1.0,1.0,0,0,6,19,47,221,240,11/27/2020
2020-03-14,0,21,90,325,346,0.0,9.0,0.0,1.0,0.0,0.0,8.0,1.0,1.0,0,0,0,19,83,304,323,11/27/2020
2020-03-15,1,22,54,379,401,1.0,10.0,0.0,1.0,0.0,0.0,9.0,2.0,1.0,0,0,1,20,53,357,377,11/27/2020
2020-03-16,2,24,95,474,498,2.0,12.0,0.0,1.0,0.0,0.0,11.0,2.0,0.0,0,0,2,22,91,448,470,11/27/2020
2020-03-17,12,36,162,636,672,6.0,18.0,0.0,1.0,0.0,0.0,17.0,2.0,0.0,0,0,11,33,147,595,628,11/27/2020
2020-03-18,9,45,116,752,797,3.0,21.0,0.0,1.0,0.0,0.0,20.0,2.0,0.0,0,0,11,44,107,702,746,11/27/2020
2020-03-19,15,60,262,1014,1074,2.0,23.0,1.0,2.0,0.0,0.0,21.0,3.0,0.0,1,1,17,61,246,948,1009,11/27/2020
2020-03-20,13,73,197,1211,1284,5.0,28.0,0.0,2.0,0.0,0.0,26.0,4.0,0.0,0,1,13,74,185,1133,1207,11/27/2020
2020-03-21,12,85,126,1337,1422,3.0,31.0,2.0,4.0,0.0,0.0,27.0,5.0,0.0,0,1,14,88,121,1254,1342,11/27/2020
2020-03-22,27,112,282,1619,1731,2.0,33.0,0.0,4.0,0.0,0.0,29.0,5.0,0.0,0,1,25,113,255,1509,1622,11/27/2020
2020-03-23,14,126,169,1788,1914,15.0,48.0,1.0,5.0,0.0,0.0,43.0,9.0,3.0,0,1,16,129,159,1668,1797,11/27/2020
2020-03-24,20,146,242,2030,2176,8.0,56.0,0.0,5.0,0.0,0.0,51.0,10.0,5.0,0,1,19,148,227,1895,2043,11/27/2020
2020-03-25,26,172,182,2212,2384,5.0,61.0,2.0,7.0,0.0,0.0,54.0,11.0,3.0,0,1,28,176,161,2056,2232,11/27/2020
2020-03-26,35,207,181,2393,2600,9.0,70.0,5.0,12.0,0.0,0.0,58.0,14.0,5.0,0,1,41,217,167,2223,2440,11/27/2020
2020-03-27,27,234,214,2607,2841,9.0,79.0,1.0,13.0,1.0,1.0,65.0,16.0,6.0,2,3,31,248,189,2412,2660,11/27/2020
2020-03-28,59,293,260,2867,3160,11.0,90.0,2.0,15.0,1.0,2.0,73.0,15.0,6.0,1,4,64,312,238,2650,2962,11/27/2020
2020-03-29,100,393,350,3217,3610,8.0,98.0,3.0,18.0,1.0,3.0,77.0,18.0,8.0,2,6,105,417,305,2955,3372,11/27/2020
2020-03-30,62,455,222,3439,3894,19.0,117.0,5.0,23.0,0.0,3.0,91.0,19.0,11.0,3,9,78,495,179,3134,3629,11/27/2020
2020-03-31,71,526,369,3808,4334,11.0,128.0,7.0,30.0,1.0,4.0,94.0,21.0,13.0,2,11,73,568,293,3427,3995,11/27/2020
2020-04-01,99,625,698,4506,5131,18.0,146.0,7.0,37.0,0.0,4.0,105.0,29.0,15.0,1,12,100,668,613,4040,4708,11/27/2020
2020-04-02,52,677,477,4983,5660,22.0,168.0,6.0,43.0,2.0,6.0,119.0,35.0,21.0,4,16,62,730,419,4459,5189,11/27/2020
2020-04-03,108,785,774,5757,6542,23.0,191.0,7.0,50.0,0.0,6.0,135.0,42.0,25.0,3,19,100,830,682,5141,5971,11/27/2020
2020-04-04,143,928,660,6417,7345,22.0,213.0,4.0,54.0,5.0,11.0,148.0,40.0,29.0,9,28,138,968,588,5729,6697,11/27/2020
2020-04-05,187,1115,1156,7573,8688,20.0,233.0,9.0,63.0,1.0,12.0,158.0,43.0,35.0,2,30,181,1149,1015,6744,7893,11/27/2020
2020-04-06,218,1333,1706,9279,10612,26.0,259.0,7.0,70.0,0.0,12.0,177.0,47.0,39.0,7,37,207,1356,1492,8236,9592,11/27/2020
2020-04-07,284,1617,1629,10908,12525,20.0,279.0,4.0,74.0,2.0,14.0,191.0,49.0,41.0,5,42,260,1616,1432,9668,11284,11/27/2020
2020-04-08,290,1907,1720,12628,14535,19.0,298.0,8.0,82.0,5.0,19.0,197.0,49.0,37.0,10,52,271,1887,1496,11164,13051,11/27/2020
2020-04-09,283,2190,1516,14144,16334,32.0,330.0,8.0,90.0,4.0,23.0,217.0,53.0,40.0,7,59,277,2164,1308,12472,14636,11/27/2020
2020-04-10,419,2609,2574,16718,19327,29.0,359.0,17.0,107.0,5.0,28.0,224.0,59.0,41.0,11,70,400,2564,2279,14751,17315,11/27/2020
2020-04-11,297,2906,1905,18623,21529,29.0,388.0,11.0,118.0,2.0,30.0,240.0,61.0,48.0,12,82,281,2845,1663,16414,19259,11/27/2020
2020-04-12,314,3220,1670,20293,23513,35.0,423.0,13.0,131.0,5.0,35.0,257.0,59.0,49.0,9,91,286,3131,1365,17779,20910,11/27/2020
2020-04-13,161,3381,935,21228,24609,35.0,458.0,13.0,144.0,3.0,38.0,276.0,64.0,54.0,9,100,187,3318,812,18591,21909,11/27/2020
2020-04-14,289,3670,1787,23015,26685,27.0,485.0,18.0,162.0,5.0,43.0,280.0,72.0,53.0,8,108,262,3580,1467,20058,23638,11/27/2020
2020-04-15,351,4021,1799,24814,28835,31.0,516.0,20.0,182.0,3.0,46.0,288.0,72.0,54.0,17,125,306,3886,1471,21529,25415,11/27/2020
2020-04-16,447,4468,2494,27308,31776,36.0,552.0,25.0,207.0,6.0,52.0,293.0,72.0,53.0,14,139,387,4273,1966,23495,27768,11/27/2020
2020-04-17,304,4772,1821,29129,33901,32.0,584.0,20.0,227.0,7.0,59.0,298.0,66.0,45.0,21,160,290,4563,1379,24874,29437,11/27/2020
2020-04-18,321,5093,1725,30854,35947,26.0,610.0,18.0,245.0,4.0,63.0,302.0,63.0,49.0,15,175,284,4847,1270,26144,30991,11/27/2020
2020-04-19,381,5474,2047,32901,38375,23.0,633.0,26.0,271.0,1.0,64.0,298.0,65.0,55.0,11,186,337,5184,1672,27816,33000,11/27/2020
2020-04-20,394,5868,1907,34808,40676,46.0,679.0,29.0,300.0,2.0,66.0,313.0,75.0,56.0,10,196,376,5560,1526,29342,34902,11/27/2020
2020-04-21,444,6312,2110,36918,43230,45.0,724.0,32.0,332.0,5.0,71.0,321.0,72.0,56.0,18,214,383,5943,1647,30989,36932,11/27/2020
2020-04-22,418,6730,2390,39308,46038,41.0,765.0,32.0,364.0,5.0,76.0,325.0,73.0,58.0,18,232,379,6322,1843,32832,39154,11/27/2020
2020-04-23,479,7209,2469,41777,48986,32.0,797.0,28.0,392.0,5.0,81.0,324.0,76.0,62.0,15,247,412,6734,1781,34613,41347,11/27/2020
2020-04-24,491,7700,3284,45061,52761,35.0,832.0,26.0,418.0,4.0,85.0,329.0,85.0,63.0,15,262,407,7141,2517,37130,44271,11/27/2020
2020-04-25,393,8093,2206,47267,55360,34.0,866.0,17.0,435.0,5.0,90.0,341.0,85.0,62.0,14,276,299,7440,1692,38822,46262,11/27/2020
2020-04-26,316,8409,2309,49576,57985,33.0,899.0,15.0,450.0,3.0,93.0,356.0,86.0,59.0,14,290,274,7714,1798,40620,48334,11/27/2020
2020-04-27,249,8658,1620,51196,59854,29.0,928.0,21.0,471.0,4.0,97.0,360.0,86.0,61.0,10,300,206,7920,1105,41725,49645,11/27/2020
2020-04-28,410,9068,2263,53459,62527,44.0,972.0,24.0,495.0,3.0,100.0,377.0,88.0,59.0,22,322,332,8252,1641,43366,51618,11/27/2020
2020-04-29,476,9544,3343,56802,66346,36.0,1008.0,38.0,533.0,11.0,111.0,364.0,78.0,53.0,18,340,370,8622,2277,45643,54265,11/27/2020
2020-04-30,432,9976,2769,59571,69547,33.0,1041.0,38.0,571.0,6.0,117.0,353.0,83.0,57.0,24,364,350,8972,1786,47429,56401,11/27/2020
2020-05-01,454,10430,3086,62657,73087,52.0,1093.0,39.0,610.0,3.0,120.0,363.0,84.0,58.0,14,378,323,9295,2022,49451,58746,11/27/2020
2020-05-02,257,10687,1926,64583,75270,36.0,1129.0,38.0,648.0,5.0,125.0,356.0,93.0,63.0,24,402,192,9487,1222,50673,60160,11/27/2020
2020-05-03,283,10970,2160,66743,77713,31.0,1160.0,26.0,674.0,8.0,133.0,353.0,91.0,61.0,21,423,183,9670,1492,52165,61835,11/27/2020
2020-05-04,387,11357,2098,68841,80198,30.0,1190.0,31.0,705.0,6.0,139.0,346.0,89.0,58.0,18,441,290,9960,1506,53671,63631,11/27/2020
2020-05-05,433,11790,2873,71714,83504,29.0,1219.0,32.0,737.0,6.0,145.0,337.0,83.0,55.0,16,457,299,10259,1874,55545,65804,11/27/2020
2020-05-06,488,12278,2830,74544,86822,28.0,1247.0,44.0,781.0,9.0,154.0,312.0,80.0,55.0,21,478,340,10599,1852,57397,67996,11/27/2020
2020-05-07,425,12703,2969,77513,90216,36.0,1283.0,44.0,825.0,5.0,159.0,299.0,72.0,53.0,21,499,270,10869,1887,59284,70153,11/27/2020
2020-05-08,359,13062,2598,80111,93173,30.0,1313.0,29.0,854.0,5.0,164.0,295.0,72.0,54.0,22,521,229,11098,1666,60950,72048,11/27/2020
2020-05-09,467,13529,3346,83457,96986,22.0,1335.0,21.0,875.0,4.0,168.0,292.0,70.0,52.0,15,536,290,11388,2155,63105,74493,11/27/2020
2020-05-10,285,13814,2117,85574,99388,20.0,1355.0,23.0,898.0,6.0,174.0,283.0,71.0,50.0,14,550,189,11577,1446,64551,76128,11/27/2020
2020-05-11,257,14071,1857,87431,101502,31.0,1386.0,16.0,914.0,6.0,180.0,292.0,72.0,50.0,15,565,174,11751,1246,65797,77548,11/27/2020
2020-05-12,387,14458,2611,90042,104500,23.0,1409.0,18.0,932.0,4.0,184.0,293.0,70.0,49.0,22,587,224,11975,1602,67399,79374,11/27/2020
2020-05-13,351,14809,3630,93672,108481,23.0,1432.0,25.0,957.0,1.0,185.0,290.0,70.0,50.0,13,600,199,12174,1869,69268,81442,11/27/2020
2020-05-14,329,15138,3408,97080,112218,19.0,1451.0,27.0,984.0,3.0,188.0,279.0,65.0,46.0,15,615,232,12406,1900,71168,83574,11/27/2020
2020-05-15,381,15519,3458,100538,116057,24.0,1475.0,41.0,1025.0,5.0,193.0,257.0,63.0,46.0,14,629,232,12638,1742,72910,85548,11/27/2020
2020-05-16,449,15968,4156,104694,120662,25.0,1500.0,15.0,1040.0,5.0,198.0,262.0,62.0,47.0,15,644,247,12885,1869,74779,87664,11/27/2020
2020-05-17,240,16208,2768,107462,123670,17.0,1517.0,9.0,1049.0,5.0,203.0,265.0,60.0,46.0,10,654,126,13011,1485,76264,89275,11/27/2020
2020-05-18,250,16458,2001,109463,125921,19.0,1536.0,16.0,1065.0,5.0,208.0,263.0,58.0,41.0,18,672,135,13146,1321,77585,90731,11/27/2020
2020-05-19,415,16873,3168,112631,129504,23.0,1559.0,33.0,1098.0,5.0,213.0,248.0,57.0,39.0,11,683,215,13361,1873,79458,92819,11/27/2020
2020-05-20,326,17199,2771,115402,132601,19.0,1578.0,23.0,1121.0,7.0,220.0,237.0,53.0,34.0,22,705,184,13545,1480,80938,94483,11/27/2020
2020-05-21,374,17573,3757,119159,136732,25.0,1603.0,15.0,1136.0,3.0,223.0,244.0,54.0,30.0,20,725,168,13713,1879,82817,96530,11/27/2020
2020-05-22,351,17924,3161,122320,140244,20.0,1623.0,28.0,1164.0,5.0,228.0,231.0,53.0,30.0,11,736,206,13919,1545,84362,98281,11/27/2020
2020-05-23,253,18177,2742,125062,143239,19.0,1642.0,11.0,1175.0,3.0,231.0,236.0,53.0,33.0,13,749,109,14028,1232,85594,99622,11/27/2020
2020-05-24,163,18340,1370,126432,144772,13.0,1655.0,14.0,1189.0,2.0,233.0,233.0,54.0,36.0,8,757,83,14111,751,86345,100456,11/27/2020
2020-05-25,147,18487,1385,127817,146304,14.0,1669.0,14.0,1203.0,0.0,233.0,233.0,54.0,34.0,10,767,76,14187,712,87057,101244,11/27/2020
2020-05-26,285,18772,2620,130437,149209,24.0,1693.0,21.0,1224.0,5.0,238.0,231.0,49.0,33.0,15,782,158,14345,1608,88665,103010,11/27/2020
2020-05-27,276,19048,2057,132494,151542,20.0,1713.0,18.0,1242.0,3.0,241.0,230.0,51.0,33.0,10,792,132,14477,1103,89768,104245,11/27/2020
2020-05-28,348,19396,3359,135853,155249,17.0,1730.0,29.0,1271.0,4.0,245.0,214.0,47.0,32.0,8,800,130,14607,1089,90857,105464,11/27/2020
2020-05-29,410,19806,3915,139768,159574,19.0,1749.0,26.0,1297.0,7.0,252.0,200.0,43.0,31.0,12,812,174,14781,1503,92360,107141,11/27/2020
2020-05-30,225,20031,3915,143683,163714,16.0,1765.0,19.0,1316.0,4.0,256.0,193.0,41.0,29.0,12,824,109,14890,1678,94038,108928,11/27/2020
2020-05-31,155,20186,1690,145373,165559,11.0,1776.0,11.0,1327.0,1.0,257.0,192.0,44.0,26.0,3,827,78,14968,800,94838,109806,11/27/2020
2020-06-01,212,20398,2792,148165,168563,8.0,1784.0,14.0,1341.0,1.0,258.0,185.0,45.0,29.0,5,832,93,15061,1337,96175,111236,11/27/2020
2020-06-02,273,20671,3022,151187,171858,8.0,1792.0,9.0,1350.0,3.0,261.0,181.0,38.0,25.0,10,842,98,15159,1389,97564,112723,11/27/2020
2020-06-03,254,20925,3486,154673,175598,14.0,1806.0,18.0,1368.0,6.0,267.0,171.0,34.0,25.0,11,853,99,15258,1604,99168,114426,11/27/2020
2020-06-04,276,21201,4471,159144,180345,7.0,1813.0,26.0,1394.0,4.0,271.0,148.0,31.0,24.0,12,865,107,15365,1961,101129,116494,11/27/2020
2020-06-05,215,21416,3513,162657,184073,15.0,1828.0,13.0,1407.0,6.0,277.0,144.0,27.0,21.0,11,876,99,15464,1498,102627,118091,11/27/2020
2020-06-06,201,21617,2616,165273,186890,10.0,1838.0,7.0,1414.0,2.0,279.0,145.0,29.0,19.0,6,882,67,15531,1086,103713,119244,11/27/2020
2020-06-07,83,21700,1625,166898,188598,11.0,1849.0,7.0,1421.0,1.0,280.0,148.0,25.0,17.0,4,886,51,15582,771,104484,120066,11/27/2020
2020-06-08,119,21819,1849,168747,190566,15.0,1864.0,13.0,1434.0,2.0,282.0,148.0,27.0,18.0,4,890,45,15627,929,105413,121040,11/27/2020
2020-06-09,223,22042,2673,171420,193462,10.0,1874.0,19.0,1453.0,0.0,282.0,139.0,28.0,21.0,1,891,64,15691,1226,106639,122330,11/27/2020
2020-06-10,209,22251,2987,174407,196658,13.0,1887.0,12.0,1465.0,2.0,284.0,138.0,24.0,17.0,4,895,100,15791,1425,108064,123855,11/27/2020
2020-06-11,195,22446,3513,177920,200366,7.0,1894.0,15.0,1480.0,1.0,285.0,129.0,25.0,16.0,6,901,88,15879,1485,109549,125428,11/27/2020
2020-06-12,209,22655,4601,182521,205176,9.0,1903.0,16.0,1496.0,1.0,286.0,121.0,24.0,16.0,2,903,78,15957,2079,111628,127585,11/27/2020
2020-06-13,113,22768,3036,185557,208325,6.0,1909.0,5.0,1501.0,0.0,286.0,122.0,20.0,15.0,3,906,49,16006,1323,112951,128957,11/27/2020
2020-06-14,81,22849,2046,187603,210452,7.0,1916.0,8.0,1509.0,1.0,287.0,120.0,20.0,14.0,3,909,33,16039,940,113891,129930,11/27/2020
2020-06-15,188,23037,3108,190711,213748,14.0,1930.0,19.0,1528.0,0.0,287.0,115.0,20.0,16.0,5,914,75,16114,1737,115628,131742,11/27/2020
2020-06-16,110,23147,3017,193728,216875,11.0,1941.0,9.0,1537.0,1.0,288.0,116.0,22.0,16.0,8,922,50,16164,1502,117130,133294,11/27/2020
2020-06-17,127,23274,2835,196563,219837,15.0,1956.0,20.0,1557.0,4.0,292.0,107.0,18.0,14.0,6,928,51,16215,1282,118412,134627,11/27/2020
2020-06-18,149,23423,3048,199611,223034,9.0,1965.0,15.0,1572.0,1.0,293.0,100.0,19.0,16.0,7,935,70,16285,1284,119696,135981,11/27/2020
2020-06-19,141,23564,3769,203380,226944,12.0,1977.0,12.0,1584.0,1.0,294.0,99.0,20.0,17.0,3,938,59,16344,1321,121017,137361,11/27/2020
2020-06-20,84,23648,1891,205271,228919,9.0,1986.0,12.0,1596.0,0.0,294.0,96.0,20.0,18.0,4,942,36,16380,803,121820,138200,11/27/2020
2020-06-21,37,23685,1064,206335,230020,8.0,1994.0,5.0,1601.0,0.0,294.0,99.0,20.0,18.0,2,944,30,16410,676,122496,138906,11/27/2020
2020-06-22,138,23823,3730,210065,233888,12.0,2006.0,17.0,1618.0,0.0,294.0,94.0,19.0,18.0,2,946,65,16475,1667,124163,140638,11/27/2020
2020-06-23,163,23986,3831,213896,237882,3.0,2009.0,13.0,1631.0,3.0,297.0,81.0,18.0,18.0,7,953,81,16556,1743,125906,142462,11/27/2020
2020-06-24,120,24106,3502,217398,241504,9.0,2018.0,10.0,1641.0,1.0,298.0,79.0,18.0,18.0,5,958,44,16600,1646,127552,144152,11/27/2020
2020-06-25,103,24209,2883,220281,244490,6.0,2024.0,14.0,1655.0,1.0,299.0,70.0,17.0,17.0,1,959,50,16650,1465,129017,145667,11/27/2020
2020-06-26,94,24303,2488,222769,247072,2.0,2026.0,10.0,1665.0,0.0,299.0,62.0,18.0,18.0,1,960,60,16710,1295,130312,147022,11/27/2020
2020-06-27,84,24387,3216,225985,250372,5.0,2031.0,3.0,1668.0,1.0,300.0,63.0,17.0,17.0,5,965,37,16747,1181,131493,148240,11/27/2020
2020-06-28,39,24426,1469,227454,251880,4.0,2035.0,4.0,1672.0,4.0,304.0,59.0,15.0,14.0,6,971,17,16764,581,132074,148838,11/27/2020
2020-06-29,85,24511,3697,231151,255662,4.0,2039.0,5.0,1677.0,0.0,304.0,58.0,14.0,14.0,1,972,39,16803,1327,133401,150204,11/27/2020
2020-06-30,57,24568,1958,233109,257677,1.0,2040.0,5.0,1682.0,1.0,305.0,53.0,12.0,11.0,4,976,32,16835,975,134376,151211,11/27/2020
2020-07-01,144,24712,4098,237207,261919,8.0,2048.0,10.0,1692.0,0.0,305.0,51.0,11.0,11.0,1,977,79,16914,1880,136256,153170,11/27/2020
2020-07-02,103,24815,2803,240010,264825,5.0,2053.0,5.0,1697.0,1.0,306.0,50.0,10.0,10.0,3,980,59,16973,1056,137312,154285,11/27/2020
2020-07-03,50,24865,2079,242089,266954,9.0,2062.0,6.0,1703.0,0.0,306.0,53.0,9.0,9.0,3,983,25,16998,771,138083,155081,11/27/2020
2020-07-04,57,24922,2345,244434,269356,2.0,2064.0,4.0,1707.0,1.0,307.0,50.0,10.0,9.0,2,985,33,17031,981,139064,156095,11/27/2020
2020-07-05,49,24971,2932,247366,272337,1.0,2065.0,2.0,1709.0,1.0,308.0,48.0,8.0,8.0,2,987,26,17057,1399,140463,157520,11/27/2020
2020-07-06,101,25072,2814,250180,275252,6.0,2071.0,6.0,1715.0,0.0,308.0,48.0,9.0,9.0,4,991,57,17114,1519,141982,159096,11/27/2020
2020-07-07,81,25153,3457,253637,278790,5.0,2076.0,7.0,1722.0,0.0,308.0,46.0,8.0,8.0,2,993,47,17161,1507,143489,160650,11/27/2020
2020-07-08,105,25258,3409,257046,282304,4.0,2080.0,2.0,1724.0,0.0,308.0,48.0,9.0,8.0,0,993,64,17225,1376,144865,162090,11/27/2020
2020-07-09,94,25352,3714,260760,286112,9.0,2089.0,3.0,1727.0,0.0,308.0,54.0,9.0,8.0,0,993,50,17275,1578,146443,163718,11/27/2020
2020-07-10,132,25484,4437,265197,290681,6.0,2095.0,3.0,1730.0,2.0,310.0,55.0,7.0,7.0,3,996,80,17355,2023,148466,165821,11/27/2020
2020-07-11,63,25547,2938,268135,293682,6.0,2101.0,3.0,1733.0,1.0,311.0,57.0,6.0,6.0,3,999,36,17391,1291,149757,167148,11/27/2020
2020-07-12,47,25594,1838,269973,295567,1.0,2102.0,3.0,1736.0,1.0,312.0,54.0,6.0,5.0,3,1002,34,17425,924,150681,168106,11/27/2020
2020-07-13,84,25678,3209,273182,298860,8.0,2110.0,10.0,1746.0,0.0,312.0,52.0,6.0,5.0,1,1003,61,17486,1473,152154,169640,11/27/2020
2020-07-14,74,25752,3298,276480,302232,7.0,2117.0,4.0,1750.0,0.0,312.0,55.0,5.0,5.0,1,1004,44,17530,1353,153507,171037,11/27/2020
2020-07-15,130,25882,4181,280661,306543,5.0,2122.0,7.0,1757.0,0.0,312.0,53.0,5.0,4.0,0,1004,100,17630,1714,155221,172851,11/27/2020
2020-07-16,103,25985,3740,284401,310386,6.0,2128.0,9.0,1766.0,0.0,312.0,50.0,6.0,5.0,1,1005,76,17706,1581,156802,174508,11/27/2020
2020-07-17,156,26141,4239,288640,314781,14.0,2142.0,3.0,1769.0,1.0,313.0,60.0,5.0,5.0,2,1007,79,17785,1810,158612,176397,11/27/2020
2020-07-18,85,26226,3272,291912,318138,5.0,2147.0,9.0,1778.0,1.0,314.0,55.0,5.0,4.0,4,1011,70,17855,1370,159982,177837,11/27/2020
2020-07-19,82,26308,2696,294608,320916,7.0,2154.0,3.0,1781.0,0.0,314.0,59.0,6.0,4.0,2,1013,57,17912,1124,161106,179018,11/27/2020
2020-07-20,71,26379,2666,297274,323653,9.0,2163.0,7.0,1788.0,0.0,314.0,61.0,7.0,5.0,2,1015,68,17980,1428,162534,180514,11/27/2020
2020-07-21,130,26509,4304,301578,328087,9.0,2172.0,11.0,1799.0,0.0,314.0,59.0,9.0,6.0,1,1016,108,18088,1883,164417,182505,11/27/2020
2020-07-22,130,26639,3928,305506,332145,7.0,2179.0,8.0,1807.0,1.0,315.0,57.0,7.0,6.0,1,1017,86,18174,1633,166050,184224,11/27/2020
2020-07-23,141,26780,4415,309921,336701,8.0,2187.0,6.0,1813.0,0.0,315.0,59.0,8.0,7.0,0,1017,115,18289,1931,167981,186270,11/27/2020
2020-07-24,172,26952,5966,315887,342839,15.0,2202.0,12.0,1825.0,0.0,315.0,62.0,9.0,7.0,0,1017,119,18408,2259,170240,188648,11/27/2020
2020-07-25,134,27086,4398,320285,347371,7.0,2209.0,7.0,1832.0,0.0,315.0,62.0,10.0,8.0,3,1020,108,18516,2051,172291,190807,11/27/2020
2020-07-26,62,27148,3033,323318,350466,8.0,2217.0,9.0,1841.0,0.0,315.0,61.0,11.0,7.0,1,1021,54,18570,1313,173604,192174,11/27/2020
2020-07-27,188,27336,4191,327509,354845,12.0,2229.0,7.0,1848.0,0.0,315.0,66.0,13.0,8.0,1,1022,138,18708,2293,175897,194605,11/27/2020
2020-07-28,105,27441,3840,331349,358790,5.0,2234.0,5.0,1853.0,0.0,315.0,66.0,14.0,7.0,1,1023,95,18803,1604,177501,196304,11/27/2020
2020-07-29,190,27631,5139,336488,364119,9.0,2243.0,10.0,1863.0,0.0,315.0,65.0,15.0,7.0,0,1023,154,18957,2254,179755,198712,11/27/2020
2020-07-30,121,27752,4345,340833,368585,6.0,2249.0,2.0,1865.0,1.0,316.0,68.0,15.0,6.0,1,1024,97,19054,1603,181358,200412,11/27/2020
2020-07-31,131,27883,5512,346345,374228,7.0,2256.0,9.0,1874.0,0.0,316.0,66.0,15.0,7.0,1,1025,89,19143,1803,183161,202304,11/27/2020
2020-08-01,109,27992,4294,350639,378631,7.0,2263.0,2.0,1876.0,0.0,316.0,71.0,14.0,7.0,1,1026,89,19232,1527,184688,203920,11/27/2020
2020-08-02,84,28076,2804,353443,381519,12.0,2275.0,12.0,1888.0,2.0,318.0,69.0,14.0,8.0,2,1028,62,19294,1245,185933,205227,11/27/2020
2020-08-03,188,28264,5248,358691,386955,11.0,2286.0,10.0,1898.0,0.0,318.0,70.0,16.0,7.0,1,1029,150,19444,2161,188094,207538,11/27/2020
2020-08-04,125,28389,3691,362382,390771,8.0,2294.0,5.0,1903.0,1.0,319.0,72.0,12.0,5.0,2,1031,99,19543,1739,189833,209376,11/27/2020
2020-08-05,147,28536,5935,368317,396853,11.0,2305.0,9.0,1912.0,1.0,320.0,73.0,10.0,5.0,2,1033,119,19662,2410,192243,211905,11/27/2020
2020-08-06,169,28705,5546,373863,402568,7.0,2312.0,9.0,1921.0,0.0,320.0,71.0,9.0,4.0,0,1033,120,19782,2341,194584,214366,11/27/2020
2020-08-07,123,28828,4851,378714,407542,12.0,2324.0,9.0,1930.0,1.0,321.0,73.0,9.0,3.0,2,1035,87,19869,2097,196681,216550,11/27/2020
2020-08-08,123,28951,4112,382826,411777,19.0,2343.0,6.0,1936.0,1.0,322.0,85.0,8.0,3.0,1,1036,91,19960,1745,198426,218386,11/27/2020
2020-08-09,42,28993,1727,384553,413546,6.0,2349.0,8.0,1944.0,0.0,322.0,83.0,9.0,4.0,0,1036,35,19995,1050,199476,219471,11/27/2020
2020-08-10,149,29142,4587,389140,418282,8.0,2357.0,9.0,1953.0,0.0,322.0,82.0,9.0,4.0,1,1037,113,20108,1980,201456,221564,11/27/2020
2020-08-11,106,29248,4334,393474,422722,5.0,2362.0,13.0,1966.0,0.0,322.0,74.0,10.0,4.0,3,1040,92,20200,2225,203681,223881,11/27/2020
2020-08-12,121,29369,5188,398662,428031,8.0,2370.0,11.0,1977.0,0.0,322.0,71.0,9.0,3.0,1,1041,101,20301,2565,206246,226547,11/27/2020
2020-08-13,135,29504,4196,402858,432362,13.0,2383.0,12.0,1989.0,0.0,322.0,72.0,11.0,3.0,0,1041,95,20396,1868,208114,228510,11/27/2020
2020-08-14,145,29649,5498,408356,438005,13.0,2396.0,11.0,2000.0,0.0,322.0,74.0,11.0,4.0,3,1044,98,20494,1939,210053,230547,11/27/2020
2020-08-15,106,29755,4534,412890,442645,9.0,2405.0,11.0,2011.0,1.0,323.0,71.0,11.0,5.0,0,1044,88,20582,1652,211705,232287,11/27/2020
2020-08-16,83,29838,2477,415367,445205,6.0,2411.0,5.0,2016.0,4.0,327.0,68.0,8.0,4.0,6,1050,70,20652,935,212640,233292,11/27/2020
2020-08-17,106,29944,4575,419942,449886,8.0,2419.0,6.0,2022.0,0.0,327.0,70.0,8.0,5.0,2,1052,87,20739,2346,214986,235725,11/27/2020
2020-08-18,128,30072,4911,424853,454925,11.0,2430.0,8.0,2030.0,1.0,328.0,72.0,8.0,4.0,5,1057,94,20833,2694,217680,238513,11/27/2020
2020-08-19,113,30185,5077,429930,460115,8.0,2438.0,9.0,2039.0,1.0,329.0,70.0,9.0,5.0,0,1057,90,20923,2585,220265,241188,11/27/2020
2020-08-20,173,30358,7411,437341,467699,12.0,2450.0,6.0,2045.0,2.0,331.0,74.0,10.0,5.0,3,1060,139,21062,3452,223717,244779,11/27/2020
2020-08-21,152,30510,6577,443918,474428,8.0,2458.0,5.0,2050.0,1.0,332.0,76.0,9.0,4.0,2,1062,125,21187,2878,226595,247782,11/27/2020
2020-08-22,96,30606,5550,449468,480074,11.0,2469.0,12.0,2062.0,0.0,332.0,75.0,11.0,4.0,1,1063,84,21271,2551,229146,250417,11/27/2020
2020-08-23,72,30678,4375,453843,484521,11.0,2480.0,5.0,2067.0,0.0,332.0,81.0,12.0,2.0,1,1064,56,21327,2435,231581,252908,11/27/2020
2020-08-24,105,30783,5784,459627,490410,7.0,2487.0,10.0,2077.0,1.0,333.0,77.0,14.0,4.0,1,1065,77,21404,3088,234669,256073,11/27/2020
2020-08-25,108,30891,4764,464391,495282,10.0,2497.0,4.0,2081.0,1.0,334.0,82.0,12.0,4.0,1,1066,92,21496,2253,236922,258418,11/27/2020
2020-08-26,170,31061,9482,473873,504934,4.0,2501.0,8.0,2089.0,0.0,334.0,78.0,10.0,5.0,1,1067,128,21624,3039,239961,261585,11/27/2020
2020-08-27,91,31152,8565,482438,513590,6.0,2507.0,14.0,2103.0,1.0,335.0,69.0,7.0,5.0,2,1069,70,21694,3092,243053,264747,11/27/2020
2020-08-28,113,31265,7994,490432,521697,14.0,2521.0,4.0,2107.0,0.0,335.0,79.0,10.0,7.0,2,1071,87,21781,2387,245440,267221,11/27/2020
2020-08-29,65,31330,5374,495806,527136,6.0,2527.0,8.0,2115.0,1.0,336.0,76.0,11.0,6.0,2,1073,51,21832,1885,247325,269157,11/27/2020
2020-08-30,66,31396,4323,500129,531525,7.0,2534.0,4.0,2119.0,0.0,336.0,79.0,9.0,5.0,2,1075,48,21880,1952,249277,271157,11/27/2020
2020-08-31,105,31501,4863,504992,536493,12.0,2546.0,16.0,2135.0,0.0,336.0,75.0,8.0,4.0,1,1076,81,21961,2151,251428,273389,11/27/2020
2020-09-01,99,31600,7109,512101,543701,6.0,2552.0,9.0,2144.0,1.0,337.0,71.0,7.0,4.0,2,1078,66,22027,2338,253766,275793,11/27/2020
2020-09-02,125,31725,10529,522630,554355,9.0,2561.0,10.0,2154.0,1.0,338.0,69.0,8.0,4.0,2,1080,104,22131,3000,256766,278897,11/27/2020
2020-09-03,90,31815,11080,533710,565525,8.0,2569.0,8.0,2162.0,0.0,338.0,69.0,9.0,4.0,3,1083,73,22204,2530,259296,281500,11/27/2020
2020-09-04,103,31918,8963,542673,574591,11.0,2580.0,4.0,2166.0,0.0,338.0,76.0,9.0,4.0,1,1084,83,22287,2333,261629,283916,11/27/2020
2020-09-05,52,31970,6309,548982,580952,6.0,2586.0,9.0,2175.0,0.0,338.0,73.0,8.0,3.0,1,1085,42,22329,1567,263196,285525,11/27/2020
2020-09-06,88,32058,4325,553307,585365,4.0,2590.0,8.0,2183.0,1.0,339.0,68.0,6.0,3.0,1,1086,65,22394,1914,265110,287504,11/27/2020
2020-09-07,35,32093,3002,556309,588402,11.0,2601.0,3.0,2186.0,0.0,339.0,76.0,5.0,3.0,1,1087,26,22420,632,265742,288162,11/27/2020
2020-09-08,74,32167,6381,562690,594857,6.0,2607.0,12.0,2198.0,1.0,340.0,69.0,6.0,3.0,2,1089,66,22486,1566,267308,289794,11/27/2020
2020-09-09,118,32285,8650,571340,603625,10.0,2617.0,5.0,2203.0,1.0,341.0,73.0,9.0,3.0,1,1090,102,22588,2095,269403,291991,11/27/2020
2020-09-10,164,32449,11334,582674,615123,9.0,2626.0,8.0,2211.0,0.0,341.0,74.0,10.0,3.0,1,1091,111,22699,2229,271632,294331,11/27/2020
2020-09-11,120,32569,9454,592128,624697,11.0,2637.0,11.0,2222.0,0.0,341.0,74.0,10.0,5.0,0,1091,97,22796,1936,273568,296364,11/27/2020
2020-09-12,110,32679,6174,598302,630981,8.0,2645.0,5.0,2227.0,2.0,343.0,75.0,9.0,5.0,3,1094,97,22893,1490,275058,297951,11/27/2020
2020-09-13,58,32737,2717,601019,633756,4.0,2649.0,3.0,2230.0,0.0,343.0,76.0,10.0,5.0,0,1094,54,22947,845,275903,298850,11/27/2020
2020-09-14,104,32841,6446,607465,640306,6.0,2655.0,3.0,2233.0,2.0,345.0,77.0,10.0,5.0,2,1096,95,23042,1701,277604,300646,11/27/2020
2020-09-15,122,32963,8470,615935,648898,7.0,2662.0,2.0,2235.0,1.0,346.0,81.0,10.0,5.0,2,1098,124,23166,2154,279758,302924,11/27/2020
2020-09-16,137,33100,9716,625651,658751,7.0,2669.0,7.0,2242.0,2.0,348.0,79.0,9.0,6.0,5,1103,118,23284,1944,281702,304986,11/27/2020
2020-09-17,125,33225,9239,634890,668115,7.0,2676.0,15.0,2257.0,0.0,348.0,71.0,8.0,4.0,0,1103,154,23438,1914,283616,307054,11/27/2020
2020-09-18,132,33357,10045,644935,678292,7.0,2683.0,7.0,2264.0,1.0,349.0,70.0,11.0,6.0,2,1105,132,23570,1895,285511,309081,11/27/2020
2020-09-19,115,33472,8297,653232,686704,7.0,2690.0,3.0,2267.0,0.0,349.0,74.0,10.0,6.0,4,1109,112,23682,1673,287184,310866,11/27/2020
2020-09-20,60,33532,3676,656908,690440,7.0,2697.0,6.0,2273.0,2.0,351.0,73.0,9.0,8.0,4,1113,49,23731,1299,288483,312214,11/27/2020
2020-09-21,102,33634,7018,663926,697560,12.0,2709.0,3.0,2276.0,2.0,353.0,80.0,8.0,6.0,2,1115,94,23825,2373,290856,314681,11/27/2020
2020-09-22,154,33788,9287,673213,707001,12.0,2721.0,3.0,2279.0,1.0,354.0,88.0,7.0,5.0,1,1116,124,23949,2172,293028,316977,11/27/2020
2020-09-23,136,33924,10651,683864,717788,12.0,2733.0,7.0,2286.0,0.0,354.0,93.0,6.0,5.0,0,1116,127,24076,2172,295200,319276,11/27/2020
2020-09-24,120,34044,12480,696344,730388,7.0,2740.0,9.0,2295.0,1.0,355.0,90.0,7.0,5.0,1,1117,121,24197,3119,298319,322516,11/27/2020
2020-09-25,150,34194,10553,706897,741091,9.0,2749.0,10.0,2305.0,0.0,355.0,89.0,6.0,5.0,1,1118,142,24339,2960,301279,325618,11/27/2020
2020-09-26,146,34340,10559,717456,751796,12.0,2761.0,9.0,2314.0,0.0,355.0,92.0,6.0,5.0,1,1119,119,24458,2396,303675,328133,11/27/2020
2020-09-27,43,34383,2764,720220,754603,7.0,2768.0,5.0,2319.0,0.0,355.0,94.0,9.0,5.0,0,1119,34,24492,831,304506,328998,11/27/2020
2020-09-28,156,34539,7308,727528,762067,7.0,2775.0,7.0,2326.0,2.0,357.0,92.0,7.0,5.0,2,1121,138,24630,2224,306730,331360,11/27/2020
2020-09-29,204,34743,11046,738574,773317,12.0,2787.0,18.0,2344.0,1.0,358.0,85.0,6.0,6.0,1,1122,186,24816,2789,309519,334335,11/27/2020
2020-09-30,222,34965,12230,750804,785769,6.0,2793.0,6.0,2350.0,0.0,358.0,85.0,6.0,6.0,1,1123,188,25004,2539,312058,337062,11/27/2020
2020-10-01,186,35151,12503,763307,798458,17.0,2810.0,13.0,2363.0,1.0,359.0,88.0,6.0,4.0,2,1125,167,25171,2376,314434,339605,11/27/2020
2020-10-02,209,35360,12153,775460,810820,14.0,2824.0,13.0,2376.0,1.0,360.0,88.0,8.0,5.0,2,1127,181,25352,2458,316892,342244,11/27/2020
2020-10-03,157,35517,9313,784773,820290,9.0,2833.0,9.0,2385.0,2.0,362.0,86.0,9.0,4.0,2,1129,131,25483,1993,318885,344368,11/27/2020
2020-10-04,81,35598,2369,787142,822740,11.0,2844.0,9.0,2394.0,1.0,363.0,87.0,8.0,5.0,2,1131,78,25561,941,319826,345387,11/27/2020
2020-10-05,173,35771,8983,796125,831896,30.0,2874.0,10.0,2404.0,2.0,365.0,105.0,9.0,6.0,4,1135,159,25720,2996,322822,348542,11/27/2020
2020-10-06,180,35951,11186,807311,843262,11.0,2885.0,4.0,2408.0,0.0,365.0,112.0,11.0,7.0,0,1135,186,25906,2866,325688,351594,11/27/2020
2020-10-07,231,36182,12441,819752,855934,13.0,2898.0,14.0,2422.0,2.0,367.0,109.0,9.0,7.0,2,1137,243,26149,3497,329185,355334,11/27/2020
2020-10-08,263,36445,15230,834982,871427,17.0,2915.0,13.0,2435.0,2.0,369.0,111.0,7.0,5.0,4,1141,272,26421,4166,333351,359772,11/27/2020
2020-10-09,217,36662,13745,848727,885389,21.0,2936.0,12.0,2447.0,0.0,369.0,120.0,10.0,7.0,3,1144,199,26620,4269,337620,364240,11/27/2020
2020-10-10,229,36891,13833,862560,899451,19.0,2955.0,10.0,2457.0,1.0,370.0,128.0,13.0,7.0,2,1146,194,26814,3749,341369,368183,11/27/2020
2020-10-11,97,36988,3263,865823,902811,12.0,2967.0,9.0,2466.0,1.0,371.0,130.0,14.0,5.0,6,1152,88,26902,1155,342524,369426,11/27/2020
2020-10-12,169,37157,6440,872263,909420,19.0,2986.0,15.0,2481.0,2.0,373.0,132.0,14.0,5.0,4,1156,159,27061,1705,344229,371290,11/27/2020
2020-10-13,213,37370,8522,880785,918155,15.0,3001.0,13.0,2494.0,4.0,377.0,130.0,13.0,5.0,7,1163,207,27268,2287,346516,373784,11/27/2020
2020-10-14,322,37692,15039,895824,933516,17.0,3018.0,7.0,2501.0,0.0,377.0,140.0,15.0,5.0,2,1165,301,27569,3988,350504,378073,11/27/2020
2020-10-15,262,37954,14639,910463,948417,12.0,3030.0,16.0,2517.0,1.0,378.0,135.0,13.0,5.0,2,1167,254,27823,3540,354044,381867,11/27/2020
2020-10-16,279,38233,15011,925474,963707,13.0,3043.0,18.0,2535.0,1.0,379.0,129.0,13.0,4.0,2,1169,275,28098,3344,357388,385486,11/27/2020
2020-10-17,354,38587,14069,939543,978130,19.0,3062.0,11.0,2546.0,1.0,380.0,136.0,17.0,4.0,2,1171,311,28409,3221,360609,389018,11/27/2020
2020-10-18,155,38742,4039,943582,982324,18.0,3080.0,11.0,2557.0,0.0,380.0,143.0,17.0,6.0,2,1173,128,28537,1304,361913,390450,11/27/2020
2020-10-19,388,39130,8491,952073,991203,21.0,3101.0,22.0,2579.0,2.0,382.0,140.0,15.0,6.0,1,1174,325,28862,2534,364447,393309,11/27/2020
2020-10-20,439,39569,13242,965315,1004884,22.0,3123.0,17.0,2596.0,0.0,382.0,145.0,14.0,8.0,3,1177,387,29249,2973,367420,396669,11/27/2020
2020-10-21,544,40113,17463,982778,1022891,22.0,3145.0,8.0,2604.0,2.0,384.0,157.0,15.0,9.0,3,1180,472,29721,3484,370904,400625,11/27/2020
2020-10-22,538,40651,15863,998641,1039292,24.0,3169.0,20.0,2624.0,3.0,387.0,158.0,14.0,9.0,3,1183,489,30210,3157,374061,404271,11/27/2020
2020-10-23,514,41165,16634,1015275,1056440,22.0,3191.0,22.0,2646.0,1.0,388.0,157.0,15.0,9.0,3,1186,460,30670,2850,376911,407581,11/27/2020
2020-10-24,359,41524,10249,1025524,1067048,17.0,3208.0,11.0,2657.0,0.0,388.0,163.0,14.0,8.0,1,1187,338,31008,2244,379155,410163,11/27/2020
2020-10-25,233,41757,4760,1030284,1072041,16.0,3224.0,15.0,2672.0,1.0,389.0,163.0,15.0,8.0,2,1189,209,31217,1444,380599,411816,11/27/2020
2020-10-26,454,42211,9174,1039458,1081669,26.0,3250.0,15.0,2687.0,2.0,391.0,172.0,18.0,8.0,3,1192,403,31620,2950,383549,415169,11/27/2020
2020-10-27,517,42728,13995,1053453,1096181,29.0,3279.0,15.0,2702.0,2.0,393.0,184.0,18.0,9.0,4,1196,453,32073,2365,385914,417987,11/27/2020
2020-10-28,469,43197,15229,1068682,1111879,25.0,3304.0,26.0,2728.0,1.0,394.0,182.0,17.0,9.0,3,1199,409,32482,2677,388591,421073,11/27/2020
2020-10-29,609,43806,16259,1084941,1128747,20.0,3324.0,22.0,2750.0,3.0,397.0,177.0,19.0,11.0,4,1203,529,33011,3098,391689,424700,11/27/2020
2020-10-30,565,44371,14863,1099804,1144175,21.0,3345.0,21.0,2771.0,5.0,402.0,172.0,19.0,9.0,4,1207,467,33478,2919,394608,428086,11/27/2020
2020-10-31,599,44970,11820,1111624,1156594,31.0,3376.0,13.0,2784.0,1.0,403.0,189.0,22.0,9.0,3,1210,485,33963,2400,397008,430971,11/27/2020
2020-11-01,330,45300,5091,1116715,1162015,20.0,3396.0,15.0,2799.0,1.0,404.0,193.0,26.0,12.0,4,1214,273,34236,1257,398265,432501,11/27/2020
2020-11-02,521,45821,9930,1126645,1172466,38.0,3434.0,27.0,2826.0,3.0,407.0,201.0,24.0,12.0,5,1219,455,34691,2906,401171,435862,11/27/2020
2020-11-03,602,46423,13040,1139685,1186108,33.0,3467.0,25.0,2851.0,1.0,408.0,208.0,24.0,12.0,1,1220,527,35218,2495,403666,438884,11/27/2020
2020-11-04,688,47111,16100,1155785,1202896,34.0,3501.0,27.0,2878.0,2.0,410.0,213.0,25.0,12.0,4,1224,634,35852,2908,406574,442426,11/27/2020
2020-11-05,768,47879,16593,1172378,1220257,46.0,3547.0,35.0,2913.0,1.0,411.0,223.0,24.0,14.0,3,1227,684,36536,2838,409412,445948,11/27/2020
2020-11-06,769,48648,16022,1188400,1237048,43.0,3590.0,31.0,2944.0,1.0,412.0,234.0,28.0,17.0,5,1232,693,37229,3028,412440,449669,11/27/2020
2020-11-07,604,49252,13650,1202050,1251302,34.0,3624.0,25.0,2969.0,1.0,413.0,242.0,31.0,18.0,1,1233,576,37805,2455,414895,452700,11/27/2020
2020-11-08,337,49589,4160,1206210,1255799,31.0,3655.0,26.0,2995.0,1.0,414.0,246.0,30.0,19.0,4,1237,322,38127,1269,416164,454291,11/27/2020
2020-11-09,807,50396,9039,1215249,1265645,39.0,3694.0,33.0,3028.0,2.0,416.0,250.0,28.0,18.0,3,1240,760,38887,2302,418466,457353,11/27/2020
2020-11-10,1053,51449,12982,1228231,1279680,45.0,3739.0,37.0,3065.0,0.0,416.0,258.0,31.0,18.0,6,1246,980,39867,2881,421347,461214,11/27/2020
2020-11-11,1087,52536,19741,1247972,1300508,40.0,3779.0,24.0,3089.0,5.0,421.0,269.0,30.0,15.0,7,1253,1001,40868,2677,424024,464892,11/27/2020
2020-11-12,893,53429,13902,1261874,1315303,38.0,3817.0,31.0,3120.0,3.0,424.0,273.0,28.0,15.0,5,1258,811,41679,2200,426224,467903,11/27/2020
2020-11-13,1165,54594,16389,1278263,1332857,36.0,3853.0,31.0,3151.0,0.0,424.0,278.0,27.0,15.0,2,1260,1116,42795,3103,429327,472122,11/27/2020
2020-11-14,782,55376,13517,1291780,1347156,40.0,3893.0,26.0,3177.0,5.0,429.0,287.0,25.0,13.0,10,1270,739,43534,2462,431789,475323,11/27/2020
2020-11-15,578,55954,6173,1297953,1353907,41.0,3934.0,21.0,3198.0,5.0,434.0,302.0,27.0,11.0,7,1277,488,44022,1426,433215,477237,11/27/2020
2020-11-16,738,56692,9614,1307567,1364259,53.0,3987.0,38.0,3236.0,3.0,437.0,314.0,25.0,13.0,5,1282,670,44692,2618,435833,480525,11/27/2020
2020-11-17,1538,58230,18172,1325739,1383969,57.0,4044.0,44.0,3280.0,2.0,439.0,325.0,29.0,13.0,5,1287,1395,46087,4164,439997,486084,11/27/2020
2020-11-18,1124,59354,16027,1341766,1401120,36.0,4080.0,37.0,3317.0,5.0,444.0,319.0,28.0,15.0,7,1294,1013,47100,3196,443193,490293,11/27/2020
2020-11-19,1128,60482,13154,1354920,1415402,44.0,4124.0,42.0,3359.0,4.0,448.0,317.0,28.0,18.0,3,1297,1037,48137,3432,446625,494762,11/27/2020
2020-11-20,1434,61916,22191,1377111,1439027,46.0,4170.0,48.0,3407.0,3.0,451.0,312.0,31.0,14.0,6,1303,1291,49428,4323,450948,500376,11/27/2020
2020-11-21,839,62755,17346,1394457,1457212,40.0,4210.0,34.0,3441.0,5.0,456.0,313.0,33.0,14.0,6,1309,750,50178,3172,454120,504298,11/27/2020
2020-11-22,566,63321,7520,1401977,1465298,62.0,4272.0,28.0,3469.0,4.0,460.0,343.0,31.0,15.0,11,1320,482,50660,1808,455928,506588,11/27/2020
2020-11-23,948,64269,11010,1412987,1477256,65.0,4337.0,41.0,3510.0,0.0,460.0,367.0,37.0,18.0,10,1330,856,51516,3439,459367,510883,11/27/2020
2020-11-24,994,65263,14374,1427361,1492624,38.0,4375.0,57.0,3567.0,6.0,466.0,342.0,36.0,20.0,8,1338,913,52429,2724,462091,514520,11/27/2020
2020-11-25,1225,66488,18314,1445675,1512163,33.0,4408.0,52.0,3619.0,4.0,470.0,319.0,37.0,23.0,4,1342,1062,53491,3273,465364,518855,11/27/2020
2020-11-26,539,67027,6319,1451994,1519021,,,,,,,,,,4,1346,463,53954,1533,466897,520851,11/27/2020
2020-02-27,0,0,0,0,0,1.0,1.0,0.0,0.0,0.0,0.0,1.0,0.0,0.0,0,0,0,0,0,0,0,11/30/2020
2020-02-28,0,0,0,0,0,0.0,1.0,0.0,0.0,0.0,0.0,1.0,1.0,0.0,0,0,0,0,0,0,0,11/30/2020
2020-02-29,0,0,0,0,0,0.0,1.0,0.0,0.0,0.0,0.0,1.0,1.0,0.0,0,0,0,0,0,0,0,11/30/2020
2020-03-01,2,2,2,2,4,0.0,1.0,0.0,0.0,0.0,0.0,1.0,1.0,1.0,0,0,2,2,2,2,4,11/30/2020
2020-03-02,0,2,1,3,5,1.0,2.0,0.0,0.0,0.0,0.0,2.0,2.0,2.0,0,0,0,2,0,2,4,11/30/2020
2020-03-03,0,2,2,5,7,0.0,2.0,0.0,0.0,0.0,0.0,2.0,2.0,2.0,0,0,0,2,1,3,5,11/30/2020
2020-03-04,0,2,12,17,19,1.0,3.0,0.0,0.0,0.0,0.0,3.0,2.0,2.0,0,0,0,2,10,13,15,11/30/2020
2020-03-05,0,2,4,21,23,0.0,3.0,0.0,0.0,0.0,0.0,3.0,2.0,2.0,0,0,1,3,4,17,20,11/30/2020
2020-03-06,1,3,12,33,36,0.0,3.0,0.0,0.0,0.0,0.0,3.0,2.0,2.0,0,0,0,3,11,28,31,11/30/2020
2020-03-07,0,3,19,52,55,0.0,3.0,0.0,0.0,0.0,0.0,3.0,2.0,1.0,0,0,0,3,19,47,50,11/30/2020
2020-03-08,0,3,18,70,73,0.0,3.0,0.0,0.0,0.0,0.0,3.0,2.0,1.0,0,0,0,3,18,65,68,11/30/2020
2020-03-09,1,4,15,85,89,0.0,3.0,0.0,0.0,0.0,0.0,3.0,2.0,1.0,0,0,1,4,14,79,83,11/30/2020
2020-03-10,2,6,25,110,116,0.0,3.0,0.0,0.0,0.0,0.0,3.0,2.0,1.0,0,0,1,5,23,102,107,11/30/2020
2020-03-11,0,6,34,144,150,1.0,4.0,0.0,0.0,0.0,0.0,4.0,1.0,1.0,0,0,0,5,34,136,141,11/30/2020
2020-03-12,9,15,41,185,200,1.0,5.0,0.0,0.0,0.0,0.0,5.0,1.0,1.0,0,0,7,12,38,174,186,11/30/2020
2020-03-13,6,21,50,235,256,4.0,9.0,1.0,1.0,0.0,0.0,8.0,1.0,1.0,0,0,6,18,47,221,239,11/30/2020
2020-03-14,0,21,90,325,346,0.0,9.0,0.0,1.0,0.0,0.0,8.0,1.0,1.0,0,0,0,18,83,304,322,11/30/2020
2020-03-15,1,22,54,379,401,1.0,10.0,0.0,1.0,0.0,0.0,9.0,2.0,1.0,0,0,1,19,53,357,376,11/30/2020
2020-03-16,2,24,95,474,498,2.0,12.0,0.0,1.0,0.0,0.0,11.0,2.0,0.0,0,0,2,21,90,447,468,11/30/2020
2020-03-17,12,36,162,636,672,6.0,18.0,0.0,1.0,0.0,0.0,17.0,2.0,0.0,0,0,11,32,147,594,626,11/30/2020
2020-03-18,9,45,116,752,797,3.0,21.0,0.0,1.0,0.0,0.0,20.0,2.0,0.0,0,0,11,43,106,700,743,11/30/2020
2020-03-19,15,60,262,1014,1074,2.0,23.0,1.0,2.0,0.0,0.0,21.0,3.0,0.0,1,1,17,60,246,946,1006,11/30/2020
2020-03-20,13,73,197,1211,1284,5.0,28.0,0.0,2.0,0.0,0.0,26.0,4.0,0.0,0,1,13,73,185,1131,1204,11/30/2020
2020-03-21,12,85,126,1337,1422,3.0,31.0,2.0,4.0,0.0,0.0,27.0,5.0,0.0,0,1,14,87,121,1252,1339,11/30/2020
2020-03-22,27,112,282,1619,1731,2.0,33.0,0.0,4.0,0.0,0.0,29.0,5.0,0.0,0,1,25,112,255,1507,1619,11/30/2020
2020-03-23,14,126,169,1788,1914,15.0,48.0,1.0,5.0,0.0,0.0,43.0,9.0,3.0,0,1,16,128,159,1666,1794,11/30/2020
2020-03-24,20,146,242,2030,2176,8.0,56.0,0.0,5.0,0.0,0.0,51.0,10.0,5.0,0,1,19,147,227,1893,2040,11/30/2020
2020-03-25,26,172,182,2212,2384,5.0,61.0,2.0,7.0,0.0,0.0,54.0,11.0,3.0,0,1,28,175,161,2054,2229,11/30/2020
2020-03-26,35,207,181,2393,2600,9.0,70.0,5.0,12.0,0.0,0.0,58.0,14.0,5.0,0,1,41,216,167,2221,2437,11/30/2020
2020-03-27,27,234,214,2607,2841,9.0,79.0,1.0,13.0,1.0,1.0,65.0,16.0,6.0,2,3,31,247,189,2410,2657,11/30/2020
2020-03-28,59,293,260,2867,3160,11.0,90.0,2.0,15.0,1.0,2.0,73.0,15.0,6.0,1,4,64,311,236,2646,2957,11/30/2020
2020-03-29,100,393,350,3217,3610,8.0,98.0,3.0,18.0,1.0,3.0,77.0,18.0,8.0,2,6,105,416,304,2950,3366,11/30/2020
2020-03-30,62,455,222,3439,3894,19.0,117.0,5.0,23.0,0.0,3.0,91.0,19.0,11.0,3,9,78,494,178,3128,3622,11/30/2020
2020-03-31,71,526,369,3808,4334,11.0,128.0,7.0,30.0,1.0,4.0,94.0,21.0,13.0,2,11,73,567,291,3419,3986,11/30/2020
2020-04-01,99,625,698,4506,5131,18.0,146.0,7.0,37.0,0.0,4.0,105.0,29.0,15.0,1,12,100,667,611,4030,4697,11/30/2020
2020-04-02,52,677,477,4983,5660,22.0,168.0,6.0,43.0,2.0,6.0,119.0,35.0,21.0,4,16,62,729,419,4449,5178,11/30/2020
2020-04-03,108,785,774,5757,6542,23.0,191.0,7.0,50.0,0.0,6.0,135.0,42.0,25.0,3,19,100,829,682,5131,5960,11/30/2020
2020-04-04,143,928,660,6417,7345,22.0,213.0,4.0,54.0,5.0,11.0,148.0,40.0,29.0,9,28,138,967,584,5715,6682,11/30/2020
2020-04-05,187,1115,1156,7573,8688,20.0,233.0,9.0,63.0,1.0,12.0,158.0,43.0,35.0,2,30,181,1148,1009,6724,7872,11/30/2020
2020-04-06,218,1333,1706,9279,10612,26.0,259.0,7.0,70.0,0.0,12.0,177.0,47.0,39.0,7,37,207,1355,1488,8212,9567,11/30/2020
2020-04-07,284,1617,1629,10908,12525,20.0,279.0,4.0,74.0,2.0,14.0,191.0,49.0,41.0,5,42,260,1615,1424,9636,11251,11/30/2020
2020-04-08,290,1907,1720,12628,14535,19.0,298.0,8.0,82.0,5.0,19.0,197.0,49.0,37.0,10,52,271,1886,1491,11127,13013,11/30/2020
2020-04-09,283,2190,1516,14144,16334,32.0,330.0,8.0,90.0,4.0,23.0,217.0,53.0,40.0,7,59,277,2163,1305,12432,14595,11/30/2020
2020-04-10,419,2609,2574,16718,19327,29.0,359.0,17.0,107.0,5.0,28.0,224.0,59.0,41.0,11,70,400,2563,2272,14704,17267,11/30/2020
2020-04-11,297,2906,1905,18623,21529,29.0,388.0,11.0,118.0,2.0,30.0,240.0,61.0,48.0,12,82,281,2844,1659,16363,19207,11/30/2020
2020-04-12,314,3220,1670,20293,23513,35.0,423.0,13.0,131.0,5.0,35.0,257.0,59.0,49.0,9,91,286,3130,1357,17720,20850,11/30/2020
2020-04-13,161,3381,935,21228,24609,35.0,458.0,13.0,144.0,3.0,38.0,276.0,64.0,54.0,9,100,187,3317,807,18527,21844,11/30/2020
2020-04-14,289,3670,1787,23015,26685,27.0,485.0,18.0,162.0,5.0,43.0,280.0,72.0,53.0,8,108,262,3579,1465,19992,23571,11/30/2020
2020-04-15,351,4021,1799,24814,28835,31.0,516.0,20.0,182.0,3.0,46.0,288.0,72.0,54.0,17,125,306,3885,1461,21453,25338,11/30/2020
2020-04-16,447,4468,2494,27308,31776,36.0,552.0,25.0,207.0,6.0,52.0,293.0,72.0,53.0,14,139,387,4272,1955,23408,27680,11/30/2020
2020-04-17,304,4772,1821,29129,33901,32.0,584.0,20.0,227.0,7.0,59.0,298.0,66.0,45.0,21,160,290,4562,1374,24782,29344,11/30/2020
2020-04-18,321,5093,1725,30854,35947,26.0,610.0,18.0,245.0,4.0,63.0,302.0,63.0,49.0,15,175,284,4846,1265,26047,30893,11/30/2020
2020-04-19,381,5474,2047,32901,38375,23.0,633.0,26.0,271.0,1.0,64.0,298.0,65.0,55.0,11,186,337,5183,1669,27716,32899,11/30/2020
2020-04-20,394,5868,1907,34808,40676,46.0,679.0,29.0,300.0,2.0,66.0,313.0,75.0,56.0,10,196,376,5559,1518,29234,34793,11/30/2020
2020-04-21,444,6312,2110,36918,43230,45.0,724.0,32.0,332.0,5.0,71.0,321.0,72.0,56.0,18,214,383,5942,1644,30878,36820,11/30/2020
2020-04-22,418,6730,2390,39308,46038,41.0,765.0,32.0,364.0,5.0,76.0,325.0,73.0,58.0,18,232,379,6321,1835,32713,39034,11/30/2020
2020-04-23,479,7209,2469,41777,48986,32.0,797.0,28.0,392.0,5.0,81.0,324.0,76.0,62.0,15,247,412,6733,1771,34484,41217,11/30/2020
2020-04-24,491,7700,3284,45061,52761,35.0,832.0,26.0,418.0,4.0,85.0,329.0,85.0,63.0,15,262,407,7140,2499,36983,44123,11/30/2020
2020-04-25,393,8093,2206,47267,55360,34.0,866.0,17.0,435.0,5.0,90.0,341.0,85.0,62.0,14,276,299,7439,1677,38660,46099,11/30/2020
2020-04-26,316,8409,2309,49576,57985,33.0,899.0,15.0,450.0,3.0,93.0,356.0,86.0,59.0,14,290,274,7713,1784,40444,48157,11/30/2020
2020-04-27,249,8658,1620,51196,59854,29.0,928.0,21.0,471.0,4.0,97.0,360.0,86.0,61.0,10,300,206,7919,1105,41549,49468,11/30/2020
2020-04-28,410,9068,2263,53459,62527,44.0,972.0,24.0,495.0,3.0,100.0,377.0,88.0,59.0,22,322,332,8251,1624,43173,51424,11/30/2020
2020-04-29,476,9544,3343,56802,66346,36.0,1008.0,38.0,533.0,11.0,111.0,364.0,78.0,53.0,18,340,370,8621,2261,45434,54055,11/30/2020
2020-04-30,432,9976,2769,59571,69547,33.0,1041.0,38.0,571.0,6.0,117.0,353.0,83.0,57.0,24,364,350,8971,1773,47207,56178,11/30/2020
2020-05-01,454,10430,3086,62657,73087,52.0,1093.0,38.0,609.0,3.0,120.0,364.0,84.0,58.0,14,378,323,9294,2004,49211,58505,11/30/2020
2020-05-02,257,10687,1926,64583,75270,36.0,1129.0,39.0,648.0,5.0,125.0,356.0,93.0,63.0,24,402,192,9486,1217,50428,59914,11/30/2020
2020-05-03,283,10970,2160,66743,77713,31.0,1160.0,26.0,674.0,8.0,133.0,353.0,91.0,61.0,21,423,183,9669,1484,51912,61581,11/30/2020
2020-05-04,387,11357,2098,68841,80198,30.0,1190.0,31.0,705.0,6.0,139.0,346.0,89.0,58.0,18,441,290,9959,1502,53414,63373,11/30/2020
2020-05-05,433,11790,2873,71714,83504,29.0,1219.0,32.0,737.0,6.0,145.0,337.0,83.0,55.0,16,457,299,10258,1871,55285,65543,11/30/2020
2020-05-06,488,12278,2830,74544,86822,28.0,1247.0,44.0,781.0,9.0,154.0,312.0,80.0,55.0,21,478,340,10598,1842,57127,67725,11/30/2020
2020-05-07,425,12703,2969,77513,90216,36.0,1283.0,44.0,825.0,5.0,159.0,299.0,72.0,53.0,21,499,270,10868,1878,59005,69873,11/30/2020
2020-05-08,359,13062,2598,80111,93173,30.0,1313.0,29.0,854.0,5.0,164.0,295.0,72.0,54.0,22,521,229,11097,1656,60661,71758,11/30/2020
2020-05-09,467,13529,3346,83457,96986,22.0,1335.0,21.0,875.0,4.0,168.0,292.0,70.0,52.0,15,536,289,11386,2147,62808,74194,11/30/2020
2020-05-10,285,13814,2117,85574,99388,20.0,1355.0,23.0,898.0,6.0,174.0,283.0,71.0,50.0,14,550,190,11576,1437,64245,75821,11/30/2020
2020-05-11,257,14071,1857,87431,101502,31.0,1386.0,16.0,914.0,6.0,180.0,292.0,72.0,50.0,15,565,174,11750,1241,65486,77236,11/30/2020
2020-05-12,387,14458,2611,90042,104500,23.0,1409.0,18.0,932.0,4.0,184.0,293.0,70.0,49.0,22,587,224,11974,1597,67083,79057,11/30/2020
2020-05-13,351,14809,3630,93672,108481,23.0,1432.0,25.0,957.0,1.0,185.0,290.0,70.0,50.0,13,600,199,12173,1867,68950,81123,11/30/2020
2020-05-14,329,15138,3408,97080,112218,19.0,1451.0,27.0,984.0,3.0,188.0,279.0,65.0,46.0,15,615,232,12405,1898,70848,83253,11/30/2020
2020-05-15,381,15519,3458,100538,116057,24.0,1475.0,41.0,1025.0,5.0,193.0,257.0,63.0,46.0,14,629,232,12637,1739,72587,85224,11/30/2020
2020-05-16,449,15968,4156,104694,120662,25.0,1500.0,15.0,1040.0,5.0,198.0,262.0,62.0,47.0,15,644,247,12884,1864,74451,87335,11/30/2020
2020-05-17,240,16208,2768,107462,123670,17.0,1517.0,9.0,1049.0,5.0,203.0,265.0,60.0,46.0,10,654,126,13010,1477,75928,88938,11/30/2020
2020-05-18,250,16458,2001,109463,125921,19.0,1536.0,16.0,1065.0,5.0,208.0,263.0,58.0,41.0,18,672,135,13145,1314,77242,90387,11/30/2020
2020-05-19,415,16873,3168,112631,129504,23.0,1559.0,33.0,1098.0,5.0,213.0,248.0,57.0,39.0,11,683,215,13360,1865,79107,92467,11/30/2020
2020-05-20,326,17199,2771,115402,132601,19.0,1578.0,23.0,1121.0,7.0,220.0,237.0,53.0,34.0,22,705,184,13544,1474,80581,94125,11/30/2020
2020-05-21,374,17573,3757,119159,136732,25.0,1603.0,15.0,1136.0,3.0,223.0,244.0,54.0,30.0,20,725,168,13712,1873,82454,96166,11/30/2020
2020-05-22,351,17924,3161,122320,140244,20.0,1623.0,28.0,1164.0,5.0,228.0,231.0,53.0,30.0,11,736,206,13918,1540,83994,97912,11/30/2020
2020-05-23,253,18177,2742,125062,143239,19.0,1642.0,11.0,1175.0,3.0,231.0,236.0,53.0,33.0,13,749,109,14027,1228,85222,99249,11/30/2020
2020-05-24,163,18340,1370,126432,144772,13.0,1655.0,14.0,1189.0,2.0,233.0,233.0,54.0,36.0,8,757,83,14110,750,85972,100082,11/30/2020
2020-05-25,147,18487,1385,127817,146304,14.0,1669.0,14.0,1203.0,0.0,233.0,233.0,54.0,34.0,10,767,76,14186,711,86683,100869,11/30/2020
2020-05-26,285,18772,2620,130437,149209,24.0,1693.0,21.0,1224.0,5.0,238.0,231.0,49.0,33.0,15,782,158,14344,1604,88287,102631,11/30/2020
2020-05-27,276,19048,2057,132494,151542,20.0,1713.0,18.0,1242.0,3.0,241.0,230.0,51.0,33.0,10,792,132,14476,1103,89390,103866,11/30/2020
2020-05-28,348,19396,3359,135853,155249,17.0,1730.0,29.0,1271.0,4.0,245.0,214.0,47.0,32.0,8,800,130,14606,1087,90477,105083,11/30/2020
2020-05-29,410,19806,3915,139768,159574,19.0,1749.0,26.0,1297.0,7.0,252.0,200.0,43.0,31.0,12,812,174,14780,1502,91979,106759,11/30/2020
2020-05-30,225,20031,3915,143683,163714,16.0,1765.0,19.0,1316.0,4.0,256.0,193.0,41.0,29.0,12,824,109,14889,1673,93652,108541,11/30/2020
2020-05-31,155,20186,1690,145373,165559,11.0,1776.0,11.0,1327.0,1.0,257.0,192.0,44.0,26.0,3,827,78,14967,798,94450,109417,11/30/2020
2020-06-01,212,20398,2792,148165,168563,8.0,1784.0,14.0,1341.0,1.0,258.0,185.0,45.0,29.0,5,832,93,15060,1332,95782,110842,11/30/2020
2020-06-02,273,20671,3022,151187,171858,8.0,1792.0,9.0,1350.0,3.0,261.0,181.0,38.0,25.0,10,842,98,15158,1381,97163,112321,11/30/2020
2020-06-03,254,20925,3486,154673,175598,14.0,1806.0,18.0,1368.0,6.0,267.0,171.0,34.0,25.0,11,853,99,15257,1591,98754,114011,11/30/2020
2020-06-04,276,21201,4471,159144,180345,7.0,1813.0,26.0,1394.0,4.0,271.0,148.0,31.0,24.0,12,865,107,15364,1952,100706,116070,11/30/2020
2020-06-05,215,21416,3513,162657,184073,15.0,1828.0,13.0,1407.0,6.0,277.0,144.0,27.0,21.0,11,876,99,15463,1490,102196,117659,11/30/2020
2020-06-06,201,21617,2616,165273,186890,10.0,1838.0,7.0,1414.0,2.0,279.0,145.0,29.0,19.0,6,882,67,15530,1083,103279,118809,11/30/2020
2020-06-07,83,21700,1625,166898,188598,11.0,1849.0,7.0,1421.0,1.0,280.0,148.0,25.0,17.0,4,886,51,15581,771,104050,119631,11/30/2020
2020-06-08,119,21819,1849,168747,190566,15.0,1864.0,13.0,1434.0,2.0,282.0,148.0,27.0,18.0,4,890,45,15626,926,104976,120602,11/30/2020
2020-06-09,223,22042,2673,171420,193462,10.0,1874.0,19.0,1453.0,0.0,282.0,139.0,28.0,21.0,1,891,64,15690,1219,106195,121885,11/30/2020
2020-06-10,209,22251,2987,174407,196658,13.0,1887.0,12.0,1465.0,2.0,284.0,138.0,24.0,17.0,4,895,100,15790,1422,107617,123407,11/30/2020
2020-06-11,195,22446,3513,177920,200366,7.0,1894.0,15.0,1480.0,1.0,285.0,129.0,25.0,16.0,6,901,88,15878,1482,109099,124977,11/30/2020
2020-06-12,209,22655,4601,182521,205176,9.0,1903.0,16.0,1496.0,1.0,286.0,121.0,24.0,16.0,2,903,78,15956,2079,111178,127134,11/30/2020
2020-06-13,113,22768,3036,185557,208325,6.0,1909.0,5.0,1501.0,0.0,286.0,122.0,20.0,15.0,3,906,49,16005,1319,112497,128502,11/30/2020
2020-06-14,81,22849,2046,187603,210452,7.0,1916.0,8.0,1509.0,1.0,287.0,120.0,20.0,14.0,3,909,33,16038,939,113436,129474,11/30/2020
2020-06-15,188,23037,3108,190711,213748,14.0,1930.0,19.0,1528.0,0.0,287.0,115.0,20.0,16.0,5,914,75,16113,1736,115172,131285,11/30/2020
2020-06-16,110,23147,3017,193728,216875,11.0,1941.0,9.0,1537.0,1.0,288.0,116.0,22.0,16.0,8,922,50,16163,1497,116669,132832,11/30/2020
2020-06-17,127,23274,2835,196563,219837,15.0,1956.0,20.0,1557.0,4.0,292.0,107.0,18.0,14.0,6,928,51,16214,1279,117948,134162,11/30/2020
2020-06-18,149,23423,3048,199611,223034,9.0,1965.0,15.0,1572.0,1.0,293.0,100.0,19.0,16.0,7,935,70,16284,1280,119228,135512,11/30/2020
2020-06-19,141,23564,3769,203380,226944,12.0,1977.0,12.0,1584.0,1.0,294.0,99.0,20.0,17.0,3,938,59,16343,1320,120548,136891,11/30/2020
2020-06-20,84,23648,1891,205271,228919,9.0,1986.0,12.0,1596.0,0.0,294.0,96.0,20.0,18.0,4,942,36,16379,800,121348,137727,11/30/2020
2020-06-21,37,23685,1064,206335,230020,8.0,1994.0,5.0,1601.0,0.0,294.0,99.0,20.0,18.0,2,944,30,16409,672,122020,138429,11/30/2020
2020-06-22,138,23823,3730,210065,233888,12.0,2006.0,17.0,1618.0,0.0,294.0,94.0,19.0,18.0,2,946,65,16474,1664,123684,140158,11/30/2020
2020-06-23,163,23986,3831,213896,237882,3.0,2009.0,13.0,1631.0,3.0,297.0,81.0,18.0,18.0,7,953,81,16555,1740,125424,141979,11/30/2020
2020-06-24,120,24106,3502,217398,241504,9.0,2018.0,10.0,1641.0,1.0,298.0,79.0,18.0,18.0,5,958,44,16599,1642,127066,143665,11/30/2020
2020-06-25,103,24209,2883,220281,244490,6.0,2024.0,14.0,1655.0,1.0,299.0,70.0,17.0,17.0,1,959,50,16649,1461,128527,145176,11/30/2020
2020-06-26,94,24303,2488,222769,247072,2.0,2026.0,10.0,1665.0,0.0,299.0,62.0,18.0,18.0,1,960,60,16709,1291,129818,146527,11/30/2020
2020-06-27,84,24387,3216,225985,250372,5.0,2031.0,3.0,1668.0,1.0,300.0,63.0,17.0,17.0,5,965,37,16746,1179,130997,147743,11/30/2020
2020-06-28,39,24426,1469,227454,251880,4.0,2035.0,4.0,1672.0,4.0,304.0,59.0,15.0,14.0,6,971,17,16763,581,131578,148341,11/30/2020
2020-06-29,85,24511,3697,231151,255662,4.0,2039.0,5.0,1677.0,0.0,304.0,58.0,14.0,14.0,1,972,39,16802,1322,132900,149702,11/30/2020
2020-06-30,57,24568,1958,233109,257677,1.0,2040.0,5.0,1682.0,1.0,305.0,53.0,12.0,11.0,4,976,32,16834,972,133872,150706,11/30/2020
2020-07-01,144,24712,4098,237207,261919,8.0,2048.0,10.0,1692.0,0.0,305.0,51.0,11.0,11.0,1,977,79,16913,1874,135746,152659,11/30/2020
2020-07-02,103,24815,2803,240010,264825,5.0,2053.0,5.0,1697.0,1.0,306.0,50.0,10.0,10.0,3,980,59,16972,1053,136799,153771,11/30/2020
2020-07-03,50,24865,2079,242089,266954,9.0,2062.0,6.0,1703.0,0.0,306.0,53.0,9.0,9.0,3,983,25,16997,768,137567,154564,11/30/2020
2020-07-04,57,24922,2345,244434,269356,2.0,2064.0,4.0,1707.0,1.0,307.0,50.0,10.0,9.0,2,985,33,17030,979,138546,155576,11/30/2020
2020-07-05,49,24971,2932,247366,272337,1.0,2065.0,2.0,1709.0,1.0,308.0,48.0,8.0,8.0,2,987,26,17056,1394,139940,156996,11/30/2020
2020-07-06,101,25072,2814,250180,275252,6.0,2071.0,6.0,1715.0,0.0,308.0,48.0,9.0,9.0,4,991,57,17113,1517,141457,158570,11/30/2020
2020-07-07,81,25153,3457,253637,278790,5.0,2076.0,7.0,1722.0,0.0,308.0,46.0,8.0,8.0,2,993,47,17160,1507,142964,160124,11/30/2020
2020-07-08,105,25258,3409,257046,282304,4.0,2080.0,2.0,1724.0,0.0,308.0,48.0,9.0,8.0,0,993,64,17224,1373,144337,161561,11/30/2020
2020-07-09,94,25352,3714,260760,286112,9.0,2089.0,3.0,1727.0,0.0,308.0,54.0,9.0,8.0,0,993,50,17274,1574,145911,163185,11/30/2020
2020-07-10,132,25484,4437,265197,290681,6.0,2095.0,3.0,1730.0,2.0,310.0,55.0,7.0,7.0,3,996,80,17354,2016,147927,165281,11/30/2020
2020-07-11,63,25547,2938,268135,293682,6.0,2101.0,3.0,1733.0,1.0,311.0,57.0,6.0,6.0,3,999,36,17390,1284,149211,166601,11/30/2020
2020-07-12,47,25594,1838,269973,295567,1.0,2102.0,3.0,1736.0,1.0,312.0,54.0,6.0,5.0,3,1002,34,17424,921,150132,167556,11/30/2020
2020-07-13,84,25678,3209,273182,298860,8.0,2110.0,10.0,1746.0,0.0,312.0,52.0,6.0,5.0,1,1003,61,17485,1471,151603,169088,11/30/2020
2020-07-14,74,25752,3298,276480,302232,7.0,2117.0,4.0,1750.0,0.0,312.0,55.0,5.0,5.0,1,1004,44,17529,1349,152952,170481,11/30/2020
2020-07-15,130,25882,4181,280661,306543,5.0,2122.0,7.0,1757.0,0.0,312.0,53.0,5.0,4.0,0,1004,100,17629,1708,154660,172289,11/30/2020
2020-07-16,103,25985,3740,284401,310386,6.0,2128.0,9.0,1766.0,0.0,312.0,50.0,6.0,5.0,1,1005,76,17705,1577,156237,173942,11/30/2020
2020-07-17,156,26141,4239,288640,314781,14.0,2142.0,3.0,1769.0,1.0,313.0,60.0,5.0,5.0,2,1007,79,17784,1804,158041,175825,11/30/2020
2020-07-18,85,26226,3272,291912,318138,5.0,2147.0,9.0,1778.0,1.0,314.0,55.0,5.0,4.0,4,1011,70,17854,1367,159408,177262,11/30/2020
2020-07-19,82,26308,2696,294608,320916,7.0,2154.0,3.0,1781.0,0.0,314.0,59.0,6.0,4.0,2,1013,57,17911,1123,160531,178442,11/30/2020
2020-07-20,71,26379,2666,297274,323653,9.0,2163.0,7.0,1788.0,0.0,314.0,61.0,7.0,5.0,2,1015,68,17979,1426,161957,179936,11/30/2020
2020-07-21,130,26509,4304,301578,328087,9.0,2172.0,11.0,1799.0,0.0,314.0,59.0,9.0,6.0,1,1016,108,18087,1882,163839,181926,11/30/2020
2020-07-22,130,26639,3928,305506,332145,7.0,2179.0,8.0,1807.0,1.0,315.0,57.0,7.0,6.0,1,1017,86,18173,1625,165464,183637,11/30/2020
2020-07-23,141,26780,4415,309921,336701,8.0,2187.0,6.0,1813.0,0.0,315.0,59.0,8.0,7.0,0,1017,115,18288,1926,167390,185678,11/30/2020
2020-07-24,172,26952,5966,315887,342839,15.0,2202.0,12.0,1825.0,0.0,315.0,62.0,9.0,7.0,0,1017,119,18407,2255,169645,188052,11/30/2020
2020-07-25,134,27086,4398,320285,347371,7.0,2209.0,7.0,1832.0,0.0,315.0,62.0,10.0,8.0,3,1020,108,18515,2046,171691,190206,11/30/2020
2020-07-26,62,27148,3033,323318,350466,8.0,2217.0,9.0,1841.0,0.0,315.0,61.0,11.0,7.0,1,1021,54,18569,1308,172999,191568,11/30/2020
2020-07-27,188,27336,4191,327509,354845,12.0,2229.0,7.0,1848.0,0.0,315.0,66.0,13.0,8.0,1,1022,138,18707,2285,175284,193991,11/30/2020
2020-07-28,105,27441,3840,331349,358790,5.0,2234.0,5.0,1853.0,0.0,315.0,66.0,14.0,7.0,1,1023,95,18802,1601,176885,195687,11/30/2020
2020-07-29,190,27631,5139,336488,364119,9.0,2243.0,10.0,1863.0,0.0,315.0,65.0,15.0,7.0,0,1023,154,18956,2249,179134,198090,11/30/2020
2020-07-30,121,27752,4345,340833,368585,6.0,2249.0,2.0,1865.0,1.0,316.0,68.0,15.0,6.0,1,1024,97,19053,1595,180729,199782,11/30/2020
2020-07-31,131,27883,5512,346345,374228,7.0,2256.0,9.0,1874.0,0.0,316.0,66.0,15.0,7.0,1,1025,89,19142,1797,182526,201668,11/30/2020
2020-08-01,109,27992,4294,350639,378631,7.0,2263.0,2.0,1876.0,0.0,316.0,71.0,14.0,7.0,1,1026,89,19231,1525,184051,203282,11/30/2020
2020-08-02,84,28076,2804,353443,381519,12.0,2275.0,12.0,1888.0,2.0,318.0,69.0,14.0,8.0,2,1028,62,19293,1244,185295,204588,11/30/2020
2020-08-03,188,28264,5248,358691,386955,11.0,2286.0,10.0,1898.0,0.0,318.0,70.0,16.0,7.0,1,1029,150,19443,2153,187448,206891,11/30/2020
2020-08-04,125,28389,3691,362382,390771,8.0,2294.0,5.0,1903.0,1.0,319.0,72.0,12.0,5.0,2,1031,99,19542,1737,189185,208727,11/30/2020
2020-08-05,147,28536,5935,368317,396853,11.0,2305.0,9.0,1912.0,1.0,320.0,73.0,10.0,5.0,2,1033,119,19661,2406,191591,211252,11/30/2020
2020-08-06,169,28705,5546,373863,402568,7.0,2312.0,9.0,1921.0,0.0,320.0,71.0,9.0,4.0,0,1033,120,19781,2336,193927,213708,11/30/2020
2020-08-07,123,28828,4851,378714,407542,12.0,2324.0,9.0,1930.0,1.0,321.0,73.0,9.0,3.0,2,1035,87,19868,2094,196021,215889,11/30/2020
2020-08-08,123,28951,4112,382826,411777,19.0,2343.0,6.0,1936.0,1.0,322.0,85.0,8.0,3.0,1,1036,91,19959,1743,197764,217723,11/30/2020
2020-08-09,42,28993,1727,384553,413546,6.0,2349.0,8.0,1944.0,0.0,322.0,83.0,9.0,4.0,0,1036,35,19994,1044,198808,218802,11/30/2020
2020-08-10,149,29142,4587,389140,418282,8.0,2357.0,9.0,1953.0,0.0,322.0,82.0,9.0,4.0,1,1037,113,20107,1977,200785,220892,11/30/2020
2020-08-11,106,29248,4334,393474,422722,5.0,2362.0,13.0,1966.0,0.0,322.0,74.0,10.0,4.0,3,1040,92,20199,2223,203008,223207,11/30/2020
2020-08-12,121,29369,5188,398662,428031,8.0,2370.0,11.0,1977.0,0.0,322.0,71.0,9.0,3.0,1,1041,101,20300,2558,205566,225866,11/30/2020
2020-08-13,135,29504,4196,402858,432362,13.0,2383.0,12.0,1989.0,0.0,322.0,72.0,11.0,3.0,0,1041,95,20395,1866,207432,227827,11/30/2020
2020-08-14,145,29649,5498,408356,438005,13.0,2396.0,11.0,2000.0,0.0,322.0,74.0,11.0,4.0,3,1044,98,20493,1937,209369,229862,11/30/2020
2020-08-15,106,29755,4534,412890,442645,9.0,2405.0,11.0,2011.0,1.0,323.0,71.0,11.0,5.0,0,1044,88,20581,1649,211018,231599,11/30/2020
2020-08-16,83,29838,2477,415367,445205,6.0,2411.0,5.0,2016.0,4.0,327.0,68.0,8.0,4.0,6,1050,70,20651,931,211949,232600,11/30/2020
2020-08-17,106,29944,4575,419942,449886,8.0,2419.0,6.0,2022.0,0.0,327.0,70.0,8.0,5.0,2,1052,87,20738,2344,214293,235031,11/30/2020
2020-08-18,128,30072,4911,424853,454925,11.0,2430.0,8.0,2030.0,1.0,328.0,72.0,8.0,4.0,5,1057,94,20832,2690,216983,237815,11/30/2020
2020-08-19,113,30185,5077,429930,460115,8.0,2438.0,9.0,2039.0,1.0,329.0,70.0,9.0,5.0,0,1057,90,20922,2578,219561,240483,11/30/2020
2020-08-20,173,30358,7411,437341,467699,12.0,2450.0,6.0,2045.0,2.0,331.0,74.0,10.0,5.0,3,1060,139,21061,3449,223010,244071,11/30/2020
2020-08-21,152,30510,6577,443918,474428,8.0,2458.0,5.0,2050.0,1.0,332.0,76.0,9.0,4.0,2,1062,125,21186,2872,225882,247068,11/30/2020
2020-08-22,96,30606,5550,449468,480074,11.0,2469.0,12.0,2062.0,0.0,332.0,75.0,11.0,4.0,1,1063,84,21270,2543,228425,249695,11/30/2020
2020-08-23,72,30678,4375,453843,484521,11.0,2480.0,6.0,2068.0,0.0,332.0,80.0,12.0,2.0,1,1064,56,21326,2433,230858,252184,11/30/2020
2020-08-24,105,30783,5784,459627,490410,7.0,2487.0,10.0,2078.0,1.0,333.0,76.0,14.0,4.0,1,1065,77,21403,3082,233940,255343,11/30/2020
2020-08-25,108,30891,4764,464391,495282,10.0,2497.0,4.0,2082.0,1.0,334.0,81.0,12.0,4.0,1,1066,92,21495,2245,236185,257680,11/30/2020
2020-08-26,170,31061,9482,473873,504934,4.0,2501.0,8.0,2090.0,0.0,334.0,77.0,10.0,5.0,1,1067,128,21623,3031,239216,260839,11/30/2020
2020-08-27,91,31152,8565,482438,513590,6.0,2507.0,13.0,2103.0,1.0,335.0,69.0,7.0,5.0,2,1069,70,21693,3087,242303,263996,11/30/2020
2020-08-28,113,31265,7994,490432,521697,14.0,2521.0,4.0,2107.0,0.0,335.0,79.0,10.0,7.0,2,1071,87,21780,2378,244681,266461,11/30/2020
2020-08-29,65,31330,5374,495806,527136,6.0,2527.0,8.0,2115.0,1.0,336.0,76.0,11.0,6.0,2,1073,51,21831,1883,246564,268395,11/30/2020
2020-08-30,66,31396,4323,500129,531525,7.0,2534.0,4.0,2119.0,0.0,336.0,79.0,9.0,5.0,2,1075,48,21879,1949,248513,270392,11/30/2020
2020-08-31,105,31501,4863,504992,536493,12.0,2546.0,16.0,2135.0,0.0,336.0,75.0,8.0,4.0,1,1076,81,21960,2151,250664,272624,11/30/2020
2020-09-01,99,31600,7109,512101,543701,6.0,2552.0,9.0,2144.0,1.0,337.0,71.0,7.0,4.0,2,1078,66,22026,2334,252998,275024,11/30/2020
2020-09-02,125,31725,10529,522630,554355,9.0,2561.0,10.0,2154.0,1.0,338.0,69.0,8.0,4.0,2,1080,104,22130,2995,255993,278123,11/30/2020
2020-09-03,90,31815,11080,533710,565525,8.0,2569.0,8.0,2162.0,0.0,338.0,69.0,9.0,4.0,3,1083,73,22203,2523,258516,280719,11/30/2020
2020-09-04,103,31918,8963,542673,574591,11.0,2580.0,4.0,2166.0,0.0,338.0,76.0,9.0,4.0,1,1084,83,22286,2331,260847,283133,11/30/2020
2020-09-05,52,31970,6309,548982,580952,6.0,2586.0,9.0,2175.0,0.0,338.0,73.0,8.0,3.0,1,1085,42,22328,1565,262412,284740,11/30/2020
2020-09-06,88,32058,4325,553307,585365,4.0,2590.0,8.0,2183.0,1.0,339.0,68.0,6.0,3.0,1,1086,65,22393,1910,264322,286715,11/30/2020
2020-09-07,35,32093,3002,556309,588402,11.0,2601.0,3.0,2186.0,0.0,339.0,76.0,5.0,3.0,1,1087,26,22419,632,264954,287373,11/30/2020
2020-09-08,74,32167,6381,562690,594857,6.0,2607.0,12.0,2198.0,1.0,340.0,69.0,6.0,3.0,2,1089,66,22485,1561,266515,289000,11/30/2020
2020-09-09,118,32285,8650,571340,603625,10.0,2617.0,5.0,2203.0,1.0,341.0,73.0,9.0,3.0,1,1090,102,22587,2093,268608,291195,11/30/2020
2020-09-10,164,32449,11334,582674,615123,9.0,2626.0,8.0,2211.0,0.0,341.0,74.0,10.0,3.0,1,1091,111,22698,2226,270834,293532,11/30/2020
2020-09-11,120,32569,9454,592128,624697,11.0,2637.0,11.0,2222.0,0.0,341.0,74.0,10.0,5.0,0,1091,97,22795,1930,272764,295559,11/30/2020
2020-09-12,110,32679,6174,598302,630981,8.0,2645.0,5.0,2227.0,2.0,343.0,75.0,9.0,5.0,3,1094,97,22892,1487,274251,297143,11/30/2020
2020-09-13,58,32737,2717,601019,633756,4.0,2649.0,3.0,2230.0,0.0,343.0,76.0,10.0,5.0,0,1094,54,22946,842,275093,298039,11/30/2020
2020-09-14,104,32841,6446,607465,640306,6.0,2655.0,3.0,2233.0,2.0,345.0,77.0,10.0,5.0,2,1096,95,23041,1697,276790,299831,11/30/2020
2020-09-15,122,32963,8470,615935,648898,7.0,2662.0,2.0,2235.0,1.0,346.0,81.0,10.0,5.0,2,1098,124,23165,2149,278939,302104,11/30/2020
2020-09-16,137,33100,9716,625651,658751,7.0,2669.0,7.0,2242.0,2.0,348.0,79.0,9.0,6.0,5,1103,118,23283,1938,280877,304160,11/30/2020
2020-09-17,125,33225,9239,634890,668115,7.0,2676.0,15.0,2257.0,0.0,348.0,71.0,8.0,4.0,0,1103,154,23437,1903,282780,306217,11/30/2020
2020-09-18,132,33357,10045,644935,678292,7.0,2683.0,7.0,2264.0,1.0,349.0,70.0,11.0,6.0,2,1105,132,23569,1891,284671,308240,11/30/2020
2020-09-19,115,33472,8297,653232,686704,7.0,2690.0,3.0,2267.0,0.0,349.0,74.0,10.0,6.0,4,1109,112,23681,1668,286339,310020,11/30/2020
2020-09-20,60,33532,3676,656908,690440,7.0,2697.0,6.0,2273.0,2.0,351.0,73.0,9.0,8.0,4,1113,49,23730,1299,287638,311368,11/30/2020
2020-09-21,102,33634,7018,663926,697560,12.0,2709.0,3.0,2276.0,2.0,353.0,80.0,8.0,6.0,2,1115,94,23824,2365,290003,313827,11/30/2020
2020-09-22,154,33788,9287,673213,707001,12.0,2721.0,3.0,2279.0,1.0,354.0,88.0,7.0,5.0,1,1116,124,23948,2163,292166,316114,11/30/2020
2020-09-23,136,33924,10651,683864,717788,12.0,2733.0,7.0,2286.0,0.0,354.0,93.0,6.0,5.0,0,1116,127,24075,2165,294331,318406,11/30/2020
2020-09-24,120,34044,12480,696344,730388,7.0,2740.0,9.0,2295.0,1.0,355.0,90.0,7.0,5.0,1,1117,120,24195,3116,297447,321642,11/30/2020
2020-09-25,150,34194,10553,706897,741091,9.0,2749.0,10.0,2305.0,0.0,355.0,89.0,6.0,5.0,1,1118,143,24338,2957,300404,324742,11/30/2020
2020-09-26,147,34341,10559,717456,751797,12.0,2761.0,9.0,2314.0,0.0,355.0,92.0,6.0,5.0,1,1119,120,24458,2389,302793,327251,11/30/2020
2020-09-27,43,34384,2764,720220,754604,7.0,2768.0,5.0,2319.0,0.0,355.0,94.0,9.0,5.0,0,1119,34,24492,829,303622,328114,11/30/2020
2020-09-28,156,34540,7308,727528,762068,7.0,2775.0,7.0,2326.0,2.0,357.0,92.0,7.0,5.0,2,1121,138,24630,2218,305840,330470,11/30/2020
2020-09-29,203,34743,11046,738574,773317,12.0,2787.0,18.0,2344.0,1.0,358.0,85.0,6.0,6.0,1,1122,185,24815,2785,308625,333440,11/30/2020
2020-09-30,222,34965,12230,750804,785769,6.0,2793.0,6.0,2350.0,0.0,358.0,85.0,6.0,6.0,1,1123,188,25003,2535,311160,336163,11/30/2020
2020-10-01,186,35151,12503,763307,798458,17.0,2810.0,13.0,2363.0,1.0,359.0,88.0,6.0,4.0,2,1125,167,25170,2367,313527,338697,11/30/2020
2020-10-02,209,35360,12153,775460,810820,14.0,2824.0,13.0,2376.0,1.0,360.0,88.0,8.0,5.0,2,1127,181,25351,2455,315982,341333,11/30/2020
2020-10-03,157,35517,9313,784773,820290,9.0,2833.0,9.0,2385.0,2.0,362.0,86.0,9.0,4.0,2,1129,131,25482,1992,317974,343456,11/30/2020
2020-10-04,81,35598,2369,787142,822740,11.0,2844.0,9.0,2394.0,1.0,363.0,87.0,8.0,5.0,2,1131,77,25559,940,318914,344473,11/30/2020
2020-10-05,174,35772,8983,796125,831897,30.0,2874.0,10.0,2404.0,2.0,365.0,105.0,9.0,6.0,4,1135,160,25719,2988,321902,347621,11/30/2020
2020-10-06,187,35959,11186,807311,843270,11.0,2885.0,4.0,2408.0,0.0,365.0,112.0,11.0,7.0,0,1135,188,25907,2861,324763,350670,11/30/2020
2020-10-07,241,36200,12441,819752,855952,13.0,2898.0,14.0,2422.0,2.0,367.0,109.0,9.0,7.0,2,1137,243,26150,3493,328256,354406,11/30/2020
2020-10-08,279,36479,15230,834982,871461,17.0,2915.0,13.0,2435.0,2.0,369.0,111.0,7.0,5.0,4,1141,278,26428,4163,332419,358847,11/30/2020
2020-10-09,218,36697,13745,848727,885424,21.0,2936.0,12.0,2447.0,0.0,369.0,120.0,10.0,7.0,3,1144,197,26625,4262,336681,363306,11/30/2020
2020-10-10,227,36924,13833,862560,899484,19.0,2955.0,10.0,2457.0,1.0,370.0,128.0,13.0,7.0,2,1146,194,26819,3742,340423,367242,11/30/2020
2020-10-11,97,37021,3263,865823,902844,12.0,2967.0,9.0,2466.0,1.0,371.0,130.0,14.0,5.0,6,1152,87,26906,1153,341576,368482,11/30/2020
2020-10-12,168,37189,6440,872263,909452,19.0,2986.0,15.0,2481.0,2.0,373.0,132.0,14.0,5.0,4,1156,157,27063,1702,343278,370341,11/30/2020
2020-10-13,213,37402,8522,880785,918187,15.0,3001.0,13.0,2494.0,4.0,377.0,130.0,13.0,5.0,7,1163,207,27270,2285,345563,372833,11/30/2020
2020-10-14,322,37724,15039,895824,933548,17.0,3018.0,7.0,2501.0,0.0,377.0,140.0,15.0,5.0,2,1165,301,27571,3983,349546,377117,11/30/2020
2020-10-15,262,37986,14639,910463,948449,12.0,3030.0,16.0,2517.0,1.0,378.0,135.0,13.0,5.0,2,1167,254,27825,3530,353076,380901,11/30/2020
2020-10-16,279,38265,15011,925474,963739,13.0,3043.0,18.0,2535.0,1.0,379.0,129.0,13.0,4.0,2,1169,275,28100,3337,356413,384513,11/30/2020
2020-10-17,354,38619,14069,939543,978162,19.0,3062.0,11.0,2546.0,1.0,380.0,136.0,17.0,4.0,2,1171,311,28411,3217,359630,388041,11/30/2020
2020-10-18,155,38774,4039,943582,982356,18.0,3080.0,11.0,2557.0,0.0,380.0,143.0,17.0,6.0,2,1173,127,28538,1299,360929,389467,11/30/2020
2020-10-19,388,39162,8491,952073,991235,21.0,3101.0,22.0,2579.0,2.0,382.0,140.0,15.0,6.0,1,1174,324,28862,2529,363458,392320,11/30/2020
2020-10-20,439,39601,13242,965315,1004916,23.0,3124.0,17.0,2596.0,0.0,382.0,146.0,14.0,8.0,3,1177,387,29249,2967,366425,395674,11/30/2020
2020-10-21,544,40145,17463,982778,1022923,22.0,3146.0,8.0,2604.0,2.0,384.0,158.0,15.0,9.0,3,1180,472,29721,3472,369897,399618,11/30/2020
2020-10-22,538,40683,15863,998641,1039324,24.0,3170.0,20.0,2624.0,3.0,387.0,159.0,14.0,9.0,3,1183,489,30210,3145,373042,403252,11/30/2020
2020-10-23,514,41197,16634,1015275,1056472,22.0,3192.0,22.0,2646.0,1.0,388.0,158.0,15.0,9.0,3,1186,459,30669,2845,375887,406556,11/30/2020
2020-10-24,359,41556,10249,1025524,1067080,17.0,3209.0,11.0,2657.0,0.0,388.0,164.0,14.0,8.0,1,1187,338,31007,2240,378127,409134,11/30/2020
2020-10-25,233,41789,4760,1030284,1072073,16.0,3225.0,15.0,2672.0,1.0,389.0,164.0,15.0,8.0,2,1189,209,31216,1437,379564,410780,11/30/2020
2020-10-26,454,42243,9174,1039458,1081701,26.0,3251.0,15.0,2687.0,2.0,391.0,173.0,18.0,8.0,3,1192,403,31619,2942,382506,414125,11/30/2020
2020-10-27,517,42760,13995,1053453,1096213,29.0,3280.0,15.0,2702.0,2.0,393.0,185.0,18.0,9.0,4,1196,453,32072,2360,384866,416938,11/30/2020
2020-10-28,469,43229,15229,1068682,1111911,25.0,3305.0,26.0,2728.0,1.0,394.0,183.0,17.0,9.0,3,1199,410,32482,2669,387535,420017,11/30/2020
2020-10-29,609,43838,16259,1084941,1128779,20.0,3325.0,22.0,2750.0,3.0,397.0,178.0,19.0,11.0,4,1203,528,33010,3089,390624,423634,11/30/2020
2020-10-30,565,44403,14863,1099804,1144207,21.0,3346.0,21.0,2771.0,5.0,402.0,173.0,19.0,9.0,4,1207,467,33477,2914,393538,427015,11/30/2020
2020-10-31,599,45002,11820,1111624,1156626,31.0,3377.0,13.0,2784.0,1.0,403.0,190.0,22.0,9.0,3,1210,484,33961,2393,395931,429892,11/30/2020
2020-11-01,330,45332,5091,1116715,1162047,20.0,3397.0,15.0,2799.0,1.0,404.0,194.0,26.0,12.0,4,1214,273,34234,1255,397186,431420,11/30/2020
2020-11-02,521,45853,9930,1126645,1172498,38.0,3435.0,27.0,2826.0,3.0,407.0,202.0,24.0,12.0,5,1219,455,34689,2902,400088,434777,11/30/2020
2020-11-03,602,46455,13040,1139685,1186140,33.0,3468.0,25.0,2851.0,1.0,408.0,209.0,24.0,12.0,1,1220,528,35217,2486,402574,437791,11/30/2020
2020-11-04,688,47143,16100,1155785,1202928,34.0,3502.0,27.0,2878.0,2.0,410.0,214.0,25.0,12.0,4,1224,634,35851,2903,405477,441328,11/30/2020
2020-11-05,768,47911,16593,1172378,1220289,46.0,3548.0,35.0,2913.0,1.0,411.0,224.0,24.0,14.0,3,1227,683,36534,2833,408310,444844,11/30/2020
2020-11-06,769,48680,16022,1188400,1237080,43.0,3591.0,31.0,2944.0,1.0,412.0,235.0,28.0,17.0,5,1232,692,37226,3017,411327,448553,11/30/2020
2020-11-07,604,49284,13650,1202050,1251334,34.0,3625.0,25.0,2969.0,1.0,413.0,243.0,31.0,18.0,1,1233,575,37801,2449,413776,451577,11/30/2020
2020-11-08,337,49621,4160,1206210,1255831,32.0,3657.0,26.0,2995.0,1.0,414.0,248.0,30.0,19.0,4,1237,322,38123,1267,415043,453166,11/30/2020
2020-11-09,807,50428,9040,1215250,1265678,39.0,3696.0,33.0,3028.0,2.0,416.0,252.0,28.0,18.0,3,1240,760,38883,2297,417340,456223,11/30/2020
2020-11-10,1053,51481,12982,1228232,1279713,45.0,3741.0,37.0,3065.0,0.0,416.0,260.0,31.0,18.0,6,1246,981,39864,2874,420214,460078,11/30/2020
2020-11-11,1087,52568,19741,1247973,1300541,42.0,3783.0,24.0,3089.0,5.0,421.0,273.0,30.0,15.0,7,1253,1001,40865,2665,422879,463744,11/30/2020
2020-11-12,893,53461,13902,1261875,1315336,38.0,3821.0,31.0,3120.0,3.0,424.0,277.0,28.0,15.0,5,1258,811,41676,2195,425074,466750,11/30/2020
2020-11-13,1165,54626,16390,1278265,1332891,36.0,3857.0,31.0,3151.0,0.0,424.0,282.0,27.0,15.0,2,1260,1117,42793,3097,428171,470964,11/30/2020
2020-11-14,782,55408,13517,1291782,1347190,41.0,3898.0,26.0,3177.0,5.0,429.0,292.0,25.0,13.0,10,1270,738,43531,2457,430628,474159,11/30/2020
2020-11-15,578,55986,6173,1297955,1353941,42.0,3940.0,21.0,3198.0,5.0,434.0,308.0,27.0,11.0,7,1277,489,44020,1418,432046,476066,11/30/2020
2020-11-16,738,56724,9614,1307569,1364293,55.0,3995.0,38.0,3236.0,3.0,437.0,322.0,25.0,13.0,5,1282,670,44690,2613,434659,479349,11/30/2020
2020-11-17,1538,58262,18173,1325742,1384004,59.0,4054.0,44.0,3280.0,2.0,439.0,335.0,29.0,13.0,5,1287,1398,46088,4150,438809,484897,11/30/2020
2020-11-18,1124,59386,16027,1341769,1401155,36.0,4090.0,37.0,3317.0,5.0,444.0,329.0,28.0,15.0,7,1294,1013,47101,3187,441996,489097,11/30/2020
2020-11-19,1128,60514,13155,1354924,1415438,45.0,4135.0,42.0,3359.0,4.0,448.0,328.0,28.0,18.0,5,1299,1037,48138,3417,445413,493551,11/30/2020
2020-11-20,1434,61948,22193,1377117,1439065,46.0,4181.0,49.0,3408.0,3.0,451.0,322.0,30.0,14.0,6,1305,1290,49428,4315,449728,499156,11/30/2020
2020-11-21,839,62787,17347,1394464,1457251,41.0,4222.0,34.0,3442.0,5.0,456.0,324.0,32.0,14.0,6,1311,754,50182,3157,452885,503067,11/30/2020
2020-11-22,567,63354,7520,1401984,1465338,63.0,4285.0,28.0,3470.0,4.0,460.0,355.0,30.0,15.0,11,1322,482,50664,1804,454689,505353,11/30/2020
2020-11-23,960,64314,11010,1412994,1477308,66.0,4351.0,40.0,3510.0,0.0,460.0,381.0,36.0,18.0,10,1332,868,51532,3428,458117,509649,11/30/2020
2020-11-24,1018,65332,14507,1427501,1492833,42.0,4393.0,58.0,3568.0,6.0,466.0,359.0,35.0,20.0,10,1342,937,52469,2775,460892,513361,11/30/2020
2020-11-25,1242,66574,18672,1446173,1512747,47.0,4440.0,54.0,3622.0,4.0,470.0,348.0,37.0,23.0,6,1348,1159,53628,3504,464396,518024,11/30/2020
2020-11-26,547,67121,6434,1452607,1519728,44.0,4484.0,32.0,3654.0,3.0,473.0,357.0,41.0,22.0,11,1359,467,54095,1561,465957,520052,11/30/2020
2020-11-27,985,68106,9542,1462149,1530255,46.0,4530.0,47.0,3701.0,7.0,480.0,349.0,39.0,19.0,4,1363,922,55017,2454,468411,523428,11/30/2020
2020-11-28,1126,69232,11665,1473814,1543046,52.0,4582.0,36.0,3737.0,0.0,480.0,365.0,40.0,19.0,2,1365,1055,56072,2675,471086,527158,11/30/2020
2020-11-29,726,69958,6388,1480202,1550160,,,,,,,,,,8,1373,651,56723,2075,473161,529884,11/30/2020
2020-02-27,0,0,0,0,0,1.0,1.0,0.0,0.0,0.0,0.0,1.0,0.0,0.0,0,0,0,0,0,0,0,12/02/2020
2020-02-28,0,0,0,0,0,0.0,1.0,0.0,0.0,0.0,0.0,1.0,1.0,0.0,0,0,0,0,0,0,0,12/02/2020
2020-02-29,0,0,0,0,0,0.0,1.0,0.0,0.0,0.0,0.0,1.0,1.0,0.0,0,0,0,0,0,0,0,12/02/2020
2020-03-01,2,2,2,2,4,0.0,1.0,0.0,0.0,0.0,0.0,1.0,1.0,1.0,0,0,2,2,2,2,4,12/02/2020
2020-03-02,0,2,1,3,5,1.0,2.0,0.0,0.0,0.0,0.0,2.0,2.0,2.0,0,0,0,2,0,2,4,12/02/2020
2020-03-03,0,2,2,5,7,0.0,2.0,0.0,0.0,0.0,0.0,2.0,2.0,2.0,0,0,0,2,1,3,5,12/02/2020
2020-03-04,0,2,12,17,19,1.0,3.0,0.0,0.0,0.0,0.0,3.0,2.0,2.0,0,0,0,2,10,13,15,12/02/2020
2020-03-05,0,2,4,21,23,0.0,3.0,0.0,0.0,0.0,0.0,3.0,2.0,2.0,0,0,1,3,4,17,20,12/02/2020
2020-03-06,1,3,12,33,36,0.0,3.0,0.0,0.0,0.0,0.0,3.0,2.0,2.0,0,0,0,3,11,28,31,12/02/2020
2020-03-07,0,3,19,52,55,0.0,3.0,0.0,0.0,0.0,0.0,3.0,2.0,1.0,0,0,0,3,19,47,50,12/02/2020
2020-03-08,0,3,18,70,73,0.0,3.0,0.0,0.0,0.0,0.0,3.0,2.0,1.0,0,0,0,3,18,65,68,12/02/2020
2020-03-09,1,4,15,85,89,0.0,3.0,0.0,0.0,0.0,0.0,3.0,2.0,1.0,0,0,1,4,14,79,83,12/02/2020
2020-03-10,2,6,25,110,116,0.0,3.0,0.0,0.0,0.0,0.0,3.0,2.0,1.0,0,0,1,5,23,102,107,12/02/2020
2020-03-11,0,6,34,144,150,1.0,4.0,0.0,0.0,0.0,0.0,4.0,1.0,1.0,0,0,0,5,34,136,141,12/02/2020
2020-03-12,9,15,41,185,200,1.0,5.0,0.0,0.0,0.0,0.0,5.0,1.0,1.0,0,0,7,12,38,174,186,12/02/2020
2020-03-13,6,21,50,235,256,4.0,9.0,1.0,1.0,0.0,0.0,8.0,1.0,1.0,0,0,6,18,47,221,239,12/02/2020
2020-03-14,0,21,90,325,346,0.0,9.0,0.0,1.0,0.0,0.0,8.0,1.0,1.0,0,0,0,18,83,304,322,12/02/2020
2020-03-15,1,22,54,379,401,1.0,10.0,0.0,1.0,0.0,0.0,9.0,2.0,1.0,0,0,1,19,53,357,376,12/02/2020
2020-03-16,2,24,95,474,498,2.0,12.0,0.0,1.0,0.0,0.0,11.0,2.0,0.0,0,0,2,21,90,447,468,12/02/2020
2020-03-17,12,36,162,636,672,6.0,18.0,0.0,1.0,0.0,0.0,17.0,2.0,0.0,0,0,11,32,146,593,625,12/02/2020
2020-03-18,9,45,116,752,797,3.0,21.0,0.0,1.0,0.0,0.0,20.0,2.0,0.0,0,0,11,43,106,699,742,12/02/2020
2020-03-19,15,60,262,1014,1074,2.0,23.0,1.0,2.0,0.0,0.0,21.0,3.0,0.0,1,1,17,60,245,944,1004,12/02/2020
2020-03-20,13,73,197,1211,1284,5.0,28.0,0.0,2.0,0.0,0.0,26.0,4.0,0.0,0,1,13,73,184,1128,1201,12/02/2020
2020-03-21,12,85,126,1337,1422,3.0,31.0,2.0,4.0,0.0,0.0,27.0,5.0,0.0,0,1,14,87,121,1249,1336,12/02/2020
2020-03-22,27,112,282,1619,1731,2.0,33.0,0.0,4.0,0.0,0.0,29.0,5.0,0.0,0,1,25,112,255,1504,1616,12/02/2020
2020-03-23,14,126,169,1788,1914,15.0,48.0,1.0,5.0,0.0,0.0,43.0,9.0,3.0,0,1,16,128,159,1663,1791,12/02/2020
2020-03-24,20,146,242,2030,2176,8.0,56.0,0.0,5.0,0.0,0.0,51.0,10.0,5.0,0,1,19,147,227,1890,2037,12/02/2020
2020-03-25,26,172,182,2212,2384,5.0,61.0,2.0,7.0,0.0,0.0,54.0,11.0,3.0,0,1,28,175,161,2051,2226,12/02/2020
2020-03-26,35,207,181,2393,2600,9.0,70.0,5.0,12.0,0.0,0.0,58.0,14.0,5.0,0,1,41,216,167,2218,2434,12/02/2020
2020-03-27,27,234,214,2607,2841,9.0,79.0,1.0,13.0,1.0,1.0,65.0,16.0,6.0,2,3,31,247,189,2407,2654,12/02/2020
2020-03-28,59,293,260,2867,3160,11.0,90.0,2.0,15.0,1.0,2.0,73.0,15.0,6.0,1,4,64,311,236,2643,2954,12/02/2020
2020-03-29,100,393,350,3217,3610,8.0,98.0,3.0,18.0,1.0,3.0,77.0,18.0,8.0,2,6,105,416,304,2947,3363,12/02/2020
2020-03-30,62,455,222,3439,3894,19.0,117.0,5.0,23.0,0.0,3.0,91.0,19.0,11.0,3,9,78,494,177,3124,3618,12/02/2020
2020-03-31,71,526,369,3808,4334,11.0,128.0,7.0,30.0,1.0,4.0,94.0,21.0,13.0,2,11,73,567,289,3413,3980,12/02/2020
2020-04-01,99,625,698,4506,5131,18.0,146.0,7.0,37.0,0.0,4.0,105.0,29.0,15.0,1,12,100,667,607,4020,4687,12/02/2020
2020-04-02,52,677,477,4983,5660,22.0,168.0,6.0,43.0,2.0,6.0,119.0,35.0,21.0,4,16,62,729,418,4438,5167,12/02/2020
2020-04-03,108,785,774,5757,6542,23.0,191.0,7.0,50.0,0.0,6.0,135.0,42.0,25.0,3,19,100,829,681,5119,5948,12/02/2020
2020-04-04,143,928,660,6417,7345,22.0,213.0,4.0,54.0,5.0,11.0,148.0,40.0,29.0,9,28,138,967,583,5702,6669,12/02/2020
2020-04-05,187,1115,1156,7573,8688,20.0,233.0,9.0,63.0,1.0,12.0,158.0,43.0,35.0,2,30,181,1148,1006,6708,7856,12/02/2020
2020-04-06,218,1333,1706,9279,10612,26.0,259.0,7.0,70.0,0.0,12.0,177.0,47.0,39.0,7,37,207,1355,1485,8193,9548,12/02/2020
2020-04-07,284,1617,1629,10908,12525,20.0,279.0,4.0,74.0,2.0,14.0,191.0,49.0,41.0,5,42,260,1615,1421,9614,11229,12/02/2020
2020-04-08,290,1907,1720,12628,14535,19.0,298.0,8.0,82.0,5.0,19.0,197.0,49.0,37.0,10,52,271,1886,1490,11104,12990,12/02/2020
2020-04-09,283,2190,1516,14144,16334,32.0,330.0,8.0,90.0,4.0,23.0,217.0,53.0,40.0,7,59,277,2163,1302,12406,14569,12/02/2020
2020-04-10,419,2609,2574,16718,19327,29.0,359.0,17.0,107.0,5.0,28.0,224.0,59.0,41.0,11,70,400,2563,2267,14673,17236,12/02/2020
2020-04-11,297,2906,1905,18623,21529,29.0,388.0,11.0,118.0,2.0,30.0,240.0,61.0,48.0,12,82,281,2844,1654,16327,19171,12/02/2020
2020-04-12,314,3220,1670,20293,23513,35.0,423.0,13.0,131.0,5.0,35.0,257.0,59.0,49.0,9,91,286,3130,1351,17678,20808,12/02/2020
2020-04-13,161,3381,935,21228,24609,35.0,458.0,13.0,144.0,3.0,38.0,276.0,64.0,54.0,9,100,187,3317,807,18485,21802,12/02/2020
2020-04-14,289,3670,1787,23015,26685,27.0,485.0,18.0,162.0,5.0,43.0,280.0,72.0,53.0,8,108,262,3579,1463,19948,23527,12/02/2020
2020-04-15,351,4021,1799,24814,28835,31.0,516.0,20.0,182.0,3.0,46.0,288.0,72.0,54.0,17,125,306,3885,1457,21405,25290,12/02/2020
2020-04-16,447,4468,2494,27308,31776,36.0,552.0,25.0,207.0,6.0,52.0,293.0,72.0,53.0,14,139,387,4272,1948,23353,27625,12/02/2020
2020-04-17,304,4772,1821,29129,33901,32.0,584.0,20.0,227.0,7.0,59.0,298.0,66.0,45.0,21,160,290,4562,1372,24725,29287,12/02/2020
2020-04-18,321,5093,1725,30854,35947,26.0,610.0,18.0,245.0,4.0,63.0,302.0,63.0,49.0,15,175,284,4846,1259,25984,30830,12/02/2020
2020-04-19,381,5474,2047,32901,38375,23.0,633.0,26.0,271.0,1.0,64.0,298.0,65.0,55.0,11,186,337,5183,1666,27650,32833,12/02/2020
2020-04-20,394,5868,1907,34808,40676,46.0,679.0,29.0,300.0,2.0,66.0,313.0,75.0,56.0,10,196,376,5559,1512,29162,34721,12/02/2020
2020-04-21,444,6312,2110,36918,43230,45.0,724.0,32.0,332.0,5.0,71.0,321.0,72.0,56.0,18,214,383,5942,1638,30800,36742,12/02/2020
2020-04-22,418,6730,2390,39308,46038,41.0,765.0,32.0,364.0,5.0,76.0,325.0,73.0,58.0,18,232,379,6321,1828,32628,38949,12/02/2020
2020-04-23,479,7209,2469,41777,48986,32.0,797.0,28.0,392.0,5.0,81.0,324.0,76.0,62.0,15,247,412,6733,1762,34390,41123,12/02/2020
2020-04-24,491,7700,3284,45061,52761,35.0,832.0,26.0,418.0,4.0,85.0,329.0,85.0,63.0,15,262,407,7140,2493,36883,44023,12/02/2020
2020-04-25,393,8093,2206,47267,55360,34.0,866.0,17.0,435.0,5.0,90.0,341.0,85.0,62.0,14,276,299,7439,1671,38554,45993,12/02/2020
2020-04-26,316,8409,2309,49576,57985,33.0,899.0,15.0,450.0,3.0,93.0,356.0,86.0,59.0,14,290,274,7713,1781,40335,48048,12/02/2020
2020-04-27,249,8658,1620,51196,59854,29.0,928.0,21.0,471.0,4.0,97.0,360.0,86.0,61.0,10,300,206,7919,1098,41433,49352,12/02/2020
2020-04-28,410,9068,2263,53459,62527,44.0,972.0,24.0,495.0,3.0,100.0,377.0,88.0,59.0,22,322,332,8251,1613,43046,51297,12/02/2020
2020-04-29,476,9544,3343,56802,66346,36.0,1008.0,38.0,533.0,11.0,111.0,364.0,78.0,53.0,18,340,370,8621,2256,45302,53923,12/02/2020
2020-04-30,432,9976,2769,59571,69547,33.0,1041.0,38.0,571.0,6.0,117.0,353.0,83.0,57.0,24,364,350,8971,1766,47068,56039,12/02/2020
2020-05-01,454,10430,3086,62657,73087,52.0,1093.0,38.0,609.0,3.0,120.0,364.0,84.0,58.0,14,378,323,9294,1999,49067,58361,12/02/2020
2020-05-02,257,10687,1926,64583,75270,36.0,1129.0,39.0,648.0,5.0,125.0,356.0,93.0,63.0,24,402,192,9486,1214,50281,59767,12/02/2020
2020-05-03,283,10970,2160,66743,77713,31.0,1160.0,27.0,675.0,8.0,133.0,352.0,91.0,61.0,21,423,183,9669,1479,51760,61429,12/02/2020
2020-05-04,387,11357,2098,68841,80198,30.0,1190.0,31.0,706.0,5.0,138.0,346.0,89.0,58.0,18,441,290,9959,1500,53260,63219,12/02/2020
2020-05-05,433,11790,2873,71714,83504,29.0,1219.0,32.0,738.0,6.0,144.0,337.0,83.0,55.0,16,457,299,10258,1866,55126,65384,12/02/2020
2020-05-06,488,12278,2830,74544,86822,28.0,1247.0,44.0,782.0,9.0,153.0,312.0,80.0,55.0,21,478,340,10598,1837,56963,67561,12/02/2020
2020-05-07,425,12703,2969,77513,90216,36.0,1283.0,44.0,826.0,5.0,158.0,299.0,72.0,53.0,21,499,270,10868,1869,58832,69700,12/02/2020
2020-05-08,359,13062,2598,80111,93173,30.0,1313.0,29.0,855.0,5.0,163.0,295.0,72.0,54.0,22,521,230,11098,1629,60461,71559,12/02/2020
2020-05-09,467,13529,3346,83457,96986,22.0,1335.0,21.0,876.0,4.0,167.0,292.0,70.0,52.0,15,536,289,11387,2138,62599,73986,12/02/2020
2020-05-10,285,13814,2117,85574,99388,20.0,1355.0,23.0,899.0,6.0,173.0,283.0,71.0,50.0,14,550,190,11577,1433,64032,75609,12/02/2020
2020-05-11,257,14071,1857,87431,101502,31.0,1386.0,16.0,915.0,6.0,179.0,292.0,72.0,50.0,15,565,174,11751,1239,65271,77022,12/02/2020
2020-05-12,387,14458,2611,90042,104500,23.0,1409.0,18.0,933.0,4.0,183.0,293.0,70.0,49.0,22,587,224,11975,1575,66846,78821,12/02/2020
2020-05-13,351,14809,3630,93672,108481,23.0,1432.0,25.0,958.0,1.0,184.0,290.0,70.0,50.0,13,600,199,12174,1864,68710,80884,12/02/2020
2020-05-14,329,15138,3408,97080,112218,19.0,1451.0,27.0,985.0,3.0,187.0,279.0,65.0,46.0,15,615,232,12406,1898,70608,83014,12/02/2020
2020-05-15,381,15519,3458,100538,116057,24.0,1475.0,41.0,1026.0,5.0,192.0,257.0,63.0,46.0,14,629,232,12638,1734,72342,84980,12/02/2020
2020-05-16,449,15968,4156,104694,120662,25.0,1500.0,15.0,1041.0,5.0,197.0,262.0,62.0,47.0,15,644,247,12885,1855,74197,87082,12/02/2020
2020-05-17,240,16208,2768,107462,123670,17.0,1517.0,9.0,1050.0,5.0,202.0,265.0,60.0,46.0,10,654,126,13011,1473,75670,88681,12/02/2020
2020-05-18,250,16458,2001,109463,125921,19.0,1536.0,16.0,1066.0,5.0,207.0,263.0,58.0,41.0,18,672,135,13146,1314,76984,90130,12/02/2020
2020-05-19,415,16873,3168,112631,129504,23.0,1559.0,33.0,1099.0,5.0,212.0,248.0,57.0,39.0,11,683,215,13361,1856,78840,92201,12/02/2020
2020-05-20,326,17199,2771,115402,132601,19.0,1578.0,23.0,1122.0,7.0,219.0,237.0,53.0,34.0,22,705,184,13545,1469,80309,93854,12/02/2020
2020-05-21,374,17573,3757,119159,136732,25.0,1603.0,15.0,1137.0,3.0,222.0,244.0,54.0,30.0,20,725,168,13713,1871,82180,95893,12/02/2020
2020-05-22,351,17924,3161,122320,140244,20.0,1623.0,28.0,1165.0,5.0,227.0,231.0,53.0,30.0,11,736,206,13919,1537,83717,97636,12/02/2020
2020-05-23,253,18177,2742,125062,143239,19.0,1642.0,11.0,1176.0,3.0,230.0,236.0,53.0,33.0,13,749,109,14028,1227,84944,98972,12/02/2020
2020-05-24,163,18340,1370,126432,144772,13.0,1655.0,14.0,1190.0,2.0,232.0,233.0,54.0,36.0,8,757,83,14111,749,85693,99804,12/02/2020
2020-05-25,147,18487,1385,127817,146304,14.0,1669.0,14.0,1204.0,0.0,232.0,233.0,54.0,34.0,10,767,76,14187,710,86403,100590,12/02/2020
2020-05-26,285,18772,2620,130437,149209,24.0,1693.0,21.0,1225.0,5.0,237.0,231.0,49.0,33.0,15,782,158,14345,1597,88000,102345,12/02/2020
2020-05-27,276,19048,2057,132494,151542,20.0,1713.0,18.0,1243.0,3.0,240.0,230.0,51.0,33.0,10,792,132,14477,1103,89103,103580,12/02/2020
2020-05-28,348,19396,3359,135853,155249,17.0,1730.0,29.0,1272.0,4.0,244.0,214.0,47.0,32.0,8,800,130,14607,1079,90182,104789,12/02/2020
2020-05-29,410,19806,3915,139768,159574,19.0,1749.0,26.0,1298.0,7.0,251.0,200.0,43.0,31.0,12,812,174,14781,1500,91682,106463,12/02/2020
2020-05-30,225,20031,3915,143683,163714,16.0,1765.0,19.0,1317.0,4.0,255.0,193.0,41.0,29.0,12,824,109,14890,1670,93352,108242,12/02/2020
2020-05-31,155,20186,1690,145373,165559,11.0,1776.0,11.0,1328.0,1.0,256.0,192.0,44.0,26.0,3,827,78,14968,798,94150,109118,12/02/2020
2020-06-01,212,20398,2792,148165,168563,8.0,1784.0,14.0,1342.0,1.0,257.0,185.0,45.0,29.0,5,832,93,15061,1329,95479,110540,12/02/2020
2020-06-02,273,20671,3022,151187,171858,8.0,1792.0,9.0,1351.0,3.0,260.0,181.0,38.0,25.0,10,842,98,15159,1377,96856,112015,12/02/2020
2020-06-03,254,20925,3486,154673,175598,14.0,1806.0,18.0,1369.0,6.0,266.0,171.0,34.0,25.0,11,853,99,15258,1587,98443,113701,12/02/2020
2020-06-04,276,21201,4471,159144,180345,7.0,1813.0,26.0,1395.0,4.0,270.0,148.0,31.0,24.0,12,865,107,15365,1950,100393,115758,12/02/2020
2020-06-05,215,21416,3513,162657,184073,15.0,1828.0,13.0,1408.0,6.0,276.0,144.0,27.0,21.0,11,876,99,15464,1488,101881,117345,12/02/2020
2020-06-06,201,21617,2616,165273,186890,10.0,1838.0,7.0,1415.0,2.0,278.0,145.0,29.0,19.0,6,882,67,15531,1080,102961,118492,12/02/2020
2020-06-07,83,21700,1625,166898,188598,11.0,1849.0,7.0,1422.0,1.0,279.0,148.0,25.0,17.0,4,886,51,15582,771,103732,119314,12/02/2020
2020-06-08,119,21819,1849,168747,190566,15.0,1864.0,13.0,1435.0,2.0,281.0,148.0,27.0,18.0,4,890,45,15627,925,104657,120284,12/02/2020
2020-06-09,223,22042,2673,171420,193462,10.0,1874.0,19.0,1454.0,0.0,281.0,139.0,28.0,21.0,1,891,64,15691,1217,105874,121565,12/02/2020
2020-06-10,209,22251,2987,174407,196658,13.0,1887.0,12.0,1466.0,2.0,283.0,138.0,24.0,17.0,4,895,100,15791,1422,107296,123087,12/02/2020
2020-06-11,195,22446,3513,177920,200366,7.0,1894.0,15.0,1481.0,1.0,284.0,129.0,25.0,16.0,6,901,88,15879,1479,108775,124654,12/02/2020
2020-06-12,209,22655,4601,182521,205176,9.0,1903.0,16.0,1497.0,1.0,285.0,121.0,24.0,16.0,2,903,78,15957,2076,110851,126808,12/02/2020
2020-06-13,113,22768,3036,185557,208325,6.0,1909.0,5.0,1502.0,0.0,285.0,122.0,20.0,15.0,3,906,49,16006,1310,112161,128167,12/02/2020
2020-06-14,81,22849,2046,187603,210452,7.0,1916.0,8.0,1510.0,1.0,286.0,120.0,20.0,14.0,3,909,33,16039,939,113100,129139,12/02/2020
2020-06-15,188,23037,3108,190711,213748,14.0,1930.0,19.0,1529.0,0.0,286.0,115.0,20.0,16.0,5,914,75,16114,1734,114834,130948,12/02/2020
2020-06-16,110,23147,3017,193728,216875,11.0,1941.0,9.0,1538.0,1.0,287.0,116.0,22.0,16.0,8,922,50,16164,1496,116330,132494,12/02/2020
2020-06-17,127,23274,2835,196563,219837,15.0,1956.0,20.0,1558.0,4.0,291.0,107.0,18.0,14.0,6,928,51,16215,1277,117607,133822,12/02/2020
2020-06-18,149,23423,3048,199611,223034,9.0,1965.0,15.0,1573.0,1.0,292.0,100.0,19.0,16.0,7,935,70,16285,1279,118886,135171,12/02/2020
2020-06-19,141,23564,3769,203380,226944,12.0,1977.0,12.0,1585.0,1.0,293.0,99.0,20.0,17.0,3,938,59,16344,1317,120203,136547,12/02/2020
2020-06-20,84,23648,1891,205271,228919,9.0,1986.0,12.0,1597.0,0.0,293.0,96.0,20.0,18.0,4,942,36,16380,800,121003,137383,12/02/2020
2020-06-21,37,23685,1064,206335,230020,8.0,1994.0,5.0,1602.0,0.0,293.0,99.0,20.0,18.0,2,944,30,16410,672,121675,138085,12/02/2020
2020-06-22,138,23823,3730,210065,233888,12.0,2006.0,17.0,1619.0,0.0,293.0,94.0,19.0,18.0,2,946,65,16475,1659,123334,139809,12/02/2020
2020-06-23,163,23986,3831,213896,237882,3.0,2009.0,13.0,1632.0,3.0,296.0,81.0,18.0,18.0,7,953,81,16556,1739,125073,141629,12/02/2020
2020-06-24,120,24106,3502,217398,241504,9.0,2018.0,10.0,1642.0,1.0,297.0,79.0,18.0,18.0,5,958,44,16600,1637,126710,143310,12/02/2020
2020-06-25,103,24209,2883,220281,244490,6.0,2024.0,14.0,1656.0,1.0,298.0,70.0,17.0,17.0,1,959,50,16650,1459,128169,144819,12/02/2020
2020-06-26,94,24303,2488,222769,247072,2.0,2026.0,10.0,1666.0,0.0,298.0,62.0,18.0,18.0,1,960,60,16710,1287,129456,146166,12/02/2020
2020-06-27,84,24387,3216,225985,250372,5.0,2031.0,3.0,1669.0,1.0,299.0,63.0,17.0,17.0,5,965,37,16747,1179,130635,147382,12/02/2020
2020-06-28,39,24426,1469,227454,251880,4.0,2035.0,4.0,1673.0,4.0,303.0,59.0,15.0,14.0,6,971,17,16764,580,131215,147979,12/02/2020
2020-06-29,85,24511,3697,231151,255662,4.0,2039.0,5.0,1678.0,0.0,303.0,58.0,14.0,14.0,1,972,39,16803,1318,132533,149336,12/02/2020
2020-06-30,57,24568,1958,233109,257677,1.0,2040.0,5.0,1683.0,1.0,304.0,53.0,12.0,11.0,4,976,32,16835,971,133504,150339,12/02/2020
2020-07-01,144,24712,4098,237207,261919,8.0,2048.0,10.0,1693.0,0.0,304.0,51.0,11.0,11.0,1,977,79,16914,1874,135378,152292,12/02/2020
2020-07-02,103,24815,2803,240010,264825,5.0,2053.0,5.0,1698.0,1.0,305.0,50.0,10.0,10.0,3,980,59,16973,1049,136427,153400,12/02/2020
2020-07-03,50,24865,2079,242089,266954,9.0,2062.0,6.0,1704.0,0.0,305.0,53.0,9.0,9.0,3,983,25,16998,767,137194,154192,12/02/2020
2020-07-04,57,24922,2345,244434,269356,2.0,2064.0,4.0,1708.0,1.0,306.0,50.0,10.0,9.0,2,985,33,17031,978,138172,155203,12/02/2020
2020-07-05,49,24971,2932,247366,272337,1.0,2065.0,2.0,1710.0,1.0,307.0,48.0,8.0,8.0,2,987,26,17057,1392,139564,156621,12/02/2020
2020-07-06,101,25072,2814,250180,275252,6.0,2071.0,6.0,1716.0,0.0,307.0,48.0,9.0,9.0,4,991,57,17114,1516,141080,158194,12/02/2020
2020-07-07,81,25153,3457,253637,278790,5.0,2076.0,7.0,1723.0,0.0,307.0,46.0,8.0,8.0,2,993,47,17161,1504,142584,159745,12/02/2020
2020-07-08,105,25258,3409,257046,282304,4.0,2080.0,2.0,1725.0,0.0,307.0,48.0,9.0,8.0,0,993,64,17225,1369,143953,161178,12/02/2020
2020-07-09,94,25352,3714,260760,286112,9.0,2089.0,3.0,1728.0,0.0,307.0,54.0,9.0,8.0,0,993,50,17275,1574,145527,162802,12/02/2020
2020-07-10,132,25484,4437,265197,290681,6.0,2095.0,3.0,1731.0,2.0,309.0,55.0,7.0,7.0,3,996,80,17355,2010,147537,164892,12/02/2020
2020-07-11,63,25547,2938,268135,293682,6.0,2101.0,3.0,1734.0,1.0,310.0,57.0,6.0,6.0,3,999,36,17391,1281,148818,166209,12/02/2020
2020-07-12,47,25594,1838,269973,295567,1.0,2102.0,3.0,1737.0,1.0,311.0,54.0,6.0,5.0,3,1002,34,17425,921,149739,167164,12/02/2020
2020-07-13,84,25678,3209,273182,298860,8.0,2110.0,10.0,1747.0,0.0,311.0,52.0,6.0,5.0,1,1003,61,17486,1469,151208,168694,12/02/2020
2020-07-14,74,25752,3298,276480,302232,7.0,2117.0,4.0,1751.0,0.0,311.0,55.0,5.0,5.0,1,1004,44,17530,1344,152552,170082,12/02/2020
2020-07-15,130,25882,4181,280661,306543,5.0,2122.0,7.0,1758.0,0.0,311.0,53.0,5.0,4.0,0,1004,100,17630,1702,154254,171884,12/02/2020
2020-07-16,103,25985,3740,284401,310386,6.0,2128.0,9.0,1767.0,0.0,311.0,50.0,6.0,5.0,1,1005,76,17706,1573,155827,173533,12/02/2020
2020-07-17,156,26141,4239,288640,314781,14.0,2142.0,3.0,1770.0,1.0,312.0,60.0,5.0,5.0,2,1007,79,17785,1801,157628,175413,12/02/2020
2020-07-18,85,26226,3272,291912,318138,5.0,2147.0,9.0,1779.0,1.0,313.0,55.0,5.0,4.0,4,1011,70,17855,1366,158994,176849,12/02/2020
2020-07-19,82,26308,2696,294608,320916,7.0,2154.0,3.0,1782.0,0.0,313.0,59.0,6.0,4.0,2,1013,57,17912,1121,160115,178027,12/02/2020
2020-07-20,71,26379,2666,297274,323653,9.0,2163.0,7.0,1789.0,0.0,313.0,61.0,7.0,5.0,2,1015,68,17980,1423,161538,179518,12/02/2020
2020-07-21,130,26509,4304,301578,328087,9.0,2172.0,11.0,1800.0,0.0,313.0,59.0,9.0,6.0,1,1016,108,18088,1877,163415,181503,12/02/2020
2020-07-22,130,26639,3928,305506,332145,7.0,2179.0,8.0,1808.0,1.0,314.0,57.0,7.0,6.0,1,1017,86,18174,1623,165038,183212,12/02/2020
2020-07-23,141,26780,4415,309921,336701,8.0,2187.0,6.0,1814.0,0.0,314.0,59.0,8.0,7.0,0,1017,115,18289,1922,166960,185249,12/02/2020
2020-07-24,172,26952,5966,315887,342839,15.0,2202.0,12.0,1826.0,0.0,314.0,62.0,9.0,7.0,0,1017,119,18408,2254,169214,187622,12/02/2020
2020-07-25,134,27086,4398,320285,347371,7.0,2209.0,7.0,1833.0,0.0,314.0,62.0,10.0,8.0,3,1020,108,18516,2043,171257,189773,12/02/2020
2020-07-26,62,27148,3033,323318,350466,8.0,2217.0,9.0,1842.0,0.0,314.0,61.0,11.0,7.0,1,1021,54,18570,1307,172564,191134,12/02/2020
2020-07-27,188,27336,4191,327509,354845,12.0,2229.0,7.0,1849.0,0.0,314.0,66.0,13.0,8.0,1,1022,138,18708,2283,174847,193555,12/02/2020
2020-07-28,105,27441,3840,331349,358790,5.0,2234.0,5.0,1854.0,0.0,314.0,66.0,14.0,7.0,1,1023,95,18803,1598,176445,195248,12/02/2020
2020-07-29,190,27631,5139,336488,364119,9.0,2243.0,10.0,1864.0,0.0,314.0,65.0,15.0,7.0,0,1023,154,18957,2242,178687,197644,12/02/2020
2020-07-30,121,27752,4345,340833,368585,6.0,2249.0,2.0,1866.0,1.0,315.0,68.0,15.0,6.0,1,1024,97,19054,1591,180278,199332,12/02/2020
2020-07-31,131,27883,5512,346345,374228,7.0,2256.0,9.0,1875.0,0.0,315.0,66.0,15.0,7.0,1,1025,89,19143,1796,182074,201217,12/02/2020
2020-08-01,109,27992,4294,350639,378631,7.0,2263.0,2.0,1877.0,0.0,315.0,71.0,14.0,7.0,1,1026,89,19232,1523,183597,202829,12/02/2020
2020-08-02,84,28076,2804,353443,381519,12.0,2275.0,12.0,1889.0,2.0,317.0,69.0,14.0,8.0,2,1028,62,19294,1241,184838,204132,12/02/2020
2020-08-03,188,28264,5248,358691,386955,11.0,2286.0,10.0,1899.0,0.0,317.0,70.0,16.0,7.0,1,1029,150,19444,2146,186984,206428,12/02/2020
2020-08-04,125,28389,3691,362382,390771,8.0,2294.0,5.0,1904.0,1.0,318.0,72.0,12.0,5.0,2,1031,99,19543,1731,188715,208258,12/02/2020
2020-08-05,147,28536,5935,368317,396853,11.0,2305.0,9.0,1913.0,1.0,319.0,73.0,10.0,5.0,2,1033,119,19662,2400,191115,210777,12/02/2020
2020-08-06,169,28705,5546,373863,402568,7.0,2312.0,9.0,1922.0,0.0,319.0,71.0,9.0,4.0,0,1033,120,19782,2333,193448,213230,12/02/2020
2020-08-07,123,28828,4851,378714,407542,12.0,2324.0,9.0,1931.0,1.0,320.0,73.0,9.0,3.0,2,1035,87,19869,2087,195535,215404,12/02/2020
2020-08-08,123,28951,4112,382826,411777,19.0,2343.0,6.0,1937.0,1.0,321.0,85.0,8.0,3.0,1,1036,91,19960,1740,197275,217235,12/02/2020
2020-08-09,42,28993,1727,384553,413546,6.0,2349.0,8.0,1945.0,0.0,321.0,83.0,9.0,4.0,0,1036,35,19995,1041,198316,218311,12/02/2020
2020-08-10,149,29142,4587,389140,418282,8.0,2357.0,9.0,1954.0,0.0,321.0,82.0,9.0,4.0,1,1037,113,20108,1969,200285,220393,12/02/2020
2020-08-11,106,29248,4334,393474,422722,5.0,2362.0,13.0,1967.0,0.0,321.0,74.0,10.0,4.0,3,1040,92,20200,2220,202505,222705,12/02/2020
2020-08-12,121,29369,5188,398662,428031,8.0,2370.0,11.0,1978.0,0.0,321.0,71.0,9.0,3.0,1,1041,101,20301,2549,205054,225355,12/02/2020
2020-08-13,135,29504,4196,402858,432362,13.0,2383.0,12.0,1990.0,0.0,321.0,72.0,11.0,3.0,0,1041,95,20396,1862,206916,227312,12/02/2020
2020-08-14,145,29649,5498,408356,438005,13.0,2396.0,11.0,2001.0,0.0,321.0,74.0,11.0,4.0,3,1044,98,20494,1931,208847,229341,12/02/2020
2020-08-15,106,29755,4534,412890,442645,9.0,2405.0,11.0,2012.0,1.0,322.0,71.0,11.0,5.0,0,1044,88,20582,1646,210493,231075,12/02/2020
2020-08-16,83,29838,2477,415367,445205,6.0,2411.0,5.0,2017.0,4.0,326.0,68.0,8.0,4.0,6,1050,70,20652,930,211423,232075,12/02/2020
2020-08-17,106,29944,4575,419942,449886,8.0,2419.0,6.0,2023.0,0.0,326.0,70.0,8.0,5.0,2,1052,87,20739,2341,213764,234503,12/02/2020
2020-08-18,128,30072,4911,424853,454925,11.0,2430.0,8.0,2031.0,1.0,327.0,72.0,8.0,4.0,5,1057,94,20833,2686,216450,237283,12/02/2020
2020-08-19,113,30185,5077,429930,460115,8.0,2438.0,9.0,2040.0,1.0,328.0,70.0,9.0,5.0,0,1057,90,20923,2576,219026,239949,12/02/2020
2020-08-20,173,30358,7411,437341,467699,12.0,2450.0,6.0,2046.0,2.0,330.0,74.0,10.0,5.0,3,1060,139,21062,3441,222467,243529,12/02/2020
2020-08-21,152,30510,6577,443918,474428,8.0,2458.0,5.0,2051.0,1.0,331.0,76.0,9.0,4.0,2,1062,125,21187,2863,225330,246517,12/02/2020
2020-08-22,96,30606,5550,449468,480074,11.0,2469.0,12.0,2063.0,0.0,331.0,75.0,11.0,4.0,1,1063,84,21271,2538,227868,249139,12/02/2020
2020-08-23,72,30678,4375,453843,484521,11.0,2480.0,6.0,2069.0,0.0,331.0,80.0,12.0,2.0,1,1064,56,21327,2429,230297,251624,12/02/2020
2020-08-24,105,30783,5784,459627,490410,7.0,2487.0,10.0,2079.0,1.0,332.0,76.0,14.0,4.0,1,1065,77,21404,3080,233377,254781,12/02/2020
2020-08-25,108,30891,4764,464391,495282,10.0,2497.0,4.0,2083.0,1.0,333.0,81.0,12.0,4.0,1,1066,92,21496,2242,235619,257115,12/02/2020
2020-08-26,170,31061,9482,473873,504934,4.0,2501.0,8.0,2091.0,0.0,333.0,77.0,10.0,5.0,1,1067,127,21623,3025,238644,260267,12/02/2020
2020-08-27,91,31152,8565,482438,513590,6.0,2507.0,13.0,2104.0,1.0,334.0,69.0,7.0,5.0,2,1069,70,21693,3084,241728,263421,12/02/2020
2020-08-28,113,31265,7994,490432,521697,14.0,2521.0,4.0,2108.0,0.0,334.0,79.0,10.0,7.0,2,1071,87,21780,2376,244104,265884,12/02/2020
2020-08-29,65,31330,5374,495806,527136,6.0,2527.0,8.0,2116.0,1.0,335.0,76.0,11.0,6.0,2,1073,51,21831,1881,245985,267816,12/02/2020
2020-08-30,66,31396,4323,500129,531525,7.0,2534.0,4.0,2120.0,0.0,335.0,79.0,9.0,5.0,2,1075,48,21879,1947,247932,269811,12/02/2020
2020-08-31,105,31501,4863,504992,536493,12.0,2546.0,16.0,2136.0,0.0,335.0,75.0,8.0,4.0,1,1076,81,21960,2147,250079,272039,12/02/2020
2020-09-01,99,31600,7109,512101,543701,6.0,2552.0,9.0,2145.0,1.0,336.0,71.0,7.0,4.0,2,1078,66,22026,2329,252408,274434,12/02/2020
2020-09-02,125,31725,10529,522630,554355,9.0,2561.0,10.0,2155.0,1.0,337.0,69.0,8.0,4.0,2,1080,104,22130,2993,255401,277531,12/02/2020
2020-09-03,90,31815,11080,533710,565525,8.0,2569.0,8.0,2163.0,0.0,337.0,69.0,9.0,4.0,3,1083,73,22203,2517,257918,280121,12/02/2020
2020-09-04,103,31918,8963,542673,574591,11.0,2580.0,4.0,2167.0,0.0,337.0,76.0,9.0,4.0,1,1084,83,22286,2326,260244,282530,12/02/2020
2020-09-05,52,31970,6309,548982,580952,6.0,2586.0,9.0,2176.0,0.0,337.0,73.0,8.0,3.0,1,1085,42,22328,1562,261806,284134,12/02/2020
2020-09-06,88,32058,4325,553307,585365,4.0,2590.0,8.0,2184.0,1.0,338.0,68.0,6.0,3.0,1,1086,65,22393,1906,263712,286105,12/02/2020
2020-09-07,35,32093,3002,556309,588402,11.0,2601.0,3.0,2187.0,0.0,338.0,76.0,5.0,3.0,1,1087,26,22419,630,264342,286761,12/02/2020
2020-09-08,74,32167,6381,562690,594857,6.0,2607.0,12.0,2199.0,1.0,339.0,69.0,6.0,3.0,2,1089,66,22485,1558,265900,288385,12/02/2020
2020-09-09,118,32285,8650,571340,603625,10.0,2617.0,5.0,2204.0,1.0,340.0,73.0,9.0,3.0,1,1090,102,22587,2090,267990,290577,12/02/2020
2020-09-10,164,32449,11334,582674,615123,9.0,2626.0,8.0,2212.0,0.0,340.0,74.0,10.0,3.0,1,1091,111,22698,2225,270215,292913,12/02/2020
2020-09-11,120,32569,9454,592128,624697,11.0,2637.0,11.0,2223.0,0.0,340.0,74.0,10.0,5.0,0,1091,97,22795,1924,272139,294934,12/02/2020
2020-09-12,110,32679,6174,598302,630981,8.0,2645.0,5.0,2228.0,2.0,342.0,75.0,9.0,5.0,3,1094,97,22892,1483,273622,296514,12/02/2020
2020-09-13,58,32737,2717,601019,633756,4.0,2649.0,3.0,2231.0,0.0,342.0,76.0,10.0,5.0,0,1094,54,22946,840,274462,297408,12/02/2020
2020-09-14,104,32841,6446,607465,640306,6.0,2655.0,3.0,2234.0,2.0,344.0,77.0,10.0,5.0,2,1096,95,23041,1695,276157,299198,12/02/2020
2020-09-15,122,32963,8470,615935,648898,7.0,2662.0,2.0,2236.0,1.0,345.0,81.0,10.0,5.0,2,1098,124,23165,2147,278304,301469,12/02/2020
2020-09-16,137,33100,9716,625651,658751,7.0,2669.0,7.0,2243.0,2.0,347.0,79.0,9.0,6.0,5,1103,118,23283,1933,280237,303520,12/02/2020
2020-09-17,125,33225,9239,634890,668115,7.0,2676.0,15.0,2258.0,0.0,347.0,71.0,8.0,4.0,0,1103,154,23437,1900,282137,305574,12/02/2020
2020-09-18,132,33357,10045,644935,678292,7.0,2683.0,7.0,2265.0,1.0,348.0,70.0,11.0,6.0,2,1105,132,23569,1889,284026,307595,12/02/2020
2020-09-19,115,33472,8297,653232,686704,7.0,2690.0,3.0,2268.0,0.0,348.0,74.0,10.0,6.0,4,1109,112,23681,1663,285689,309370,12/02/2020
2020-09-20,60,33532,3676,656908,690440,7.0,2697.0,6.0,2274.0,2.0,350.0,73.0,9.0,8.0,4,1113,49,23730,1299,286988,310718,12/02/2020
2020-09-21,102,33634,7018,663926,697560,12.0,2709.0,3.0,2277.0,2.0,352.0,80.0,8.0,6.0,2,1115,94,23824,2359,289347,313171,12/02/2020
2020-09-22,154,33788,9287,673213,707001,12.0,2721.0,3.0,2280.0,1.0,353.0,88.0,7.0,5.0,1,1116,124,23948,2154,291501,315449,12/02/2020
2020-09-23,136,33924,10651,683864,717788,12.0,2733.0,7.0,2287.0,0.0,353.0,93.0,6.0,5.0,0,1116,127,24075,2162,293663,317738,12/02/2020
2020-09-24,120,34044,12480,696344,730388,7.0,2740.0,9.0,2296.0,1.0,354.0,90.0,7.0,5.0,1,1117,120,24195,3114,296777,320972,12/02/2020
2020-09-25,150,34194,10553,706897,741091,9.0,2749.0,10.0,2306.0,0.0,354.0,89.0,6.0,5.0,1,1118,143,24338,2950,299727,324065,12/02/2020
2020-09-26,147,34341,10560,717457,751798,12.0,2761.0,9.0,2315.0,0.0,354.0,92.0,6.0,5.0,1,1119,120,24458,2387,302114,326572,12/02/2020
2020-09-27,43,34384,2764,720221,754605,7.0,2768.0,5.0,2320.0,0.0,354.0,94.0,9.0,5.0,0,1119,34,24492,827,302941,327433,12/02/2020
2020-09-28,156,34540,7307,727528,762068,7.0,2775.0,7.0,2327.0,2.0,356.0,92.0,7.0,5.0,2,1121,138,24630,2213,305154,329784,12/02/2020
2020-09-29,203,34743,11046,738574,773317,12.0,2787.0,18.0,2345.0,1.0,357.0,85.0,6.0,6.0,1,1122,185,24815,2778,307932,332747,12/02/2020
2020-09-30,223,34966,12230,750804,785770,6.0,2793.0,6.0,2351.0,0.0,357.0,85.0,6.0,6.0,1,1123,189,25004,2528,310460,335464,12/02/2020
2020-10-01,185,35151,12503,763307,798458,17.0,2810.0,13.0,2364.0,1.0,358.0,88.0,6.0,4.0,2,1125,166,25170,2360,312820,337990,12/02/2020
2020-10-02,209,35360,12154,775461,810821,14.0,2824.0,13.0,2377.0,1.0,359.0,88.0,8.0,5.0,2,1127,181,25351,2451,315271,340622,12/02/2020
2020-10-03,157,35517,9313,784774,820291,9.0,2833.0,9.0,2386.0,2.0,361.0,86.0,9.0,4.0,2,1129,131,25482,1986,317257,342739,12/02/2020
2020-10-04,81,35598,2369,787143,822741,11.0,2844.0,9.0,2395.0,1.0,362.0,87.0,8.0,5.0,2,1131,77,25559,936,318193,343752,12/02/2020
2020-10-05,174,35772,8982,796125,831897,30.0,2874.0,10.0,2405.0,2.0,364.0,105.0,9.0,6.0,4,1135,160,25719,2984,321177,346896,12/02/2020
2020-10-06,187,35959,11186,807311,843270,11.0,2885.0,4.0,2409.0,0.0,364.0,112.0,11.0,7.0,0,1135,188,25907,2851,324028,349935,12/02/2020
2020-10-07,242,36201,12442,819753,855954,13.0,2898.0,14.0,2423.0,2.0,366.0,109.0,9.0,7.0,2,1137,244,26151,3485,327513,353664,12/02/2020
2020-10-08,279,36480,15231,834984,871464,17.0,2915.0,13.0,2436.0,2.0,368.0,111.0,7.0,5.0,4,1141,277,26428,4156,331669,358097,12/02/2020
2020-10-09,229,36709,13745,848729,885438,21.0,2936.0,12.0,2448.0,0.0,368.0,120.0,10.0,7.0,3,1144,200,26628,4249,335918,362546,12/02/2020
2020-10-10,231,36940,13832,862561,899501,19.0,2955.0,10.0,2458.0,1.0,369.0,128.0,13.0,7.0,2,1146,193,26821,3731,339649,366470,12/02/2020
2020-10-11,97,37037,3263,865824,902861,12.0,2967.0,9.0,2467.0,1.0,370.0,130.0,14.0,5.0,6,1152,87,26908,1152,340801,367709,12/02/2020
2020-10-12,169,37206,6440,872264,909470,19.0,2986.0,15.0,2482.0,2.0,372.0,132.0,14.0,5.0,4,1156,157,27065,1698,342499,369564,12/02/2020
2020-10-13,213,37419,8522,880786,918205,15.0,3001.0,13.0,2495.0,4.0,376.0,130.0,13.0,5.0,7,1163,207,27272,2282,344781,372053,12/02/2020
2020-10-14,322,37741,15039,895825,933566,17.0,3018.0,7.0,2502.0,0.0,376.0,140.0,15.0,5.0,2,1165,300,27572,3975,348756,376328,12/02/2020
2020-10-15,262,38003,14639,910464,948467,12.0,3030.0,16.0,2518.0,1.0,377.0,135.0,13.0,5.0,2,1167,254,27826,3520,352276,380102,12/02/2020
2020-10-16,279,38282,15011,925475,963757,12.0,3042.0,18.0,2536.0,1.0,378.0,128.0,13.0,4.0,2,1169,275,28101,3330,355606,383707,12/02/2020
2020-10-17,354,38636,14069,939544,978180,19.0,3061.0,10.0,2546.0,1.0,379.0,136.0,17.0,4.0,2,1171,310,28411,3211,358817,387228,12/02/2020
2020-10-18,155,38791,4039,943583,982374,18.0,3079.0,11.0,2557.0,0.0,379.0,143.0,17.0,6.0,2,1173,126,28537,1292,360109,388646,12/02/2020
2020-10-19,388,39179,8491,952074,991253,21.0,3100.0,22.0,2579.0,2.0,381.0,140.0,15.0,6.0,1,1174,324,28861,2525,362634,391495,12/02/2020
2020-10-20,439,39618,13242,965316,1004934,23.0,3123.0,17.0,2596.0,0.0,381.0,146.0,14.0,8.0,3,1177,387,29248,2961,365595,394843,12/02/2020
2020-10-21,544,40162,17463,982779,1022941,22.0,3145.0,8.0,2604.0,2.0,383.0,158.0,15.0,9.0,3,1180,472,29720,3463,369058,398778,12/02/2020
2020-10-22,538,40700,15863,998642,1039342,24.0,3169.0,20.0,2624.0,3.0,386.0,159.0,14.0,9.0,3,1183,489,30209,3138,372196,402405,12/02/2020
2020-10-23,514,41214,16634,1015276,1056490,22.0,3191.0,22.0,2646.0,1.0,387.0,158.0,15.0,9.0,3,1186,458,30667,2841,375037,405704,12/02/2020
2020-10-24,359,41573,10249,1025525,1067098,17.0,3208.0,11.0,2657.0,0.0,387.0,164.0,14.0,8.0,1,1187,338,31005,2236,377273,408278,12/02/2020
2020-10-25,233,41806,4760,1030285,1072091,16.0,3224.0,15.0,2672.0,1.0,388.0,164.0,15.0,8.0,2,1189,209,31214,1432,378705,409919,12/02/2020
2020-10-26,454,42260,9174,1039459,1081719,26.0,3250.0,15.0,2687.0,2.0,390.0,173.0,18.0,8.0,3,1192,403,31617,2936,381641,413258,12/02/2020
2020-10-27,517,42777,13995,1053454,1096231,29.0,3279.0,15.0,2702.0,2.0,392.0,185.0,18.0,9.0,4,1196,453,32070,2356,383997,416067,12/02/2020
2020-10-28,469,43246,15229,1068683,1111929,25.0,3304.0,26.0,2728.0,1.0,393.0,183.0,17.0,9.0,3,1199,411,32481,2665,386662,419143,12/02/2020
2020-10-29,609,43855,16259,1084942,1128797,20.0,3324.0,22.0,2750.0,3.0,396.0,178.0,19.0,11.0,4,1203,526,33007,3086,389748,422755,12/02/2020
2020-10-30,565,44420,14863,1099805,1144225,21.0,3345.0,21.0,2771.0,5.0,401.0,173.0,19.0,9.0,4,1207,467,33474,2908,392656,426130,12/02/2020
2020-10-31,599,45019,11820,1111625,1156644,31.0,3376.0,13.0,2784.0,1.0,402.0,190.0,22.0,9.0,3,1210,484,33958,2386,395042,429000,12/02/2020
2020-11-01,330,45349,5091,1116716,1162065,20.0,3396.0,15.0,2799.0,1.0,403.0,194.0,26.0,12.0,4,1214,273,34231,1254,396296,430527,12/02/2020
2020-11-02,521,45870,9930,1126646,1172516,38.0,3434.0,27.0,2826.0,3.0,406.0,202.0,24.0,12.0,5,1219,454,34685,2897,399193,433878,12/02/2020
2020-11-03,602,46472,13040,1139686,1186158,33.0,3467.0,25.0,2851.0,1.0,407.0,209.0,24.0,12.0,1,1220,529,35214,2482,401675,436889,12/02/2020
2020-11-04,688,47160,16100,1155786,1202946,34.0,3501.0,27.0,2878.0,2.0,409.0,214.0,25.0,12.0,4,1224,634,35848,2897,404572,440420,12/02/2020
2020-11-05,768,47928,16593,1172379,1220307,46.0,3547.0,35.0,2913.0,1.0,410.0,224.0,24.0,14.0,3,1227,682,36530,2828,407400,443930,12/02/2020
2020-11-06,769,48697,16022,1188401,1237098,43.0,3590.0,31.0,2944.0,1.0,411.0,235.0,28.0,17.0,5,1232,691,37221,3013,410413,447634,12/02/2020
2020-11-07,604,49301,13650,1202051,1251352,34.0,3624.0,25.0,2969.0,1.0,412.0,243.0,31.0,18.0,1,1233,576,37797,2442,412855,450652,12/02/2020
2020-11-08,337,49638,4160,1206211,1255849,32.0,3656.0,26.0,2995.0,1.0,413.0,248.0,30.0,19.0,4,1237,321,38118,1265,414120,452238,12/02/2020
2020-11-09,807,50445,9040,1215251,1265696,39.0,3695.0,33.0,3028.0,2.0,415.0,252.0,28.0,18.0,3,1240,761,38879,2294,416414,455293,12/02/2020
2020-11-10,1053,51498,12982,1228233,1279731,45.0,3740.0,37.0,3065.0,0.0,415.0,260.0,31.0,18.0,6,1246,980,39859,2868,419282,459141,12/02/2020
2020-11-11,1087,52585,19741,1247974,1300559,42.0,3782.0,24.0,3089.0,5.0,420.0,273.0,30.0,15.0,7,1253,1000,40859,2661,421943,462802,12/02/2020
2020-11-12,893,53478,13902,1261876,1315354,39.0,3821.0,31.0,3120.0,3.0,423.0,278.0,28.0,15.0,5,1258,811,41670,2190,424133,465803,12/02/2020
2020-11-13,1165,54643,16390,1278266,1332909,37.0,3858.0,31.0,3151.0,0.0,423.0,284.0,27.0,15.0,2,1260,1115,42785,3091,427224,470009,12/02/2020
2020-11-14,782,55425,13517,1291783,1347208,41.0,3899.0,26.0,3177.0,5.0,428.0,294.0,25.0,13.0,10,1270,739,43524,2454,429678,473202,12/02/2020
2020-11-15,578,56003,6173,1297956,1353959,43.0,3942.0,21.0,3198.0,5.0,433.0,311.0,28.0,11.0,7,1277,492,44016,1416,431094,475110,12/02/2020
2020-11-16,738,56741,9614,1307570,1364311,55.0,3997.0,38.0,3236.0,3.0,436.0,325.0,26.0,13.0,5,1282,669,44685,2608,433702,478387,12/02/2020
2020-11-17,1538,58279,18173,1325743,1384022,59.0,4056.0,44.0,3280.0,2.0,438.0,338.0,30.0,13.0,5,1287,1398,46083,4132,437834,483917,12/02/2020
2020-11-18,1124,59403,16027,1341770,1401173,36.0,4092.0,38.0,3318.0,5.0,443.0,331.0,29.0,15.0,7,1294,1009,47092,3181,441015,488107,12/02/2020
2020-11-19,1128,60531,13155,1354925,1415456,45.0,4137.0,42.0,3360.0,4.0,447.0,330.0,30.0,18.0,5,1299,1035,48127,3403,444418,492545,12/02/2020
2020-11-20,1434,61965,22193,1377118,1439083,47.0,4184.0,48.0,3408.0,3.0,450.0,326.0,32.0,14.0,6,1305,1288,49415,4306,448724,498139,12/02/2020
2020-11-21,839,62804,17349,1394467,1457271,42.0,4226.0,34.0,3442.0,5.0,455.0,329.0,34.0,14.0,6,1311,754,50169,3151,451875,502044,12/02/2020
2020-11-22,567,63371,7519,1401986,1465357,63.0,4289.0,28.0,3470.0,4.0,459.0,360.0,32.0,15.0,11,1322,485,50654,1800,453675,504329,12/02/2020
2020-11-23,960,64331,11011,1412997,1477328,70.0,4359.0,40.0,3510.0,0.0,459.0,390.0,39.0,18.0,10,1332,869,51523,3421,457096,508619,12/02/2020
2020-11-24,1024,65355,14507,1427504,1492859,43.0,4402.0,58.0,3568.0,6.0,465.0,369.0,39.0,20.0,10,1342,946,52469,2764,459860,512329,12/02/2020
2020-11-25,1252,66607,18701,1446205,1512812,51.0,4453.0,58.0,3626.0,4.0,469.0,358.0,41.0,24.0,6,1348,1170,53639,3509,463369,517008,12/02/2020
2020-11-26,548,67155,6477,1452682,1519837,50.0,4503.0,32.0,3658.0,4.0,473.0,372.0,44.0,23.0,12,1360,471,54110,1583,464952,519062,12/02/2020
2020-11-27,1001,68156,9684,1462366,1530522,51.0,4554.0,49.0,3707.0,7.0,480.0,367.0,43.0,20.0,5,1365,945,55055,2525,467477,522532,12/02/2020
2020-11-28,1141,69297,11834,1474200,1543497,61.0,4615.0,40.0,3747.0,0.0,480.0,388.0,43.0,20.0,3,1368,1087,56142,2751,470228,526370,12/02/2020
2020-11-29,795,70092,6816,1481016,1551108,62.0,4677.0,33.0,3780.0,3.0,483.0,414.0,44.0,23.0,8,1376,739,56881,2272,472500,529381,12/02/2020
2020-11-30,1201,71293,9842,1490858,1562151,55.0,4732.0,59.0,3839.0,2.0,485.0,408.0,45.0,28.0,5,1381,1092,57973,2810,475310,533283,12/02/2020
2020-12-01,1140,72433,11240,1502098,1574531,,,,,,,,,,10,1391,1032,59005,2591,477901,536906,12/02/2020
2020-02-27,0,0,0,0,0,1.0,1.0,0.0,0.0,0.0,0.0,1.0,0.0,0.0,0,0,0,0,0,0,0,12/03/2020
2020-02-28,0,0,0,0,0,0.0,1.0,0.0,0.0,0.0,0.0,1.0,1.0,0.0,0,0,0,0,0,0,0,12/03/2020
2020-02-29,0,0,0,0,0,0.0,1.0,0.0,0.0,0.0,0.0,1.0,1.0,0.0,0,0,0,0,0,0,0,12/03/2020
2020-03-01,2,2,2,2,4,0.0,1.0,0.0,0.0,0.0,0.0,1.0,1.0,1.0,0,0,2,2,2,2,4,12/03/2020
2020-03-02,0,2,1,3,5,1.0,2.0,0.0,0.0,0.0,0.0,2.0,2.0,2.0,0,0,0,2,0,2,4,12/03/2020
2020-03-03,0,2,2,5,7,0.0,2.0,0.0,0.0,0.0,0.0,2.0,2.0,2.0,0,0,0,2,1,3,5,12/03/2020
2020-03-04,0,2,12,17,19,1.0,3.0,0.0,0.0,0.0,0.0,3.0,2.0,2.0,0,0,0,2,10,13,15,12/03/2020
2020-03-05,0,2,4,21,23,0.0,3.0,0.0,0.0,0.0,0.0,3.0,2.0,2.0,0,0,1,3,4,17,20,12/03/2020
2020-03-06,1,3,12,33,36,0.0,3.0,0.0,0.0,0.0,0.0,3.0,2.0,2.0,0,0,0,3,11,28,31,12/03/2020
2020-03-07,0,3,19,52,55,0.0,3.0,0.0,0.0,0.0,0.0,3.0,2.0,1.0,0,0,0,3,19,47,50,12/03/2020
2020-03-08,0,3,18,70,73,0.0,3.0,0.0,0.0,0.0,0.0,3.0,2.0,1.0,0,0,0,3,18,65,68,12/03/2020
2020-03-09,1,4,15,85,89,0.0,3.0,0.0,0.0,0.0,0.0,3.0,2.0,1.0,0,0,1,4,14,79,83,12/03/2020
2020-03-10,2,6,25,110,116,0.0,3.0,0.0,0.0,0.0,0.0,3.0,2.0,1.0,0,0,1,5,23,102,107,12/03/2020
2020-03-11,0,6,34,144,150,1.0,4.0,0.0,0.0,0.0,0.0,4.0,1.0,1.0,0,0,0,5,34,136,141,12/03/2020
2020-03-12,9,15,41,185,200,1.0,5.0,0.0,0.0,0.0,0.0,5.0,1.0,1.0,0,0,7,12,38,174,186,12/03/2020
2020-03-13,6,21,50,235,256,4.0,9.0,1.0,1.0,0.0,0.0,8.0,1.0,1.0,0,0,6,18,47,221,239,12/03/2020
2020-03-14,0,21,90,325,346,0.0,9.0,0.0,1.0,0.0,0.0,8.0,1.0,1.0,0,0,0,18,83,304,322,12/03/2020
2020-03-15,1,22,54,379,401,1.0,10.0,0.0,1.0,0.0,0.0,9.0,2.0,1.0,0,0,1,19,53,357,376,12/03/2020
2020-03-16,2,24,95,474,498,2.0,12.0,0.0,1.0,0.0,0.0,11.0,2.0,0.0,0,0,2,21,90,447,468,12/03/2020
2020-03-17,12,36,162,636,672,6.0,18.0,0.0,1.0,0.0,0.0,17.0,2.0,0.0,0,0,11,32,146,593,625,12/03/2020
2020-03-18,9,45,116,752,797,3.0,21.0,0.0,1.0,0.0,0.0,20.0,2.0,0.0,0,0,11,43,106,699,742,12/03/2020
2020-03-19,15,60,262,1014,1074,2.0,23.0,1.0,2.0,0.0,0.0,21.0,3.0,0.0,1,1,17,60,245,944,1004,12/03/2020
2020-03-20,13,73,197,1211,1284,5.0,28.0,0.0,2.0,0.0,0.0,26.0,4.0,0.0,0,1,13,73,183,1127,1200,12/03/2020
2020-03-21,12,85,126,1337,1422,3.0,31.0,2.0,4.0,0.0,0.0,27.0,5.0,0.0,0,1,14,87,120,1247,1334,12/03/2020
2020-03-22,27,112,282,1619,1731,2.0,33.0,0.0,4.0,0.0,0.0,29.0,5.0,0.0,0,1,25,112,254,1501,1613,12/03/2020
2020-03-23,14,126,169,1788,1914,15.0,48.0,1.0,5.0,0.0,0.0,43.0,9.0,3.0,0,1,16,128,159,1660,1788,12/03/2020
2020-03-24,20,146,242,2030,2176,8.0,56.0,0.0,5.0,0.0,0.0,51.0,10.0,5.0,0,1,19,147,226,1886,2033,12/03/2020
2020-03-25,26,172,182,2212,2384,5.0,61.0,2.0,7.0,0.0,0.0,54.0,11.0,3.0,0,1,28,175,161,2047,2222,12/03/2020
2020-03-26,35,207,181,2393,2600,9.0,70.0,5.0,12.0,0.0,0.0,58.0,14.0,5.0,0,1,41,216,167,2214,2430,12/03/2020
2020-03-27,27,234,214,2607,2841,9.0,79.0,1.0,13.0,1.0,1.0,65.0,16.0,6.0,2,3,31,247,189,2403,2650,12/03/2020
2020-03-28,59,293,260,2867,3160,11.0,90.0,2.0,15.0,1.0,2.0,73.0,15.0,6.0,1,4,64,311,236,2639,2950,12/03/2020
2020-03-29,100,393,350,3217,3610,8.0,98.0,3.0,18.0,1.0,3.0,77.0,18.0,8.0,2,6,105,416,303,2942,3358,12/03/2020
2020-03-30,62,455,222,3439,3894,19.0,117.0,5.0,23.0,0.0,3.0,91.0,19.0,11.0,3,9,78,494,176,3118,3612,12/03/2020
2020-03-31,71,526,369,3808,4334,11.0,128.0,7.0,30.0,1.0,4.0,94.0,21.0,13.0,2,11,73,567,287,3405,3972,12/03/2020
2020-04-01,99,625,698,4506,5131,18.0,146.0,7.0,37.0,0.0,4.0,105.0,29.0,15.0,1,12,100,667,605,4010,4677,12/03/2020
2020-04-02,52,677,477,4983,5660,22.0,168.0,6.0,43.0,2.0,6.0,119.0,35.0,21.0,4,16,62,729,417,4427,5156,12/03/2020
2020-04-03,108,785,774,5757,6542,23.0,191.0,7.0,50.0,0.0,6.0,135.0,42.0,25.0,3,19,100,829,678,5105,5934,12/03/2020
2020-04-04,143,928,660,6417,7345,22.0,213.0,4.0,54.0,5.0,11.0,148.0,40.0,29.0,9,28,138,967,582,5687,6654,12/03/2020
2020-04-05,187,1115,1156,7573,8688,20.0,233.0,9.0,63.0,1.0,12.0,158.0,43.0,35.0,2,30,181,1148,1001,6688,7836,12/03/2020
2020-04-06,218,1333,1706,9279,10612,26.0,259.0,7.0,70.0,0.0,12.0,177.0,47.0,39.0,7,37,207,1355,1480,8168,9523,12/03/2020
2020-04-07,284,1617,1629,10908,12525,20.0,279.0,4.0,74.0,2.0,14.0,191.0,49.0,41.0,5,42,260,1615,1416,9584,11199,12/03/2020
2020-04-08,290,1907,1720,12628,14535,19.0,298.0,8.0,82.0,5.0,19.0,197.0,49.0,37.0,10,52,271,1886,1483,11067,12953,12/03/2020
2020-04-09,283,2190,1516,14144,16334,32.0,330.0,8.0,90.0,4.0,23.0,217.0,53.0,40.0,7,59,277,2163,1299,12366,14529,12/03/2020
2020-04-10,419,2609,2574,16718,19327,29.0,359.0,17.0,107.0,5.0,28.0,224.0,59.0,41.0,11,70,400,2563,2262,14628,17191,12/03/2020
2020-04-11,297,2906,1905,18623,21529,29.0,388.0,11.0,118.0,2.0,30.0,240.0,61.0,48.0,12,82,281,2844,1651,16279,19123,12/03/2020
2020-04-12,314,3220,1670,20293,23513,35.0,423.0,13.0,131.0,5.0,35.0,257.0,59.0,49.0,9,91,286,3130,1340,17619,20749,12/03/2020
2020-04-13,161,3381,935,21228,24609,35.0,458.0,13.0,144.0,3.0,38.0,276.0,64.0,54.0,9,100,187,3317,803,18422,21739,12/03/2020
2020-04-14,289,3670,1787,23015,26685,27.0,485.0,18.0,162.0,5.0,43.0,280.0,72.0,53.0,8,108,262,3579,1457,19879,23458,12/03/2020
2020-04-15,351,4021,1799,24814,28835,31.0,516.0,20.0,182.0,3.0,46.0,288.0,72.0,54.0,17,125,306,3885,1452,21331,25216,12/03/2020
2020-04-16,447,4468,2494,27308,31776,36.0,552.0,25.0,207.0,6.0,52.0,293.0,72.0,53.0,14,139,387,4272,1944,23275,27547,12/03/2020
2020-04-17,304,4772,1821,29129,33901,32.0,584.0,20.0,227.0,7.0,59.0,298.0,66.0,45.0,21,160,290,4562,1362,24637,29199,12/03/2020
2020-04-18,321,5093,1725,30854,35947,26.0,610.0,18.0,245.0,4.0,63.0,302.0,63.0,49.0,15,175,284,4846,1256,25893,30739,12/03/2020
2020-04-19,381,5474,2047,32901,38375,23.0,633.0,26.0,271.0,1.0,64.0,298.0,65.0,55.0,11,186,337,5183,1665,27558,32741,12/03/2020
2020-04-20,394,5868,1907,34808,40676,46.0,679.0,29.0,300.0,2.0,66.0,313.0,75.0,56.0,10,196,376,5559,1507,29065,34624,12/03/2020
2020-04-21,444,6312,2110,36918,43230,45.0,724.0,32.0,332.0,5.0,71.0,321.0,72.0,56.0,18,214,383,5942,1633,30698,36640,12/03/2020
2020-04-22,418,6730,2390,39308,46038,41.0,765.0,32.0,364.0,5.0,76.0,325.0,73.0,58.0,18,232,379,6321,1824,32522,38843,12/03/2020
2020-04-23,479,7209,2469,41777,48986,32.0,797.0,28.0,392.0,5.0,81.0,324.0,76.0,62.0,15,247,412,6733,1758,34280,41013,12/03/2020
2020-04-24,491,7700,3284,45061,52761,35.0,832.0,26.0,418.0,4.0,85.0,329.0,85.0,63.0,15,262,407,7140,2484,36764,43904,12/03/2020
2020-04-25,393,8093,2206,47267,55360,34.0,866.0,17.0,435.0,5.0,90.0,341.0,85.0,62.0,14,276,299,7439,1648,38412,45851,12/03/2020
2020-04-26,316,8409,2309,49576,57985,33.0,899.0,15.0,450.0,3.0,93.0,356.0,86.0,59.0,14,290,274,7713,1769,40181,47894,12/03/2020
2020-04-27,249,8658,1620,51196,59854,29.0,928.0,21.0,471.0,4.0,97.0,360.0,86.0,61.0,10,300,206,7919,1093,41274,49193,12/03/2020
2020-04-28,410,9068,2263,53459,62527,44.0,972.0,24.0,495.0,3.0,100.0,377.0,88.0,59.0,22,322,332,8251,1610,42884,51135,12/03/2020
2020-04-29,476,9544,3343,56802,66346,36.0,1008.0,38.0,533.0,11.0,111.0,364.0,78.0,53.0,18,340,370,8621,2248,45132,53753,12/03/2020
2020-04-30,432,9976,2769,59571,69547,33.0,1041.0,38.0,571.0,6.0,117.0,353.0,83.0,57.0,24,364,350,8971,1761,46893,55864,12/03/2020
2020-05-01,454,10430,3086,62657,73087,52.0,1093.0,39.0,610.0,3.0,120.0,363.0,84.0,58.0,14,378,323,9294,1978,48871,58165,12/03/2020
2020-05-02,257,10687,1926,64583,75270,36.0,1129.0,38.0,648.0,5.0,125.0,356.0,93.0,63.0,24,402,192,9486,1210,50081,59567,12/03/2020
2020-05-03,283,10970,2160,66743,77713,31.0,1160.0,27.0,675.0,8.0,133.0,352.0,91.0,61.0,21,423,183,9669,1473,51554,61223,12/03/2020
2020-05-04,387,11357,2098,68841,80198,30.0,1190.0,31.0,706.0,5.0,138.0,346.0,89.0,58.0,18,441,290,9959,1491,53045,63004,12/03/2020
2020-05-05,433,11790,2873,71714,83504,29.0,1219.0,32.0,738.0,6.0,144.0,337.0,83.0,55.0,16,457,299,10258,1859,54904,65162,12/03/2020
2020-05-06,488,12278,2830,74544,86822,28.0,1247.0,44.0,782.0,9.0,153.0,312.0,80.0,55.0,21,478,340,10598,1829,56733,67331,12/03/2020
2020-05-07,425,12703,2969,77513,90216,36.0,1283.0,44.0,826.0,5.0,158.0,299.0,72.0,53.0,21,499,270,10868,1862,58595,69463,12/03/2020
2020-05-08,359,13062,2598,80111,93173,30.0,1313.0,29.0,855.0,5.0,163.0,295.0,72.0,54.0,22,521,230,11098,1624,60219,71317,12/03/2020
2020-05-09,467,13529,3346,83457,96986,22.0,1335.0,21.0,876.0,4.0,167.0,292.0,70.0,52.0,15,536,289,11387,2126,62345,73732,12/03/2020
2020-05-10,285,13814,2117,85574,99388,20.0,1355.0,23.0,899.0,6.0,173.0,283.0,71.0,50.0,14,550,190,11577,1428,63773,75350,12/03/2020
2020-05-11,257,14071,1857,87431,101502,31.0,1386.0,16.0,915.0,6.0,179.0,292.0,72.0,50.0,15,565,173,11750,1236,65009,76759,12/03/2020
2020-05-12,387,14458,2611,90042,104500,23.0,1409.0,18.0,933.0,4.0,183.0,293.0,70.0,49.0,22,587,224,11974,1565,66574,78548,12/03/2020
2020-05-13,351,14809,3630,93672,108481,23.0,1432.0,25.0,958.0,1.0,184.0,290.0,70.0,50.0,13,600,199,12173,1862,68436,80609,12/03/2020
2020-05-14,329,15138,3408,97080,112218,19.0,1451.0,27.0,985.0,3.0,187.0,279.0,65.0,46.0,15,615,232,12405,1888,70324,82729,12/03/2020
2020-05-15,381,15519,3458,100538,116057,24.0,1475.0,41.0,1026.0,5.0,192.0,257.0,63.0,46.0,14,629,232,12637,1729,72053,84690,12/03/2020
2020-05-16,449,15968,4156,104694,120662,25.0,1500.0,15.0,1041.0,5.0,197.0,262.0,62.0,47.0,15,644,247,12884,1853,73906,86790,12/03/2020
2020-05-17,240,16208,2768,107462,123670,17.0,1517.0,9.0,1050.0,5.0,202.0,265.0,60.0,46.0,10,654,126,13010,1468,75374,88384,12/03/2020
2020-05-18,250,16458,2001,109463,125921,19.0,1536.0,16.0,1066.0,5.0,207.0,263.0,58.0,41.0,18,672,135,13145,1313,76687,89832,12/03/2020
2020-05-19,415,16873,3168,112631,129504,23.0,1559.0,33.0,1099.0,5.0,212.0,248.0,57.0,39.0,11,683,215,13360,1852,78539,91899,12/03/2020
2020-05-20,326,17199,2771,115402,132601,19.0,1578.0,23.0,1122.0,7.0,219.0,237.0,53.0,34.0,22,705,184,13544,1466,80005,93549,12/03/2020
2020-05-21,374,17573,3757,119159,136732,25.0,1603.0,15.0,1137.0,3.0,222.0,244.0,54.0,30.0,20,725,168,13712,1867,81872,95584,12/03/2020
2020-05-22,351,17924,3161,122320,140244,20.0,1623.0,28.0,1165.0,5.0,227.0,231.0,53.0,30.0,11,736,206,13918,1534,83406,97324,12/03/2020
2020-05-23,253,18177,2742,125062,143239,19.0,1642.0,11.0,1176.0,3.0,230.0,236.0,53.0,33.0,13,749,109,14027,1222,84628,98655,12/03/2020
2020-05-24,163,18340,1370,126432,144772,13.0,1655.0,14.0,1190.0,2.0,232.0,233.0,54.0,36.0,8,757,83,14110,746,85374,99484,12/03/2020
2020-05-25,147,18487,1385,127817,146304,14.0,1669.0,14.0,1204.0,0.0,232.0,233.0,54.0,34.0,10,767,76,14186,708,86082,100268,12/03/2020
2020-05-26,285,18772,2620,130437,149209,24.0,1693.0,21.0,1225.0,5.0,237.0,231.0,49.0,33.0,15,782,158,14344,1589,87671,102015,12/03/2020
2020-05-27,276,19048,2057,132494,151542,20.0,1713.0,18.0,1243.0,3.0,240.0,230.0,51.0,33.0,10,792,132,14476,1098,88769,103245,12/03/2020
2020-05-28,348,19396,3359,135853,155249,17.0,1730.0,29.0,1272.0,4.0,244.0,214.0,47.0,32.0,8,800,130,14606,1072,89841,104447,12/03/2020
2020-05-29,410,19806,3915,139768,159574,19.0,1749.0,26.0,1298.0,7.0,251.0,200.0,43.0,31.0,12,812,174,14780,1492,91333,106113,12/03/2020
2020-05-30,225,20031,3915,143683,163714,16.0,1765.0,19.0,1317.0,4.0,255.0,193.0,41.0,29.0,12,824,109,14889,1664,92997,107886,12/03/2020
2020-05-31,155,20186,1690,145373,165559,11.0,1776.0,11.0,1328.0,1.0,256.0,192.0,44.0,26.0,3,827,78,14967,795,93792,108759,12/03/2020
2020-06-01,212,20398,2792,148165,168563,8.0,1784.0,14.0,1342.0,1.0,257.0,185.0,45.0,29.0,5,832,93,15060,1327,95119,110179,12/03/2020
2020-06-02,273,20671,3022,151187,171858,8.0,1792.0,9.0,1351.0,3.0,260.0,181.0,38.0,25.0,10,842,98,15158,1377,96496,111654,12/03/2020
2020-06-03,254,20925,3486,154673,175598,14.0,1806.0,18.0,1369.0,6.0,266.0,171.0,34.0,25.0,11,853,99,15257,1587,98083,113340,12/03/2020
2020-06-04,276,21201,4471,159144,180345,7.0,1813.0,26.0,1395.0,4.0,270.0,148.0,31.0,24.0,12,865,107,15364,1945,100028,115392,12/03/2020
2020-06-05,215,21416,3513,162657,184073,15.0,1828.0,13.0,1408.0,6.0,276.0,144.0,27.0,21.0,11,876,99,15463,1486,101514,116977,12/03/2020
2020-06-06,201,21617,2616,165273,186890,10.0,1838.0,7.0,1415.0,2.0,278.0,145.0,29.0,19.0,6,882,67,15530,1076,102590,118120,12/03/2020
2020-06-07,83,21700,1625,166898,188598,11.0,1849.0,7.0,1422.0,1.0,279.0,148.0,25.0,17.0,4,886,51,15581,769,103359,118940,12/03/2020
2020-06-08,119,21819,1849,168747,190566,15.0,1864.0,13.0,1435.0,2.0,281.0,148.0,27.0,18.0,4,890,45,15626,924,104283,119909,12/03/2020
2020-06-09,223,22042,2673,171420,193462,10.0,1874.0,19.0,1454.0,0.0,281.0,139.0,28.0,21.0,1,891,64,15690,1216,105499,121189,12/03/2020
2020-06-10,209,22251,2987,174407,196658,13.0,1887.0,12.0,1466.0,2.0,283.0,138.0,24.0,17.0,4,895,100,15790,1421,106920,122710,12/03/2020
2020-06-11,195,22446,3513,177920,200366,7.0,1894.0,15.0,1481.0,1.0,284.0,129.0,25.0,16.0,6,901,88,15878,1477,108397,124275,12/03/2020
2020-06-12,209,22655,4601,182521,205176,9.0,1903.0,16.0,1497.0,1.0,285.0,121.0,24.0,16.0,2,903,78,15956,2060,110457,126413,12/03/2020
2020-06-13,113,22768,3036,185557,208325,6.0,1909.0,5.0,1502.0,0.0,285.0,122.0,20.0,15.0,3,906,49,16005,1308,111765,127770,12/03/2020
2020-06-14,81,22849,2046,187603,210452,7.0,1916.0,8.0,1510.0,1.0,286.0,120.0,20.0,14.0,3,909,33,16038,937,112702,128740,12/03/2020
2020-06-15,188,23037,3108,190711,213748,14.0,1930.0,19.0,1529.0,0.0,286.0,115.0,20.0,16.0,5,914,75,16113,1727,114429,130542,12/03/2020
2020-06-16,110,23147,3017,193728,216875,11.0,1941.0,9.0,1538.0,1.0,287.0,116.0,22.0,16.0,8,922,50,16163,1490,115919,132082,12/03/2020
2020-06-17,127,23274,2835,196563,219837,15.0,1956.0,20.0,1558.0,4.0,291.0,107.0,18.0,14.0,6,928,51,16214,1274,117193,133407,12/03/2020
2020-06-18,149,23423,3048,199611,223034,9.0,1965.0,15.0,1573.0,1.0,292.0,100.0,19.0,16.0,7,935,70,16284,1274,118467,134751,12/03/2020
2020-06-19,141,23564,3769,203380,226944,12.0,1977.0,12.0,1585.0,1.0,293.0,99.0,20.0,17.0,3,938,59,16343,1315,119782,136125,12/03/2020
2020-06-20,84,23648,1891,205271,228919,9.0,1986.0,12.0,1597.0,0.0,293.0,96.0,20.0,18.0,4,942,36,16379,798,120580,136959,12/03/2020
2020-06-21,37,23685,1064,206335,230020,8.0,1994.0,5.0,1602.0,0.0,293.0,99.0,20.0,18.0,2,944,30,16409,670,121250,137659,12/03/2020
2020-06-22,138,23823,3730,210065,233888,12.0,2006.0,17.0,1619.0,0.0,293.0,94.0,19.0,18.0,2,946,65,16474,1656,122906,139380,12/03/2020
2020-06-23,163,23986,3831,213896,237882,3.0,2009.0,13.0,1632.0,3.0,296.0,81.0,18.0,18.0,7,953,81,16555,1733,124639,141194,12/03/2020
2020-06-24,120,24106,3502,217398,241504,9.0,2018.0,10.0,1642.0,1.0,297.0,79.0,18.0,18.0,5,958,44,16599,1633,126272,142871,12/03/2020
2020-06-25,103,24209,2883,220281,244490,6.0,2024.0,14.0,1656.0,1.0,298.0,70.0,17.0,17.0,1,959,50,16649,1457,127729,144378,12/03/2020
2020-06-26,94,24303,2488,222769,247072,2.0,2026.0,10.0,1666.0,0.0,298.0,62.0,18.0,18.0,1,960,60,16709,1284,129013,145722,12/03/2020
2020-06-27,84,24387,3216,225985,250372,5.0,2031.0,3.0,1669.0,1.0,299.0,63.0,17.0,17.0,5,965,37,16746,1179,130192,146938,12/03/2020
2020-06-28,39,24426,1469,227454,251880,4.0,2035.0,4.0,1673.0,4.0,303.0,59.0,15.0,14.0,6,971,17,16763,580,130772,147535,12/03/2020
2020-06-29,85,24511,3697,231151,255662,4.0,2039.0,5.0,1678.0,0.0,303.0,58.0,14.0,14.0,1,972,39,16802,1313,132085,148887,12/03/2020
2020-06-30,57,24568,1958,233109,257677,1.0,2040.0,5.0,1683.0,1.0,304.0,53.0,12.0,11.0,4,976,32,16834,971,133056,149890,12/03/2020
2020-07-01,144,24712,4098,237207,261919,8.0,2048.0,10.0,1693.0,0.0,304.0,51.0,11.0,11.0,1,977,79,16913,1870,134926,151839,12/03/2020
2020-07-02,103,24815,2803,240010,264825,5.0,2053.0,5.0,1698.0,1.0,305.0,50.0,10.0,10.0,3,980,59,16972,1047,135973,152945,12/03/2020
2020-07-03,50,24865,2079,242089,266954,9.0,2062.0,6.0,1704.0,0.0,305.0,53.0,9.0,9.0,3,983,25,16997,764,136737,153734,12/03/2020
2020-07-04,57,24922,2345,244434,269356,2.0,2064.0,4.0,1708.0,1.0,306.0,50.0,10.0,9.0,2,985,33,17030,977,137714,154744,12/03/2020
2020-07-05,49,24971,2932,247366,272337,1.0,2065.0,2.0,1710.0,1.0,307.0,48.0,8.0,8.0,2,987,26,17056,1388,139102,156158,12/03/2020
2020-07-06,101,25072,2814,250180,275252,6.0,2071.0,6.0,1716.0,0.0,307.0,48.0,9.0,9.0,4,991,57,17113,1514,140616,157729,12/03/2020
2020-07-07,81,25153,3457,253637,278790,5.0,2076.0,7.0,1723.0,0.0,307.0,46.0,8.0,8.0,2,993,47,17160,1501,142117,159277,12/03/2020
2020-07-08,105,25258,3409,257046,282304,4.0,2080.0,2.0,1725.0,0.0,307.0,48.0,9.0,8.0,0,993,64,17224,1368,143485,160709,12/03/2020
2020-07-09,94,25352,3714,260760,286112,9.0,2089.0,3.0,1728.0,0.0,307.0,54.0,9.0,8.0,0,993,50,17274,1574,145059,162333,12/03/2020
2020-07-10,132,25484,4437,265197,290681,6.0,2095.0,3.0,1731.0,2.0,309.0,55.0,7.0,7.0,3,996,80,17354,2010,147069,164423,12/03/2020
2020-07-11,63,25547,2938,268135,293682,6.0,2101.0,3.0,1734.0,1.0,310.0,57.0,6.0,6.0,3,999,36,17390,1274,148343,165733,12/03/2020
2020-07-12,47,25594,1838,269973,295567,1.0,2102.0,3.0,1737.0,1.0,311.0,54.0,6.0,5.0,3,1002,34,17424,918,149261,166685,12/03/2020
2020-07-13,84,25678,3209,273182,298860,8.0,2110.0,10.0,1747.0,0.0,311.0,52.0,6.0,5.0,1,1003,61,17485,1466,150727,168212,12/03/2020
2020-07-14,74,25752,3298,276480,302232,7.0,2117.0,4.0,1751.0,0.0,311.0,55.0,5.0,5.0,1,1004,44,17529,1343,152070,169599,12/03/2020
2020-07-15,130,25882,4181,280661,306543,5.0,2122.0,7.0,1758.0,0.0,311.0,53.0,5.0,4.0,0,1004,100,17629,1699,153769,171398,12/03/2020
2020-07-16,103,25985,3740,284401,310386,6.0,2128.0,9.0,1767.0,0.0,311.0,50.0,6.0,5.0,1,1005,76,17705,1570,155339,173044,12/03/2020
2020-07-17,156,26141,4239,288640,314781,14.0,2142.0,3.0,1770.0,1.0,312.0,60.0,5.0,5.0,2,1007,79,17784,1797,157136,174920,12/03/2020
2020-07-18,85,26226,3272,291912,318138,5.0,2147.0,9.0,1779.0,1.0,313.0,55.0,5.0,4.0,4,1011,70,17854,1363,158499,176353,12/03/2020
2020-07-19,82,26308,2696,294608,320916,7.0,2154.0,3.0,1782.0,0.0,313.0,59.0,6.0,4.0,2,1013,57,17911,1118,159617,177528,12/03/2020
2020-07-20,71,26379,2666,297274,323653,9.0,2163.0,7.0,1789.0,0.0,313.0,61.0,7.0,5.0,2,1015,68,17979,1421,161038,179017,12/03/2020
2020-07-21,130,26509,4304,301578,328087,9.0,2172.0,11.0,1800.0,0.0,313.0,59.0,9.0,6.0,1,1016,108,18087,1875,162913,181000,12/03/2020
2020-07-22,130,26639,3928,305506,332145,7.0,2179.0,8.0,1808.0,1.0,314.0,57.0,7.0,6.0,1,1017,86,18173,1621,164534,182707,12/03/2020
2020-07-23,141,26780,4415,309921,336701,8.0,2187.0,6.0,1814.0,0.0,314.0,59.0,8.0,7.0,0,1017,115,18288,1919,166453,184741,12/03/2020
2020-07-24,172,26952,5966,315887,342839,15.0,2202.0,12.0,1826.0,0.0,314.0,62.0,9.0,7.0,0,1017,119,18407,2248,168701,187108,12/03/2020
2020-07-25,134,27086,4398,320285,347371,7.0,2209.0,7.0,1833.0,0.0,314.0,62.0,10.0,8.0,3,1020,108,18515,2039,170740,189255,12/03/2020
2020-07-26,62,27148,3033,323318,350466,8.0,2217.0,9.0,1842.0,0.0,314.0,61.0,11.0,7.0,1,1021,54,18569,1307,172047,190616,12/03/2020
2020-07-27,188,27336,4191,327509,354845,12.0,2229.0,7.0,1849.0,0.0,314.0,66.0,13.0,8.0,1,1022,138,18707,2281,174328,193035,12/03/2020
2020-07-28,105,27441,3840,331349,358790,5.0,2234.0,5.0,1854.0,0.0,314.0,66.0,14.0,7.0,1,1023,95,18802,1596,175924,194726,12/03/2020
2020-07-29,190,27631,5139,336488,364119,9.0,2243.0,10.0,1864.0,0.0,314.0,65.0,15.0,7.0,0,1023,154,18956,2236,178160,197116,12/03/2020
2020-07-30,121,27752,4345,340833,368585,6.0,2249.0,2.0,1866.0,1.0,315.0,68.0,15.0,6.0,1,1024,97,19053,1590,179750,198803,12/03/2020
2020-07-31,131,27883,5512,346345,374228,7.0,2256.0,9.0,1875.0,0.0,315.0,66.0,15.0,7.0,1,1025,89,19142,1792,181542,200684,12/03/2020
2020-08-01,109,27992,4294,350639,378631,7.0,2263.0,2.0,1877.0,0.0,315.0,71.0,14.0,7.0,1,1026,89,19231,1521,183063,202294,12/03/2020
2020-08-02,84,28076,2804,353443,381519,12.0,2275.0,12.0,1889.0,2.0,317.0,69.0,14.0,8.0,2,1028,62,19293,1240,184303,203596,12/03/2020
2020-08-03,188,28264,5248,358691,386955,11.0,2286.0,10.0,1899.0,0.0,317.0,70.0,16.0,7.0,1,1029,150,19443,2144,186447,205890,12/03/2020
2020-08-04,125,28389,3691,362382,390771,8.0,2294.0,5.0,1904.0,1.0,318.0,72.0,12.0,5.0,2,1031,99,19542,1727,188174,207716,12/03/2020
2020-08-05,147,28536,5935,368317,396853,11.0,2305.0,9.0,1913.0,1.0,319.0,73.0,10.0,5.0,2,1033,119,19661,2396,190570,210231,12/03/2020
2020-08-06,169,28705,5546,373863,402568,7.0,2312.0,9.0,1922.0,0.0,319.0,71.0,9.0,4.0,0,1033,120,19781,2330,192900,212681,12/03/2020
2020-08-07,123,28828,4851,378714,407542,12.0,2324.0,9.0,1931.0,1.0,320.0,73.0,9.0,3.0,2,1035,87,19868,2084,194984,214852,12/03/2020
2020-08-08,123,28951,4112,382826,411777,19.0,2343.0,6.0,1937.0,1.0,321.0,85.0,8.0,3.0,1,1036,91,19959,1737,196721,216680,12/03/2020
2020-08-09,42,28993,1727,384553,413546,6.0,2349.0,8.0,1945.0,0.0,321.0,83.0,9.0,4.0,0,1036,35,19994,1040,197761,217755,12/03/2020
2020-08-10,149,29142,4587,389140,418282,8.0,2357.0,9.0,1954.0,0.0,321.0,82.0,9.0,4.0,1,1037,113,20107,1966,199727,219834,12/03/2020
2020-08-11,106,29248,4334,393474,422722,5.0,2362.0,13.0,1967.0,0.0,321.0,74.0,10.0,4.0,3,1040,92,20199,2218,201945,222144,12/03/2020
2020-08-12,121,29369,5188,398662,428031,8.0,2370.0,11.0,1978.0,0.0,321.0,71.0,9.0,3.0,1,1041,101,20300,2547,204492,224792,12/03/2020
2020-08-13,135,29504,4196,402858,432362,13.0,2383.0,12.0,1990.0,0.0,321.0,72.0,11.0,3.0,0,1041,95,20395,1855,206347,226742,12/03/2020
2020-08-14,145,29649,5498,408356,438005,13.0,2396.0,11.0,2001.0,0.0,321.0,74.0,11.0,4.0,3,1044,98,20493,1927,208274,228767,12/03/2020
2020-08-15,106,29755,4534,412890,442645,9.0,2405.0,11.0,2012.0,1.0,322.0,71.0,11.0,5.0,0,1044,88,20581,1645,209919,230500,12/03/2020
2020-08-16,83,29838,2477,415367,445205,6.0,2411.0,5.0,2017.0,4.0,326.0,68.0,8.0,4.0,6,1050,70,20651,929,210848,231499,12/03/2020
2020-08-17,106,29944,4575,419942,449886,8.0,2419.0,6.0,2023.0,0.0,326.0,70.0,8.0,5.0,2,1052,87,20738,2338,213186,233924,12/03/2020
2020-08-18,128,30072,4911,424853,454925,11.0,2430.0,8.0,2031.0,1.0,327.0,72.0,8.0,4.0,5,1057,94,20832,2680,215866,236698,12/03/2020
2020-08-19,113,30185,5077,429930,460115,8.0,2438.0,9.0,2040.0,1.0,328.0,70.0,9.0,5.0,0,1057,90,20922,2576,218442,239364,12/03/2020
2020-08-20,173,30358,7411,437341,467699,12.0,2450.0,6.0,2046.0,2.0,330.0,74.0,10.0,5.0,3,1060,139,21061,3438,221880,242941,12/03/2020
2020-08-21,152,30510,6577,443918,474428,8.0,2458.0,5.0,2051.0,1.0,331.0,76.0,9.0,4.0,2,1062,125,21186,2863,224743,245929,12/03/2020
2020-08-22,96,30606,5550,449468,480074,11.0,2469.0,12.0,2063.0,0.0,331.0,75.0,11.0,4.0,1,1063,84,21270,2532,227275,248545,12/03/2020
2020-08-23,72,30678,4375,453843,484521,11.0,2480.0,5.0,2068.0,0.0,331.0,81.0,12.0,2.0,1,1064,56,21326,2426,229701,251027,12/03/2020
2020-08-24,105,30783,5784,459627,490410,7.0,2487.0,10.0,2078.0,1.0,332.0,77.0,14.0,4.0,1,1065,77,21403,3076,232777,254180,12/03/2020
2020-08-25,108,30891,4764,464391,495282,10.0,2497.0,4.0,2082.0,1.0,333.0,82.0,12.0,4.0,1,1066,92,21495,2242,235019,256514,12/03/2020
2020-08-26,170,31061,9482,473873,504934,4.0,2501.0,8.0,2090.0,0.0,333.0,78.0,10.0,5.0,1,1067,127,21622,3019,238038,259660,12/03/2020
2020-08-27,91,31152,8565,482438,513590,6.0,2507.0,14.0,2104.0,1.0,334.0,69.0,7.0,5.0,2,1069,70,21692,3080,241118,262810,12/03/2020
2020-08-28,113,31265,7994,490432,521697,14.0,2521.0,4.0,2108.0,0.0,334.0,79.0,10.0,7.0,2,1071,87,21779,2368,243486,265265,12/03/2020
2020-08-29,65,31330,5374,495806,527136,6.0,2527.0,8.0,2116.0,1.0,335.0,76.0,11.0,6.0,2,1073,51,21830,1877,245363,267193,12/03/2020
2020-08-30,66,31396,4323,500129,531525,7.0,2534.0,4.0,2120.0,0.0,335.0,79.0,9.0,5.0,2,1075,48,21878,1945,247308,269186,12/03/2020
2020-08-31,105,31501,4863,504992,536493,12.0,2546.0,16.0,2136.0,0.0,335.0,75.0,8.0,4.0,1,1076,81,21959,2146,249454,271413,12/03/2020
2020-09-01,99,31600,7109,512101,543701,6.0,2552.0,9.0,2145.0,1.0,336.0,71.0,7.0,4.0,2,1078,66,22025,2328,251782,273807,12/03/2020
2020-09-02,125,31725,10529,522630,554355,9.0,2561.0,10.0,2155.0,1.0,337.0,69.0,8.0,4.0,2,1080,104,22129,2992,254774,276903,12/03/2020
2020-09-03,90,31815,11080,533710,565525,8.0,2569.0,8.0,2163.0,0.0,337.0,69.0,9.0,4.0,3,1083,73,22202,2517,257291,279493,12/03/2020
2020-09-04,103,31918,8963,542673,574591,11.0,2580.0,4.0,2167.0,0.0,337.0,76.0,9.0,4.0,1,1084,83,22285,2320,259611,281896,12/03/2020
2020-09-05,52,31970,6309,548982,580952,6.0,2586.0,9.0,2176.0,0.0,337.0,73.0,8.0,3.0,1,1085,42,22327,1561,261172,283499,12/03/2020
2020-09-06,88,32058,4325,553307,585365,4.0,2590.0,8.0,2184.0,1.0,338.0,68.0,6.0,3.0,1,1086,65,22392,1902,263074,285466,12/03/2020
2020-09-07,35,32093,3002,556309,588402,11.0,2601.0,3.0,2187.0,0.0,338.0,76.0,5.0,3.0,1,1087,26,22418,627,263701,286119,12/03/2020
2020-09-08,74,32167,6381,562690,594857,6.0,2607.0,12.0,2199.0,1.0,339.0,69.0,6.0,3.0,2,1089,66,22484,1556,265257,287741,12/03/2020
2020-09-09,118,32285,8650,571340,603625,10.0,2617.0,5.0,2204.0,1.0,340.0,73.0,9.0,3.0,1,1090,102,22586,2085,267342,289928,12/03/2020
2020-09-10,164,32449,11334,582674,615123,9.0,2626.0,8.0,2212.0,0.0,340.0,74.0,10.0,3.0,1,1091,111,22697,2222,269564,292261,12/03/2020
2020-09-11,120,32569,9454,592128,624697,11.0,2637.0,11.0,2223.0,0.0,340.0,74.0,10.0,5.0,0,1091,97,22794,1921,271485,294279,12/03/2020
2020-09-12,110,32679,6174,598302,630981,8.0,2645.0,5.0,2228.0,2.0,342.0,75.0,9.0,5.0,3,1094,97,22891,1479,272964,295855,12/03/2020
2020-09-13,58,32737,2717,601019,633756,4.0,2649.0,3.0,2231.0,0.0,342.0,76.0,10.0,5.0,0,1094,54,22945,840,273804,296749,12/03/2020
2020-09-14,104,32841,6446,607465,640306,6.0,2655.0,3.0,2234.0,2.0,344.0,77.0,10.0,5.0,2,1096,95,23040,1694,275498,298538,12/03/2020
2020-09-15,122,32963,8470,615935,648898,7.0,2662.0,2.0,2236.0,1.0,345.0,81.0,10.0,5.0,2,1098,124,23164,2145,277643,300807,12/03/2020
2020-09-16,137,33100,9716,625651,658751,7.0,2669.0,7.0,2243.0,2.0,347.0,79.0,9.0,6.0,5,1103,118,23282,1926,279569,302851,12/03/2020
2020-09-17,125,33225,9239,634890,668115,7.0,2676.0,15.0,2258.0,0.0,347.0,71.0,8.0,4.0,0,1103,154,23436,1896,281465,304901,12/03/2020
2020-09-18,132,33357,10045,644935,678292,7.0,2683.0,7.0,2265.0,1.0,348.0,70.0,11.0,6.0,2,1105,132,23568,1885,283350,306918,12/03/2020
2020-09-19,115,33472,8297,653232,686704,7.0,2690.0,3.0,2268.0,0.0,348.0,74.0,10.0,6.0,4,1109,112,23680,1663,285013,308693,12/03/2020
2020-09-20,60,33532,3676,656908,690440,7.0,2697.0,6.0,2274.0,2.0,350.0,73.0,9.0,8.0,4,1113,49,23729,1297,286310,310039,12/03/2020
2020-09-21,102,33634,7018,663926,697560,12.0,2709.0,3.0,2277.0,2.0,352.0,80.0,8.0,6.0,2,1115,94,23823,2357,288667,312490,12/03/2020
2020-09-22,154,33788,9287,673213,707001,12.0,2721.0,3.0,2280.0,1.0,353.0,88.0,7.0,5.0,1,1116,124,23947,2149,290816,314763,12/03/2020
2020-09-23,136,33924,10651,683864,717788,12.0,2733.0,7.0,2287.0,0.0,353.0,93.0,6.0,5.0,0,1116,127,24074,2159,292975,317049,12/03/2020
2020-09-24,120,34044,12480,696344,730388,7.0,2740.0,9.0,2296.0,1.0,354.0,90.0,7.0,5.0,1,1117,120,24194,3111,296086,320280,12/03/2020
2020-09-25,150,34194,10553,706897,741091,9.0,2749.0,10.0,2306.0,0.0,354.0,89.0,6.0,5.0,1,1118,143,24337,2947,299033,323370,12/03/2020
2020-09-26,147,34341,10560,717457,751798,12.0,2761.0,9.0,2315.0,0.0,354.0,92.0,6.0,5.0,1,1119,120,24457,2387,301420,325877,12/03/2020
2020-09-27,43,34384,2764,720221,754605,7.0,2768.0,5.0,2320.0,0.0,354.0,94.0,9.0,5.0,0,1119,34,24491,826,302246,326737,12/03/2020
2020-09-28,156,34540,7307,727528,762068,7.0,2775.0,7.0,2327.0,2.0,356.0,92.0,7.0,5.0,2,1121,138,24629,2209,304455,329084,12/03/2020
2020-09-29,203,34743,11046,738574,773317,12.0,2787.0,18.0,2345.0,1.0,357.0,85.0,6.0,6.0,1,1122,185,24814,2773,307228,332042,12/03/2020
2020-09-30,223,34966,12230,750804,785770,6.0,2793.0,6.0,2351.0,0.0,357.0,85.0,6.0,6.0,1,1123,189,25003,2523,309751,334754,12/03/2020
2020-10-01,185,35151,12503,763307,798458,17.0,2810.0,13.0,2364.0,1.0,358.0,88.0,6.0,4.0,2,1125,166,25169,2360,312111,337280,12/03/2020
2020-10-02,209,35360,12154,775461,810821,14.0,2824.0,13.0,2377.0,1.0,359.0,88.0,8.0,5.0,2,1127,181,25350,2446,314557,339907,12/03/2020
2020-10-03,157,35517,9313,784774,820291,9.0,2833.0,9.0,2386.0,2.0,361.0,86.0,9.0,4.0,2,1129,131,25481,1983,316540,342021,12/03/2020
2020-10-04,81,35598,2369,787143,822741,11.0,2844.0,9.0,2395.0,1.0,362.0,87.0,8.0,5.0,2,1131,77,25558,936,317476,343034,12/03/2020
2020-10-05,174,35772,8982,796125,831897,30.0,2874.0,10.0,2405.0,2.0,364.0,105.0,9.0,6.0,4,1135,160,25718,2980,320456,346174,12/03/2020
2020-10-06,187,35959,11186,807311,843270,11.0,2885.0,4.0,2409.0,0.0,364.0,112.0,11.0,7.0,0,1135,188,25906,2846,323302,349208,12/03/2020
2020-10-07,242,36201,12442,819753,855954,13.0,2898.0,14.0,2423.0,2.0,366.0,109.0,9.0,7.0,2,1137,244,26150,3479,326781,352931,12/03/2020
2020-10-08,279,36480,15231,834984,871464,17.0,2915.0,13.0,2436.0,2.0,368.0,111.0,7.0,5.0,4,1141,278,26428,4151,330932,357360,12/03/2020
2020-10-09,229,36709,13745,848729,885438,21.0,2936.0,12.0,2448.0,0.0,368.0,120.0,10.0,7.0,3,1144,200,26628,4245,335177,361805,12/03/2020
2020-10-10,231,36940,13832,862561,899501,19.0,2955.0,10.0,2458.0,1.0,369.0,128.0,13.0,7.0,2,1146,192,26820,3729,338906,365726,12/03/2020
2020-10-11,97,37037,3263,865824,902861,12.0,2967.0,9.0,2467.0,1.0,370.0,130.0,14.0,5.0,6,1152,87,26907,1148,340054,366961,12/03/2020
2020-10-12,169,37206,6440,872264,909470,19.0,2986.0,15.0,2482.0,2.0,372.0,132.0,14.0,5.0,4,1156,157,27064,1696,341750,368814,12/03/2020
2020-10-13,213,37419,8522,880786,918205,15.0,3001.0,13.0,2495.0,4.0,376.0,130.0,13.0,5.0,7,1163,207,27271,2277,344027,371298,12/03/2020
2020-10-14,322,37741,15039,895825,933566,17.0,3018.0,7.0,2502.0,0.0,376.0,140.0,15.0,5.0,2,1165,300,27571,3969,347996,375567,12/03/2020
2020-10-15,262,38003,14639,910464,948467,12.0,3030.0,16.0,2518.0,1.0,377.0,135.0,13.0,5.0,2,1167,254,27825,3513,351509,379334,12/03/2020
2020-10-16,279,38282,15011,925475,963757,12.0,3042.0,18.0,2536.0,1.0,378.0,128.0,13.0,4.0,2,1169,275,28100,3324,354833,382933,12/03/2020
2020-10-17,354,38636,14069,939544,978180,19.0,3061.0,11.0,2547.0,1.0,379.0,135.0,17.0,4.0,2,1171,310,28410,3211,358044,386454,12/03/2020
2020-10-18,155,38791,4039,943583,982374,18.0,3079.0,11.0,2558.0,0.0,379.0,142.0,17.0,6.0,2,1173,126,28536,1291,359335,387871,12/03/2020
2020-10-19,388,39179,8491,952074,991253,21.0,3100.0,22.0,2580.0,2.0,381.0,139.0,15.0,6.0,1,1174,324,28860,2522,361857,390717,12/03/2020
2020-10-20,439,39618,13242,965316,1004934,23.0,3123.0,16.0,2596.0,0.0,381.0,146.0,14.0,8.0,3,1177,386,29246,2958,364815,394061,12/03/2020
2020-10-21,544,40162,17463,982779,1022941,22.0,3145.0,8.0,2604.0,2.0,383.0,158.0,15.0,9.0,3,1180,472,29718,3456,368271,397989,12/03/2020
2020-10-22,538,40700,15863,998642,1039342,24.0,3169.0,20.0,2624.0,3.0,386.0,159.0,14.0,9.0,3,1183,489,30207,3131,371402,401609,12/03/2020
2020-10-23,514,41214,16634,1015276,1056490,22.0,3191.0,22.0,2646.0,1.0,387.0,158.0,15.0,9.0,3,1186,458,30665,2837,374239,404904,12/03/2020
2020-10-24,359,41573,10249,1025525,1067098,17.0,3208.0,11.0,2657.0,0.0,387.0,164.0,14.0,8.0,1,1187,338,31003,2233,376472,407475,12/03/2020
2020-10-25,233,41806,4760,1030285,1072091,16.0,3224.0,15.0,2672.0,1.0,388.0,164.0,15.0,8.0,2,1189,209,31212,1428,377900,409112,12/03/2020
2020-10-26,454,42260,9174,1039459,1081719,26.0,3250.0,15.0,2687.0,2.0,390.0,173.0,18.0,8.0,3,1192,403,31615,2925,380825,412440,12/03/2020
2020-10-27,517,42777,13995,1053454,1096231,29.0,3279.0,15.0,2702.0,2.0,392.0,185.0,18.0,9.0,4,1196,453,32068,2354,383179,415247,12/03/2020
2020-10-28,469,43246,15229,1068683,1111929,25.0,3304.0,26.0,2728.0,1.0,393.0,183.0,17.0,9.0,3,1199,411,32479,2656,385835,418314,12/03/2020
2020-10-29,609,43855,16259,1084942,1128797,20.0,3324.0,22.0,2750.0,3.0,396.0,178.0,19.0,11.0,4,1203,526,33005,3082,388917,421922,12/03/2020
2020-10-30,565,44420,14863,1099805,1144225,21.0,3345.0,21.0,2771.0,5.0,401.0,173.0,19.0,9.0,4,1207,467,33472,2904,391821,425293,12/03/2020
2020-10-31,599,45019,11820,1111625,1156644,31.0,3376.0,13.0,2784.0,1.0,402.0,190.0,22.0,9.0,3,1210,484,33956,2381,394202,428158,12/03/2020
2020-11-01,330,45349,5091,1116716,1162065,22.0,3398.0,15.0,2799.0,1.0,403.0,196.0,26.0,12.0,4,1214,273,34229,1249,395451,429680,12/03/2020
2020-11-02,521,45870,9930,1126646,1172516,38.0,3436.0,27.0,2826.0,3.0,406.0,204.0,24.0,12.0,5,1219,454,34683,2894,398345,433028,12/03/2020
2020-11-03,602,46472,13040,1139686,1186158,33.0,3469.0,25.0,2851.0,1.0,407.0,211.0,24.0,12.0,1,1220,529,35212,2475,400820,436032,12/03/2020
2020-11-04,688,47160,16100,1155786,1202946,34.0,3503.0,27.0,2878.0,2.0,409.0,216.0,25.0,12.0,4,1224,633,35845,2889,403709,439554,12/03/2020
2020-11-05,768,47928,16593,1172379,1220307,46.0,3549.0,35.0,2913.0,1.0,410.0,226.0,24.0,14.0,3,1227,682,36527,2821,406530,443057,12/03/2020
2020-11-06,769,48697,16022,1188401,1237098,43.0,3592.0,31.0,2944.0,1.0,411.0,237.0,28.0,17.0,5,1232,691,37218,3003,409533,446751,12/03/2020
2020-11-07,604,49301,13650,1202051,1251352,34.0,3626.0,25.0,2969.0,1.0,412.0,245.0,31.0,18.0,1,1233,576,37794,2440,411973,449767,12/03/2020
2020-11-08,337,49638,4160,1206211,1255849,33.0,3659.0,26.0,2995.0,1.0,413.0,251.0,30.0,19.0,4,1237,321,38115,1262,413235,451350,12/03/2020
2020-11-09,807,50445,9040,1215251,1265696,39.0,3698.0,33.0,3028.0,2.0,415.0,255.0,28.0,18.0,3,1240,761,38876,2289,415524,454400,12/03/2020
2020-11-10,1053,51498,12982,1228233,1279731,45.0,3743.0,37.0,3065.0,0.0,415.0,263.0,31.0,18.0,6,1246,980,39856,2862,418386,458242,12/03/2020
2020-11-11,1087,52585,19741,1247974,1300559,42.0,3785.0,24.0,3089.0,5.0,420.0,276.0,30.0,15.0,7,1253,1001,40857,2656,421042,461899,12/03/2020
2020-11-12,893,53478,13902,1261876,1315354,39.0,3824.0,31.0,3120.0,3.0,423.0,281.0,28.0,15.0,5,1258,811,41668,2188,423230,464898,12/03/2020
2020-11-13,1165,54643,16390,1278266,1332909,37.0,3861.0,31.0,3151.0,0.0,423.0,287.0,27.0,15.0,2,1260,1115,42783,3084,426314,469097,12/03/2020
2020-11-14,782,55425,13517,1291783,1347208,41.0,3902.0,26.0,3177.0,5.0,428.0,297.0,25.0,13.0,10,1270,738,43521,2450,428764,472285,12/03/2020
2020-11-15,578,56003,6173,1297956,1353959,44.0,3946.0,21.0,3198.0,5.0,433.0,315.0,28.0,11.0,7,1277,492,44013,1413,430177,474190,12/03/2020
2020-11-16,738,56741,9614,1307570,1364311,55.0,4001.0,38.0,3236.0,3.0,436.0,329.0,26.0,13.0,5,1282,668,44681,2608,432785,477466,12/03/2020
2020-11-17,1538,58279,18173,1325743,1384022,59.0,4060.0,44.0,3280.0,2.0,438.0,342.0,30.0,13.0,5,1287,1399,46080,4119,436904,482984,12/03/2020
2020-11-18,1124,59403,16028,1341771,1401174,36.0,4096.0,38.0,3318.0,5.0,443.0,335.0,29.0,15.0,7,1294,1010,47090,3178,440082,487172,12/03/2020
2020-11-19,1128,60531,13156,1354927,1415458,45.0,4141.0,42.0,3360.0,4.0,447.0,334.0,29.0,18.0,5,1299,1034,48124,3400,443482,491606,12/03/2020
2020-11-20,1434,61965,22194,1377121,1439086,47.0,4188.0,48.0,3408.0,3.0,450.0,330.0,32.0,14.0,6,1305,1288,49412,4297,447779,497191,12/03/2020
2020-11-21,839,62804,17349,1394470,1457274,42.0,4230.0,34.0,3442.0,5.0,455.0,333.0,34.0,14.0,7,1312,754,50166,3139,450918,501084,12/03/2020
2020-11-22,567,63371,7521,1401991,1465362,63.0,4293.0,28.0,3470.0,4.0,459.0,364.0,32.0,15.0,11,1323,486,50652,1797,452715,503367,12/03/2020
2020-11-23,961,64332,11012,1413003,1477335,70.0,4363.0,40.0,3510.0,0.0,459.0,394.0,39.0,18.0,10,1333,871,51523,3416,456131,507654,12/03/2020
2020-11-24,1024,65356,14506,1427509,1492865,44.0,4407.0,58.0,3568.0,6.0,465.0,374.0,39.0,20.0,10,1343,945,52468,2758,458889,511357,12/03/2020
2020-11-25,1252,66608,18701,1446210,1512818,52.0,4459.0,58.0,3626.0,4.0,469.0,364.0,41.0,24.0,6,1349,1169,53637,3501,462390,516027,12/03/2020
2020-11-26,547,67155,6477,1452687,1519842,50.0,4509.0,33.0,3659.0,4.0,473.0,377.0,44.0,23.0,12,1361,470,54107,1581,463971,518078,12/03/2020
2020-11-27,1001,68156,9686,1462373,1530529,51.0,4560.0,49.0,3708.0,7.0,480.0,372.0,44.0,20.0,6,1367,946,55053,2517,466488,521541,12/03/2020
2020-11-28,1141,69297,11835,1474208,1543505,61.0,4621.0,40.0,3748.0,0.0,480.0,393.0,44.0,20.0,3,1370,1083,56136,2742,469230,525366,12/03/2020
2020-11-29,795,70092,6815,1481023,1551115,62.0,4683.0,33.0,3781.0,3.0,483.0,419.0,45.0,23.0,8,1378,747,56883,2264,471494,528377,12/03/2020
2020-11-30,1203,71295,9863,1490886,1562181,62.0,4745.0,58.0,3839.0,2.0,485.0,421.0,48.0,29.0,5,1383,1130,58013,2812,474306,532319,12/03/2020
2020-12-01,1492,72787,13777,1504663,1577450,44.0,4789.0,53.0,3892.0,3.0,488.0,409.0,45.0,31.0,11,1394,1379,59392,3351,477657,537049,12/03/2020
2020-12-02,1476,74263,15081,1519744,1594007,,,,,,,,,,6,1400,1330,60722,3097,480754,541476,12/03/2020
2020-02-27,0,0,0,0,0,1.0,1.0,0.0,0.0,0.0,0.0,1.0,0.0,0.0,0,0,0,0,0,0,0,12/04/2020
2020-02-28,0,0,0,0,0,0.0,1.0,0.0,0.0,0.0,0.0,1.0,1.0,0.0,0,0,0,0,0,0,0,12/04/2020
2020-02-29,0,0,0,0,0,0.0,1.0,0.0,0.0,0.0,0.0,1.0,1.0,0.0,0,0,0,0,0,0,0,12/04/2020
2020-03-01,2,2,2,2,4,0.0,1.0,0.0,0.0,0.0,0.0,1.0,1.0,1.0,0,0,2,2,2,2,4,12/04/2020
2020-03-02,0,2,1,3,5,1.0,2.0,0.0,0.0,0.0,0.0,2.0,2.0,2.0,0,0,0,2,0,2,4,12/04/2020
2020-03-03,0,2,2,5,7,0.0,2.0,0.0,0.0,0.0,0.0,2.0,2.0,2.0,0,0,0,2,1,3,5,12/04/2020
2020-03-04,0,2,12,17,19,1.0,3.0,0.0,0.0,0.0,0.0,3.0,2.0,2.0,0,0,0,2,10,13,15,12/04/2020
2020-03-05,0,2,4,21,23,0.0,3.0,0.0,0.0,0.0,0.0,3.0,2.0,2.0,0,0,1,3,4,17,20,12/04/2020
2020-03-06,1,3,12,33,36,0.0,3.0,0.0,0.0,0.0,0.0,3.0,2.0,2.0,0,0,0,3,11,28,31,12/04/2020
2020-03-07,0,3,19,52,55,0.0,3.0,0.0,0.0,0.0,0.0,3.0,2.0,1.0,0,0,0,3,19,47,50,12/04/2020
2020-03-08,0,3,18,70,73,0.0,3.0,0.0,0.0,0.0,0.0,3.0,2.0,1.0,0,0,0,3,18,65,68,12/04/2020
2020-03-09,1,4,15,85,89,0.0,3.0,0.0,0.0,0.0,0.0,3.0,2.0,1.0,0,0,1,4,14,79,83,12/04/2020
2020-03-10,2,6,25,110,116,0.0,3.0,0.0,0.0,0.0,0.0,3.0,2.0,1.0,0,0,1,5,23,102,107,12/04/2020
2020-03-11,0,6,34,144,150,1.0,4.0,0.0,0.0,0.0,0.0,4.0,1.0,1.0,0,0,0,5,34,136,141,12/04/2020
2020-03-12,9,15,41,185,200,1.0,5.0,0.0,0.0,0.0,0.0,5.0,1.0,1.0,0,0,7,12,38,174,186,12/04/2020
2020-03-13,6,21,50,235,256,4.0,9.0,1.0,1.0,0.0,0.0,8.0,1.0,1.0,0,0,6,18,47,221,239,12/04/2020
2020-03-14,0,21,90,325,346,0.0,9.0,0.0,1.0,0.0,0.0,8.0,1.0,1.0,0,0,0,18,83,304,322,12/04/2020
2020-03-15,1,22,54,379,401,1.0,10.0,0.0,1.0,0.0,0.0,9.0,2.0,1.0,0,0,1,19,53,357,376,12/04/2020
2020-03-16,2,24,95,474,498,2.0,12.0,0.0,1.0,0.0,0.0,11.0,2.0,0.0,0,0,2,21,90,447,468,12/04/2020
2020-03-17,12,36,162,636,672,6.0,18.0,0.0,1.0,0.0,0.0,17.0,2.0,0.0,0,0,11,32,146,593,625,12/04/2020
2020-03-18,9,45,116,752,797,3.0,21.0,0.0,1.0,0.0,0.0,20.0,2.0,0.0,0,0,11,43,105,698,741,12/04/2020
2020-03-19,15,60,262,1014,1074,2.0,23.0,1.0,2.0,0.0,0.0,21.0,3.0,0.0,1,1,17,60,245,943,1003,12/04/2020
2020-03-20,13,73,197,1211,1284,5.0,28.0,0.0,2.0,0.0,0.0,26.0,4.0,0.0,0,1,13,73,183,1126,1199,12/04/2020
2020-03-21,12,85,126,1337,1422,3.0,31.0,2.0,4.0,0.0,0.0,27.0,5.0,0.0,0,1,14,87,120,1246,1333,12/04/2020
2020-03-22,27,112,282,1619,1731,2.0,33.0,0.0,4.0,0.0,0.0,29.0,5.0,0.0,0,1,25,112,254,1500,1612,12/04/2020
2020-03-23,14,126,169,1788,1914,15.0,48.0,1.0,5.0,0.0,0.0,43.0,9.0,3.0,0,1,16,128,159,1659,1787,12/04/2020
2020-03-24,20,146,242,2030,2176,8.0,56.0,0.0,5.0,0.0,0.0,51.0,10.0,5.0,0,1,19,147,225,1884,2031,12/04/2020
2020-03-25,26,172,182,2212,2384,5.0,61.0,2.0,7.0,0.0,0.0,54.0,11.0,3.0,0,1,28,175,161,2045,2220,12/04/2020
2020-03-26,35,207,181,2393,2600,9.0,70.0,5.0,12.0,0.0,0.0,58.0,14.0,5.0,0,1,41,216,167,2212,2428,12/04/2020
2020-03-27,27,234,214,2607,2841,9.0,79.0,1.0,13.0,1.0,1.0,65.0,16.0,6.0,2,3,31,247,189,2401,2648,12/04/2020
2020-03-28,59,293,260,2867,3160,11.0,90.0,2.0,15.0,1.0,2.0,73.0,15.0,6.0,1,4,64,311,236,2637,2948,12/04/2020
2020-03-29,100,393,350,3217,3610,8.0,98.0,3.0,18.0,1.0,3.0,77.0,18.0,8.0,2,6,105,416,303,2940,3356,12/04/2020
2020-03-30,62,455,222,3439,3894,19.0,117.0,5.0,23.0,0.0,3.0,91.0,19.0,11.0,3,9,78,494,176,3116,3610,12/04/2020
2020-03-31,71,526,369,3808,4334,11.0,128.0,7.0,30.0,1.0,4.0,94.0,21.0,13.0,2,11,73,567,287,3403,3970,12/04/2020
2020-04-01,99,625,698,4506,5131,18.0,146.0,7.0,37.0,0.0,4.0,105.0,29.0,15.0,1,12,100,667,603,4006,4673,12/04/2020
2020-04-02,52,677,477,4983,5660,22.0,168.0,6.0,43.0,2.0,6.0,119.0,35.0,21.0,4,16,62,729,417,4423,5152,12/04/2020
2020-04-03,108,785,774,5757,6542,23.0,191.0,7.0,50.0,0.0,6.0,135.0,42.0,25.0,3,19,100,829,676,5099,5928,12/04/2020
2020-04-04,143,928,660,6417,7345,22.0,213.0,4.0,54.0,5.0,11.0,148.0,40.0,29.0,9,28,138,967,582,5681,6648,12/04/2020
2020-04-05,187,1115,1156,7573,8688,20.0,233.0,9.0,63.0,1.0,12.0,158.0,43.0,35.0,2,30,181,1148,1000,6681,7829,12/04/2020
2020-04-06,218,1333,1706,9279,10612,26.0,259.0,7.0,70.0,0.0,12.0,177.0,47.0,39.0,7,37,207,1355,1479,8160,9515,12/04/2020
2020-04-07,284,1617,1629,10908,12525,20.0,279.0,4.0,74.0,2.0,14.0,191.0,49.0,41.0,5,42,260,1615,1410,9570,11185,12/04/2020
2020-04-08,290,1907,1720,12628,14535,19.0,298.0,8.0,82.0,5.0,19.0,197.0,49.0,37.0,10,52,271,1886,1483,11053,12939,12/04/2020
2020-04-09,283,2190,1516,14144,16334,32.0,330.0,8.0,90.0,4.0,23.0,217.0,53.0,40.0,7,59,277,2163,1297,12350,14513,12/04/2020
2020-04-10,419,2609,2574,16718,19327,29.0,359.0,17.0,107.0,5.0,28.0,224.0,59.0,41.0,11,70,400,2563,2258,14608,17171,12/04/2020
2020-04-11,297,2906,1905,18623,21529,29.0,388.0,11.0,118.0,2.0,30.0,240.0,61.0,48.0,12,82,281,2844,1650,16258,19102,12/04/2020
2020-04-12,314,3220,1670,20293,23513,35.0,423.0,13.0,131.0,5.0,35.0,257.0,59.0,49.0,9,91,286,3130,1335,17593,20723,12/04/2020
2020-04-13,161,3381,935,21228,24609,35.0,458.0,13.0,144.0,3.0,38.0,276.0,64.0,54.0,9,100,187,3317,803,18396,21713,12/04/2020
2020-04-14,289,3670,1787,23015,26685,27.0,485.0,18.0,162.0,5.0,43.0,280.0,72.0,53.0,8,108,262,3579,1452,19848,23427,12/04/2020
2020-04-15,351,4021,1799,24814,28835,31.0,516.0,20.0,182.0,3.0,46.0,288.0,72.0,54.0,17,125,306,3885,1448,21296,25181,12/04/2020
2020-04-16,447,4468,2494,27308,31776,36.0,552.0,25.0,207.0,6.0,52.0,293.0,72.0,53.0,14,139,387,4272,1941,23237,27509,12/04/2020
2020-04-17,304,4772,1821,29129,33901,32.0,584.0,20.0,227.0,7.0,59.0,298.0,66.0,45.0,21,160,290,4562,1360,24597,29159,12/04/2020
2020-04-18,321,5093,1725,30854,35947,26.0,610.0,18.0,245.0,4.0,63.0,302.0,63.0,49.0,15,175,284,4846,1254,25851,30697,12/04/2020
2020-04-19,381,5474,2047,32901,38375,23.0,633.0,26.0,271.0,1.0,64.0,298.0,65.0,55.0,11,186,337,5183,1661,27512,32695,12/04/2020
2020-04-20,394,5868,1907,34808,40676,46.0,679.0,29.0,300.0,2.0,66.0,313.0,75.0,56.0,10,196,376,5559,1506,29018,34577,12/04/2020
2020-04-21,444,6312,2110,36918,43230,45.0,724.0,32.0,332.0,5.0,71.0,321.0,72.0,56.0,18,214,383,5942,1632,30650,36592,12/04/2020
2020-04-22,418,6730,2390,39308,46038,41.0,765.0,32.0,364.0,5.0,76.0,325.0,73.0,58.0,18,232,379,6321,1821,32471,38792,12/04/2020
2020-04-23,479,7209,2469,41777,48986,32.0,797.0,28.0,392.0,5.0,81.0,324.0,76.0,62.0,15,247,412,6733,1755,34226,40959,12/04/2020
2020-04-24,491,7700,3284,45061,52761,35.0,832.0,26.0,418.0,4.0,85.0,329.0,85.0,63.0,15,262,407,7140,2473,36699,43839,12/04/2020
2020-04-25,393,8093,2206,47267,55360,34.0,866.0,17.0,435.0,5.0,90.0,341.0,85.0,62.0,14,276,299,7439,1642,38341,45780,12/04/2020
2020-04-26,316,8409,2309,49576,57985,33.0,899.0,15.0,450.0,3.0,93.0,356.0,86.0,59.0,14,290,274,7713,1764,40105,47818,12/04/2020
2020-04-27,249,8658,1620,51196,59854,29.0,928.0,21.0,471.0,4.0,97.0,360.0,86.0,61.0,10,300,206,7919,1091,41196,49115,12/04/2020
2020-04-28,410,9068,2263,53459,62527,44.0,972.0,24.0,495.0,3.0,100.0,377.0,88.0,59.0,22,322,331,8250,1592,42788,51038,12/04/2020
2020-04-29,476,9544,3343,56802,66346,36.0,1008.0,38.0,533.0,11.0,111.0,364.0,78.0,53.0,18,340,370,8620,2242,45030,53650,12/04/2020
2020-04-30,432,9976,2769,59571,69547,33.0,1041.0,38.0,571.0,6.0,117.0,353.0,83.0,57.0,24,364,350,8970,1757,46787,55757,12/04/2020
2020-05-01,454,10430,3086,62657,73087,52.0,1093.0,39.0,610.0,3.0,120.0,363.0,84.0,58.0,14,378,323,9293,1977,48764,58057,12/04/2020
2020-05-02,257,10687,1926,64583,75270,36.0,1129.0,38.0,648.0,5.0,125.0,356.0,93.0,63.0,24,402,192,9485,1209,49973,59458,12/04/2020
2020-05-03,283,10970,2160,66743,77713,31.0,1160.0,26.0,674.0,8.0,133.0,353.0,91.0,61.0,21,423,183,9668,1469,51442,61110,12/04/2020
2020-05-04,387,11357,2098,68841,80198,30.0,1190.0,31.0,705.0,6.0,139.0,346.0,89.0,58.0,18,441,290,9958,1489,52931,62889,12/04/2020
2020-05-05,433,11790,2873,71714,83504,29.0,1219.0,32.0,737.0,6.0,145.0,337.0,83.0,55.0,16,457,299,10257,1857,54788,65045,12/04/2020
2020-05-06,488,12278,2830,74544,86822,28.0,1247.0,44.0,781.0,9.0,154.0,312.0,80.0,55.0,21,478,340,10597,1825,56613,67210,12/04/2020
2020-05-07,425,12703,2969,77513,90216,36.0,1283.0,44.0,825.0,5.0,159.0,299.0,72.0,53.0,21,499,270,10867,1859,58472,69339,12/04/2020
2020-05-08,359,13062,2598,80111,93173,30.0,1313.0,29.0,854.0,5.0,164.0,295.0,72.0,54.0,22,521,230,11097,1610,60082,71179,12/04/2020
2020-05-09,467,13529,3346,83457,96986,22.0,1335.0,21.0,875.0,4.0,168.0,292.0,70.0,52.0,15,536,289,11386,2125,62207,73593,12/04/2020
2020-05-10,285,13814,2117,85574,99388,20.0,1355.0,23.0,898.0,6.0,174.0,283.0,71.0,50.0,14,550,190,11576,1425,63632,75208,12/04/2020
2020-05-11,257,14071,1857,87431,101502,31.0,1386.0,16.0,914.0,6.0,180.0,292.0,72.0,50.0,15,565,173,11749,1236,64868,76617,12/04/2020
2020-05-12,387,14458,2611,90042,104500,23.0,1409.0,18.0,932.0,4.0,184.0,293.0,70.0,49.0,22,587,224,11973,1559,66427,78400,12/04/2020
2020-05-13,351,14809,3630,93672,108481,23.0,1432.0,25.0,957.0,1.0,185.0,290.0,70.0,50.0,13,600,199,12172,1858,68285,80457,12/04/2020
2020-05-14,329,15138,3408,97080,112218,19.0,1451.0,27.0,984.0,3.0,188.0,279.0,65.0,46.0,15,615,232,12404,1887,70172,82576,12/04/2020
2020-05-15,381,15519,3458,100538,116057,24.0,1475.0,41.0,1025.0,5.0,193.0,257.0,63.0,46.0,14,629,231,12635,1728,71900,84535,12/04/2020
2020-05-16,449,15968,4156,104694,120662,25.0,1500.0,15.0,1040.0,5.0,198.0,262.0,62.0,47.0,15,644,247,12882,1849,73749,86631,12/04/2020
2020-05-17,240,16208,2768,107462,123670,17.0,1517.0,9.0,1049.0,5.0,203.0,265.0,60.0,46.0,10,654,126,13008,1464,75213,88221,12/04/2020
2020-05-18,250,16458,2001,109463,125921,19.0,1536.0,16.0,1065.0,5.0,208.0,263.0,58.0,41.0,18,672,135,13143,1313,76526,89669,12/04/2020
2020-05-19,415,16873,3168,112631,129504,23.0,1559.0,33.0,1098.0,5.0,213.0,248.0,57.0,39.0,11,683,215,13358,1850,78376,91734,12/04/2020
2020-05-20,326,17199,2771,115402,132601,19.0,1578.0,23.0,1121.0,7.0,220.0,237.0,53.0,34.0,22,705,184,13542,1466,79842,93384,12/04/2020
2020-05-21,374,17573,3757,119159,136732,25.0,1603.0,15.0,1136.0,3.0,223.0,244.0,54.0,30.0,20,725,168,13710,1864,81706,95416,12/04/2020
2020-05-22,351,17924,3161,122320,140244,20.0,1623.0,28.0,1164.0,5.0,228.0,231.0,53.0,30.0,11,736,206,13916,1530,83236,97152,12/04/2020
2020-05-23,253,18177,2742,125062,143239,19.0,1642.0,11.0,1175.0,3.0,231.0,236.0,53.0,33.0,13,749,109,14025,1221,84457,98482,12/04/2020
2020-05-24,163,18340,1370,126432,144772,13.0,1655.0,14.0,1189.0,2.0,233.0,233.0,54.0,36.0,8,757,83,14108,746,85203,99311,12/04/2020
2020-05-25,147,18487,1385,127817,146304,14.0,1669.0,14.0,1203.0,0.0,233.0,233.0,54.0,34.0,10,767,76,14184,706,85909,100093,12/04/2020
2020-05-26,285,18772,2620,130437,149209,24.0,1693.0,21.0,1224.0,5.0,238.0,231.0,49.0,33.0,15,782,158,14342,1586,87495,101837,12/04/2020
2020-05-27,276,19048,2057,132494,151542,20.0,1713.0,18.0,1242.0,3.0,241.0,230.0,51.0,33.0,10,792,132,14474,1094,88589,103063,12/04/2020
2020-05-28,348,19396,3359,135853,155249,17.0,1730.0,29.0,1271.0,4.0,245.0,214.0,47.0,32.0,8,800,130,14604,1071,89660,104264,12/04/2020
2020-05-29,410,19806,3915,139768,159574,19.0,1749.0,26.0,1297.0,7.0,252.0,200.0,43.0,31.0,12,812,174,14778,1490,91150,105928,12/04/2020
2020-05-30,225,20031,3915,143683,163714,16.0,1765.0,19.0,1316.0,4.0,256.0,193.0,41.0,29.0,12,824,109,14887,1658,92808,107695,12/04/2020
2020-05-31,155,20186,1690,145373,165559,11.0,1776.0,11.0,1327.0,1.0,257.0,192.0,44.0,26.0,3,827,78,14965,795,93603,108568,12/04/2020
2020-06-01,212,20398,2792,148165,168563,8.0,1784.0,14.0,1341.0,1.0,258.0,185.0,45.0,29.0,5,832,93,15058,1326,94929,109987,12/04/2020
2020-06-02,273,20671,3022,151187,171858,8.0,1792.0,9.0,1350.0,3.0,261.0,181.0,38.0,25.0,10,842,98,15156,1373,96302,111458,12/04/2020
2020-06-03,254,20925,3486,154673,175598,14.0,1806.0,18.0,1368.0,6.0,267.0,171.0,34.0,25.0,11,853,99,15255,1586,97888,113143,12/04/2020
2020-06-04,276,21201,4471,159144,180345,7.0,1813.0,26.0,1394.0,4.0,271.0,148.0,31.0,24.0,12,865,107,15362,1937,99825,115187,12/04/2020
2020-06-05,215,21416,3513,162657,184073,15.0,1828.0,13.0,1407.0,6.0,277.0,144.0,27.0,21.0,11,876,99,15461,1476,101301,116762,12/04/2020
2020-06-06,201,21617,2616,165273,186890,10.0,1838.0,7.0,1414.0,2.0,279.0,145.0,29.0,19.0,6,882,67,15528,1075,102376,117904,12/04/2020
2020-06-07,83,21700,1625,166898,188598,11.0,1849.0,7.0,1421.0,1.0,280.0,148.0,25.0,17.0,4,886,51,15579,769,103145,118724,12/04/2020
2020-06-08,119,21819,1849,168747,190566,15.0,1864.0,13.0,1434.0,2.0,282.0,148.0,27.0,18.0,4,890,45,15624,924,104069,119693,12/04/2020
2020-06-09,223,22042,2673,171420,193462,10.0,1874.0,19.0,1453.0,0.0,282.0,139.0,28.0,21.0,1,891,64,15688,1212,105281,120969,12/04/2020
2020-06-10,209,22251,2987,174407,196658,13.0,1887.0,12.0,1465.0,2.0,284.0,138.0,24.0,17.0,4,895,100,15788,1420,106701,122489,12/04/2020
2020-06-11,195,22446,3513,177920,200366,7.0,1894.0,15.0,1480.0,1.0,285.0,129.0,25.0,16.0,6,901,88,15876,1471,108172,124048,12/04/2020
2020-06-12,209,22655,4601,182521,205176,9.0,1903.0,16.0,1496.0,1.0,286.0,121.0,24.0,16.0,2,903,78,15954,2039,110211,126165,12/04/2020
2020-06-13,113,22768,3036,185557,208325,6.0,1909.0,5.0,1501.0,0.0,286.0,122.0,20.0,15.0,3,906,49,16003,1292,111503,127506,12/04/2020
2020-06-14,81,22849,2046,187603,210452,7.0,1916.0,8.0,1509.0,1.0,287.0,120.0,20.0,14.0,3,909,33,16036,936,112439,128475,12/04/2020
2020-06-15,188,23037,3108,190711,213748,14.0,1930.0,19.0,1528.0,0.0,287.0,115.0,20.0,16.0,5,914,75,16111,1724,114163,130274,12/04/2020
2020-06-16,110,23147,3017,193728,216875,11.0,1941.0,9.0,1537.0,1.0,288.0,116.0,22.0,16.0,8,922,50,16161,1488,115651,131812,12/04/2020
2020-06-17,127,23274,2835,196563,219837,15.0,1956.0,20.0,1557.0,4.0,292.0,107.0,18.0,14.0,6,928,51,16212,1271,116922,133134,12/04/2020
2020-06-18,149,23423,3048,199611,223034,9.0,1965.0,15.0,1572.0,1.0,293.0,100.0,19.0,16.0,7,935,70,16282,1271,118193,134475,12/04/2020
2020-06-19,141,23564,3769,203380,226944,12.0,1977.0,12.0,1584.0,1.0,294.0,99.0,20.0,17.0,3,938,59,16341,1314,119507,135848,12/04/2020
2020-06-20,84,23648,1891,205271,228919,9.0,1986.0,12.0,1596.0,0.0,294.0,96.0,20.0,18.0,4,942,36,16377,796,120303,136680,12/04/2020
2020-06-21,37,23685,1064,206335,230020,8.0,1994.0,5.0,1601.0,0.0,294.0,99.0,20.0,18.0,2,944,30,16407,669,120972,137379,12/04/2020
2020-06-22,138,23823,3730,210065,233888,12.0,2006.0,17.0,1618.0,0.0,294.0,94.0,19.0,18.0,2,946,65,16472,1655,122627,139099,12/04/2020
2020-06-23,163,23986,3831,213896,237882,3.0,2009.0,13.0,1631.0,3.0,297.0,81.0,18.0,18.0,7,953,81,16553,1729,124356,140909,12/04/2020
2020-06-24,120,24106,3502,217398,241504,9.0,2018.0,10.0,1641.0,1.0,298.0,79.0,18.0,18.0,5,958,44,16597,1631,125987,142584,12/04/2020
2020-06-25,103,24209,2883,220281,244490,6.0,2024.0,14.0,1655.0,1.0,299.0,70.0,17.0,17.0,1,959,50,16647,1454,127441,144088,12/04/2020
2020-06-26,94,24303,2488,222769,247072,2.0,2026.0,10.0,1665.0,0.0,299.0,62.0,18.0,18.0,1,960,60,16707,1283,128724,145431,12/04/2020
2020-06-27,84,24387,3216,225985,250372,5.0,2031.0,3.0,1668.0,1.0,300.0,63.0,17.0,17.0,5,965,37,16744,1178,129902,146646,12/04/2020
2020-06-28,39,24426,1469,227454,251880,4.0,2035.0,4.0,1672.0,4.0,304.0,59.0,15.0,14.0,6,971,17,16761,580,130482,147243,12/04/2020
2020-06-29,85,24511,3697,231151,255662,4.0,2039.0,5.0,1677.0,0.0,304.0,58.0,14.0,14.0,1,972,39,16800,1313,131795,148595,12/04/2020
2020-06-30,57,24568,1958,233109,257677,1.0,2040.0,5.0,1682.0,1.0,305.0,53.0,12.0,11.0,4,976,32,16832,970,132765,149597,12/04/2020
2020-07-01,144,24712,4098,237207,261919,8.0,2048.0,10.0,1692.0,0.0,305.0,51.0,11.0,11.0,1,977,79,16911,1869,134634,151545,12/04/2020
2020-07-02,103,24815,2803,240010,264825,5.0,2053.0,5.0,1697.0,1.0,306.0,50.0,10.0,10.0,3,980,59,16970,1047,135681,152651,12/04/2020
2020-07-03,50,24865,2079,242089,266954,9.0,2062.0,6.0,1703.0,0.0,306.0,53.0,9.0,9.0,3,983,25,16995,764,136445,153440,12/04/2020
2020-07-04,57,24922,2345,244434,269356,2.0,2064.0,4.0,1707.0,1.0,307.0,50.0,10.0,9.0,2,985,33,17028,975,137420,154448,12/04/2020
2020-07-05,49,24971,2932,247366,272337,1.0,2065.0,2.0,1709.0,1.0,308.0,48.0,8.0,8.0,2,987,26,17054,1386,138806,155860,12/04/2020
2020-07-06,101,25072,2814,250180,275252,6.0,2071.0,6.0,1715.0,0.0,308.0,48.0,9.0,9.0,4,991,57,17111,1513,140319,157430,12/04/2020
2020-07-07,81,25153,3457,253637,278790,5.0,2076.0,7.0,1722.0,0.0,308.0,46.0,8.0,8.0,2,993,47,17158,1501,141820,158978,12/04/2020
2020-07-08,105,25258,3409,257046,282304,4.0,2080.0,2.0,1724.0,0.0,308.0,48.0,9.0,8.0,0,993,64,17222,1365,143185,160407,12/04/2020
2020-07-09,94,25352,3714,260760,286112,9.0,2089.0,3.0,1727.0,0.0,308.0,54.0,9.0,8.0,0,993,50,17272,1573,144758,162030,12/04/2020
2020-07-10,132,25484,4437,265197,290681,6.0,2095.0,3.0,1730.0,2.0,310.0,55.0,7.0,7.0,3,996,80,17352,2009,146767,164119,12/04/2020
2020-07-11,63,25547,2938,268135,293682,6.0,2101.0,3.0,1733.0,1.0,311.0,57.0,6.0,6.0,3,999,36,17388,1273,148040,165428,12/04/2020
2020-07-12,47,25594,1838,269973,295567,1.0,2102.0,3.0,1736.0,1.0,312.0,54.0,6.0,5.0,3,1002,34,17422,918,148958,166380,12/04/2020
2020-07-13,84,25678,3209,273182,298860,8.0,2110.0,10.0,1746.0,0.0,312.0,52.0,6.0,5.0,1,1003,61,17483,1463,150421,167904,12/04/2020
2020-07-14,74,25752,3298,276480,302232,7.0,2117.0,4.0,1750.0,0.0,312.0,55.0,5.0,5.0,1,1004,44,17527,1343,151764,169291,12/04/2020
2020-07-15,130,25882,4181,280661,306543,5.0,2122.0,7.0,1757.0,0.0,312.0,53.0,5.0,4.0,0,1004,100,17627,1698,153462,171089,12/04/2020
2020-07-16,103,25985,3740,284401,310386,6.0,2128.0,9.0,1766.0,0.0,312.0,50.0,6.0,5.0,1,1005,76,17703,1567,155029,172732,12/04/2020
2020-07-17,156,26141,4239,288640,314781,14.0,2142.0,3.0,1769.0,1.0,313.0,60.0,5.0,5.0,2,1007,79,17782,1796,156825,174607,12/04/2020
2020-07-18,85,26226,3272,291912,318138,5.0,2147.0,9.0,1778.0,1.0,314.0,55.0,5.0,4.0,4,1011,70,17852,1362,158187,176039,12/04/2020
2020-07-19,82,26308,2696,294608,320916,7.0,2154.0,3.0,1781.0,0.0,314.0,59.0,6.0,4.0,2,1013,57,17909,1116,159303,177212,12/04/2020
2020-07-20,71,26379,2666,297274,323653,9.0,2163.0,7.0,1788.0,0.0,314.0,61.0,7.0,5.0,2,1015,68,17977,1419,160722,178699,12/04/2020
2020-07-21,130,26509,4304,301578,328087,9.0,2172.0,11.0,1799.0,0.0,314.0,59.0,9.0,6.0,1,1016,108,18085,1875,162597,180682,12/04/2020
2020-07-22,130,26639,3928,305506,332145,7.0,2179.0,8.0,1807.0,1.0,315.0,57.0,7.0,6.0,1,1017,86,18171,1621,164218,182389,12/04/2020
2020-07-23,141,26780,4415,309921,336701,8.0,2187.0,6.0,1813.0,0.0,315.0,59.0,8.0,7.0,0,1017,115,18286,1919,166137,184423,12/04/2020
2020-07-24,172,26952,5966,315887,342839,15.0,2202.0,12.0,1825.0,0.0,315.0,62.0,9.0,7.0,0,1017,119,18405,2248,168385,186790,12/04/2020
2020-07-25,134,27086,4398,320285,347371,7.0,2209.0,7.0,1832.0,0.0,315.0,62.0,10.0,8.0,3,1020,108,18513,2036,170421,188934,12/04/2020
2020-07-26,62,27148,3033,323318,350466,8.0,2217.0,9.0,1841.0,0.0,315.0,61.0,11.0,7.0,1,1021,54,18567,1306,171727,190294,12/04/2020
2020-07-27,188,27336,4191,327509,354845,12.0,2229.0,7.0,1848.0,0.0,315.0,66.0,13.0,8.0,1,1022,138,18705,2277,174004,192709,12/04/2020
2020-07-28,105,27441,3840,331349,358790,5.0,2234.0,5.0,1853.0,0.0,315.0,66.0,14.0,7.0,1,1023,95,18800,1596,175600,194400,12/04/2020
2020-07-29,190,27631,5139,336488,364119,9.0,2243.0,10.0,1863.0,0.0,315.0,65.0,15.0,7.0,0,1023,154,18954,2233,177833,196787,12/04/2020
2020-07-30,121,27752,4345,340833,368585,6.0,2249.0,2.0,1865.0,1.0,316.0,68.0,15.0,6.0,1,1024,97,19051,1588,179421,198472,12/04/2020
2020-07-31,131,27883,5512,346345,374228,7.0,2256.0,9.0,1874.0,0.0,316.0,66.0,15.0,7.0,1,1025,89,19140,1790,181211,200351,12/04/2020
2020-08-01,109,27992,4294,350639,378631,7.0,2263.0,2.0,1876.0,0.0,316.0,71.0,14.0,7.0,1,1026,89,19229,1518,182729,201958,12/04/2020
2020-08-02,84,28076,2804,353443,381519,12.0,2275.0,12.0,1888.0,2.0,318.0,69.0,14.0,8.0,2,1028,62,19291,1240,183969,203260,12/04/2020
2020-08-03,188,28264,5248,358691,386955,11.0,2286.0,10.0,1898.0,0.0,318.0,70.0,16.0,7.0,1,1029,150,19441,2141,186110,205551,12/04/2020
2020-08-04,125,28389,3691,362382,390771,8.0,2294.0,5.0,1903.0,1.0,319.0,72.0,12.0,5.0,2,1031,99,19540,1722,187832,207372,12/04/2020
2020-08-05,147,28536,5935,368317,396853,11.0,2305.0,9.0,1912.0,1.0,320.0,73.0,10.0,5.0,2,1033,119,19659,2395,190227,209886,12/04/2020
2020-08-06,169,28705,5546,373863,402568,7.0,2312.0,9.0,1921.0,0.0,320.0,71.0,9.0,4.0,0,1033,120,19779,2327,192554,212333,12/04/2020
2020-08-07,123,28828,4851,378714,407542,12.0,2324.0,9.0,1930.0,1.0,321.0,73.0,9.0,3.0,2,1035,87,19866,2083,194637,214503,12/04/2020
2020-08-08,123,28951,4112,382826,411777,19.0,2343.0,6.0,1936.0,1.0,322.0,85.0,8.0,3.0,1,1036,91,19957,1734,196371,216328,12/04/2020
2020-08-09,42,28993,1727,384553,413546,6.0,2349.0,8.0,1944.0,0.0,322.0,83.0,9.0,4.0,0,1036,35,19992,1039,197410,217402,12/04/2020
2020-08-10,149,29142,4587,389140,418282,8.0,2357.0,9.0,1953.0,0.0,322.0,82.0,9.0,4.0,1,1037,113,20105,1966,199376,219481,12/04/2020
2020-08-11,106,29248,4334,393474,422722,5.0,2362.0,13.0,1966.0,0.0,322.0,74.0,10.0,4.0,3,1040,92,20197,2215,201591,221788,12/04/2020
2020-08-12,121,29369,5188,398662,428031,8.0,2370.0,11.0,1977.0,0.0,322.0,71.0,9.0,3.0,1,1041,101,20298,2542,204133,224431,12/04/2020
2020-08-13,135,29504,4196,402858,432362,13.0,2383.0,12.0,1989.0,0.0,322.0,72.0,11.0,3.0,0,1041,95,20393,1852,205985,226378,12/04/2020
2020-08-14,145,29649,5498,408356,438005,13.0,2396.0,11.0,2000.0,0.0,322.0,74.0,11.0,4.0,3,1044,98,20491,1927,207912,228403,12/04/2020
2020-08-15,106,29755,4534,412890,442645,9.0,2405.0,11.0,2011.0,1.0,323.0,71.0,11.0,5.0,0,1044,88,20579,1645,209557,230136,12/04/2020
2020-08-16,83,29838,2477,415367,445205,6.0,2411.0,5.0,2016.0,4.0,327.0,68.0,8.0,4.0,6,1050,70,20649,929,210486,231135,12/04/2020
2020-08-17,106,29944,4575,419942,449886,8.0,2419.0,6.0,2022.0,0.0,327.0,70.0,8.0,5.0,2,1052,87,20736,2334,212820,233556,12/04/2020
2020-08-18,128,30072,4911,424853,454925,11.0,2430.0,8.0,2030.0,1.0,328.0,72.0,8.0,4.0,5,1057,94,20830,2677,215497,236327,12/04/2020
2020-08-19,113,30185,5077,429930,460115,8.0,2438.0,9.0,2039.0,1.0,329.0,70.0,9.0,5.0,0,1057,90,20920,2575,218072,238992,12/04/2020
2020-08-20,173,30358,7411,437341,467699,12.0,2450.0,6.0,2045.0,2.0,331.0,74.0,10.0,5.0,3,1060,139,21059,3436,221508,242567,12/04/2020
2020-08-21,152,30510,6577,443918,474428,8.0,2458.0,5.0,2050.0,1.0,332.0,76.0,9.0,4.0,2,1062,125,21184,2860,224368,245552,12/04/2020
2020-08-22,96,30606,5550,449468,480074,11.0,2469.0,12.0,2062.0,0.0,332.0,75.0,11.0,4.0,1,1063,84,21268,2527,226895,248163,12/04/2020
2020-08-23,72,30678,4375,453843,484521,11.0,2480.0,6.0,2068.0,0.0,332.0,80.0,12.0,2.0,1,1064,56,21324,2425,229320,250644,12/04/2020
2020-08-24,105,30783,5784,459627,490410,7.0,2487.0,10.0,2078.0,1.0,333.0,76.0,14.0,4.0,1,1065,77,21401,3072,232392,253793,12/04/2020
2020-08-25,108,30891,4764,464391,495282,10.0,2497.0,4.0,2082.0,1.0,334.0,81.0,12.0,4.0,1,1066,92,21493,2240,234632,256125,12/04/2020
2020-08-26,170,31061,9482,473873,504934,4.0,2501.0,8.0,2090.0,0.0,334.0,77.0,10.0,5.0,1,1067,127,21620,3019,237651,259271,12/04/2020
2020-08-27,91,31152,8565,482438,513590,6.0,2507.0,13.0,2103.0,1.0,335.0,69.0,7.0,5.0,2,1069,70,21690,3074,240725,262415,12/04/2020
2020-08-28,113,31265,7994,490432,521697,14.0,2521.0,4.0,2107.0,0.0,335.0,79.0,10.0,7.0,2,1071,87,21777,2365,243090,264867,12/04/2020
2020-08-29,65,31330,5374,495806,527136,6.0,2527.0,8.0,2115.0,1.0,336.0,76.0,11.0,6.0,2,1073,51,21828,1876,244966,266794,12/04/2020
2020-08-30,66,31396,4323,500129,531525,7.0,2534.0,4.0,2119.0,0.0,336.0,79.0,9.0,5.0,2,1075,48,21876,1942,246908,268784,12/04/2020
2020-08-31,105,31501,4863,504992,536493,12.0,2546.0,16.0,2135.0,0.0,336.0,75.0,8.0,4.0,1,1076,81,21957,2141,249049,271006,12/04/2020
2020-09-01,99,31600,7109,512101,543701,6.0,2552.0,9.0,2144.0,1.0,337.0,71.0,7.0,4.0,2,1078,66,22023,2326,251375,273398,12/04/2020
2020-09-02,125,31725,10529,522630,554355,9.0,2561.0,10.0,2154.0,1.0,338.0,69.0,8.0,4.0,2,1080,104,22127,2989,254364,276491,12/04/2020
2020-09-03,90,31815,11080,533710,565525,8.0,2569.0,8.0,2162.0,0.0,338.0,69.0,9.0,4.0,3,1083,73,22200,2516,256880,279080,12/04/2020
2020-09-04,103,31918,8963,542673,574591,11.0,2580.0,4.0,2166.0,0.0,338.0,76.0,9.0,4.0,1,1084,83,22283,2316,259196,281479,12/04/2020
2020-09-05,52,31970,6309,548982,580952,6.0,2586.0,9.0,2175.0,0.0,338.0,73.0,8.0,3.0,1,1085,42,22325,1560,260756,283081,12/04/2020
2020-09-06,88,32058,4325,553307,585365,4.0,2590.0,8.0,2183.0,1.0,339.0,68.0,6.0,3.0,1,1086,65,22390,1900,262656,285046,12/04/2020
2020-09-07,35,32093,3002,556309,588402,11.0,2601.0,3.0,2186.0,0.0,339.0,76.0,5.0,3.0,1,1087,26,22416,625,263281,285697,12/04/2020
2020-09-08,74,32167,6381,562690,594857,6.0,2607.0,12.0,2198.0,1.0,340.0,69.0,6.0,3.0,2,1089,66,22482,1550,264831,287313,12/04/2020
2020-09-09,118,32285,8650,571340,603625,10.0,2617.0,5.0,2203.0,1.0,341.0,73.0,9.0,3.0,1,1090,102,22584,2084,266915,289499,12/04/2020
2020-09-10,164,32449,11334,582674,615123,9.0,2626.0,8.0,2211.0,0.0,341.0,74.0,10.0,3.0,1,1091,111,22695,2218,269133,291828,12/04/2020
2020-09-11,120,32569,9454,592128,624697,11.0,2637.0,11.0,2222.0,0.0,341.0,74.0,10.0,5.0,0,1091,97,22792,1915,271048,293840,12/04/2020
2020-09-12,110,32679,6174,598302,630981,8.0,2645.0,5.0,2227.0,2.0,343.0,75.0,9.0,5.0,3,1094,97,22889,1477,272525,295414,12/04/2020
2020-09-13,58,32737,2717,601019,633756,4.0,2649.0,3.0,2230.0,0.0,343.0,76.0,10.0,5.0,0,1094,54,22943,839,273364,296307,12/04/2020
2020-09-14,104,32841,6446,607465,640306,6.0,2655.0,3.0,2233.0,2.0,345.0,77.0,10.0,5.0,2,1096,95,23038,1688,275052,298090,12/04/2020
2020-09-15,122,32963,8470,615935,648898,7.0,2662.0,2.0,2235.0,1.0,346.0,81.0,10.0,5.0,2,1098,124,23162,2141,277193,300355,12/04/2020
2020-09-16,137,33100,9716,625651,658751,7.0,2669.0,7.0,2242.0,2.0,348.0,79.0,9.0,6.0,5,1103,118,23280,1923,279116,302396,12/04/2020
2020-09-17,125,33225,9239,634890,668115,7.0,2676.0,15.0,2257.0,0.0,348.0,71.0,8.0,4.0,0,1103,154,23434,1895,281011,304445,12/04/2020
2020-09-18,132,33357,10045,644935,678292,7.0,2683.0,7.0,2264.0,1.0,349.0,70.0,11.0,6.0,2,1105,132,23566,1883,282894,306460,12/04/2020
2020-09-19,115,33472,8297,653232,686704,7.0,2690.0,3.0,2267.0,0.0,349.0,74.0,10.0,6.0,4,1109,112,23678,1663,284557,308235,12/04/2020
2020-09-20,60,33532,3676,656908,690440,7.0,2697.0,6.0,2273.0,2.0,351.0,73.0,9.0,8.0,4,1113,49,23727,1295,285852,309579,12/04/2020
2020-09-21,102,33634,7018,663926,697560,12.0,2709.0,3.0,2276.0,2.0,353.0,80.0,8.0,6.0,2,1115,94,23821,2357,288209,312030,12/04/2020
2020-09-22,154,33788,9287,673213,707001,12.0,2721.0,3.0,2279.0,1.0,354.0,88.0,7.0,5.0,1,1116,124,23945,2145,290354,314299,12/04/2020
2020-09-23,136,33924,10651,683864,717788,12.0,2733.0,7.0,2286.0,0.0,354.0,93.0,6.0,5.0,0,1116,127,24072,2154,292508,316580,12/04/2020
2020-09-24,120,34044,12480,696344,730388,7.0,2740.0,9.0,2295.0,1.0,355.0,90.0,7.0,5.0,1,1117,120,24192,3105,295613,319805,12/04/2020
2020-09-25,150,34194,10553,706897,741091,9.0,2749.0,10.0,2305.0,0.0,355.0,89.0,6.0,5.0,1,1118,143,24335,2945,298558,322893,12/04/2020
2020-09-26,147,34341,10560,717457,751798,12.0,2761.0,9.0,2314.0,0.0,355.0,92.0,6.0,5.0,1,1119,120,24455,2384,300942,325397,12/04/2020
2020-09-27,43,34384,2764,720221,754605,7.0,2768.0,5.0,2319.0,0.0,355.0,94.0,9.0,5.0,0,1119,34,24489,826,301768,326257,12/04/2020
2020-09-28,156,34540,7307,727528,762068,7.0,2775.0,7.0,2326.0,2.0,357.0,92.0,7.0,5.0,2,1121,138,24627,2207,303975,328602,12/04/2020
2020-09-29,203,34743,11046,738574,773317,12.0,2787.0,18.0,2344.0,1.0,358.0,85.0,6.0,6.0,1,1122,185,24812,2768,306743,331555,12/04/2020
2020-09-30,223,34966,12230,750804,785770,6.0,2793.0,6.0,2350.0,0.0,358.0,85.0,6.0,6.0,1,1123,189,25001,2518,309261,334262,12/04/2020
2020-10-01,185,35151,12503,763307,798458,17.0,2810.0,13.0,2363.0,1.0,359.0,88.0,6.0,4.0,2,1125,166,25167,2355,311616,336783,12/04/2020
2020-10-02,209,35360,12154,775461,810821,14.0,2824.0,13.0,2376.0,1.0,360.0,88.0,8.0,5.0,2,1127,181,25348,2446,314062,339410,12/04/2020
2020-10-03,157,35517,9313,784774,820291,9.0,2833.0,9.0,2385.0,2.0,362.0,86.0,9.0,4.0,2,1129,131,25479,1981,316043,341522,12/04/2020
2020-10-04,81,35598,2369,787143,822741,11.0,2844.0,9.0,2394.0,1.0,363.0,87.0,8.0,5.0,2,1131,77,25556,936,316979,342535,12/04/2020
2020-10-05,174,35772,8982,796125,831897,30.0,2874.0,10.0,2404.0,2.0,365.0,105.0,9.0,6.0,4,1135,160,25716,2977,319956,345672,12/04/2020
2020-10-06,187,35959,11186,807311,843270,11.0,2885.0,4.0,2408.0,0.0,365.0,112.0,11.0,7.0,0,1135,188,25904,2843,322799,348703,12/04/2020
2020-10-07,242,36201,12442,819753,855954,13.0,2898.0,14.0,2422.0,2.0,367.0,109.0,9.0,7.0,2,1137,244,26148,3474,326273,352421,12/04/2020
2020-10-08,279,36480,15231,834984,871464,17.0,2915.0,13.0,2435.0,2.0,369.0,111.0,7.0,5.0,4,1141,278,26426,4145,330418,356844,12/04/2020
2020-10-09,229,36709,13745,848729,885438,21.0,2936.0,12.0,2447.0,0.0,369.0,120.0,10.0,7.0,3,1144,200,26626,4240,334658,361284,12/04/2020
2020-10-10,231,36940,13832,862561,899501,19.0,2955.0,10.0,2457.0,1.0,370.0,128.0,13.0,7.0,2,1146,192,26818,3729,338387,365205,12/04/2020
2020-10-11,97,37037,3263,865824,902861,12.0,2967.0,9.0,2466.0,1.0,371.0,130.0,14.0,5.0,6,1152,87,26905,1146,339533,366438,12/04/2020
2020-10-12,169,37206,6440,872264,909470,19.0,2986.0,15.0,2481.0,2.0,373.0,132.0,14.0,5.0,4,1156,157,27062,1694,341227,368289,12/04/2020
2020-10-13,213,37419,8522,880786,918205,15.0,3001.0,13.0,2494.0,4.0,377.0,130.0,13.0,5.0,7,1163,207,27269,2277,343504,370773,12/04/2020
2020-10-14,322,37741,15039,895825,933566,17.0,3018.0,7.0,2501.0,0.0,377.0,140.0,15.0,5.0,2,1165,300,27569,3963,347467,375036,12/04/2020
2020-10-15,262,38003,14639,910464,948467,12.0,3030.0,16.0,2517.0,1.0,378.0,135.0,13.0,5.0,2,1167,254,27823,3512,350979,378802,12/04/2020
2020-10-16,279,38282,15011,925475,963757,12.0,3042.0,18.0,2535.0,1.0,379.0,128.0,13.0,4.0,2,1169,275,28098,3323,354302,382400,12/04/2020
2020-10-17,354,38636,14069,939544,978180,19.0,3061.0,11.0,2546.0,1.0,380.0,135.0,17.0,4.0,2,1171,310,28408,3208,357510,385918,12/04/2020
2020-10-18,155,38791,4039,943583,982374,18.0,3079.0,11.0,2557.0,0.0,380.0,142.0,17.0,6.0,2,1173,126,28534,1289,358799,387333,12/04/2020
2020-10-19,388,39179,8491,952074,991253,21.0,3100.0,22.0,2579.0,2.0,382.0,139.0,15.0,6.0,1,1174,324,28858,2521,361320,390178,12/04/2020
2020-10-20,439,39618,13242,965316,1004934,23.0,3123.0,16.0,2595.0,0.0,382.0,146.0,14.0,8.0,3,1177,386,29244,2953,364273,393517,12/04/2020
2020-10-21,544,40162,17463,982779,1022941,22.0,3145.0,8.0,2603.0,2.0,384.0,158.0,15.0,9.0,3,1180,472,29716,3450,367723,397439,12/04/2020
2020-10-22,538,40700,15863,998642,1039342,24.0,3169.0,20.0,2623.0,3.0,387.0,159.0,14.0,9.0,3,1183,489,30205,3125,370848,401053,12/04/2020
2020-10-23,514,41214,16634,1015276,1056490,22.0,3191.0,22.0,2645.0,1.0,388.0,158.0,15.0,9.0,3,1186,458,30663,2834,373682,404345,12/04/2020
2020-10-24,359,41573,10249,1025525,1067098,17.0,3208.0,11.0,2656.0,0.0,388.0,164.0,14.0,8.0,1,1187,338,31001,2228,375910,406911,12/04/2020
2020-10-25,233,41806,4760,1030285,1072091,16.0,3224.0,15.0,2671.0,1.0,389.0,164.0,15.0,8.0,2,1189,209,31210,1425,377335,408545,12/04/2020
2020-10-26,454,42260,9174,1039459,1081719,26.0,3250.0,15.0,2686.0,2.0,391.0,173.0,18.0,8.0,3,1192,403,31613,2918,380253,411866,12/04/2020
2020-10-27,517,42777,13995,1053454,1096231,29.0,3279.0,15.0,2701.0,2.0,393.0,185.0,18.0,9.0,4,1196,453,32066,2352,382605,414671,12/04/2020
2020-10-28,469,43246,15229,1068683,1111929,25.0,3304.0,26.0,2727.0,1.0,394.0,183.0,17.0,9.0,3,1199,411,32477,2650,385255,417732,12/04/2020
2020-10-29,609,43855,16259,1084942,1128797,20.0,3324.0,22.0,2749.0,3.0,397.0,178.0,19.0,11.0,4,1203,526,33003,3078,388333,421336,12/04/2020
2020-10-30,565,44420,14863,1099805,1144225,21.0,3345.0,21.0,2770.0,5.0,402.0,173.0,19.0,9.0,4,1207,467,33470,2903,391236,424706,12/04/2020
2020-10-31,599,45019,11820,1111625,1156644,31.0,3376.0,13.0,2783.0,1.0,403.0,190.0,22.0,9.0,3,1210,484,33954,2377,393613,427567,12/04/2020
2020-11-01,330,45349,5091,1116716,1162065,22.0,3398.0,15.0,2798.0,1.0,404.0,196.0,26.0,12.0,4,1214,273,34227,1248,394861,429088,12/04/2020
2020-11-02,521,45870,9930,1126646,1172516,38.0,3436.0,27.0,2825.0,3.0,407.0,204.0,24.0,12.0,5,1219,454,34681,2891,397752,432433,12/04/2020
2020-11-03,602,46472,13040,1139686,1186158,33.0,3469.0,25.0,2850.0,1.0,408.0,211.0,24.0,12.0,1,1220,529,35210,2471,400223,435433,12/04/2020
2020-11-04,688,47160,16100,1155786,1202946,34.0,3503.0,27.0,2877.0,2.0,410.0,216.0,25.0,12.0,4,1224,633,35843,2885,403108,438951,12/04/2020
2020-11-05,768,47928,16593,1172379,1220307,46.0,3549.0,35.0,2912.0,1.0,411.0,226.0,24.0,14.0,3,1227,682,36525,2814,405922,442447,12/04/2020
2020-11-06,769,48697,16022,1188401,1237098,43.0,3592.0,31.0,2943.0,1.0,412.0,237.0,28.0,17.0,5,1232,691,37216,2999,408921,446137,12/04/2020
2020-11-07,604,49301,13650,1202051,1251352,34.0,3626.0,25.0,2968.0,1.0,413.0,245.0,31.0,18.0,1,1233,576,37792,2436,411357,449149,12/04/2020
2020-11-08,337,49638,4160,1206211,1255849,33.0,3659.0,26.0,2994.0,1.0,414.0,251.0,30.0,19.0,4,1237,321,38113,1260,412617,450730,12/04/2020
2020-11-09,807,50445,9040,1215251,1265696,39.0,3698.0,33.0,3027.0,2.0,416.0,255.0,28.0,18.0,3,1240,761,38874,2287,414904,453778,12/04/2020
2020-11-10,1053,51498,12982,1228233,1279731,45.0,3743.0,37.0,3064.0,0.0,416.0,263.0,31.0,18.0,6,1246,980,39854,2857,417761,457615,12/04/2020
2020-11-11,1087,52585,19741,1247974,1300559,42.0,3785.0,24.0,3088.0,5.0,421.0,276.0,30.0,15.0,7,1253,1001,40855,2654,420415,461270,12/04/2020
2020-11-12,893,53478,13902,1261876,1315354,39.0,3824.0,31.0,3119.0,3.0,424.0,281.0,28.0,15.0,5,1258,811,41666,2180,422595,464261,12/04/2020
2020-11-13,1165,54643,16390,1278266,1332909,37.0,3861.0,31.0,3150.0,0.0,424.0,287.0,27.0,15.0,2,1260,1115,42781,3077,425672,468453,12/04/2020
2020-11-14,782,55425,13517,1291783,1347208,41.0,3902.0,26.0,3176.0,5.0,429.0,297.0,25.0,13.0,10,1270,738,43519,2446,428118,471637,12/04/2020
2020-11-15,578,56003,6173,1297956,1353959,44.0,3946.0,21.0,3197.0,5.0,434.0,315.0,28.0,11.0,7,1277,492,44011,1412,429530,473541,12/04/2020
2020-11-16,738,56741,9614,1307570,1364311,55.0,4001.0,38.0,3235.0,3.0,437.0,329.0,26.0,13.0,5,1282,668,44679,2604,432134,476813,12/04/2020
2020-11-17,1538,58279,18173,1325743,1384022,59.0,4060.0,44.0,3279.0,2.0,439.0,342.0,30.0,13.0,5,1287,1399,46078,4117,436251,482329,12/04/2020
2020-11-18,1124,59403,16028,1341771,1401174,36.0,4096.0,38.0,3317.0,5.0,444.0,335.0,29.0,15.0,7,1294,1010,47088,3171,439422,486510,12/04/2020
2020-11-19,1128,60531,13156,1354927,1415458,45.0,4141.0,42.0,3359.0,4.0,448.0,334.0,29.0,18.0,5,1299,1034,48122,3398,442820,490942,12/04/2020
2020-11-20,1434,61965,22194,1377121,1439086,47.0,4188.0,48.0,3407.0,3.0,451.0,330.0,32.0,14.0,6,1305,1288,49410,4291,447111,496521,12/04/2020
2020-11-21,839,62804,17349,1394470,1457274,42.0,4230.0,34.0,3441.0,5.0,456.0,333.0,34.0,14.0,7,1312,753,50163,3136,450247,500410,12/04/2020
2020-11-22,567,63371,7521,1401991,1465362,63.0,4293.0,28.0,3469.0,4.0,460.0,364.0,32.0,15.0,11,1323,486,50649,1796,452043,502692,12/04/2020
2020-11-23,961,64332,11012,1413003,1477335,71.0,4364.0,41.0,3510.0,0.0,460.0,394.0,39.0,18.0,10,1333,868,51517,3412,455455,506972,12/04/2020
2020-11-24,1024,65356,14506,1427509,1492865,45.0,4409.0,57.0,3567.0,6.0,466.0,376.0,40.0,20.0,10,1343,945,52462,2755,458210,510672,12/04/2020
2020-11-25,1252,66608,18701,1446210,1512818,52.0,4461.0,58.0,3625.0,4.0,470.0,366.0,41.0,24.0,6,1349,1169,53631,3495,461705,515336,12/04/2020
2020-11-26,547,67155,6477,1452687,1519842,50.0,4511.0,33.0,3658.0,4.0,474.0,379.0,44.0,23.0,12,1361,470,54101,1578,463283,517384,12/04/2020
2020-11-27,1008,68163,9686,1462373,1530536,51.0,4562.0,49.0,3707.0,7.0,481.0,374.0,44.0,20.0,6,1367,952,55053,2516,465799,520852,12/04/2020
2020-11-28,1141,69304,11835,1474208,1543512,61.0,4623.0,40.0,3747.0,0.0,481.0,395.0,44.0,20.0,3,1370,1080,56133,2738,468537,524670,12/04/2020
2020-11-29,795,70099,6815,1481023,1551122,62.0,4685.0,33.0,3780.0,3.0,484.0,421.0,45.0,23.0,8,1378,746,56879,2262,470799,527678,12/04/2020
2020-11-30,1203,71302,9870,1490893,1562195,64.0,4749.0,58.0,3838.0,2.0,486.0,425.0,48.0,29.0,5,1383,1129,58008,2808,473607,531615,12/04/2020
2020-12-01,1495,72797,13789,1504682,1577479,51.0,4800.0,53.0,3891.0,3.0,489.0,420.0,46.0,31.0,12,1395,1404,59412,3354,476961,536373,12/04/2020
2020-12-02,1511,74308,15380,1520062,1594370,43.0,4843.0,48.0,3939.0,7.0,496.0,408.0,45.0,29.0,10,1405,1399,60811,3220,480181,540992,12/04/2020
2020-12-03,1484,75792,12994,1533056,1608848,,,,,,,,,,8,1413,1326,62137,2741,482922,545059,12/04/2020
2020-02-27,0,0,0,0,0,1.0,1.0,0.0,0.0,0.0,0.0,1.0,0.0,0.0,0,0,0,0,0,0,0,12/07/2020
2020-02-28,0,0,0,0,0,0.0,1.0,0.0,0.0,0.0,0.0,1.0,1.0,0.0,0,0,0,0,0,0,0,12/07/2020
2020-02-29,0,0,0,0,0,0.0,1.0,0.0,0.0,0.0,0.0,1.0,1.0,0.0,0,0,0,0,0,0,0,12/07/2020
2020-03-01,2,2,2,2,4,0.0,1.0,0.0,0.0,0.0,0.0,1.0,1.0,1.0,0,0,2,2,2,2,4,12/07/2020
2020-03-02,0,2,1,3,5,1.0,2.0,0.0,0.0,0.0,0.0,2.0,2.0,2.0,0,0,0,2,0,2,4,12/07/2020
2020-03-03,0,2,2,5,7,0.0,2.0,0.0,0.0,0.0,0.0,2.0,2.0,2.0,0,0,0,2,1,3,5,12/07/2020
2020-03-04,0,2,12,17,19,1.0,3.0,0.0,0.0,0.0,0.0,3.0,2.0,2.0,0,0,0,2,10,13,15,12/07/2020
2020-03-05,0,2,4,21,23,0.0,3.0,0.0,0.0,0.0,0.0,3.0,2.0,2.0,0,0,1,3,4,17,20,12/07/2020
2020-03-06,1,3,12,33,36,0.0,3.0,0.0,0.0,0.0,0.0,3.0,2.0,2.0,0,0,0,3,11,28,31,12/07/2020
2020-03-07,0,3,19,52,55,0.0,3.0,0.0,0.0,0.0,0.0,3.0,2.0,1.0,0,0,0,3,19,47,50,12/07/2020
2020-03-08,0,3,18,70,73,0.0,3.0,0.0,0.0,0.0,0.0,3.0,2.0,1.0,0,0,0,3,18,65,68,12/07/2020
2020-03-09,1,4,15,85,89,0.0,3.0,0.0,0.0,0.0,0.0,3.0,2.0,1.0,0,0,1,4,14,79,83,12/07/2020
2020-03-10,2,6,25,110,116,0.0,3.0,0.0,0.0,0.0,0.0,3.0,2.0,1.0,0,0,1,5,23,102,107,12/07/2020
2020-03-11,0,6,34,144,150,1.0,4.0,0.0,0.0,0.0,0.0,4.0,1.0,1.0,0,0,0,5,34,136,141,12/07/2020
2020-03-12,9,15,41,185,200,1.0,5.0,0.0,0.0,0.0,0.0,5.0,1.0,1.0,0,0,7,12,38,174,186,12/07/2020
2020-03-13,6,21,50,235,256,4.0,9.0,1.0,1.0,0.0,0.0,8.0,1.0,1.0,0,0,6,18,47,221,239,12/07/2020
2020-03-14,0,21,90,325,346,0.0,9.0,0.0,1.0,0.0,0.0,8.0,1.0,1.0,0,0,0,18,83,304,322,12/07/2020
2020-03-15,1,22,54,379,401,1.0,10.0,0.0,1.0,0.0,0.0,9.0,2.0,1.0,0,0,1,19,53,357,376,12/07/2020
2020-03-16,2,24,95,474,498,2.0,12.0,0.0,1.0,0.0,0.0,11.0,2.0,0.0,0,0,2,21,90,447,468,12/07/2020
2020-03-17,12,36,162,636,672,6.0,18.0,0.0,1.0,0.0,0.0,17.0,2.0,0.0,0,0,11,32,145,592,624,12/07/2020
2020-03-18,9,45,116,752,797,3.0,21.0,0.0,1.0,0.0,0.0,20.0,2.0,0.0,0,0,11,43,105,697,740,12/07/2020
2020-03-19,15,60,262,1014,1074,2.0,23.0,1.0,2.0,0.0,0.0,21.0,3.0,0.0,1,1,17,60,245,942,1002,12/07/2020
2020-03-20,13,73,197,1211,1284,5.0,28.0,0.0,2.0,0.0,0.0,26.0,4.0,0.0,0,1,13,73,183,1125,1198,12/07/2020
2020-03-21,12,85,126,1337,1422,3.0,31.0,2.0,4.0,0.0,0.0,27.0,5.0,0.0,0,1,14,87,119,1244,1331,12/07/2020
2020-03-22,27,112,282,1619,1731,2.0,33.0,0.0,4.0,0.0,0.0,29.0,5.0,0.0,0,1,25,112,253,1497,1609,12/07/2020
2020-03-23,14,126,169,1788,1914,15.0,48.0,1.0,5.0,0.0,0.0,43.0,9.0,3.0,0,1,16,128,158,1655,1783,12/07/2020
2020-03-24,20,146,242,2030,2176,8.0,56.0,0.0,5.0,0.0,0.0,51.0,10.0,5.0,0,1,19,147,223,1878,2025,12/07/2020
2020-03-25,26,172,182,2212,2384,5.0,61.0,2.0,7.0,0.0,0.0,54.0,11.0,3.0,0,1,28,175,160,2038,2213,12/07/2020
2020-03-26,35,207,181,2393,2600,9.0,70.0,5.0,12.0,0.0,0.0,58.0,14.0,5.0,0,1,41,216,167,2205,2421,12/07/2020
2020-03-27,27,234,214,2607,2841,9.0,79.0,1.0,13.0,1.0,1.0,65.0,16.0,6.0,2,3,31,247,188,2393,2640,12/07/2020
2020-03-28,59,293,260,2867,3160,11.0,90.0,2.0,15.0,1.0,2.0,73.0,15.0,6.0,1,4,64,311,236,2629,2940,12/07/2020
2020-03-29,100,393,350,3217,3610,8.0,98.0,3.0,18.0,1.0,3.0,77.0,18.0,8.0,2,6,105,416,299,2928,3344,12/07/2020
2020-03-30,62,455,222,3439,3894,19.0,117.0,5.0,23.0,0.0,3.0,91.0,19.0,11.0,3,9,78,494,174,3102,3596,12/07/2020
2020-03-31,71,526,369,3808,4334,11.0,128.0,7.0,30.0,1.0,4.0,94.0,21.0,13.0,2,11,73,567,286,3388,3955,12/07/2020
2020-04-01,99,625,698,4506,5131,18.0,146.0,7.0,37.0,0.0,4.0,105.0,29.0,15.0,1,12,100,667,598,3986,4653,12/07/2020
2020-04-02,52,677,477,4983,5660,22.0,168.0,6.0,43.0,2.0,6.0,119.0,35.0,21.0,4,16,62,729,416,4402,5131,12/07/2020
2020-04-03,108,785,774,5757,6542,23.0,191.0,7.0,50.0,0.0,6.0,135.0,42.0,25.0,3,19,100,829,671,5073,5902,12/07/2020
2020-04-04,143,928,660,6417,7345,22.0,213.0,4.0,54.0,5.0,11.0,148.0,40.0,29.0,9,28,138,967,580,5653,6620,12/07/2020
2020-04-05,187,1115,1156,7573,8688,20.0,233.0,9.0,63.0,1.0,12.0,158.0,43.0,35.0,2,30,181,1148,994,6647,7795,12/07/2020
2020-04-06,218,1333,1706,9279,10612,26.0,259.0,7.0,70.0,0.0,12.0,177.0,47.0,39.0,7,37,207,1355,1475,8122,9477,12/07/2020
2020-04-07,284,1617,1629,10908,12525,20.0,279.0,4.0,74.0,2.0,14.0,191.0,49.0,41.0,5,42,260,1615,1405,9527,11142,12/07/2020
2020-04-08,290,1907,1720,12628,14535,19.0,298.0,8.0,82.0,5.0,19.0,197.0,49.0,37.0,10,52,271,1886,1473,11000,12886,12/07/2020
2020-04-09,283,2190,1516,14144,16334,32.0,330.0,8.0,90.0,4.0,23.0,217.0,53.0,40.0,7,59,277,2163,1291,12291,14454,12/07/2020
2020-04-10,419,2609,2574,16718,19327,29.0,359.0,17.0,107.0,5.0,28.0,224.0,59.0,41.0,11,70,400,2563,2249,14540,17103,12/07/2020
2020-04-11,297,2906,1905,18623,21529,29.0,388.0,11.0,118.0,2.0,30.0,240.0,61.0,48.0,12,82,280,2843,1643,16183,19026,12/07/2020
2020-04-12,314,3220,1670,20293,23513,35.0,423.0,13.0,131.0,5.0,35.0,257.0,59.0,49.0,9,91,286,3129,1321,17504,20633,12/07/2020
2020-04-13,161,3381,935,21228,24609,35.0,458.0,13.0,144.0,3.0,38.0,276.0,64.0,54.0,9,100,187,3316,800,18304,21620,12/07/2020
2020-04-14,289,3670,1787,23015,26685,27.0,485.0,18.0,162.0,5.0,43.0,280.0,72.0,53.0,8,108,261,3577,1442,19746,23323,12/07/2020
2020-04-15,351,4021,1799,24814,28835,31.0,516.0,20.0,182.0,3.0,46.0,288.0,72.0,54.0,17,125,306,3883,1439,21185,25068,12/07/2020
2020-04-16,447,4468,2494,27308,31776,36.0,552.0,25.0,207.0,6.0,52.0,293.0,72.0,53.0,14,139,387,4270,1934,23119,27389,12/07/2020
2020-04-17,304,4772,1821,29129,33901,32.0,584.0,20.0,227.0,7.0,59.0,298.0,66.0,45.0,21,160,290,4560,1349,24468,29028,12/07/2020
2020-04-18,321,5093,1725,30854,35947,26.0,610.0,18.0,245.0,4.0,63.0,302.0,63.0,49.0,15,175,284,4844,1247,25715,30559,12/07/2020
2020-04-19,381,5474,2047,32901,38375,23.0,633.0,26.0,271.0,1.0,64.0,298.0,65.0,55.0,11,186,337,5181,1657,27372,32553,12/07/2020
2020-04-20,394,5868,1907,34808,40676,46.0,679.0,29.0,300.0,2.0,66.0,313.0,75.0,56.0,10,196,376,5557,1498,28870,34427,12/07/2020
2020-04-21,444,6312,2110,36918,43230,45.0,724.0,32.0,332.0,5.0,71.0,321.0,72.0,56.0,18,214,383,5940,1627,30497,36437,12/07/2020
2020-04-22,418,6730,2390,39308,46038,41.0,765.0,32.0,364.0,5.0,76.0,325.0,73.0,58.0,18,232,379,6319,1806,32303,38622,12/07/2020
2020-04-23,479,7209,2469,41777,48986,32.0,797.0,28.0,392.0,5.0,81.0,324.0,76.0,62.0,15,247,412,6731,1744,34047,40778,12/07/2020
2020-04-24,491,7700,3284,45061,52761,35.0,832.0,26.0,418.0,4.0,85.0,329.0,85.0,63.0,15,262,407,7138,2455,36502,43640,12/07/2020
2020-04-25,393,8093,2206,47267,55360,34.0,866.0,17.0,435.0,5.0,90.0,341.0,85.0,62.0,14,276,299,7437,1628,38130,45567,12/07/2020
2020-04-26,316,8409,2309,49576,57985,33.0,899.0,15.0,450.0,3.0,93.0,356.0,86.0,59.0,14,290,274,7711,1752,39882,47593,12/07/2020
2020-04-27,249,8658,1620,51196,59854,29.0,928.0,21.0,471.0,4.0,97.0,360.0,86.0,61.0,10,300,206,7917,1087,40969,48886,12/07/2020
2020-04-28,410,9068,2263,53459,62527,44.0,972.0,24.0,495.0,3.0,100.0,377.0,88.0,59.0,22,322,331,8248,1581,42550,50798,12/07/2020
2020-04-29,476,9544,3343,56802,66346,36.0,1008.0,38.0,533.0,11.0,111.0,364.0,78.0,53.0,18,340,370,8618,2232,44782,53400,12/07/2020
2020-04-30,432,9976,2769,59571,69547,33.0,1041.0,38.0,571.0,6.0,117.0,353.0,83.0,57.0,24,364,351,8969,1744,46526,55495,12/07/2020
2020-05-01,454,10430,3086,62657,73087,52.0,1093.0,38.0,609.0,3.0,120.0,364.0,84.0,58.0,14,378,323,9292,1970,48496,57788,12/07/2020
2020-05-02,257,10687,1926,64583,75270,36.0,1129.0,39.0,648.0,5.0,125.0,356.0,93.0,63.0,24,402,193,9485,1203,49699,59184,12/07/2020
2020-05-03,283,10970,2160,66743,77713,31.0,1160.0,26.0,674.0,8.0,133.0,353.0,91.0,61.0,21,423,183,9668,1456,51155,60823,12/07/2020
2020-05-04,387,11357,2098,68841,80198,30.0,1190.0,31.0,705.0,6.0,139.0,346.0,89.0,58.0,18,441,290,9958,1482,52637,62595,12/07/2020
2020-05-05,433,11790,2873,71714,83504,29.0,1219.0,32.0,737.0,6.0,145.0,337.0,83.0,55.0,16,457,299,10257,1850,54487,64744,12/07/2020
2020-05-06,488,12278,2830,74544,86822,28.0,1247.0,44.0,781.0,9.0,154.0,312.0,80.0,55.0,21,478,340,10597,1818,56305,66902,12/07/2020
2020-05-07,425,12703,2969,77513,90216,36.0,1283.0,44.0,825.0,5.0,159.0,299.0,72.0,53.0,21,499,270,10867,1847,58152,69019,12/07/2020
2020-05-08,359,13062,2598,80111,93173,30.0,1313.0,29.0,854.0,5.0,164.0,295.0,72.0,54.0,22,521,230,11097,1595,59747,70844,12/07/2020
2020-05-09,467,13529,3346,83457,96986,22.0,1335.0,21.0,875.0,4.0,168.0,292.0,70.0,52.0,15,536,289,11386,2117,61864,73250,12/07/2020
2020-05-10,285,13814,2117,85574,99388,20.0,1355.0,23.0,898.0,6.0,174.0,283.0,71.0,50.0,14,550,190,11576,1418,63282,74858,12/07/2020
2020-05-11,257,14071,1857,87431,101502,31.0,1386.0,16.0,914.0,6.0,180.0,292.0,72.0,50.0,15,565,173,11749,1231,64513,76262,12/07/2020
2020-05-12,387,14458,2611,90042,104500,23.0,1409.0,18.0,932.0,4.0,184.0,293.0,70.0,49.0,22,587,224,11973,1556,66069,78042,12/07/2020
2020-05-13,351,14809,3630,93672,108481,23.0,1432.0,25.0,957.0,1.0,185.0,290.0,70.0,50.0,13,600,199,12172,1850,67919,80091,12/07/2020
2020-05-14,329,15138,3408,97080,112218,19.0,1451.0,27.0,984.0,3.0,188.0,279.0,65.0,46.0,15,615,232,12404,1879,69798,82202,12/07/2020
2020-05-15,381,15519,3458,100538,116057,24.0,1475.0,41.0,1025.0,5.0,193.0,257.0,63.0,46.0,14,629,232,12636,1725,71523,84159,12/07/2020
2020-05-16,449,15968,4156,104694,120662,25.0,1500.0,15.0,1040.0,5.0,198.0,262.0,62.0,47.0,15,644,247,12883,1841,73364,86247,12/07/2020
2020-05-17,240,16208,2768,107462,123670,17.0,1517.0,9.0,1049.0,5.0,203.0,265.0,60.0,46.0,10,654,126,13009,1458,74822,87831,12/07/2020
2020-05-18,250,16458,2001,109463,125921,19.0,1536.0,16.0,1065.0,5.0,208.0,263.0,58.0,41.0,18,672,135,13144,1308,76130,89274,12/07/2020
2020-05-19,415,16873,3168,112631,129504,23.0,1559.0,33.0,1098.0,5.0,213.0,248.0,57.0,39.0,11,683,215,13359,1840,77970,91329,12/07/2020
2020-05-20,326,17199,2771,115402,132601,19.0,1578.0,23.0,1121.0,7.0,220.0,237.0,53.0,34.0,22,705,184,13543,1458,79428,92971,12/07/2020
2020-05-21,374,17573,3757,119159,136732,25.0,1603.0,15.0,1136.0,3.0,223.0,244.0,54.0,30.0,20,725,168,13711,1859,81287,94998,12/07/2020
2020-05-22,351,17924,3161,122320,140244,20.0,1623.0,28.0,1164.0,5.0,228.0,231.0,53.0,30.0,11,736,206,13917,1524,82811,96728,12/07/2020
2020-05-23,253,18177,2742,125062,143239,19.0,1642.0,11.0,1175.0,3.0,231.0,236.0,53.0,33.0,13,749,109,14026,1215,84026,98052,12/07/2020
2020-05-24,163,18340,1370,126432,144772,13.0,1655.0,14.0,1189.0,2.0,233.0,233.0,54.0,36.0,8,757,83,14109,742,84768,98877,12/07/2020
2020-05-25,147,18487,1385,127817,146304,14.0,1669.0,14.0,1203.0,0.0,233.0,233.0,54.0,34.0,10,767,76,14185,702,85470,99655,12/07/2020
2020-05-26,285,18772,2620,130437,149209,24.0,1693.0,21.0,1224.0,5.0,238.0,231.0,49.0,33.0,15,782,158,14343,1579,87049,101392,12/07/2020
2020-05-27,276,19048,2057,132494,151542,20.0,1713.0,18.0,1242.0,3.0,241.0,230.0,51.0,33.0,10,792,132,14475,1091,88140,102615,12/07/2020
2020-05-28,348,19396,3359,135853,155249,17.0,1730.0,29.0,1271.0,4.0,245.0,214.0,47.0,32.0,8,800,130,14605,1063,89203,103808,12/07/2020
2020-05-29,410,19806,3915,139768,159574,19.0,1749.0,26.0,1297.0,7.0,252.0,200.0,43.0,31.0,12,812,174,14779,1485,90688,105467,12/07/2020
2020-05-30,225,20031,3915,143683,163714,16.0,1765.0,19.0,1316.0,4.0,256.0,193.0,41.0,29.0,12,824,109,14888,1650,92338,107226,12/07/2020
2020-05-31,155,20186,1690,145373,165559,11.0,1776.0,11.0,1327.0,1.0,257.0,192.0,44.0,26.0,3,827,78,14966,794,93132,108098,12/07/2020
2020-06-01,212,20398,2792,148165,168563,8.0,1784.0,14.0,1341.0,1.0,258.0,185.0,45.0,29.0,5,832,93,15059,1325,94457,109516,12/07/2020
2020-06-02,273,20671,3022,151187,171858,8.0,1792.0,9.0,1350.0,3.0,261.0,181.0,38.0,25.0,10,842,98,15157,1369,95826,110983,12/07/2020
2020-06-03,254,20925,3486,154673,175598,14.0,1806.0,18.0,1368.0,6.0,267.0,171.0,34.0,25.0,11,853,99,15256,1581,97407,112663,12/07/2020
2020-06-04,276,21201,4471,159144,180345,7.0,1813.0,26.0,1394.0,4.0,271.0,148.0,31.0,24.0,12,865,107,15363,1923,99330,114693,12/07/2020
2020-06-05,215,21416,3513,162657,184073,15.0,1828.0,13.0,1407.0,6.0,277.0,144.0,27.0,21.0,11,876,99,15462,1470,100800,116262,12/07/2020
2020-06-06,201,21617,2616,165273,186890,10.0,1838.0,7.0,1414.0,2.0,279.0,145.0,29.0,19.0,6,882,67,15529,1070,101870,117399,12/07/2020
2020-06-07,83,21700,1625,166898,188598,11.0,1849.0,7.0,1421.0,1.0,280.0,148.0,25.0,17.0,4,886,51,15580,768,102638,118218,12/07/2020
2020-06-08,119,21819,1849,168747,190566,15.0,1864.0,13.0,1434.0,2.0,282.0,148.0,27.0,18.0,4,890,45,15625,922,103560,119185,12/07/2020
2020-06-09,223,22042,2673,171420,193462,10.0,1874.0,19.0,1453.0,0.0,282.0,139.0,28.0,21.0,1,891,64,15689,1210,104770,120459,12/07/2020
2020-06-10,209,22251,2987,174407,196658,13.0,1887.0,12.0,1465.0,2.0,284.0,138.0,24.0,17.0,4,895,100,15789,1418,106188,121977,12/07/2020
2020-06-11,195,22446,3513,177920,200366,7.0,1894.0,15.0,1480.0,1.0,285.0,129.0,25.0,16.0,6,901,88,15877,1469,107657,123534,12/07/2020
2020-06-12,209,22655,4601,182521,205176,9.0,1903.0,16.0,1496.0,1.0,286.0,121.0,24.0,16.0,2,903,78,15955,2032,109689,125644,12/07/2020
2020-06-13,113,22768,3036,185557,208325,6.0,1909.0,5.0,1501.0,0.0,286.0,122.0,20.0,15.0,3,906,49,16004,1289,110978,126982,12/07/2020
2020-06-14,81,22849,2046,187603,210452,7.0,1916.0,8.0,1509.0,1.0,287.0,120.0,20.0,14.0,3,909,33,16037,935,111913,127950,12/07/2020
2020-06-15,188,23037,3108,190711,213748,14.0,1930.0,19.0,1528.0,0.0,287.0,115.0,20.0,16.0,5,914,75,16112,1720,113633,129745,12/07/2020
2020-06-16,110,23147,3017,193728,216875,11.0,1941.0,9.0,1537.0,1.0,288.0,116.0,22.0,16.0,8,922,50,16162,1485,115118,131280,12/07/2020
2020-06-17,127,23274,2835,196563,219837,15.0,1956.0,20.0,1557.0,4.0,292.0,107.0,18.0,14.0,6,928,51,16213,1266,116384,132597,12/07/2020
2020-06-18,149,23423,3048,199611,223034,9.0,1965.0,15.0,1572.0,1.0,293.0,100.0,19.0,16.0,7,935,70,16283,1269,117653,133936,12/07/2020
2020-06-19,141,23564,3769,203380,226944,12.0,1977.0,12.0,1584.0,1.0,294.0,99.0,20.0,17.0,3,938,59,16342,1313,118966,135308,12/07/2020
2020-06-20,84,23648,1891,205271,228919,9.0,1986.0,12.0,1596.0,0.0,294.0,96.0,20.0,18.0,4,942,36,16378,788,119754,136132,12/07/2020
2020-06-21,37,23685,1064,206335,230020,8.0,1994.0,5.0,1601.0,0.0,294.0,99.0,20.0,18.0,2,944,30,16408,660,120414,136822,12/07/2020
2020-06-22,138,23823,3730,210065,233888,12.0,2006.0,17.0,1618.0,0.0,294.0,94.0,19.0,18.0,2,946,65,16473,1648,122062,138535,12/07/2020
2020-06-23,163,23986,3831,213896,237882,3.0,2009.0,13.0,1631.0,3.0,297.0,81.0,18.0,18.0,7,953,81,16554,1723,123785,140339,12/07/2020
2020-06-24,120,24106,3502,217398,241504,9.0,2018.0,10.0,1641.0,1.0,298.0,79.0,18.0,18.0,5,958,44,16598,1626,125411,142009,12/07/2020
2020-06-25,103,24209,2883,220281,244490,6.0,2024.0,14.0,1655.0,1.0,299.0,70.0,17.0,17.0,1,959,50,16648,1449,126860,143508,12/07/2020
2020-06-26,94,24303,2488,222769,247072,2.0,2026.0,10.0,1665.0,0.0,299.0,62.0,18.0,18.0,1,960,60,16708,1281,128141,144849,12/07/2020
2020-06-27,84,24387,3216,225985,250372,5.0,2031.0,3.0,1668.0,1.0,300.0,63.0,17.0,17.0,5,965,37,16745,1174,129315,146060,12/07/2020
2020-06-28,39,24426,1469,227454,251880,4.0,2035.0,4.0,1672.0,4.0,304.0,59.0,15.0,14.0,6,971,17,16762,580,129895,146657,12/07/2020
2020-06-29,85,24511,3697,231151,255662,4.0,2039.0,5.0,1677.0,0.0,304.0,58.0,14.0,14.0,1,972,39,16801,1312,131207,148008,12/07/2020
2020-06-30,57,24568,1958,233109,257677,1.0,2040.0,5.0,1682.0,1.0,305.0,53.0,12.0,11.0,4,976,32,16833,966,132173,149006,12/07/2020
2020-07-01,144,24712,4098,237207,261919,8.0,2048.0,10.0,1692.0,0.0,305.0,51.0,11.0,11.0,1,977,79,16912,1867,134040,150952,12/07/2020
2020-07-02,103,24815,2803,240010,264825,5.0,2053.0,5.0,1697.0,1.0,306.0,50.0,10.0,10.0,3,980,59,16971,1045,135085,152056,12/07/2020
2020-07-03,50,24865,2079,242089,266954,9.0,2062.0,6.0,1703.0,0.0,306.0,53.0,9.0,9.0,3,983,25,16996,761,135846,152842,12/07/2020
2020-07-04,57,24922,2345,244434,269356,2.0,2064.0,4.0,1707.0,1.0,307.0,50.0,10.0,9.0,2,985,33,17029,972,136818,153847,12/07/2020
2020-07-05,49,24971,2932,247366,272337,1.0,2065.0,2.0,1709.0,1.0,308.0,48.0,8.0,8.0,2,987,26,17055,1380,138198,155253,12/07/2020
2020-07-06,101,25072,2814,250180,275252,6.0,2071.0,6.0,1715.0,0.0,308.0,48.0,9.0,9.0,4,991,57,17112,1509,139707,156819,12/07/2020
2020-07-07,81,25153,3457,253637,278790,5.0,2076.0,7.0,1722.0,0.0,308.0,46.0,8.0,8.0,2,993,47,17159,1499,141206,158365,12/07/2020
2020-07-08,105,25258,3409,257046,282304,4.0,2080.0,2.0,1724.0,0.0,308.0,48.0,9.0,8.0,0,993,64,17223,1365,142571,159794,12/07/2020
2020-07-09,94,25352,3714,260760,286112,9.0,2089.0,3.0,1727.0,0.0,308.0,54.0,9.0,8.0,0,993,50,17273,1565,144136,161409,12/07/2020
2020-07-10,132,25484,4437,265197,290681,6.0,2095.0,3.0,1730.0,2.0,310.0,55.0,7.0,7.0,3,996,80,17353,2002,146138,163491,12/07/2020
2020-07-11,63,25547,2938,268135,293682,6.0,2101.0,3.0,1733.0,1.0,311.0,57.0,6.0,6.0,3,999,36,17389,1272,147410,164799,12/07/2020
2020-07-12,47,25594,1838,269973,295567,1.0,2102.0,3.0,1736.0,1.0,312.0,54.0,6.0,5.0,3,1002,34,17423,917,148327,165750,12/07/2020
2020-07-13,84,25678,3209,273182,298860,8.0,2110.0,10.0,1746.0,0.0,312.0,52.0,6.0,5.0,1,1003,61,17484,1461,149788,167272,12/07/2020
2020-07-14,74,25752,3298,276480,302232,7.0,2117.0,4.0,1750.0,0.0,312.0,55.0,5.0,5.0,1,1004,44,17528,1339,151127,168655,12/07/2020
2020-07-15,130,25882,4181,280661,306543,5.0,2122.0,7.0,1757.0,0.0,312.0,53.0,5.0,4.0,0,1004,100,17628,1695,152822,170450,12/07/2020
2020-07-16,103,25985,3740,284401,310386,6.0,2128.0,9.0,1766.0,0.0,312.0,50.0,6.0,5.0,1,1005,76,17704,1561,154383,172087,12/07/2020
2020-07-17,156,26141,4239,288640,314781,14.0,2142.0,3.0,1769.0,1.0,313.0,60.0,5.0,5.0,2,1007,79,17783,1793,156176,173959,12/07/2020
2020-07-18,85,26226,3272,291912,318138,5.0,2147.0,9.0,1778.0,1.0,314.0,55.0,5.0,4.0,4,1011,70,17853,1356,157532,175385,12/07/2020
2020-07-19,82,26308,2696,294608,320916,7.0,2154.0,3.0,1781.0,0.0,314.0,59.0,6.0,4.0,2,1013,57,17910,1107,158639,176549,12/07/2020
2020-07-20,71,26379,2666,297274,323653,9.0,2163.0,7.0,1788.0,0.0,314.0,61.0,7.0,5.0,2,1015,68,17978,1414,160053,178031,12/07/2020
2020-07-21,130,26509,4304,301578,328087,9.0,2172.0,11.0,1799.0,0.0,314.0,59.0,9.0,6.0,1,1016,108,18086,1868,161921,180007,12/07/2020
2020-07-22,130,26639,3928,305506,332145,7.0,2179.0,8.0,1807.0,1.0,315.0,57.0,7.0,6.0,1,1017,86,18172,1617,163538,181710,12/07/2020
2020-07-23,141,26780,4415,309921,336701,8.0,2187.0,6.0,1813.0,0.0,315.0,59.0,8.0,7.0,0,1017,115,18287,1912,165450,183737,12/07/2020
2020-07-24,172,26952,5966,315887,342839,15.0,2202.0,12.0,1825.0,0.0,315.0,62.0,9.0,7.0,0,1017,119,18406,2244,167694,186100,12/07/2020
2020-07-25,134,27086,4398,320285,347371,7.0,2209.0,7.0,1832.0,0.0,315.0,62.0,10.0,8.0,3,1020,108,18514,2034,169728,188242,12/07/2020
2020-07-26,62,27148,3033,323318,350466,8.0,2217.0,9.0,1841.0,0.0,315.0,61.0,11.0,7.0,1,1021,54,18568,1302,171030,189598,12/07/2020
2020-07-27,188,27336,4191,327509,354845,12.0,2229.0,7.0,1848.0,0.0,315.0,66.0,13.0,8.0,1,1022,138,18706,2271,173301,192007,12/07/2020
2020-07-28,105,27441,3840,331349,358790,5.0,2234.0,5.0,1853.0,0.0,315.0,66.0,14.0,7.0,1,1023,95,18801,1591,174892,193693,12/07/2020
2020-07-29,190,27631,5139,336488,364119,9.0,2243.0,10.0,1863.0,0.0,315.0,65.0,15.0,7.0,0,1023,154,18955,2228,177120,196075,12/07/2020
2020-07-30,121,27752,4345,340833,368585,6.0,2249.0,2.0,1865.0,1.0,316.0,68.0,15.0,6.0,1,1024,97,19052,1579,178699,197751,12/07/2020
2020-07-31,131,27883,5512,346345,374228,7.0,2256.0,9.0,1874.0,0.0,316.0,66.0,15.0,7.0,1,1025,89,19141,1785,180484,199625,12/07/2020
2020-08-01,109,27992,4294,350639,378631,7.0,2263.0,2.0,1876.0,0.0,316.0,71.0,14.0,7.0,1,1026,89,19230,1514,181998,201228,12/07/2020
2020-08-02,84,28076,2804,353443,381519,12.0,2275.0,12.0,1888.0,2.0,318.0,69.0,14.0,8.0,2,1028,62,19292,1237,183235,202527,12/07/2020
2020-08-03,188,28264,5248,358691,386955,11.0,2286.0,10.0,1898.0,0.0,318.0,70.0,16.0,7.0,1,1029,150,19442,2131,185366,204808,12/07/2020
2020-08-04,125,28389,3691,362382,390771,8.0,2294.0,5.0,1903.0,1.0,319.0,72.0,12.0,5.0,2,1031,99,19541,1718,187084,206625,12/07/2020
2020-08-05,147,28536,5935,368317,396853,11.0,2305.0,9.0,1912.0,1.0,320.0,73.0,10.0,5.0,2,1033,119,19660,2386,189470,209130,12/07/2020
2020-08-06,169,28705,5546,373863,402568,7.0,2312.0,9.0,1921.0,0.0,320.0,71.0,9.0,4.0,0,1033,120,19780,2318,191788,211568,12/07/2020
2020-08-07,123,28828,4851,378714,407542,12.0,2324.0,9.0,1930.0,1.0,321.0,73.0,9.0,3.0,2,1035,87,19867,2073,193861,213728,12/07/2020
2020-08-08,123,28951,4112,382826,411777,19.0,2343.0,6.0,1936.0,1.0,322.0,85.0,8.0,3.0,1,1036,91,19958,1729,195590,215548,12/07/2020
2020-08-09,42,28993,1727,384553,413546,6.0,2349.0,8.0,1944.0,0.0,322.0,83.0,9.0,4.0,0,1036,35,19993,1035,196625,216618,12/07/2020
2020-08-10,149,29142,4587,389140,418282,8.0,2357.0,9.0,1953.0,0.0,322.0,82.0,9.0,4.0,1,1037,113,20106,1965,198590,218696,12/07/2020
2020-08-11,106,29248,4334,393474,422722,5.0,2362.0,13.0,1966.0,0.0,322.0,74.0,10.0,4.0,3,1040,92,20198,2209,200799,220997,12/07/2020
2020-08-12,121,29369,5188,398662,428031,8.0,2370.0,11.0,1977.0,0.0,322.0,71.0,9.0,3.0,1,1041,101,20299,2533,203332,223631,12/07/2020
2020-08-13,135,29504,4196,402858,432362,13.0,2383.0,12.0,1989.0,0.0,322.0,72.0,11.0,3.0,0,1041,95,20394,1844,205176,225570,12/07/2020
2020-08-14,145,29649,5498,408356,438005,13.0,2396.0,11.0,2000.0,0.0,322.0,74.0,11.0,4.0,3,1044,98,20492,1920,207096,227588,12/07/2020
2020-08-15,106,29755,4534,412890,442645,9.0,2405.0,11.0,2011.0,1.0,323.0,71.0,11.0,5.0,0,1044,88,20580,1639,208735,229315,12/07/2020
2020-08-16,83,29838,2477,415367,445205,6.0,2411.0,5.0,2016.0,4.0,327.0,68.0,8.0,4.0,6,1050,70,20650,927,209662,230312,12/07/2020
2020-08-17,106,29944,4575,419942,449886,8.0,2419.0,6.0,2022.0,0.0,327.0,70.0,8.0,5.0,2,1052,87,20737,2326,211988,232725,12/07/2020
2020-08-18,128,30072,4911,424853,454925,11.0,2430.0,8.0,2030.0,1.0,328.0,72.0,8.0,4.0,5,1057,94,20831,2673,214661,235492,12/07/2020
2020-08-19,113,30185,5077,429930,460115,8.0,2438.0,9.0,2039.0,1.0,329.0,70.0,9.0,5.0,0,1057,90,20921,2568,217229,238150,12/07/2020
2020-08-20,173,30358,7411,437341,467699,12.0,2450.0,6.0,2045.0,2.0,331.0,74.0,10.0,5.0,3,1060,139,21060,3428,220657,241717,12/07/2020
2020-08-21,152,30510,6577,443918,474428,8.0,2458.0,5.0,2050.0,1.0,332.0,76.0,9.0,4.0,2,1062,125,21185,2850,223507,244692,12/07/2020
2020-08-22,96,30606,5550,449468,480074,11.0,2469.0,12.0,2062.0,0.0,332.0,75.0,11.0,4.0,1,1063,84,21269,2520,226027,247296,12/07/2020
2020-08-23,72,30678,4375,453843,484521,11.0,2480.0,6.0,2068.0,0.0,332.0,80.0,12.0,2.0,1,1064,56,21325,2423,228450,249775,12/07/2020
2020-08-24,105,30783,5784,459627,490410,7.0,2487.0,10.0,2078.0,1.0,333.0,76.0,14.0,4.0,1,1065,77,21402,3069,231519,252921,12/07/2020
2020-08-25,108,30891,4764,464391,495282,10.0,2497.0,4.0,2082.0,1.0,334.0,81.0,12.0,4.0,1,1066,92,21494,2236,233755,255249,12/07/2020
2020-08-26,170,31061,9482,473873,504934,4.0,2501.0,8.0,2090.0,0.0,334.0,77.0,10.0,5.0,1,1067,127,21621,3007,236762,258383,12/07/2020
2020-08-27,91,31152,8565,482438,513590,6.0,2507.0,13.0,2103.0,1.0,335.0,69.0,7.0,5.0,2,1069,70,21691,3064,239826,261517,12/07/2020
2020-08-28,113,31265,7994,490432,521697,14.0,2521.0,4.0,2107.0,0.0,335.0,79.0,10.0,7.0,2,1071,87,21778,2360,242186,263964,12/07/2020
2020-08-29,65,31330,5374,495806,527136,6.0,2527.0,8.0,2115.0,1.0,336.0,76.0,11.0,6.0,2,1073,51,21829,1871,244057,265886,12/07/2020
2020-08-30,66,31396,4323,500129,531525,7.0,2534.0,4.0,2119.0,0.0,336.0,79.0,9.0,5.0,2,1075,48,21877,1938,245995,267872,12/07/2020
2020-08-31,105,31501,4863,504992,536493,12.0,2546.0,16.0,2135.0,0.0,336.0,75.0,8.0,4.0,1,1076,81,21958,2138,248133,270091,12/07/2020
2020-09-01,99,31600,7109,512101,543701,6.0,2552.0,9.0,2144.0,1.0,337.0,71.0,7.0,4.0,2,1078,66,22024,2321,250454,272478,12/07/2020
2020-09-02,125,31725,10529,522630,554355,9.0,2561.0,10.0,2154.0,1.0,338.0,69.0,8.0,4.0,2,1080,104,22128,2984,253438,275566,12/07/2020
2020-09-03,90,31815,11080,533710,565525,8.0,2569.0,8.0,2162.0,0.0,338.0,69.0,9.0,4.0,3,1083,73,22201,2507,255945,278146,12/07/2020
2020-09-04,103,31918,8963,542673,574591,11.0,2580.0,4.0,2166.0,0.0,338.0,76.0,9.0,4.0,1,1084,83,22284,2308,258253,280537,12/07/2020
2020-09-05,52,31970,6309,548982,580952,6.0,2586.0,9.0,2175.0,0.0,338.0,73.0,8.0,3.0,1,1085,42,22326,1559,259812,282138,12/07/2020
2020-09-06,88,32058,4325,553307,585365,4.0,2590.0,8.0,2183.0,1.0,339.0,68.0,6.0,3.0,1,1086,65,22391,1895,261707,284098,12/07/2020
2020-09-07,35,32093,3002,556309,588402,11.0,2601.0,3.0,2186.0,0.0,339.0,76.0,5.0,3.0,1,1087,26,22417,625,262332,284749,12/07/2020
2020-09-08,74,32167,6381,562690,594857,6.0,2607.0,12.0,2198.0,1.0,340.0,69.0,6.0,3.0,2,1089,66,22483,1548,263880,286363,12/07/2020
2020-09-09,118,32285,8650,571340,603625,10.0,2617.0,5.0,2203.0,1.0,341.0,73.0,9.0,3.0,1,1090,102,22585,2077,265957,288542,12/07/2020
2020-09-10,164,32449,11334,582674,615123,9.0,2626.0,8.0,2211.0,0.0,341.0,74.0,10.0,3.0,1,1091,111,22696,2203,268160,290856,12/07/2020
2020-09-11,120,32569,9454,592128,624697,11.0,2637.0,11.0,2222.0,0.0,341.0,74.0,10.0,5.0,0,1091,97,22793,1909,270069,292862,12/07/2020
2020-09-12,110,32679,6174,598302,630981,8.0,2645.0,5.0,2227.0,2.0,343.0,75.0,9.0,5.0,3,1094,97,22890,1475,271544,294434,12/07/2020
2020-09-13,58,32737,2717,601019,633756,4.0,2649.0,3.0,2230.0,0.0,343.0,76.0,10.0,5.0,0,1094,54,22944,839,272383,295327,12/07/2020
2020-09-14,104,32841,6446,607465,640306,6.0,2655.0,3.0,2233.0,2.0,345.0,77.0,10.0,5.0,2,1096,95,23039,1676,274059,297098,12/07/2020
2020-09-15,122,32963,8470,615935,648898,7.0,2662.0,2.0,2235.0,1.0,346.0,81.0,10.0,5.0,2,1098,124,23163,2135,276194,299357,12/07/2020
2020-09-16,137,33100,9716,625651,658751,7.0,2669.0,7.0,2242.0,2.0,348.0,79.0,9.0,6.0,5,1103,118,23281,1915,278109,301390,12/07/2020
2020-09-17,125,33225,9239,634890,668115,7.0,2676.0,15.0,2257.0,0.0,348.0,71.0,8.0,4.0,0,1103,154,23435,1893,280002,303437,12/07/2020
2020-09-18,132,33357,10045,644935,678292,7.0,2683.0,7.0,2264.0,1.0,349.0,70.0,11.0,6.0,2,1105,132,23567,1877,281879,305446,12/07/2020
2020-09-19,115,33472,8297,653232,686704,7.0,2690.0,3.0,2267.0,0.0,349.0,74.0,10.0,6.0,4,1109,112,23679,1657,283536,307215,12/07/2020
2020-09-20,60,33532,3676,656908,690440,7.0,2697.0,6.0,2273.0,2.0,351.0,73.0,9.0,8.0,4,1113,49,23728,1294,284830,308558,12/07/2020
2020-09-21,102,33634,7018,663926,697560,12.0,2709.0,3.0,2276.0,2.0,353.0,80.0,8.0,6.0,2,1115,94,23822,2353,287183,311005,12/07/2020
2020-09-22,154,33788,9287,673213,707001,12.0,2721.0,3.0,2279.0,1.0,354.0,88.0,7.0,5.0,1,1116,124,23946,2138,289321,313267,12/07/2020
2020-09-23,136,33924,10651,683864,717788,12.0,2733.0,7.0,2286.0,0.0,354.0,93.0,6.0,5.0,0,1116,127,24073,2149,291470,315543,12/07/2020
2020-09-24,120,34044,12480,696344,730388,7.0,2740.0,9.0,2295.0,1.0,355.0,90.0,7.0,5.0,1,1117,120,24193,3094,294564,318757,12/07/2020
2020-09-25,150,34194,10553,706897,741091,9.0,2749.0,10.0,2305.0,0.0,355.0,89.0,6.0,5.0,1,1118,143,24336,2940,297504,321840,12/07/2020
2020-09-26,147,34341,10560,717457,751798,12.0,2761.0,9.0,2314.0,0.0,355.0,92.0,6.0,5.0,1,1119,120,24456,2373,299877,324333,12/07/2020
2020-09-27,43,34384,2764,720221,754605,7.0,2768.0,5.0,2319.0,0.0,355.0,94.0,9.0,5.0,0,1119,34,24490,825,300702,325192,12/07/2020
2020-09-28,156,34540,7307,727528,762068,7.0,2775.0,7.0,2326.0,2.0,357.0,92.0,7.0,5.0,2,1121,138,24628,2203,302905,327533,12/07/2020
2020-09-29,203,34743,11046,738574,773317,12.0,2787.0,18.0,2344.0,1.0,358.0,85.0,6.0,6.0,1,1122,185,24813,2759,305664,330477,12/07/2020
2020-09-30,223,34966,12230,750804,785770,6.0,2793.0,6.0,2350.0,0.0,358.0,85.0,6.0,6.0,1,1123,189,25002,2511,308175,333177,12/07/2020
2020-10-01,185,35151,12503,763307,798458,17.0,2810.0,13.0,2363.0,1.0,359.0,88.0,6.0,4.0,2,1125,166,25168,2346,310521,335689,12/07/2020
2020-10-02,209,35360,12154,775461,810821,14.0,2824.0,13.0,2376.0,1.0,360.0,88.0,8.0,5.0,2,1127,181,25349,2438,312959,338308,12/07/2020
2020-10-03,157,35517,9313,784774,820291,9.0,2833.0,9.0,2385.0,2.0,362.0,86.0,9.0,4.0,2,1129,131,25480,1974,314933,340413,12/07/2020
2020-10-04,81,35598,2369,787143,822741,11.0,2844.0,9.0,2394.0,1.0,363.0,87.0,8.0,5.0,2,1131,77,25557,934,315867,341424,12/07/2020
2020-10-05,174,35772,8982,796125,831897,30.0,2874.0,10.0,2404.0,2.0,365.0,105.0,9.0,6.0,4,1135,160,25717,2972,318839,344556,12/07/2020
2020-10-06,187,35959,11186,807311,843270,11.0,2885.0,4.0,2408.0,0.0,365.0,112.0,11.0,7.0,0,1135,188,25905,2834,321673,347578,12/07/2020
2020-10-07,242,36201,12442,819753,855954,13.0,2898.0,14.0,2422.0,2.0,367.0,109.0,9.0,7.0,2,1137,244,26149,3458,325131,351280,12/07/2020
2020-10-08,279,36480,15231,834984,871464,17.0,2915.0,13.0,2435.0,2.0,369.0,111.0,7.0,5.0,4,1141,277,26426,4139,329270,355696,12/07/2020
2020-10-09,229,36709,13745,848729,885438,21.0,2936.0,12.0,2447.0,0.0,369.0,120.0,10.0,7.0,3,1144,200,26626,4221,333491,360117,12/07/2020
2020-10-10,231,36940,13832,862561,899501,19.0,2955.0,10.0,2457.0,1.0,370.0,128.0,13.0,7.0,2,1146,192,26818,3714,337205,364023,12/07/2020
2020-10-11,97,37037,3263,865824,902861,12.0,2967.0,9.0,2466.0,1.0,371.0,130.0,14.0,5.0,6,1152,87,26905,1142,338347,365252,12/07/2020
2020-10-12,169,37206,6440,872264,909470,19.0,2986.0,15.0,2481.0,2.0,373.0,132.0,14.0,5.0,4,1156,157,27062,1687,340034,367096,12/07/2020
2020-10-13,213,37419,8522,880786,918205,15.0,3001.0,13.0,2494.0,4.0,377.0,130.0,13.0,5.0,7,1163,207,27269,2271,342305,369574,12/07/2020
2020-10-14,322,37741,15039,895825,933566,17.0,3018.0,7.0,2501.0,0.0,377.0,140.0,15.0,5.0,2,1165,299,27568,3950,346255,373823,12/07/2020
2020-10-15,262,38003,14639,910464,948467,12.0,3030.0,16.0,2517.0,1.0,378.0,135.0,13.0,5.0,2,1167,253,27821,3496,349751,377572,12/07/2020
2020-10-16,279,38282,15011,925475,963757,13.0,3043.0,18.0,2535.0,1.0,379.0,129.0,13.0,4.0,2,1169,275,28096,3312,353063,381159,12/07/2020
2020-10-17,354,38636,14069,939544,978180,19.0,3062.0,11.0,2546.0,1.0,380.0,136.0,17.0,4.0,2,1171,309,28405,3199,356262,384667,12/07/2020
2020-10-18,155,38791,4039,943583,982374,18.0,3080.0,11.0,2557.0,0.0,380.0,143.0,17.0,6.0,2,1173,126,28531,1283,357545,386076,12/07/2020
2020-10-19,388,39179,8491,952074,991253,21.0,3101.0,22.0,2579.0,2.0,382.0,140.0,15.0,6.0,1,1174,323,28854,2509,360054,388908,12/07/2020
2020-10-20,439,39618,13242,965316,1004934,23.0,3124.0,17.0,2596.0,0.0,382.0,146.0,14.0,8.0,3,1177,387,29241,2947,363001,392242,12/07/2020
2020-10-21,544,40162,17463,982779,1022941,23.0,3147.0,8.0,2604.0,2.0,384.0,159.0,15.0,9.0,3,1180,472,29713,3430,366431,396144,12/07/2020
2020-10-22,538,40700,15863,998642,1039342,24.0,3171.0,20.0,2624.0,3.0,387.0,160.0,14.0,9.0,3,1183,489,30202,3116,369547,399749,12/07/2020
2020-10-23,514,41214,16634,1015276,1056490,22.0,3193.0,22.0,2646.0,1.0,388.0,159.0,15.0,9.0,3,1186,458,30660,2827,372374,403034,12/07/2020
2020-10-24,359,41573,10249,1025525,1067098,17.0,3210.0,11.0,2657.0,0.0,388.0,165.0,14.0,8.0,1,1187,338,30998,2215,374589,405587,12/07/2020
2020-10-25,233,41806,4760,1030285,1072091,16.0,3226.0,15.0,2672.0,1.0,389.0,165.0,15.0,8.0,2,1189,209,31207,1417,376006,407213,12/07/2020
2020-10-26,454,42260,9174,1039459,1081719,27.0,3253.0,15.0,2687.0,2.0,391.0,175.0,18.0,8.0,3,1192,403,31610,2914,378920,410530,12/07/2020
2020-10-27,517,42777,13995,1053454,1096231,29.0,3282.0,15.0,2702.0,2.0,393.0,187.0,18.0,9.0,4,1196,453,32063,2346,381266,413329,12/07/2020
2020-10-28,469,43246,15229,1068683,1111929,25.0,3307.0,26.0,2728.0,1.0,394.0,185.0,17.0,9.0,3,1199,411,32474,2641,383907,416381,12/07/2020
2020-10-29,609,43855,16259,1084942,1128797,20.0,3327.0,22.0,2750.0,3.0,397.0,180.0,19.0,11.0,4,1203,526,33000,3070,386977,419977,12/07/2020
2020-10-30,565,44420,14863,1099805,1144225,21.0,3348.0,21.0,2771.0,5.0,402.0,175.0,19.0,9.0,4,1207,467,33467,2893,389870,423337,12/07/2020
2020-10-31,599,45019,11820,1111625,1156644,31.0,3379.0,13.0,2784.0,1.0,403.0,192.0,22.0,9.0,3,1210,483,33950,2363,392233,426183,12/07/2020
2020-11-01,330,45349,5091,1116716,1162065,22.0,3401.0,15.0,2799.0,1.0,404.0,198.0,26.0,12.0,4,1214,273,34223,1247,393480,427703,12/07/2020
2020-11-02,521,45870,9930,1126646,1172516,38.0,3439.0,27.0,2826.0,3.0,407.0,206.0,24.0,12.0,5,1219,455,34678,2877,396357,431035,12/07/2020
2020-11-03,602,46472,13040,1139686,1186158,33.0,3472.0,25.0,2851.0,1.0,408.0,213.0,24.0,12.0,1,1220,529,35207,2463,398820,434027,12/07/2020
2020-11-04,688,47160,16100,1155786,1202946,34.0,3506.0,27.0,2878.0,2.0,410.0,218.0,25.0,12.0,4,1224,632,35839,2879,401699,437538,12/07/2020
2020-11-05,768,47928,16593,1172379,1220307,46.0,3552.0,35.0,2913.0,1.0,411.0,228.0,24.0,14.0,3,1227,682,36521,2803,404502,441023,12/07/2020
2020-11-06,769,48697,16022,1188401,1237098,43.0,3595.0,31.0,2944.0,1.0,412.0,239.0,28.0,17.0,5,1232,691,37212,2993,407495,444707,12/07/2020
2020-11-07,604,49301,13650,1202051,1251352,34.0,3629.0,25.0,2969.0,1.0,413.0,247.0,31.0,18.0,1,1233,576,37788,2426,409921,447709,12/07/2020
2020-11-08,337,49638,4160,1206211,1255849,33.0,3662.0,26.0,2995.0,1.0,414.0,253.0,30.0,19.0,4,1237,321,38109,1256,411177,449286,12/07/2020
2020-11-09,807,50445,9040,1215251,1265696,39.0,3701.0,33.0,3028.0,2.0,416.0,257.0,28.0,18.0,3,1240,762,38871,2283,413460,452331,12/07/2020
2020-11-10,1053,51498,12982,1228233,1279731,45.0,3746.0,37.0,3065.0,0.0,416.0,265.0,31.0,18.0,6,1246,978,39849,2850,416310,456159,12/07/2020
2020-11-11,1087,52585,19741,1247974,1300559,42.0,3788.0,24.0,3089.0,5.0,421.0,278.0,30.0,15.0,7,1253,1002,40851,2645,418955,459806,12/07/2020
2020-11-12,893,53478,13902,1261876,1315354,39.0,3827.0,31.0,3120.0,3.0,424.0,283.0,28.0,15.0,5,1258,810,41661,2172,421127,462788,12/07/2020
2020-11-13,1165,54643,16390,1278266,1332909,38.0,3865.0,31.0,3151.0,0.0,424.0,290.0,27.0,15.0,2,1260,1115,42776,3070,424197,466973,12/07/2020
2020-11-14,782,55425,13517,1291783,1347208,42.0,3907.0,26.0,3177.0,5.0,429.0,301.0,25.0,13.0,10,1270,738,43514,2438,426635,470149,12/07/2020
2020-11-15,578,56003,6173,1297956,1353959,44.0,3951.0,21.0,3198.0,5.0,434.0,319.0,28.0,11.0,7,1277,492,44006,1405,428040,472046,12/07/2020
2020-11-16,738,56741,9614,1307570,1364311,55.0,4006.0,38.0,3236.0,3.0,437.0,333.0,26.0,13.0,5,1282,668,44674,2600,430640,475314,12/07/2020
2020-11-17,1538,58279,18173,1325743,1384022,59.0,4065.0,44.0,3280.0,2.0,439.0,346.0,30.0,13.0,5,1287,1399,46073,4101,434741,480814,12/07/2020
2020-11-18,1124,59403,16029,1341772,1401175,36.0,4101.0,38.0,3318.0,5.0,444.0,339.0,29.0,15.0,7,1294,1011,47084,3161,437902,484986,12/07/2020
2020-11-19,1128,60531,13170,1354942,1415473,45.0,4146.0,42.0,3360.0,4.0,448.0,338.0,29.0,18.0,5,1299,1032,48116,3383,441285,489401,12/07/2020
2020-11-20,1456,61987,22223,1377165,1439152,47.0,4193.0,48.0,3408.0,3.0,451.0,334.0,32.0,14.0,6,1305,1293,49409,4289,445574,494983,12/07/2020
2020-11-21,853,62840,17370,1394535,1457375,42.0,4235.0,34.0,3442.0,5.0,456.0,337.0,34.0,14.0,7,1312,753,50162,3130,448704,498866,12/07/2020
2020-11-22,571,63411,7519,1402054,1465465,63.0,4298.0,28.0,3470.0,4.0,460.0,368.0,32.0,15.0,11,1323,485,50647,1785,450489,501136,12/07/2020
2020-11-23,980,64391,11025,1413079,1477470,71.0,4369.0,40.0,3510.0,0.0,460.0,399.0,39.0,18.0,10,1333,883,51530,3396,453885,505415,12/07/2020
2020-11-24,1045,65436,14578,1427657,1493093,44.0,4413.0,58.0,3568.0,6.0,466.0,379.0,40.0,20.0,10,1343,936,52466,2769,456654,509120,12/07/2020
2020-11-25,1264,66700,18787,1446444,1513144,52.0,4465.0,58.0,3626.0,4.0,470.0,369.0,41.0,24.0,7,1350,1176,53642,3529,460183,513825,12/07/2020
2020-11-26,547,67247,6482,1452926,1520173,50.0,4515.0,33.0,3659.0,4.0,474.0,382.0,44.0,23.0,12,1362,466,54108,1569,461752,515860,12/07/2020
2020-11-27,1032,68279,9716,1462642,1530921,51.0,4566.0,49.0,3708.0,7.0,481.0,377.0,44.0,20.0,6,1368,960,55068,2521,464273,519341,12/07/2020
2020-11-28,1173,69452,11950,1474592,1544044,62.0,4628.0,40.0,3748.0,0.0,481.0,399.0,45.0,20.0,3,1371,1086,56154,2813,467086,523240,12/07/2020
2020-11-29,818,70270,6932,1481524,1551794,62.0,4690.0,33.0,3781.0,3.0,484.0,425.0,46.0,23.0,8,1379,750,56904,2317,469403,526307,12/07/2020
2020-11-30,1276,71546,9913,1491437,1562983,65.0,4755.0,59.0,3840.0,2.0,486.0,429.0,49.0,29.0,5,1384,1154,58058,2818,472221,530279,12/07/2020
2020-12-01,1540,73086,13943,1505380,1578466,56.0,4811.0,53.0,3893.0,4.0,490.0,428.0,47.0,31.0,12,1396,1405,59463,3396,475617,535080,12/07/2020
2020-12-02,1546,74632,15570,1520950,1595582,54.0,4865.0,50.0,3943.0,7.0,497.0,425.0,47.0,30.0,14,1410,1413,60876,3281,478898,539774,12/07/2020
2020-12-03,1741,76373,14625,1535575,1611948,62.0,4927.0,74.0,4017.0,5.0,502.0,408.0,45.0,31.0,9,1419,1618,62494,3350,482248,544742,12/07/2020
2020-12-04,1585,77958,16458,1552033,1629991,57.0,4984.0,48.0,4065.0,7.0,509.0,410.0,42.0,30.0,10,1429,1450,63944,3812,486060,550004,12/07/2020
2020-12-05,1193,79151,12581,1564614,1643765,55.0,5039.0,39.0,4104.0,4.0,513.0,422.0,45.0,30.0,8,1437,1030,64974,2913,488973,553947,12/07/2020
2020-12-06,977,80128,6879,1571493,1651621,,,,,,,,,,11,1448,844,65818,2169,491142,556960,12/07/2020
2020-02-27,0,0,0,0,0,1.0,1.0,0.0,0.0,0.0,0.0,1.0,0.0,0.0,0,0,0,0,0,0,0,12/08/2020
2020-02-28,0,0,0,0,0,0.0,1.0,0.0,0.0,0.0,0.0,1.0,1.0,0.0,0,0,0,0,0,0,0,12/08/2020
2020-02-29,0,0,0,0,0,0.0,1.0,0.0,0.0,0.0,0.0,1.0,1.0,0.0,0,0,0,0,0,0,0,12/08/2020
2020-03-01,2,2,2,2,4,0.0,1.0,0.0,0.0,0.0,0.0,1.0,1.0,1.0,0,0,2,2,2,2,4,12/08/2020
2020-03-02,0,2,1,3,5,1.0,2.0,0.0,0.0,0.0,0.0,2.0,2.0,2.0,0,0,0,2,0,2,4,12/08/2020
2020-03-03,0,2,2,5,7,0.0,2.0,0.0,0.0,0.0,0.0,2.0,2.0,2.0,0,0,0,2,1,3,5,12/08/2020
2020-03-04,0,2,12,17,19,1.0,3.0,0.0,0.0,0.0,0.0,3.0,2.0,2.0,0,0,0,2,10,13,15,12/08/2020
2020-03-05,0,2,4,21,23,0.0,3.0,0.0,0.0,0.0,0.0,3.0,2.0,2.0,0,0,1,3,4,17,20,12/08/2020
2020-03-06,1,3,12,33,36,0.0,3.0,0.0,0.0,0.0,0.0,3.0,2.0,2.0,0,0,0,3,11,28,31,12/08/2020
2020-03-07,0,3,19,52,55,0.0,3.0,0.0,0.0,0.0,0.0,3.0,2.0,1.0,0,0,0,3,19,47,50,12/08/2020
2020-03-08,0,3,18,70,73,0.0,3.0,0.0,0.0,0.0,0.0,3.0,2.0,1.0,0,0,0,3,18,65,68,12/08/2020
2020-03-09,1,4,15,85,89,0.0,3.0,0.0,0.0,0.0,0.0,3.0,2.0,1.0,0,0,1,4,14,79,83,12/08/2020
2020-03-10,2,6,25,110,116,0.0,3.0,0.0,0.0,0.0,0.0,3.0,2.0,1.0,0,0,1,5,23,102,107,12/08/2020
2020-03-11,0,6,34,144,150,1.0,4.0,0.0,0.0,0.0,0.0,4.0,1.0,1.0,0,0,0,5,34,136,141,12/08/2020
2020-03-12,9,15,41,185,200,1.0,5.0,0.0,0.0,0.0,0.0,5.0,1.0,1.0,0,0,7,12,38,174,186,12/08/2020
2020-03-13,6,21,50,235,256,4.0,9.0,1.0,1.0,0.0,0.0,8.0,1.0,1.0,0,0,6,18,47,221,239,12/08/2020
2020-03-14,0,21,90,325,346,0.0,9.0,0.0,1.0,0.0,0.0,8.0,1.0,1.0,0,0,0,18,83,304,322,12/08/2020
2020-03-15,1,22,54,379,401,1.0,10.0,0.0,1.0,0.0,0.0,9.0,2.0,1.0,0,0,1,19,53,357,376,12/08/2020
2020-03-16,2,24,95,474,498,2.0,12.0,0.0,1.0,0.0,0.0,11.0,2.0,0.0,0,0,2,21,90,447,468,12/08/2020
2020-03-17,12,36,162,636,672,6.0,18.0,0.0,1.0,0.0,0.0,17.0,2.0,0.0,0,0,11,32,145,592,624,12/08/2020
2020-03-18,9,45,116,752,797,3.0,21.0,0.0,1.0,0.0,0.0,20.0,2.0,0.0,0,0,11,43,105,697,740,12/08/2020
2020-03-19,15,60,262,1014,1074,2.0,23.0,1.0,2.0,0.0,0.0,21.0,3.0,0.0,1,1,17,60,245,942,1002,12/08/2020
2020-03-20,13,73,197,1211,1284,5.0,28.0,0.0,2.0,0.0,0.0,26.0,4.0,0.0,0,1,13,73,183,1125,1198,12/08/2020
2020-03-21,12,85,126,1337,1422,3.0,31.0,2.0,4.0,0.0,0.0,27.0,5.0,0.0,0,1,14,87,119,1244,1331,12/08/2020
2020-03-22,27,112,282,1619,1731,2.0,33.0,0.0,4.0,0.0,0.0,29.0,5.0,0.0,0,1,25,112,253,1497,1609,12/08/2020
2020-03-23,14,126,169,1788,1914,15.0,48.0,1.0,5.0,0.0,0.0,43.0,9.0,3.0,0,1,16,128,158,1655,1783,12/08/2020
2020-03-24,20,146,242,2030,2176,8.0,56.0,0.0,5.0,0.0,0.0,51.0,10.0,5.0,0,1,19,147,223,1878,2025,12/08/2020
2020-03-25,26,172,182,2212,2384,5.0,61.0,2.0,7.0,0.0,0.0,54.0,11.0,3.0,0,1,28,175,159,2037,2212,12/08/2020
2020-03-26,35,207,181,2393,2600,9.0,70.0,5.0,12.0,0.0,0.0,58.0,14.0,5.0,0,1,41,216,167,2204,2420,12/08/2020
2020-03-27,27,234,214,2607,2841,9.0,79.0,1.0,13.0,1.0,1.0,65.0,16.0,6.0,2,3,31,247,188,2392,2639,12/08/2020
2020-03-28,59,293,260,2867,3160,11.0,90.0,2.0,15.0,1.0,2.0,73.0,15.0,6.0,1,4,64,311,236,2628,2939,12/08/2020
2020-03-29,100,393,350,3217,3610,8.0,98.0,3.0,18.0,1.0,3.0,77.0,18.0,8.0,2,6,105,416,299,2927,3343,12/08/2020
2020-03-30,62,455,222,3439,3894,19.0,117.0,5.0,23.0,0.0,3.0,91.0,19.0,11.0,3,9,78,494,174,3101,3595,12/08/2020
2020-03-31,71,526,369,3808,4334,11.0,128.0,7.0,30.0,1.0,4.0,94.0,21.0,13.0,2,11,73,567,286,3387,3954,12/08/2020
2020-04-01,99,625,698,4506,5131,18.0,146.0,7.0,37.0,0.0,4.0,105.0,29.0,15.0,1,12,100,667,597,3984,4651,12/08/2020
2020-04-02,52,677,477,4983,5660,22.0,168.0,6.0,43.0,2.0,6.0,119.0,35.0,21.0,4,16,62,729,416,4400,5129,12/08/2020
2020-04-03,108,785,774,5757,6542,23.0,191.0,7.0,50.0,0.0,6.0,135.0,42.0,25.0,3,19,100,829,671,5071,5900,12/08/2020
2020-04-04,143,928,660,6417,7345,22.0,213.0,4.0,54.0,5.0,11.0,148.0,40.0,29.0,9,28,138,967,580,5651,6618,12/08/2020
2020-04-05,187,1115,1156,7573,8688,20.0,233.0,9.0,63.0,1.0,12.0,158.0,43.0,35.0,2,30,181,1148,994,6645,7793,12/08/2020
2020-04-06,218,1333,1706,9279,10612,26.0,259.0,7.0,70.0,0.0,12.0,177.0,47.0,39.0,7,37,207,1355,1475,8120,9475,12/08/2020
2020-04-07,284,1617,1629,10908,12525,20.0,279.0,4.0,74.0,2.0,14.0,191.0,49.0,41.0,5,42,260,1615,1404,9524,11139,12/08/2020
2020-04-08,290,1907,1720,12628,14535,19.0,298.0,8.0,82.0,5.0,19.0,197.0,49.0,37.0,10,52,271,1886,1473,10997,12883,12/08/2020
2020-04-09,283,2190,1516,14144,16334,32.0,330.0,8.0,90.0,4.0,23.0,217.0,53.0,40.0,7,59,277,2163,1287,12284,14447,12/08/2020
2020-04-10,419,2609,2574,16718,19327,29.0,359.0,17.0,107.0,5.0,28.0,224.0,59.0,41.0,11,70,400,2563,2247,14531,17094,12/08/2020
2020-04-11,297,2906,1905,18623,21529,29.0,388.0,11.0,118.0,2.0,30.0,240.0,61.0,48.0,12,82,280,2843,1639,16170,19013,12/08/2020
2020-04-12,314,3220,1670,20293,23513,35.0,423.0,13.0,131.0,5.0,35.0,257.0,59.0,49.0,9,91,286,3129,1320,17490,20619,12/08/2020
2020-04-13,161,3381,935,21228,24609,35.0,458.0,13.0,144.0,3.0,38.0,276.0,64.0,54.0,9,100,187,3316,799,18289,21605,12/08/2020
2020-04-14,289,3670,1787,23015,26685,27.0,485.0,18.0,162.0,5.0,43.0,280.0,72.0,53.0,8,108,261,3577,1438,19727,23304,12/08/2020
2020-04-15,351,4021,1799,24814,28835,31.0,516.0,20.0,182.0,3.0,46.0,288.0,72.0,54.0,17,125,306,3883,1439,21166,25049,12/08/2020
2020-04-16,447,4468,2494,27308,31776,36.0,552.0,25.0,207.0,6.0,52.0,293.0,72.0,53.0,14,139,387,4270,1933,23099,27369,12/08/2020
2020-04-17,304,4772,1821,29129,33901,32.0,584.0,20.0,227.0,7.0,59.0,298.0,66.0,45.0,21,160,290,4560,1346,24445,29005,12/08/2020
2020-04-18,321,5093,1725,30854,35947,26.0,610.0,18.0,245.0,4.0,63.0,302.0,63.0,49.0,15,175,284,4844,1243,25688,30532,12/08/2020
2020-04-19,381,5474,2047,32901,38375,23.0,633.0,26.0,271.0,1.0,64.0,298.0,65.0,55.0,11,186,337,5181,1656,27344,32525,12/08/2020
2020-04-20,394,5868,1907,34808,40676,46.0,679.0,29.0,300.0,2.0,66.0,313.0,75.0,56.0,10,196,376,5557,1492,28836,34393,12/08/2020
2020-04-21,444,6312,2110,36918,43230,45.0,724.0,32.0,332.0,5.0,71.0,321.0,72.0,56.0,18,214,383,5940,1626,30462,36402,12/08/2020
2020-04-22,418,6730,2390,39308,46038,41.0,765.0,32.0,364.0,5.0,76.0,325.0,73.0,58.0,18,232,379,6319,1804,32266,38585,12/08/2020
2020-04-23,479,7209,2469,41777,48986,32.0,797.0,28.0,392.0,5.0,81.0,324.0,76.0,62.0,15,247,412,6731,1740,34006,40737,12/08/2020
2020-04-24,491,7700,3284,45061,52761,35.0,832.0,26.0,418.0,4.0,85.0,329.0,85.0,63.0,15,262,407,7138,2449,36455,43593,12/08/2020
2020-04-25,393,8093,2206,47267,55360,34.0,866.0,17.0,435.0,5.0,90.0,341.0,85.0,62.0,14,276,299,7437,1623,38078,45515,12/08/2020
2020-04-26,316,8409,2309,49576,57985,33.0,899.0,15.0,450.0,3.0,93.0,356.0,86.0,59.0,14,290,274,7711,1751,39829,47540,12/08/2020
2020-04-27,249,8658,1620,51196,59854,29.0,928.0,21.0,471.0,4.0,97.0,360.0,86.0,61.0,10,300,206,7917,1084,40913,48830,12/08/2020
2020-04-28,410,9068,2263,53459,62527,44.0,972.0,24.0,495.0,3.0,100.0,377.0,88.0,59.0,22,322,331,8248,1580,42493,50741,12/08/2020
2020-04-29,476,9544,3343,56802,66346,36.0,1008.0,38.0,533.0,11.0,111.0,364.0,78.0,53.0,18,340,370,8618,2226,44719,53337,12/08/2020
2020-04-30,432,9976,2769,59571,69547,33.0,1041.0,38.0,571.0,6.0,117.0,353.0,83.0,57.0,24,364,351,8969,1742,46461,55430,12/08/2020
2020-05-01,454,10430,3086,62657,73087,52.0,1093.0,38.0,609.0,3.0,120.0,364.0,84.0,58.0,14,378,323,9292,1966,48427,57719,12/08/2020
2020-05-02,257,10687,1926,64583,75270,36.0,1129.0,39.0,648.0,5.0,125.0,356.0,93.0,63.0,24,402,193,9485,1200,49627,59112,12/08/2020
2020-05-03,283,10970,2160,66743,77713,31.0,1160.0,26.0,674.0,8.0,133.0,353.0,91.0,61.0,21,423,183,9668,1456,51083,60751,12/08/2020
2020-05-04,387,11357,2098,68841,80198,30.0,1190.0,31.0,705.0,6.0,139.0,346.0,89.0,58.0,18,441,290,9958,1482,52565,62523,12/08/2020
2020-05-05,433,11790,2873,71714,83504,29.0,1219.0,32.0,737.0,6.0,145.0,337.0,83.0,55.0,16,457,299,10257,1849,54414,64671,12/08/2020
2020-05-06,488,12278,2830,74544,86822,28.0,1247.0,44.0,781.0,9.0,154.0,312.0,80.0,55.0,21,478,340,10597,1816,56230,66827,12/08/2020
2020-05-07,425,12703,2969,77513,90216,36.0,1283.0,44.0,825.0,5.0,159.0,299.0,72.0,53.0,21,499,270,10867,1845,58075,68942,12/08/2020
2020-05-08,359,13062,2598,80111,93173,30.0,1313.0,29.0,854.0,5.0,164.0,295.0,72.0,54.0,22,521,230,11097,1593,59668,70765,12/08/2020
2020-05-09,467,13529,3346,83457,96986,22.0,1335.0,21.0,875.0,4.0,168.0,292.0,70.0,52.0,15,536,289,11386,2114,61782,73168,12/08/2020
2020-05-10,285,13814,2117,85574,99388,20.0,1355.0,23.0,898.0,6.0,174.0,283.0,71.0,50.0,14,550,190,11576,1416,63198,74774,12/08/2020
2020-05-11,257,14071,1857,87431,101502,31.0,1386.0,16.0,914.0,6.0,180.0,292.0,72.0,50.0,15,565,173,11749,1230,64428,76177,12/08/2020
2020-05-12,387,14458,2611,90042,104500,23.0,1409.0,18.0,932.0,4.0,184.0,293.0,70.0,49.0,22,587,224,11973,1555,65983,77956,12/08/2020
2020-05-13,351,14809,3630,93672,108481,23.0,1432.0,25.0,957.0,1.0,185.0,290.0,70.0,50.0,13,600,199,12172,1848,67831,80003,12/08/2020
2020-05-14,329,15138,3408,97080,112218,19.0,1451.0,27.0,984.0,3.0,188.0,279.0,65.0,46.0,15,615,232,12404,1876,69707,82111,12/08/2020
2020-05-15,381,15519,3458,100538,116057,24.0,1475.0,41.0,1025.0,5.0,193.0,257.0,63.0,46.0,14,629,232,12636,1720,71427,84063,12/08/2020
2020-05-16,449,15968,4156,104694,120662,25.0,1500.0,15.0,1040.0,5.0,198.0,262.0,62.0,47.0,15,644,247,12883,1839,73266,86149,12/08/2020
2020-05-17,240,16208,2768,107462,123670,17.0,1517.0,9.0,1049.0,5.0,203.0,265.0,60.0,46.0,10,654,126,13009,1455,74721,87730,12/08/2020
2020-05-18,250,16458,2001,109463,125921,19.0,1536.0,16.0,1065.0,5.0,208.0,263.0,58.0,41.0,18,672,135,13144,1307,76028,89172,12/08/2020
2020-05-19,415,16873,3168,112631,129504,23.0,1559.0,33.0,1098.0,5.0,213.0,248.0,57.0,39.0,11,683,215,13359,1838,77866,91225,12/08/2020
2020-05-20,326,17199,2771,115402,132601,19.0,1578.0,23.0,1121.0,7.0,220.0,237.0,53.0,34.0,22,705,184,13543,1456,79322,92865,12/08/2020
2020-05-21,374,17573,3757,119159,136732,25.0,1603.0,15.0,1136.0,3.0,223.0,244.0,54.0,30.0,20,725,168,13711,1857,81179,94890,12/08/2020
2020-05-22,351,17924,3161,122320,140244,20.0,1623.0,28.0,1164.0,5.0,228.0,231.0,53.0,30.0,11,736,206,13917,1520,82699,96616,12/08/2020
2020-05-23,253,18177,2742,125062,143239,19.0,1642.0,11.0,1175.0,3.0,231.0,236.0,53.0,33.0,13,749,109,14026,1214,83913,97939,12/08/2020
2020-05-24,163,18340,1370,126432,144772,13.0,1655.0,14.0,1189.0,2.0,233.0,233.0,54.0,36.0,8,757,83,14109,742,84655,98764,12/08/2020
2020-05-25,147,18487,1385,127817,146304,14.0,1669.0,14.0,1203.0,0.0,233.0,233.0,54.0,34.0,10,767,76,14185,701,85356,99541,12/08/2020
2020-05-26,285,18772,2620,130437,149209,24.0,1693.0,21.0,1224.0,5.0,238.0,231.0,49.0,33.0,15,782,158,14343,1578,86934,101277,12/08/2020
2020-05-27,276,19048,2057,132494,151542,20.0,1713.0,18.0,1242.0,3.0,241.0,230.0,51.0,33.0,10,792,132,14475,1089,88023,102498,12/08/2020
2020-05-28,348,19396,3359,135853,155249,17.0,1730.0,29.0,1271.0,4.0,245.0,214.0,47.0,32.0,8,800,130,14605,1061,89084,103689,12/08/2020
2020-05-29,410,19806,3915,139768,159574,19.0,1749.0,26.0,1297.0,7.0,252.0,200.0,43.0,31.0,12,812,174,14779,1482,90566,105345,12/08/2020
2020-05-30,225,20031,3915,143683,163714,16.0,1765.0,19.0,1316.0,4.0,256.0,193.0,41.0,29.0,12,824,109,14888,1649,92215,107103,12/08/2020
2020-05-31,155,20186,1690,145373,165559,11.0,1776.0,11.0,1327.0,1.0,257.0,192.0,44.0,26.0,3,827,78,14966,790,93005,107971,12/08/2020
2020-06-01,212,20398,2792,148165,168563,8.0,1784.0,14.0,1341.0,1.0,258.0,185.0,45.0,29.0,5,832,93,15059,1324,94329,109388,12/08/2020
2020-06-02,273,20671,3022,151187,171858,8.0,1792.0,9.0,1350.0,3.0,261.0,181.0,38.0,25.0,10,842,98,15157,1369,95698,110855,12/08/2020
2020-06-03,254,20925,3486,154673,175598,14.0,1806.0,18.0,1368.0,6.0,267.0,171.0,34.0,25.0,11,853,99,15256,1579,97277,112533,12/08/2020
2020-06-04,276,21201,4471,159144,180345,7.0,1813.0,26.0,1394.0,4.0,271.0,148.0,31.0,24.0,12,865,107,15363,1921,99198,114561,12/08/2020
2020-06-05,215,21416,3513,162657,184073,15.0,1828.0,13.0,1407.0,6.0,277.0,144.0,27.0,21.0,11,876,99,15462,1468,100666,116128,12/08/2020
2020-06-06,201,21617,2616,165273,186890,10.0,1838.0,7.0,1414.0,2.0,279.0,145.0,29.0,19.0,6,882,67,15529,1069,101735,117264,12/08/2020
2020-06-07,83,21700,1625,166898,188598,11.0,1849.0,7.0,1421.0,1.0,280.0,148.0,25.0,17.0,4,886,51,15580,768,102503,118083,12/08/2020
2020-06-08,119,21819,1849,168747,190566,15.0,1864.0,13.0,1434.0,2.0,282.0,148.0,27.0,18.0,4,890,45,15625,921,103424,119049,12/08/2020
2020-06-09,223,22042,2673,171420,193462,10.0,1874.0,19.0,1453.0,0.0,282.0,139.0,28.0,21.0,1,891,64,15689,1206,104630,120319,12/08/2020
2020-06-10,209,22251,2987,174407,196658,13.0,1887.0,12.0,1465.0,2.0,284.0,138.0,24.0,17.0,4,895,100,15789,1418,106048,121837,12/08/2020
2020-06-11,195,22446,3513,177920,200366,7.0,1894.0,15.0,1480.0,1.0,285.0,129.0,25.0,16.0,6,901,88,15877,1466,107514,123391,12/08/2020
2020-06-12,209,22655,4601,182521,205176,9.0,1903.0,16.0,1496.0,1.0,286.0,121.0,24.0,16.0,2,903,78,15955,2028,109542,125497,12/08/2020
2020-06-13,113,22768,3036,185557,208325,6.0,1909.0,5.0,1501.0,0.0,286.0,122.0,20.0,15.0,3,906,49,16004,1289,110831,126835,12/08/2020
2020-06-14,81,22849,2046,187603,210452,7.0,1916.0,8.0,1509.0,1.0,287.0,120.0,20.0,14.0,3,909,33,16037,935,111766,127803,12/08/2020
2020-06-15,188,23037,3108,190711,213748,14.0,1930.0,19.0,1528.0,0.0,287.0,115.0,20.0,16.0,5,914,75,16112,1718,113484,129596,12/08/2020
2020-06-16,110,23147,3017,193728,216875,11.0,1941.0,9.0,1537.0,1.0,288.0,116.0,22.0,16.0,8,922,50,16162,1483,114967,131129,12/08/2020
2020-06-17,127,23274,2835,196563,219837,15.0,1956.0,20.0,1557.0,4.0,292.0,107.0,18.0,14.0,6,928,51,16213,1263,116230,132443,12/08/2020
2020-06-18,149,23423,3048,199611,223034,9.0,1965.0,15.0,1572.0,1.0,293.0,100.0,19.0,16.0,7,935,70,16283,1268,117498,133781,12/08/2020
2020-06-19,141,23564,3769,203380,226944,12.0,1977.0,12.0,1584.0,1.0,294.0,99.0,20.0,17.0,3,938,59,16342,1312,118810,135152,12/08/2020
2020-06-20,84,23648,1891,205271,228919,9.0,1986.0,12.0,1596.0,0.0,294.0,96.0,20.0,18.0,4,942,36,16378,786,119596,135974,12/08/2020
2020-06-21,37,23685,1064,206335,230020,8.0,1994.0,5.0,1601.0,0.0,294.0,99.0,20.0,18.0,2,944,30,16408,659,120255,136663,12/08/2020
2020-06-22,138,23823,3730,210065,233888,12.0,2006.0,17.0,1618.0,0.0,294.0,94.0,19.0,18.0,2,946,65,16473,1645,121900,138373,12/08/2020
2020-06-23,163,23986,3831,213896,237882,3.0,2009.0,13.0,1631.0,3.0,297.0,81.0,18.0,18.0,7,953,81,16554,1721,123621,140175,12/08/2020
2020-06-24,120,24106,3502,217398,241504,9.0,2018.0,10.0,1641.0,1.0,298.0,79.0,18.0,18.0,5,958,44,16598,1621,125242,141840,12/08/2020
2020-06-25,103,24209,2883,220281,244490,6.0,2024.0,14.0,1655.0,1.0,299.0,70.0,17.0,17.0,1,959,50,16648,1448,126690,143338,12/08/2020
2020-06-26,94,24303,2488,222769,247072,2.0,2026.0,10.0,1665.0,0.0,299.0,62.0,18.0,18.0,1,960,60,16708,1280,127970,144678,12/08/2020
2020-06-27,84,24387,3216,225985,250372,5.0,2031.0,3.0,1668.0,1.0,300.0,63.0,17.0,17.0,5,965,37,16745,1171,129141,145886,12/08/2020
2020-06-28,39,24426,1469,227454,251880,4.0,2035.0,4.0,1672.0,4.0,304.0,59.0,15.0,14.0,6,971,17,16762,579,129720,146482,12/08/2020
2020-06-29,85,24511,3697,231151,255662,4.0,2039.0,5.0,1677.0,0.0,304.0,58.0,14.0,14.0,1,972,39,16801,1310,131030,147831,12/08/2020
2020-06-30,57,24568,1958,233109,257677,1.0,2040.0,5.0,1682.0,1.0,305.0,53.0,12.0,11.0,4,976,32,16833,965,131995,148828,12/08/2020
2020-07-01,144,24712,4098,237207,261919,8.0,2048.0,10.0,1692.0,0.0,305.0,51.0,11.0,11.0,1,977,79,16912,1866,133861,150773,12/08/2020
2020-07-02,103,24815,2803,240010,264825,5.0,2053.0,5.0,1697.0,1.0,306.0,50.0,10.0,10.0,3,980,59,16971,1044,134905,151876,12/08/2020
2020-07-03,50,24865,2079,242089,266954,9.0,2062.0,6.0,1703.0,0.0,306.0,53.0,9.0,9.0,3,983,25,16996,759,135664,152660,12/08/2020
2020-07-04,57,24922,2345,244434,269356,2.0,2064.0,4.0,1707.0,1.0,307.0,50.0,10.0,9.0,2,985,33,17029,970,136634,153663,12/08/2020
2020-07-05,49,24971,2932,247366,272337,1.0,2065.0,2.0,1709.0,1.0,308.0,48.0,8.0,8.0,2,987,26,17055,1380,138014,155069,12/08/2020
2020-07-06,101,25072,2814,250180,275252,6.0,2071.0,6.0,1715.0,0.0,308.0,48.0,9.0,9.0,4,991,57,17112,1508,139522,156634,12/08/2020
2020-07-07,81,25153,3457,253637,278790,5.0,2076.0,7.0,1722.0,0.0,308.0,46.0,8.0,8.0,2,993,47,17159,1498,141020,158179,12/08/2020
2020-07-08,105,25258,3409,257046,282304,4.0,2080.0,2.0,1724.0,0.0,308.0,48.0,9.0,8.0,0,993,64,17223,1362,142382,159605,12/08/2020
2020-07-09,94,25352,3714,260760,286112,9.0,2089.0,3.0,1727.0,0.0,308.0,54.0,9.0,8.0,0,993,50,17273,1564,143946,161219,12/08/2020
2020-07-10,132,25484,4437,265197,290681,6.0,2095.0,3.0,1730.0,2.0,310.0,55.0,7.0,7.0,3,996,80,17353,2001,145947,163300,12/08/2020
2020-07-11,63,25547,2938,268135,293682,6.0,2101.0,3.0,1733.0,1.0,311.0,57.0,6.0,6.0,3,999,36,17389,1272,147219,164608,12/08/2020
2020-07-12,47,25594,1838,269973,295567,1.0,2102.0,3.0,1736.0,1.0,312.0,54.0,6.0,5.0,3,1002,34,17423,917,148136,165559,12/08/2020
2020-07-13,84,25678,3209,273182,298860,8.0,2110.0,10.0,1746.0,0.0,312.0,52.0,6.0,5.0,1,1003,61,17484,1458,149594,167078,12/08/2020
2020-07-14,74,25752,3298,276480,302232,7.0,2117.0,4.0,1750.0,0.0,312.0,55.0,5.0,5.0,1,1004,44,17528,1338,150932,168460,12/08/2020
2020-07-15,130,25882,4181,280661,306543,5.0,2122.0,7.0,1757.0,0.0,312.0,53.0,5.0,4.0,0,1004,100,17628,1694,152626,170254,12/08/2020
2020-07-16,103,25985,3740,284401,310386,6.0,2128.0,9.0,1766.0,0.0,312.0,50.0,6.0,5.0,1,1005,76,17704,1560,154186,171890,12/08/2020
2020-07-17,156,26141,4239,288640,314781,14.0,2142.0,3.0,1769.0,1.0,313.0,60.0,5.0,5.0,2,1007,79,17783,1792,155978,173761,12/08/2020
2020-07-18,85,26226,3272,291912,318138,5.0,2147.0,9.0,1778.0,1.0,314.0,55.0,5.0,4.0,4,1011,70,17853,1353,157331,175184,12/08/2020
2020-07-19,82,26308,2696,294608,320916,7.0,2154.0,3.0,1781.0,0.0,314.0,59.0,6.0,4.0,2,1013,57,17910,1106,158437,176347,12/08/2020
2020-07-20,71,26379,2666,297274,323653,9.0,2163.0,7.0,1788.0,0.0,314.0,61.0,7.0,5.0,2,1015,68,17978,1411,159848,177826,12/08/2020
2020-07-21,130,26509,4304,301578,328087,9.0,2172.0,11.0,1799.0,0.0,314.0,59.0,9.0,6.0,1,1016,108,18086,1865,161713,179799,12/08/2020
2020-07-22,130,26639,3928,305506,332145,7.0,2179.0,8.0,1807.0,1.0,315.0,57.0,7.0,6.0,1,1017,86,18172,1616,163329,181501,12/08/2020
2020-07-23,141,26780,4415,309921,336701,8.0,2187.0,6.0,1813.0,0.0,315.0,59.0,8.0,7.0,0,1017,115,18287,1909,165238,183525,12/08/2020
2020-07-24,172,26952,5966,315887,342839,15.0,2202.0,12.0,1825.0,0.0,315.0,62.0,9.0,7.0,0,1017,119,18406,2244,167482,185888,12/08/2020
2020-07-25,134,27086,4398,320285,347371,7.0,2209.0,7.0,1832.0,0.0,315.0,62.0,10.0,8.0,3,1020,108,18514,2033,169515,188029,12/08/2020
2020-07-26,62,27148,3033,323318,350466,8.0,2217.0,9.0,1841.0,0.0,315.0,61.0,11.0,7.0,1,1021,54,18568,1301,170816,189384,12/08/2020
2020-07-27,188,27336,4191,327509,354845,12.0,2229.0,7.0,1848.0,0.0,315.0,66.0,13.0,8.0,1,1022,138,18706,2268,173084,191790,12/08/2020
2020-07-28,105,27441,3840,331349,358790,5.0,2234.0,5.0,1853.0,0.0,315.0,66.0,14.0,7.0,1,1023,95,18801,1590,174674,193475,12/08/2020
2020-07-29,190,27631,5139,336488,364119,9.0,2243.0,10.0,1863.0,0.0,315.0,65.0,15.0,7.0,0,1023,154,18955,2226,176900,195855,12/08/2020
2020-07-30,121,27752,4345,340833,368585,6.0,2249.0,2.0,1865.0,1.0,316.0,68.0,15.0,6.0,1,1024,97,19052,1576,178476,197528,12/08/2020
2020-07-31,131,27883,5512,346345,374228,7.0,2256.0,9.0,1874.0,0.0,316.0,66.0,15.0,7.0,1,1025,89,19141,1782,180258,199399,12/08/2020
2020-08-01,109,27992,4294,350639,378631,7.0,2263.0,2.0,1876.0,0.0,316.0,71.0,14.0,7.0,1,1026,89,19230,1510,181768,200998,12/08/2020
2020-08-02,84,28076,2804,353443,381519,12.0,2275.0,12.0,1888.0,2.0,318.0,69.0,14.0,8.0,2,1028,62,19292,1237,183005,202297,12/08/2020
2020-08-03,188,28264,5248,358691,386955,11.0,2286.0,10.0,1898.0,0.0,318.0,70.0,16.0,7.0,1,1029,150,19442,2131,185136,204578,12/08/2020
2020-08-04,125,28389,3691,362382,390771,8.0,2294.0,5.0,1903.0,1.0,319.0,72.0,12.0,5.0,2,1031,99,19541,1718,186854,206395,12/08/2020
2020-08-05,147,28536,5935,368317,396853,11.0,2305.0,9.0,1912.0,1.0,320.0,73.0,10.0,5.0,2,1033,119,19660,2384,189238,208898,12/08/2020
2020-08-06,169,28705,5546,373863,402568,7.0,2312.0,9.0,1921.0,0.0,320.0,71.0,9.0,4.0,0,1033,120,19780,2317,191555,211335,12/08/2020
2020-08-07,123,28828,4851,378714,407542,12.0,2324.0,9.0,1930.0,1.0,321.0,73.0,9.0,3.0,2,1035,87,19867,2070,193625,213492,12/08/2020
2020-08-08,123,28951,4112,382826,411777,19.0,2343.0,6.0,1936.0,1.0,322.0,85.0,8.0,3.0,1,1036,91,19958,1727,195352,215310,12/08/2020
2020-08-09,42,28993,1727,384553,413546,6.0,2349.0,8.0,1944.0,0.0,322.0,83.0,9.0,4.0,0,1036,35,19993,1034,196386,216379,12/08/2020
2020-08-10,149,29142,4587,389140,418282,8.0,2357.0,9.0,1953.0,0.0,322.0,82.0,9.0,4.0,1,1037,113,20106,1963,198349,218455,12/08/2020
2020-08-11,106,29248,4334,393474,422722,5.0,2362.0,13.0,1966.0,0.0,322.0,74.0,10.0,4.0,3,1040,92,20198,2206,200555,220753,12/08/2020
2020-08-12,121,29369,5188,398662,428031,8.0,2370.0,11.0,1977.0,0.0,322.0,71.0,9.0,3.0,1,1041,101,20299,2530,203085,223384,12/08/2020
2020-08-13,135,29504,4196,402858,432362,13.0,2383.0,12.0,1989.0,0.0,322.0,72.0,11.0,3.0,0,1041,95,20394,1844,204929,225323,12/08/2020
2020-08-14,145,29649,5498,408356,438005,13.0,2396.0,11.0,2000.0,0.0,322.0,74.0,11.0,4.0,3,1044,98,20492,1916,206845,227337,12/08/2020
2020-08-15,106,29755,4534,412890,442645,9.0,2405.0,11.0,2011.0,1.0,323.0,71.0,11.0,5.0,0,1044,88,20580,1636,208481,229061,12/08/2020
2020-08-16,83,29838,2477,415367,445205,6.0,2411.0,5.0,2016.0,4.0,327.0,68.0,8.0,4.0,6,1050,70,20650,926,209407,230057,12/08/2020
2020-08-17,106,29944,4575,419942,449886,8.0,2419.0,6.0,2022.0,0.0,327.0,70.0,8.0,5.0,2,1052,87,20737,2322,211729,232466,12/08/2020
2020-08-18,128,30072,4911,424853,454925,11.0,2430.0,8.0,2030.0,1.0,328.0,72.0,8.0,4.0,5,1057,94,20831,2671,214400,235231,12/08/2020
2020-08-19,113,30185,5077,429930,460115,8.0,2438.0,9.0,2039.0,1.0,329.0,70.0,9.0,5.0,0,1057,90,20921,2566,216966,237887,12/08/2020
2020-08-20,173,30358,7411,437341,467699,12.0,2450.0,6.0,2045.0,2.0,331.0,74.0,10.0,5.0,3,1060,139,21060,3426,220392,241452,12/08/2020
2020-08-21,152,30510,6577,443918,474428,8.0,2458.0,5.0,2050.0,1.0,332.0,76.0,9.0,4.0,2,1062,125,21185,2848,223240,244425,12/08/2020
2020-08-22,96,30606,5550,449468,480074,11.0,2469.0,12.0,2062.0,0.0,332.0,75.0,11.0,4.0,1,1063,84,21269,2519,225759,247028,12/08/2020
2020-08-23,72,30678,4375,453843,484521,11.0,2480.0,6.0,2068.0,0.0,332.0,80.0,12.0,2.0,1,1064,56,21325,2423,228182,249507,12/08/2020
2020-08-24,105,30783,5784,459627,490410,7.0,2487.0,10.0,2078.0,1.0,333.0,76.0,14.0,4.0,1,1065,77,21402,3065,231247,252649,12/08/2020
2020-08-25,108,30891,4764,464391,495282,10.0,2497.0,4.0,2082.0,1.0,334.0,81.0,12.0,4.0,1,1066,92,21494,2234,233481,254975,12/08/2020
2020-08-26,170,31061,9482,473873,504934,4.0,2501.0,8.0,2090.0,0.0,334.0,77.0,10.0,5.0,1,1067,127,21621,3005,236486,258107,12/08/2020
2020-08-27,91,31152,8565,482438,513590,6.0,2507.0,13.0,2103.0,1.0,335.0,69.0,7.0,5.0,2,1069,70,21691,3063,239549,261240,12/08/2020
2020-08-28,113,31265,7994,490432,521697,14.0,2521.0,4.0,2107.0,0.0,335.0,79.0,10.0,7.0,2,1071,87,21778,2358,241907,263685,12/08/2020
2020-08-29,65,31330,5374,495806,527136,6.0,2527.0,8.0,2115.0,1.0,336.0,76.0,11.0,6.0,2,1073,51,21829,1871,243778,265607,12/08/2020
2020-08-30,66,31396,4323,500129,531525,7.0,2534.0,4.0,2119.0,0.0,336.0,79.0,9.0,5.0,2,1075,48,21877,1938,245716,267593,12/08/2020
2020-08-31,105,31501,4863,504992,536493,12.0,2546.0,16.0,2135.0,0.0,336.0,75.0,8.0,4.0,1,1076,81,21958,2136,247852,269810,12/08/2020
2020-09-01,99,31600,7109,512101,543701,6.0,2552.0,9.0,2144.0,1.0,337.0,71.0,7.0,4.0,2,1078,66,22024,2320,250172,272196,12/08/2020
2020-09-02,125,31725,10529,522630,554355,9.0,2561.0,10.0,2154.0,1.0,338.0,69.0,8.0,4.0,2,1080,104,22128,2981,253153,275281,12/08/2020
2020-09-03,90,31815,11080,533710,565525,8.0,2569.0,8.0,2162.0,0.0,338.0,69.0,9.0,4.0,3,1083,73,22201,2504,255657,277858,12/08/2020
2020-09-04,103,31918,8963,542673,574591,11.0,2580.0,4.0,2166.0,0.0,338.0,76.0,9.0,4.0,1,1084,83,22284,2304,257961,280245,12/08/2020
2020-09-05,52,31970,6309,548982,580952,6.0,2586.0,9.0,2175.0,0.0,338.0,73.0,8.0,3.0,1,1085,42,22326,1559,259520,281846,12/08/2020
2020-09-06,88,32058,4325,553307,585365,4.0,2590.0,8.0,2183.0,1.0,339.0,68.0,6.0,3.0,1,1086,65,22391,1894,261414,283805,12/08/2020
2020-09-07,35,32093,3002,556309,588402,11.0,2601.0,3.0,2186.0,0.0,339.0,76.0,5.0,3.0,1,1087,26,22417,624,262038,284455,12/08/2020
2020-09-08,74,32167,6381,562690,594857,6.0,2607.0,12.0,2198.0,1.0,340.0,69.0,6.0,3.0,2,1089,66,22483,1547,263585,286068,12/08/2020
2020-09-09,118,32285,8650,571340,603625,10.0,2617.0,5.0,2203.0,1.0,341.0,73.0,9.0,3.0,1,1090,102,22585,2076,265661,288246,12/08/2020
2020-09-10,164,32449,11334,582674,615123,9.0,2626.0,8.0,2211.0,0.0,341.0,74.0,10.0,3.0,1,1091,111,22696,2201,267862,290558,12/08/2020
2020-09-11,120,32569,9454,592128,624697,11.0,2637.0,11.0,2222.0,0.0,341.0,74.0,10.0,5.0,0,1091,97,22793,1907,269769,292562,12/08/2020
2020-09-12,110,32679,6174,598302,630981,8.0,2645.0,5.0,2227.0,2.0,343.0,75.0,9.0,5.0,3,1094,97,22890,1474,271243,294133,12/08/2020
2020-09-13,58,32737,2717,601019,633756,4.0,2649.0,3.0,2230.0,0.0,343.0,76.0,10.0,5.0,0,1094,54,22944,837,272080,295024,12/08/2020
2020-09-14,104,32841,6446,607465,640306,6.0,2655.0,3.0,2233.0,2.0,345.0,77.0,10.0,5.0,2,1096,95,23039,1674,273754,296793,12/08/2020
2020-09-15,122,32963,8470,615935,648898,7.0,2662.0,2.0,2235.0,1.0,346.0,81.0,10.0,5.0,2,1098,124,23163,2133,275887,299050,12/08/2020
2020-09-16,137,33100,9716,625651,658751,7.0,2669.0,7.0,2242.0,2.0,348.0,79.0,9.0,6.0,5,1103,118,23281,1914,277801,301082,12/08/2020
2020-09-17,125,33225,9239,634890,668115,7.0,2676.0,15.0,2257.0,0.0,348.0,71.0,8.0,4.0,0,1103,154,23435,1893,279694,303129,12/08/2020
2020-09-18,132,33357,10045,644935,678292,7.0,2683.0,7.0,2264.0,1.0,349.0,70.0,11.0,6.0,2,1105,132,23567,1875,281569,305136,12/08/2020
2020-09-19,115,33472,8297,653232,686704,7.0,2690.0,3.0,2267.0,0.0,349.0,74.0,10.0,6.0,4,1109,112,23679,1657,283226,306905,12/08/2020
2020-09-20,60,33532,3676,656908,690440,7.0,2697.0,6.0,2273.0,2.0,351.0,73.0,9.0,8.0,4,1113,49,23728,1294,284520,308248,12/08/2020
2020-09-21,102,33634,7018,663926,697560,12.0,2709.0,3.0,2276.0,2.0,353.0,80.0,8.0,6.0,2,1115,94,23822,2352,286872,310694,12/08/2020
2020-09-22,154,33788,9287,673213,707001,12.0,2721.0,3.0,2279.0,1.0,354.0,88.0,7.0,5.0,1,1116,124,23946,2134,289006,312952,12/08/2020
2020-09-23,136,33924,10651,683864,717788,12.0,2733.0,7.0,2286.0,0.0,354.0,93.0,6.0,5.0,0,1116,127,24073,2145,291151,315224,12/08/2020
2020-09-24,120,34044,12480,696344,730388,8.0,2741.0,9.0,2295.0,1.0,355.0,91.0,7.0,5.0,1,1117,120,24193,3091,294242,318435,12/08/2020
2020-09-25,150,34194,10553,706897,741091,9.0,2750.0,10.0,2305.0,0.0,355.0,90.0,6.0,5.0,1,1118,143,24336,2936,297178,321514,12/08/2020
2020-09-26,147,34341,10560,717457,751798,12.0,2762.0,9.0,2314.0,0.0,355.0,93.0,6.0,5.0,1,1119,120,24456,2373,299551,324007,12/08/2020
2020-09-27,43,34384,2764,720221,754605,7.0,2769.0,5.0,2319.0,0.0,355.0,95.0,9.0,5.0,0,1119,34,24490,825,300376,324866,12/08/2020
2020-09-28,156,34540,7307,727528,762068,7.0,2776.0,7.0,2326.0,2.0,357.0,93.0,7.0,5.0,2,1121,138,24628,2202,302578,327206,12/08/2020
2020-09-29,203,34743,11046,738574,773317,12.0,2788.0,18.0,2344.0,1.0,358.0,86.0,6.0,6.0,1,1122,185,24813,2758,305336,330149,12/08/2020
2020-09-30,223,34966,12230,750804,785770,6.0,2794.0,6.0,2350.0,0.0,358.0,86.0,6.0,6.0,1,1123,189,25002,2510,307846,332848,12/08/2020
2020-10-01,185,35151,12503,763307,798458,17.0,2811.0,13.0,2363.0,1.0,359.0,89.0,6.0,4.0,2,1125,166,25168,2343,310189,335357,12/08/2020
2020-10-02,209,35360,12154,775461,810821,14.0,2825.0,13.0,2376.0,1.0,360.0,89.0,8.0,5.0,2,1127,181,25349,2436,312625,337974,12/08/2020
2020-10-03,157,35517,9313,784774,820291,9.0,2834.0,9.0,2385.0,2.0,362.0,87.0,9.0,4.0,2,1129,131,25480,1972,314597,340077,12/08/2020
2020-10-04,81,35598,2369,787143,822741,11.0,2845.0,9.0,2394.0,1.0,363.0,88.0,8.0,5.0,2,1131,77,25557,932,315529,341086,12/08/2020
2020-10-05,174,35772,8982,796125,831897,30.0,2875.0,10.0,2404.0,2.0,365.0,106.0,9.0,6.0,4,1135,160,25717,2969,318498,344215,12/08/2020
2020-10-06,187,35959,11186,807311,843270,11.0,2886.0,4.0,2408.0,0.0,365.0,113.0,11.0,7.0,0,1135,188,25905,2829,321327,347232,12/08/2020
2020-10-07,242,36201,12442,819753,855954,13.0,2899.0,14.0,2422.0,2.0,367.0,110.0,9.0,7.0,2,1137,244,26149,3455,324782,350931,12/08/2020
2020-10-08,279,36480,15231,834984,871464,17.0,2916.0,13.0,2435.0,2.0,369.0,112.0,7.0,5.0,4,1141,277,26426,4136,328918,355344,12/08/2020
2020-10-09,229,36709,13745,848729,885438,21.0,2937.0,12.0,2447.0,0.0,369.0,121.0,10.0,7.0,3,1144,200,26626,4221,333139,359765,12/08/2020
2020-10-10,231,36940,13832,862561,899501,19.0,2956.0,10.0,2457.0,1.0,370.0,129.0,13.0,7.0,2,1146,192,26818,3714,336853,363671,12/08/2020
2020-10-11,97,37037,3263,865824,902861,12.0,2968.0,9.0,2466.0,1.0,371.0,131.0,14.0,5.0,6,1152,87,26905,1140,337993,364898,12/08/2020
2020-10-12,169,37206,6440,872264,909470,19.0,2987.0,15.0,2481.0,2.0,373.0,133.0,14.0,5.0,4,1156,157,27062,1684,339677,366739,12/08/2020
2020-10-13,213,37419,8522,880786,918205,15.0,3002.0,13.0,2494.0,4.0,377.0,131.0,13.0,5.0,7,1163,207,27269,2270,341947,369216,12/08/2020
2020-10-14,322,37741,15039,895825,933566,17.0,3019.0,7.0,2501.0,0.0,377.0,141.0,15.0,5.0,2,1165,299,27568,3945,345892,373460,12/08/2020
2020-10-15,262,38003,14639,910464,948467,12.0,3031.0,16.0,2517.0,1.0,378.0,136.0,13.0,5.0,2,1167,253,27821,3492,349384,377205,12/08/2020
2020-10-16,279,38282,15011,925475,963757,13.0,3044.0,18.0,2535.0,1.0,379.0,130.0,13.0,4.0,2,1169,275,28096,3307,352691,380787,12/08/2020
2020-10-17,354,38636,14069,939544,978180,19.0,3063.0,11.0,2546.0,1.0,380.0,137.0,17.0,4.0,2,1171,309,28405,3195,355886,384291,12/08/2020
2020-10-18,155,38791,4039,943583,982374,18.0,3081.0,11.0,2557.0,0.0,380.0,144.0,17.0,6.0,2,1173,126,28531,1279,357165,385696,12/08/2020
2020-10-19,388,39179,8491,952074,991253,21.0,3102.0,22.0,2579.0,2.0,382.0,141.0,15.0,6.0,1,1174,323,28854,2506,359671,388525,12/08/2020
2020-10-20,439,39618,13242,965316,1004934,23.0,3125.0,17.0,2596.0,0.0,382.0,147.0,14.0,8.0,3,1177,387,29241,2943,362614,391855,12/08/2020
2020-10-21,544,40162,17463,982779,1022941,23.0,3148.0,8.0,2604.0,2.0,384.0,160.0,15.0,9.0,3,1180,472,29713,3423,366037,395750,12/08/2020
2020-10-22,538,40700,15863,998642,1039342,24.0,3172.0,20.0,2624.0,3.0,387.0,161.0,14.0,9.0,3,1183,489,30202,3112,369149,399351,12/08/2020
2020-10-23,514,41214,16634,1015276,1056490,22.0,3194.0,22.0,2646.0,1.0,388.0,160.0,15.0,9.0,3,1186,458,30660,2825,371974,402634,12/08/2020
2020-10-24,359,41573,10249,1025525,1067098,17.0,3211.0,11.0,2657.0,0.0,388.0,166.0,14.0,8.0,1,1187,338,30998,2214,374188,405186,12/08/2020
2020-10-25,233,41806,4760,1030285,1072091,16.0,3227.0,15.0,2672.0,1.0,389.0,166.0,15.0,8.0,2,1189,209,31207,1415,375603,406810,12/08/2020
2020-10-26,454,42260,9174,1039459,1081719,27.0,3254.0,15.0,2687.0,2.0,391.0,176.0,18.0,8.0,3,1192,403,31610,2911,378514,410124,12/08/2020
2020-10-27,517,42777,13995,1053454,1096231,29.0,3283.0,15.0,2702.0,2.0,393.0,188.0,18.0,9.0,4,1196,453,32063,2344,380858,412921,12/08/2020
2020-10-28,469,43246,15229,1068683,1111929,25.0,3308.0,26.0,2728.0,1.0,394.0,186.0,17.0,9.0,3,1199,411,32474,2635,383493,415967,12/08/2020
2020-10-29,609,43855,16259,1084942,1128797,20.0,3328.0,22.0,2750.0,3.0,397.0,181.0,19.0,11.0,4,1203,526,33000,3068,386561,419561,12/08/2020
2020-10-30,565,44420,14863,1099805,1144225,21.0,3349.0,21.0,2771.0,5.0,402.0,176.0,19.0,9.0,4,1207,467,33467,2888,389449,422916,12/08/2020
2020-10-31,599,45019,11820,1111625,1156644,31.0,3380.0,13.0,2784.0,1.0,403.0,193.0,22.0,9.0,3,1210,483,33950,2360,391809,425759,12/08/2020
2020-11-01,330,45349,5091,1116716,1162065,22.0,3402.0,15.0,2799.0,1.0,404.0,199.0,26.0,12.0,4,1214,273,34223,1244,393053,427276,12/08/2020
2020-11-02,521,45870,9930,1126646,1172516,38.0,3440.0,27.0,2826.0,3.0,407.0,207.0,24.0,12.0,5,1219,455,34678,2873,395926,430604,12/08/2020
2020-11-03,602,46472,13040,1139686,1186158,33.0,3473.0,25.0,2851.0,1.0,408.0,214.0,24.0,12.0,1,1220,529,35207,2459,398385,433592,12/08/2020
2020-11-04,688,47160,16100,1155786,1202946,34.0,3507.0,27.0,2878.0,2.0,410.0,219.0,25.0,12.0,4,1224,632,35839,2875,401260,437099,12/08/2020
2020-11-05,768,47928,16593,1172379,1220307,46.0,3553.0,35.0,2913.0,1.0,411.0,229.0,24.0,14.0,3,1227,682,36521,2799,404059,440580,12/08/2020
2020-11-06,769,48697,16022,1188401,1237098,43.0,3596.0,31.0,2944.0,1.0,412.0,240.0,28.0,17.0,5,1232,691,37212,2990,407049,444261,12/08/2020
2020-11-07,604,49301,13650,1202051,1251352,34.0,3630.0,25.0,2969.0,1.0,413.0,248.0,31.0,18.0,1,1233,576,37788,2420,409469,447257,12/08/2020
2020-11-08,337,49638,4160,1206211,1255849,33.0,3663.0,26.0,2995.0,1.0,414.0,254.0,30.0,19.0,4,1237,321,38109,1255,410724,448833,12/08/2020
2020-11-09,807,50445,9040,1215251,1265696,40.0,3703.0,33.0,3028.0,2.0,416.0,259.0,28.0,18.0,3,1240,763,38872,2280,413004,451876,12/08/2020
2020-11-10,1053,51498,12982,1228233,1279731,45.0,3748.0,37.0,3065.0,0.0,416.0,267.0,31.0,18.0,6,1246,979,39851,2846,415850,455701,12/08/2020
2020-11-11,1087,52585,19741,1247974,1300559,42.0,3790.0,24.0,3089.0,5.0,421.0,280.0,30.0,15.0,7,1253,1001,40852,2639,418489,459341,12/08/2020
2020-11-12,893,53478,13902,1261876,1315354,39.0,3829.0,31.0,3120.0,3.0,424.0,285.0,28.0,15.0,5,1258,811,41663,2170,420659,462322,12/08/2020
2020-11-13,1165,54643,16390,1278266,1332909,39.0,3868.0,31.0,3151.0,0.0,424.0,293.0,27.0,15.0,2,1260,1115,42778,3067,423726,466504,12/08/2020
2020-11-14,782,55425,13517,1291783,1347208,42.0,3910.0,26.0,3177.0,5.0,429.0,304.0,25.0,13.0,10,1270,738,43516,2436,426162,469678,12/08/2020
2020-11-15,578,56003,6173,1297956,1353959,44.0,3954.0,21.0,3198.0,5.0,434.0,322.0,28.0,11.0,7,1277,495,44011,1404,427566,471577,12/08/2020
2020-11-16,738,56741,9614,1307570,1364311,56.0,4010.0,38.0,3236.0,3.0,437.0,337.0,26.0,13.0,5,1282,673,44684,2598,430164,474848,12/08/2020
2020-11-17,1538,58279,18173,1325743,1384022,59.0,4069.0,44.0,3280.0,2.0,439.0,350.0,30.0,13.0,5,1287,1401,46085,4093,434257,480342,12/08/2020
2020-11-18,1124,59403,16029,1341772,1401175,38.0,4107.0,38.0,3318.0,5.0,444.0,345.0,29.0,15.0,7,1294,1012,47097,3156,437413,484510,12/08/2020
2020-11-19,1128,60531,13170,1354942,1415473,46.0,4153.0,42.0,3360.0,4.0,448.0,345.0,30.0,18.0,5,1299,1034,48131,3375,440788,488919,12/08/2020
2020-11-20,1456,61987,22223,1377165,1439152,49.0,4202.0,48.0,3408.0,3.0,451.0,343.0,33.0,14.0,6,1305,1293,49424,4282,445070,494494,12/08/2020
2020-11-21,853,62840,17370,1394535,1457375,43.0,4245.0,34.0,3442.0,5.0,456.0,347.0,35.0,14.0,7,1312,755,50179,3122,448192,498371,12/08/2020
2020-11-22,571,63411,7519,1402054,1465465,64.0,4309.0,28.0,3470.0,4.0,460.0,379.0,33.0,15.0,11,1323,486,50665,1781,449973,500638,12/08/2020
2020-11-23,980,64391,11025,1413079,1477470,72.0,4381.0,39.0,3509.0,0.0,460.0,412.0,40.0,18.0,10,1333,885,51550,3392,453365,504915,12/08/2020
2020-11-24,1045,65436,14578,1427657,1493093,46.0,4427.0,60.0,3569.0,6.0,466.0,392.0,42.0,22.0,10,1343,937,52487,2764,456129,508616,12/08/2020
2020-11-25,1264,66700,18787,1446444,1513144,54.0,4481.0,58.0,3627.0,4.0,470.0,384.0,43.0,26.0,7,1350,1176,53663,3524,459653,513316,12/08/2020
2020-11-26,547,67247,6482,1452926,1520173,50.0,4531.0,36.0,3663.0,4.0,474.0,394.0,46.0,25.0,12,1362,468,54131,1569,461222,515353,12/08/2020
2020-11-27,1032,68279,9716,1462642,1530921,52.0,4583.0,49.0,3712.0,7.0,481.0,390.0,46.0,22.0,6,1368,960,55091,2519,463741,518832,12/08/2020
2020-11-28,1173,69452,11950,1474592,1544044,63.0,4646.0,40.0,3752.0,0.0,481.0,413.0,47.0,22.0,3,1371,1086,56177,2812,466553,522730,12/08/2020
2020-11-29,818,70270,6932,1481524,1551794,62.0,4708.0,35.0,3787.0,3.0,484.0,437.0,48.0,24.0,8,1379,752,56929,2315,468868,525797,12/08/2020
2020-11-30,1276,71546,9913,1491437,1562983,65.0,4773.0,59.0,3846.0,2.0,486.0,441.0,51.0,30.0,6,1385,1152,58081,2808,471676,529757,12/08/2020
2020-12-01,1548,73094,13943,1505380,1578474,57.0,4830.0,54.0,3900.0,4.0,490.0,440.0,50.0,32.0,12,1397,1413,59494,3389,475065,534559,12/08/2020
2020-12-02,1556,74650,15568,1520948,1595598,55.0,4885.0,52.0,3952.0,7.0,497.0,436.0,50.0,31.0,14,1411,1421,60915,3269,478334,539249,12/08/2020
2020-12-03,1760,76410,14626,1535574,1611984,62.0,4947.0,77.0,4029.0,5.0,502.0,416.0,47.0,32.0,9,1420,1634,62549,3339,481673,544222,12/08/2020
2020-12-04,1641,78051,16515,1552089,1630140,61.0,5008.0,49.0,4078.0,7.0,509.0,421.0,43.0,30.0,11,1431,1512,64061,3830,485503,549564,12/08/2020
2020-12-05,1200,79251,12597,1564686,1643937,65.0,5073.0,41.0,4119.0,4.0,513.0,441.0,45.0,30.0,11,1442,1051,65112,2907,488410,553522,12/08/2020
2020-12-06,1123,80374,7807,1572493,1652867,60.0,5133.0,48.0,4167.0,9.0,522.0,444.0,43.0,25.0,11,1453,973,66085,2518,490928,557013,12/08/2020
2020-12-07,1138,81512,9283,1581776,1663288,,,,,,,,,,17,1470,982,67067,2891,493819,560886,12/08/2020
2020-02-27,0,0,0,0,0,1.0,1.0,0.0,0.0,0.0,0.0,1.0,0.0,0.0,0,0,0,0,0,0,0,12/09/2020
2020-02-28,0,0,0,0,0,0.0,1.0,0.0,0.0,0.0,0.0,1.0,1.0,0.0,0,0,0,0,0,0,0,12/09/2020
2020-02-29,0,0,0,0,0,0.0,1.0,0.0,0.0,0.0,0.0,1.0,1.0,0.0,0,0,0,0,0,0,0,12/09/2020
2020-03-01,2,2,2,2,4,0.0,1.0,0.0,0.0,0.0,0.0,1.0,1.0,1.0,0,0,2,2,2,2,4,12/09/2020
2020-03-02,0,2,1,3,5,1.0,2.0,0.0,0.0,0.0,0.0,2.0,2.0,2.0,0,0,0,2,0,2,4,12/09/2020
2020-03-03,0,2,2,5,7,0.0,2.0,0.0,0.0,0.0,0.0,2.0,2.0,2.0,0,0,0,2,1,3,5,12/09/2020
2020-03-04,0,2,12,17,19,1.0,3.0,0.0,0.0,0.0,0.0,3.0,2.0,2.0,0,0,0,2,10,13,15,12/09/2020
2020-03-05,0,2,4,21,23,0.0,3.0,0.0,0.0,0.0,0.0,3.0,2.0,2.0,0,0,1,3,4,17,20,12/09/2020
2020-03-06,1,3,12,33,36,0.0,3.0,0.0,0.0,0.0,0.0,3.0,2.0,2.0,0,0,0,3,11,28,31,12/09/2020
2020-03-07,0,3,19,52,55,0.0,3.0,0.0,0.0,0.0,0.0,3.0,2.0,1.0,0,0,0,3,19,47,50,12/09/2020
2020-03-08,0,3,18,70,73,0.0,3.0,0.0,0.0,0.0,0.0,3.0,2.0,1.0,0,0,0,3,18,65,68,12/09/2020
2020-03-09,1,4,15,85,89,0.0,3.0,0.0,0.0,0.0,0.0,3.0,2.0,1.0,0,0,1,4,14,79,83,12/09/2020
2020-03-10,2,6,25,110,116,0.0,3.0,0.0,0.0,0.0,0.0,3.0,2.0,1.0,0,0,1,5,23,102,107,12/09/2020
2020-03-11,0,6,34,144,150,1.0,4.0,0.0,0.0,0.0,0.0,4.0,1.0,1.0,0,0,0,5,34,136,141,12/09/2020
2020-03-12,9,15,41,185,200,1.0,5.0,0.0,0.0,0.0,0.0,5.0,1.0,1.0,0,0,7,12,38,174,186,12/09/2020
2020-03-13,6,21,50,235,256,4.0,9.0,1.0,1.0,0.0,0.0,8.0,1.0,1.0,0,0,6,18,47,221,239,12/09/2020
2020-03-14,0,21,90,325,346,0.0,9.0,0.0,1.0,0.0,0.0,8.0,1.0,1.0,0,0,0,18,83,304,322,12/09/2020
2020-03-15,1,22,54,379,401,1.0,10.0,0.0,1.0,0.0,0.0,9.0,2.0,1.0,0,0,1,19,53,357,376,12/09/2020
2020-03-16,2,24,95,474,498,2.0,12.0,0.0,1.0,0.0,0.0,11.0,2.0,0.0,0,0,2,21,90,447,468,12/09/2020
2020-03-17,12,36,162,636,672,6.0,18.0,0.0,1.0,0.0,0.0,17.0,2.0,0.0,0,0,11,32,144,591,623,12/09/2020
2020-03-18,9,45,116,752,797,3.0,21.0,0.0,1.0,0.0,0.0,20.0,2.0,0.0,0,0,11,43,105,696,739,12/09/2020
2020-03-19,15,60,262,1014,1074,2.0,23.0,1.0,2.0,0.0,0.0,21.0,3.0,0.0,1,1,17,60,245,941,1001,12/09/2020
2020-03-20,13,73,197,1211,1284,5.0,28.0,0.0,2.0,0.0,0.0,26.0,4.0,0.0,0,1,13,73,183,1124,1197,12/09/2020
2020-03-21,12,85,126,1337,1422,3.0,31.0,2.0,4.0,0.0,0.0,27.0,5.0,0.0,0,1,14,87,119,1243,1330,12/09/2020
2020-03-22,27,112,282,1619,1731,2.0,33.0,0.0,4.0,0.0,0.0,29.0,5.0,0.0,0,1,25,112,253,1496,1608,12/09/2020
2020-03-23,14,126,169,1788,1914,15.0,48.0,1.0,5.0,0.0,0.0,43.0,9.0,3.0,0,1,16,128,158,1654,1782,12/09/2020
2020-03-24,20,146,242,2030,2176,8.0,56.0,0.0,5.0,0.0,0.0,51.0,10.0,5.0,0,1,19,147,222,1876,2023,12/09/2020
2020-03-25,26,172,182,2212,2384,5.0,61.0,2.0,7.0,0.0,0.0,54.0,11.0,3.0,0,1,28,175,158,2034,2209,12/09/2020
2020-03-26,35,207,181,2393,2600,9.0,70.0,5.0,12.0,0.0,0.0,58.0,14.0,5.0,0,1,41,216,167,2201,2417,12/09/2020
2020-03-27,27,234,214,2607,2841,9.0,79.0,1.0,13.0,1.0,1.0,65.0,16.0,6.0,2,3,31,247,188,2389,2636,12/09/2020
2020-03-28,59,293,260,2867,3160,11.0,90.0,2.0,15.0,1.0,2.0,73.0,15.0,6.0,1,4,64,311,236,2625,2936,12/09/2020
2020-03-29,100,393,350,3217,3610,8.0,98.0,3.0,18.0,1.0,3.0,77.0,18.0,8.0,2,6,105,416,296,2921,3337,12/09/2020
2020-03-30,62,455,222,3439,3894,19.0,117.0,5.0,23.0,0.0,3.0,91.0,19.0,11.0,3,9,78,494,173,3094,3588,12/09/2020
2020-03-31,71,526,369,3808,4334,11.0,128.0,7.0,30.0,1.0,4.0,94.0,21.0,13.0,2,11,73,567,286,3380,3947,12/09/2020
2020-04-01,99,625,698,4506,5131,18.0,146.0,7.0,37.0,0.0,4.0,105.0,29.0,15.0,1,12,100,667,597,3977,4644,12/09/2020
2020-04-02,52,677,477,4983,5660,22.0,168.0,6.0,43.0,2.0,6.0,119.0,35.0,21.0,4,16,62,729,414,4391,5120,12/09/2020
2020-04-03,108,785,774,5757,6542,23.0,191.0,7.0,50.0,0.0,6.0,135.0,42.0,25.0,3,19,100,829,669,5060,5889,12/09/2020
2020-04-04,143,928,660,6417,7345,22.0,213.0,4.0,54.0,5.0,11.0,148.0,40.0,29.0,9,28,138,967,579,5639,6606,12/09/2020
2020-04-05,187,1115,1156,7573,8688,20.0,233.0,9.0,63.0,1.0,12.0,158.0,43.0,35.0,2,30,181,1148,990,6629,7777,12/09/2020
2020-04-06,218,1333,1706,9279,10612,26.0,259.0,7.0,70.0,0.0,12.0,177.0,47.0,39.0,7,37,207,1355,1472,8101,9456,12/09/2020
2020-04-07,284,1617,1629,10908,12525,20.0,279.0,4.0,74.0,2.0,14.0,191.0,49.0,41.0,5,42,260,1615,1398,9499,11114,12/09/2020
2020-04-08,290,1907,1720,12628,14535,19.0,298.0,8.0,82.0,5.0,19.0,197.0,49.0,37.0,10,52,271,1886,1469,10968,12854,12/09/2020
2020-04-09,283,2190,1516,14144,16334,32.0,330.0,8.0,90.0,4.0,23.0,217.0,53.0,40.0,7,59,277,2163,1283,12251,14414,12/09/2020
2020-04-10,419,2609,2574,16718,19327,29.0,359.0,17.0,107.0,5.0,28.0,224.0,59.0,41.0,11,70,400,2563,2242,14493,17056,12/09/2020
2020-04-11,297,2906,1905,18623,21529,29.0,388.0,11.0,118.0,2.0,30.0,240.0,61.0,48.0,12,82,280,2843,1635,16128,18971,12/09/2020
2020-04-12,314,3220,1670,20293,23513,35.0,423.0,13.0,131.0,5.0,35.0,257.0,59.0,49.0,9,91,286,3129,1316,17444,20573,12/09/2020
2020-04-13,161,3381,935,21228,24609,35.0,458.0,13.0,144.0,3.0,38.0,276.0,64.0,54.0,9,100,187,3316,796,18240,21556,12/09/2020
2020-04-14,289,3670,1787,23015,26685,27.0,485.0,18.0,162.0,5.0,43.0,280.0,72.0,53.0,8,108,261,3577,1437,19677,23254,12/09/2020
2020-04-15,351,4021,1799,24814,28835,31.0,516.0,20.0,182.0,3.0,46.0,288.0,72.0,54.0,17,125,306,3883,1433,21110,24993,12/09/2020
2020-04-16,447,4468,2494,27308,31776,36.0,552.0,25.0,207.0,6.0,52.0,293.0,72.0,53.0,14,139,387,4270,1926,23036,27306,12/09/2020
2020-04-17,304,4772,1821,29129,33901,32.0,584.0,20.0,227.0,7.0,59.0,298.0,66.0,45.0,21,160,290,4560,1340,24376,28936,12/09/2020
2020-04-18,321,5093,1725,30854,35947,26.0,610.0,18.0,245.0,4.0,63.0,302.0,63.0,49.0,15,175,284,4844,1244,25620,30464,12/09/2020
2020-04-19,381,5474,2047,32901,38375,23.0,633.0,26.0,271.0,1.0,64.0,298.0,65.0,55.0,11,186,337,5181,1654,27274,32455,12/09/2020
2020-04-20,394,5868,1907,34808,40676,46.0,679.0,29.0,300.0,2.0,66.0,313.0,75.0,56.0,10,196,376,5557,1490,28764,34321,12/09/2020
2020-04-21,444,6312,2110,36918,43230,45.0,724.0,32.0,332.0,5.0,71.0,321.0,72.0,56.0,18,214,383,5940,1624,30388,36328,12/09/2020
2020-04-22,418,6730,2390,39308,46038,41.0,765.0,32.0,364.0,5.0,76.0,325.0,73.0,58.0,18,232,379,6319,1794,32182,38501,12/09/2020
2020-04-23,479,7209,2469,41777,48986,32.0,797.0,28.0,392.0,5.0,81.0,324.0,76.0,62.0,15,247,412,6731,1737,33919,40650,12/09/2020
2020-04-24,491,7700,3284,45061,52761,35.0,832.0,26.0,418.0,4.0,85.0,329.0,85.0,63.0,15,262,407,7138,2431,36350,43488,12/09/2020
2020-04-25,393,8093,2206,47267,55360,34.0,866.0,17.0,435.0,5.0,90.0,341.0,85.0,62.0,14,276,299,7437,1616,37966,45403,12/09/2020
2020-04-26,316,8409,2309,49576,57985,33.0,899.0,15.0,450.0,3.0,93.0,356.0,86.0,59.0,14,290,274,7711,1744,39710,47421,12/09/2020
2020-04-27,249,8658,1620,51196,59854,29.0,928.0,21.0,471.0,4.0,97.0,360.0,86.0,61.0,10,300,206,7917,1083,40793,48710,12/09/2020
2020-04-28,410,9068,2263,53459,62527,44.0,972.0,24.0,495.0,3.0,100.0,377.0,88.0,59.0,22,322,331,8248,1572,42365,50613,12/09/2020
2020-04-29,476,9544,3343,56802,66346,36.0,1008.0,38.0,533.0,11.0,111.0,364.0,78.0,53.0,18,340,370,8618,2219,44584,53202,12/09/2020
2020-04-30,432,9976,2769,59571,69547,33.0,1041.0,38.0,571.0,6.0,117.0,353.0,83.0,57.0,24,364,351,8969,1742,46326,55295,12/09/2020
2020-05-01,454,10430,3086,62657,73087,52.0,1093.0,38.0,609.0,3.0,120.0,364.0,84.0,58.0,14,378,323,9292,1957,48283,57575,12/09/2020
2020-05-02,257,10687,1926,64583,75270,36.0,1129.0,39.0,648.0,5.0,125.0,356.0,93.0,63.0,24,402,193,9485,1196,49479,58964,12/09/2020
2020-05-03,283,10970,2160,66743,77713,31.0,1160.0,26.0,674.0,8.0,133.0,353.0,91.0,61.0,21,423,183,9668,1456,50935,60603,12/09/2020
2020-05-04,387,11357,2098,68841,80198,30.0,1190.0,31.0,705.0,6.0,139.0,346.0,89.0,58.0,18,441,290,9958,1474,52409,62367,12/09/2020
2020-05-05,433,11790,2873,71714,83504,29.0,1219.0,32.0,737.0,6.0,145.0,337.0,83.0,55.0,16,457,299,10257,1845,54254,64511,12/09/2020
2020-05-06,488,12278,2830,74544,86822,28.0,1247.0,44.0,781.0,9.0,154.0,312.0,80.0,55.0,21,478,340,10597,1808,56062,66659,12/09/2020
2020-05-07,425,12703,2969,77513,90216,36.0,1283.0,44.0,825.0,5.0,159.0,299.0,72.0,53.0,21,499,270,10867,1834,57896,68763,12/09/2020
2020-05-08,359,13062,2598,80111,93173,30.0,1313.0,29.0,854.0,5.0,164.0,295.0,72.0,54.0,22,521,230,11097,1580,59476,70573,12/09/2020
2020-05-09,467,13529,3346,83457,96986,22.0,1335.0,21.0,875.0,4.0,168.0,292.0,70.0,52.0,15,536,289,11386,2111,61587,72973,12/09/2020
2020-05-10,285,13814,2117,85574,99388,20.0,1355.0,23.0,898.0,6.0,174.0,283.0,71.0,50.0,14,550,190,11576,1413,63000,74576,12/09/2020
2020-05-11,257,14071,1857,87431,101502,31.0,1386.0,16.0,914.0,6.0,180.0,292.0,72.0,50.0,15,565,173,11749,1229,64229,75978,12/09/2020
2020-05-12,387,14458,2611,90042,104500,23.0,1409.0,18.0,932.0,4.0,184.0,293.0,70.0,49.0,22,587,224,11973,1548,65777,77750,12/09/2020
2020-05-13,351,14809,3630,93672,108481,23.0,1432.0,25.0,957.0,1.0,185.0,290.0,70.0,50.0,13,600,199,12172,1848,67625,79797,12/09/2020
2020-05-14,329,15138,3408,97080,112218,19.0,1451.0,27.0,984.0,3.0,188.0,279.0,65.0,46.0,15,615,232,12404,1871,69496,81900,12/09/2020
2020-05-15,381,15519,3458,100538,116057,24.0,1475.0,41.0,1025.0,5.0,193.0,257.0,63.0,46.0,14,629,232,12636,1717,71213,83849,12/09/2020
2020-05-16,449,15968,4156,104694,120662,25.0,1500.0,15.0,1040.0,5.0,198.0,262.0,62.0,47.0,15,644,247,12883,1833,73046,85929,12/09/2020
2020-05-17,240,16208,2768,107462,123670,17.0,1517.0,9.0,1049.0,5.0,203.0,265.0,60.0,46.0,10,654,126,13009,1448,74494,87503,12/09/2020
2020-05-18,250,16458,2001,109463,125921,19.0,1536.0,16.0,1065.0,5.0,208.0,263.0,58.0,41.0,18,672,135,13144,1307,75801,88945,12/09/2020
2020-05-19,415,16873,3168,112631,129504,23.0,1559.0,33.0,1098.0,5.0,213.0,248.0,57.0,39.0,11,683,215,13359,1833,77634,90993,12/09/2020
2020-05-20,326,17199,2771,115402,132601,19.0,1578.0,23.0,1121.0,7.0,220.0,237.0,53.0,34.0,22,705,184,13543,1457,79091,92634,12/09/2020
2020-05-21,374,17573,3757,119159,136732,25.0,1603.0,15.0,1136.0,3.0,223.0,244.0,54.0,30.0,20,725,168,13711,1851,80942,94653,12/09/2020
2020-05-22,351,17924,3161,122320,140244,20.0,1623.0,28.0,1164.0,5.0,228.0,231.0,53.0,30.0,11,736,206,13917,1519,82461,96378,12/09/2020
2020-05-23,253,18177,2742,125062,143239,19.0,1642.0,11.0,1175.0,3.0,231.0,236.0,53.0,33.0,13,749,109,14026,1213,83674,97700,12/09/2020
2020-05-24,163,18340,1370,126432,144772,13.0,1655.0,14.0,1189.0,2.0,233.0,233.0,54.0,36.0,8,757,83,14109,742,84416,98525,12/09/2020
2020-05-25,147,18487,1385,127817,146304,14.0,1669.0,14.0,1203.0,0.0,233.0,233.0,54.0,34.0,10,767,76,14185,700,85116,99301,12/09/2020
2020-05-26,285,18772,2620,130437,149209,24.0,1693.0,21.0,1224.0,5.0,238.0,231.0,49.0,33.0,15,782,158,14343,1575,86691,101034,12/09/2020
2020-05-27,276,19048,2057,132494,151542,20.0,1713.0,18.0,1242.0,3.0,241.0,230.0,51.0,33.0,10,792,132,14475,1086,87777,102252,12/09/2020
2020-05-28,348,19396,3359,135853,155249,17.0,1730.0,29.0,1271.0,4.0,245.0,214.0,47.0,32.0,8,800,130,14605,1060,88837,103442,12/09/2020
2020-05-29,410,19806,3915,139768,159574,19.0,1749.0,26.0,1297.0,7.0,252.0,200.0,43.0,31.0,12,812,174,14779,1477,90314,105093,12/09/2020
2020-05-30,225,20031,3915,143683,163714,16.0,1765.0,19.0,1316.0,4.0,256.0,193.0,41.0,29.0,12,824,109,14888,1644,91958,106846,12/09/2020
2020-05-31,155,20186,1690,145373,165559,11.0,1776.0,11.0,1327.0,1.0,257.0,192.0,44.0,26.0,3,827,78,14966,790,92748,107714,12/09/2020
2020-06-01,212,20398,2792,148165,168563,8.0,1784.0,14.0,1341.0,1.0,258.0,185.0,45.0,29.0,5,832,93,15059,1322,94070,109129,12/09/2020
2020-06-02,273,20671,3022,151187,171858,8.0,1792.0,9.0,1350.0,3.0,261.0,181.0,38.0,25.0,10,842,98,15157,1366,95436,110593,12/09/2020
2020-06-03,254,20925,3486,154673,175598,14.0,1806.0,18.0,1368.0,6.0,267.0,171.0,34.0,25.0,11,853,99,15256,1577,97013,112269,12/09/2020
2020-06-04,276,21201,4471,159144,180345,7.0,1813.0,26.0,1394.0,4.0,271.0,148.0,31.0,24.0,12,865,107,15363,1916,98929,114292,12/09/2020
2020-06-05,215,21416,3513,162657,184073,15.0,1828.0,13.0,1407.0,6.0,277.0,144.0,27.0,21.0,11,876,99,15462,1468,100397,115859,12/09/2020
2020-06-06,201,21617,2616,165273,186890,10.0,1838.0,7.0,1414.0,2.0,279.0,145.0,29.0,19.0,6,882,67,15529,1067,101464,116993,12/09/2020
2020-06-07,83,21700,1625,166898,188598,11.0,1849.0,7.0,1421.0,1.0,280.0,148.0,25.0,17.0,4,886,51,15580,768,102232,117812,12/09/2020
2020-06-08,119,21819,1849,168747,190566,15.0,1864.0,13.0,1434.0,2.0,282.0,148.0,27.0,18.0,4,890,45,15625,919,103151,118776,12/09/2020
2020-06-09,223,22042,2673,171420,193462,10.0,1874.0,19.0,1453.0,0.0,282.0,139.0,28.0,21.0,1,891,64,15689,1205,104356,120045,12/09/2020
2020-06-10,209,22251,2987,174407,196658,13.0,1887.0,12.0,1465.0,2.0,284.0,138.0,24.0,17.0,4,895,100,15789,1415,105771,121560,12/09/2020
2020-06-11,195,22446,3513,177920,200366,7.0,1894.0,15.0,1480.0,1.0,285.0,129.0,25.0,16.0,6,901,88,15877,1461,107232,123109,12/09/2020
2020-06-12,209,22655,4601,182521,205176,9.0,1903.0,16.0,1496.0,1.0,286.0,121.0,24.0,16.0,2,903,78,15955,2018,109250,125205,12/09/2020
2020-06-13,113,22768,3036,185557,208325,6.0,1909.0,5.0,1501.0,0.0,286.0,122.0,20.0,15.0,3,906,49,16004,1279,110529,126533,12/09/2020
2020-06-14,81,22849,2046,187603,210452,7.0,1916.0,8.0,1509.0,1.0,287.0,120.0,20.0,14.0,3,909,33,16037,934,111463,127500,12/09/2020
2020-06-15,188,23037,3108,190711,213748,14.0,1930.0,19.0,1528.0,0.0,287.0,115.0,20.0,16.0,5,914,75,16112,1716,113179,129291,12/09/2020
2020-06-16,110,23147,3017,193728,216875,11.0,1941.0,9.0,1537.0,1.0,288.0,116.0,22.0,16.0,8,922,50,16162,1480,114659,130821,12/09/2020
2020-06-17,127,23274,2835,196563,219837,15.0,1956.0,20.0,1557.0,4.0,292.0,107.0,18.0,14.0,6,928,51,16213,1262,115921,132134,12/09/2020
2020-06-18,149,23423,3048,199611,223034,9.0,1965.0,15.0,1572.0,1.0,293.0,100.0,19.0,16.0,7,935,70,16283,1266,117187,133470,12/09/2020
2020-06-19,141,23564,3769,203380,226944,12.0,1977.0,12.0,1584.0,1.0,294.0,99.0,20.0,17.0,3,938,59,16342,1310,118497,134839,12/09/2020
2020-06-20,84,23648,1891,205271,228919,9.0,1986.0,12.0,1596.0,0.0,294.0,96.0,20.0,18.0,4,942,36,16378,787,119284,135662,12/09/2020
2020-06-21,37,23685,1064,206335,230020,8.0,1994.0,5.0,1601.0,0.0,294.0,99.0,20.0,18.0,2,944,30,16408,657,119941,136349,12/09/2020
2020-06-22,138,23823,3730,210065,233888,12.0,2006.0,17.0,1618.0,0.0,294.0,94.0,19.0,18.0,2,946,65,16473,1645,121586,138059,12/09/2020
2020-06-23,163,23986,3831,213896,237882,3.0,2009.0,13.0,1631.0,3.0,297.0,81.0,18.0,18.0,7,953,81,16554,1719,123305,139859,12/09/2020
2020-06-24,120,24106,3502,217398,241504,9.0,2018.0,10.0,1641.0,1.0,298.0,79.0,18.0,18.0,5,958,44,16598,1617,124922,141520,12/09/2020
2020-06-25,103,24209,2883,220281,244490,6.0,2024.0,14.0,1655.0,1.0,299.0,70.0,17.0,17.0,1,959,50,16648,1447,126369,143017,12/09/2020
2020-06-26,94,24303,2488,222769,247072,2.0,2026.0,10.0,1665.0,0.0,299.0,62.0,18.0,18.0,1,960,60,16708,1278,127647,144355,12/09/2020
2020-06-27,84,24387,3216,225985,250372,5.0,2031.0,3.0,1668.0,1.0,300.0,63.0,17.0,17.0,5,965,37,16745,1169,128816,145561,12/09/2020
2020-06-28,39,24426,1469,227454,251880,4.0,2035.0,4.0,1672.0,4.0,304.0,59.0,15.0,14.0,6,971,17,16762,577,129393,146155,12/09/2020
2020-06-29,85,24511,3697,231151,255662,4.0,2039.0,5.0,1677.0,0.0,304.0,58.0,14.0,14.0,1,972,39,16801,1308,130701,147502,12/09/2020
2020-06-30,57,24568,1958,233109,257677,1.0,2040.0,5.0,1682.0,1.0,305.0,53.0,12.0,11.0,4,976,32,16833,967,131668,148501,12/09/2020
2020-07-01,144,24712,4098,237207,261919,8.0,2048.0,10.0,1692.0,0.0,305.0,51.0,11.0,11.0,1,977,79,16912,1866,133534,150446,12/09/2020
2020-07-02,103,24815,2803,240010,264825,5.0,2053.0,5.0,1697.0,1.0,306.0,50.0,10.0,10.0,3,980,59,16971,1041,134575,151546,12/09/2020
2020-07-03,50,24865,2079,242089,266954,9.0,2062.0,6.0,1703.0,0.0,306.0,53.0,9.0,9.0,3,983,25,16996,758,135333,152329,12/09/2020
2020-07-04,57,24922,2345,244434,269356,2.0,2064.0,4.0,1707.0,1.0,307.0,50.0,10.0,9.0,2,985,33,17029,967,136300,153329,12/09/2020
2020-07-05,49,24971,2932,247366,272337,1.0,2065.0,2.0,1709.0,1.0,308.0,48.0,8.0,8.0,2,987,26,17055,1379,137679,154734,12/09/2020
2020-07-06,101,25072,2814,250180,275252,6.0,2071.0,6.0,1715.0,0.0,308.0,48.0,9.0,9.0,4,991,57,17112,1507,139186,156298,12/09/2020
2020-07-07,81,25153,3457,253637,278790,5.0,2076.0,7.0,1722.0,0.0,308.0,46.0,8.0,8.0,2,993,47,17159,1496,140682,157841,12/09/2020
2020-07-08,105,25258,3409,257046,282304,4.0,2080.0,2.0,1724.0,0.0,308.0,48.0,9.0,8.0,0,993,64,17223,1360,142042,159265,12/09/2020
2020-07-09,94,25352,3714,260760,286112,9.0,2089.0,3.0,1727.0,0.0,308.0,54.0,9.0,8.0,0,993,50,17273,1561,143603,160876,12/09/2020
2020-07-10,132,25484,4437,265197,290681,6.0,2095.0,3.0,1730.0,2.0,310.0,55.0,7.0,7.0,3,996,80,17353,2001,145604,162957,12/09/2020
2020-07-11,63,25547,2938,268135,293682,6.0,2101.0,3.0,1733.0,1.0,311.0,57.0,6.0,6.0,3,999,36,17389,1270,146874,164263,12/09/2020
2020-07-12,47,25594,1838,269973,295567,1.0,2102.0,3.0,1736.0,1.0,312.0,54.0,6.0,5.0,3,1002,34,17423,915,147789,165212,12/09/2020
2020-07-13,84,25678,3209,273182,298860,8.0,2110.0,10.0,1746.0,0.0,312.0,52.0,6.0,5.0,1,1003,61,17484,1456,149245,166729,12/09/2020
2020-07-14,74,25752,3298,276480,302232,7.0,2117.0,4.0,1750.0,0.0,312.0,55.0,5.0,5.0,1,1004,44,17528,1337,150582,168110,12/09/2020
2020-07-15,130,25882,4181,280661,306543,5.0,2122.0,7.0,1757.0,0.0,312.0,53.0,5.0,4.0,0,1004,100,17628,1691,152273,169901,12/09/2020
2020-07-16,103,25985,3740,284401,310386,6.0,2128.0,9.0,1766.0,0.0,312.0,50.0,6.0,5.0,1,1005,76,17704,1557,153830,171534,12/09/2020
2020-07-17,156,26141,4239,288640,314781,14.0,2142.0,3.0,1769.0,1.0,313.0,60.0,5.0,5.0,2,1007,79,17783,1792,155622,173405,12/09/2020
2020-07-18,85,26226,3272,291912,318138,5.0,2147.0,9.0,1778.0,1.0,314.0,55.0,5.0,4.0,4,1011,70,17853,1350,156972,174825,12/09/2020
2020-07-19,82,26308,2696,294608,320916,7.0,2154.0,3.0,1781.0,0.0,314.0,59.0,6.0,4.0,2,1013,57,17910,1103,158075,175985,12/09/2020
2020-07-20,71,26379,2666,297274,323653,9.0,2163.0,7.0,1788.0,0.0,314.0,61.0,7.0,5.0,2,1015,68,17978,1408,159483,177461,12/09/2020
2020-07-21,130,26509,4304,301578,328087,9.0,2172.0,11.0,1799.0,0.0,314.0,59.0,9.0,6.0,1,1016,108,18086,1863,161346,179432,12/09/2020
2020-07-22,130,26639,3928,305506,332145,7.0,2179.0,8.0,1807.0,1.0,315.0,57.0,7.0,6.0,1,1017,86,18172,1615,162961,181133,12/09/2020
2020-07-23,141,26780,4415,309921,336701,8.0,2187.0,6.0,1813.0,0.0,315.0,59.0,8.0,7.0,0,1017,115,18287,1906,164867,183154,12/09/2020
2020-07-24,172,26952,5966,315887,342839,15.0,2202.0,12.0,1825.0,0.0,315.0,62.0,9.0,7.0,0,1017,119,18406,2239,167106,185512,12/09/2020
2020-07-25,134,27086,4398,320285,347371,7.0,2209.0,7.0,1832.0,0.0,315.0,62.0,10.0,8.0,3,1020,108,18514,2032,169138,187652,12/09/2020
2020-07-26,62,27148,3033,323318,350466,8.0,2217.0,9.0,1841.0,0.0,315.0,61.0,11.0,7.0,1,1021,54,18568,1296,170434,189002,12/09/2020
2020-07-27,188,27336,4191,327509,354845,12.0,2229.0,7.0,1848.0,0.0,315.0,66.0,13.0,8.0,1,1022,138,18706,2265,172699,191405,12/09/2020
2020-07-28,105,27441,3840,331349,358790,5.0,2234.0,5.0,1853.0,0.0,315.0,66.0,14.0,7.0,1,1023,95,18801,1588,174287,193088,12/09/2020
2020-07-29,190,27631,5139,336488,364119,9.0,2243.0,10.0,1863.0,0.0,315.0,65.0,15.0,7.0,0,1023,154,18955,2225,176512,195467,12/09/2020
2020-07-30,121,27752,4345,340833,368585,6.0,2249.0,2.0,1865.0,1.0,316.0,68.0,15.0,6.0,1,1024,97,19052,1572,178084,197136,12/09/2020
2020-07-31,131,27883,5512,346345,374228,7.0,2256.0,9.0,1874.0,0.0,316.0,66.0,15.0,7.0,1,1025,89,19141,1777,179861,199002,12/09/2020
2020-08-01,109,27992,4294,350639,378631,7.0,2263.0,2.0,1876.0,0.0,316.0,71.0,14.0,7.0,1,1026,89,19230,1509,181370,200600,12/09/2020
2020-08-02,84,28076,2804,353443,381519,12.0,2275.0,12.0,1888.0,2.0,318.0,69.0,14.0,8.0,2,1028,62,19292,1235,182605,201897,12/09/2020
2020-08-03,188,28264,5248,358691,386955,11.0,2286.0,10.0,1898.0,0.0,318.0,70.0,16.0,7.0,1,1029,150,19442,2130,184735,204177,12/09/2020
2020-08-04,125,28389,3691,362382,390771,8.0,2294.0,5.0,1903.0,1.0,319.0,72.0,12.0,5.0,2,1031,99,19541,1716,186451,205992,12/09/2020
2020-08-05,147,28536,5935,368317,396853,11.0,2305.0,9.0,1912.0,1.0,320.0,73.0,10.0,5.0,2,1033,119,19660,2382,188833,208493,12/09/2020
2020-08-06,169,28705,5546,373863,402568,7.0,2312.0,9.0,1921.0,0.0,320.0,71.0,9.0,4.0,0,1033,120,19780,2315,191148,210928,12/09/2020
2020-08-07,123,28828,4851,378714,407542,12.0,2324.0,9.0,1930.0,1.0,321.0,73.0,9.0,3.0,2,1035,87,19867,2064,193212,213079,12/09/2020
2020-08-08,123,28951,4112,382826,411777,19.0,2343.0,6.0,1936.0,1.0,322.0,85.0,8.0,3.0,1,1036,91,19958,1727,194939,214897,12/09/2020
2020-08-09,42,28993,1727,384553,413546,6.0,2349.0,8.0,1944.0,0.0,322.0,83.0,9.0,4.0,0,1036,35,19993,1034,195973,215966,12/09/2020
2020-08-10,149,29142,4587,389140,418282,8.0,2357.0,9.0,1953.0,0.0,322.0,82.0,9.0,4.0,1,1037,113,20106,1957,197930,218036,12/09/2020
2020-08-11,106,29248,4334,393474,422722,5.0,2362.0,13.0,1966.0,0.0,322.0,74.0,10.0,4.0,3,1040,92,20198,2206,200136,220334,12/09/2020
2020-08-12,121,29369,5188,398662,428031,8.0,2370.0,11.0,1977.0,0.0,322.0,71.0,9.0,3.0,1,1041,101,20299,2531,202667,222966,12/09/2020
2020-08-13,135,29504,4196,402858,432362,13.0,2383.0,12.0,1989.0,0.0,322.0,72.0,11.0,3.0,0,1041,95,20394,1843,204510,224904,12/09/2020
2020-08-14,145,29649,5498,408356,438005,13.0,2396.0,11.0,2000.0,0.0,322.0,74.0,11.0,4.0,3,1044,98,20492,1911,206421,226913,12/09/2020
2020-08-15,106,29755,4534,412890,442645,9.0,2405.0,11.0,2011.0,1.0,323.0,71.0,11.0,5.0,0,1044,88,20580,1635,208056,228636,12/09/2020
2020-08-16,83,29838,2477,415367,445205,6.0,2411.0,5.0,2016.0,4.0,327.0,68.0,8.0,4.0,6,1050,70,20650,926,208982,229632,12/09/2020
2020-08-17,106,29944,4575,419942,449886,8.0,2419.0,6.0,2022.0,0.0,327.0,70.0,8.0,5.0,2,1052,87,20737,2322,211304,232041,12/09/2020
2020-08-18,128,30072,4911,424853,454925,11.0,2430.0,8.0,2030.0,1.0,328.0,72.0,8.0,4.0,5,1057,94,20831,2669,213973,234804,12/09/2020
2020-08-19,113,30185,5077,429930,460115,8.0,2438.0,9.0,2039.0,1.0,329.0,70.0,9.0,5.0,0,1057,90,20921,2567,216540,237461,12/09/2020
2020-08-20,173,30358,7411,437341,467699,12.0,2450.0,6.0,2045.0,2.0,331.0,74.0,10.0,5.0,3,1060,139,21060,3423,219963,241023,12/09/2020
2020-08-21,152,30510,6577,443918,474428,8.0,2458.0,5.0,2050.0,1.0,332.0,76.0,9.0,4.0,2,1062,125,21185,2846,222809,243994,12/09/2020
2020-08-22,96,30606,5550,449468,480074,11.0,2469.0,12.0,2062.0,0.0,332.0,75.0,11.0,4.0,1,1063,84,21269,2518,225327,246596,12/09/2020
2020-08-23,72,30678,4375,453843,484521,11.0,2480.0,6.0,2068.0,0.0,332.0,80.0,12.0,2.0,1,1064,56,21325,2420,227747,249072,12/09/2020
2020-08-24,105,30783,5784,459627,490410,7.0,2487.0,10.0,2078.0,1.0,333.0,76.0,14.0,4.0,1,1065,77,21402,3064,230811,252213,12/09/2020
2020-08-25,108,30891,4764,464391,495282,10.0,2497.0,4.0,2082.0,1.0,334.0,81.0,12.0,4.0,1,1066,92,21494,2231,233042,254536,12/09/2020
2020-08-26,170,31061,9482,473873,504934,4.0,2501.0,8.0,2090.0,0.0,334.0,77.0,10.0,5.0,1,1067,127,21621,3004,236046,257667,12/09/2020
2020-08-27,91,31152,8565,482438,513590,6.0,2507.0,13.0,2103.0,1.0,335.0,69.0,7.0,5.0,2,1069,70,21691,3061,239107,260798,12/09/2020
2020-08-28,113,31265,7994,490432,521697,14.0,2521.0,4.0,2107.0,0.0,335.0,79.0,10.0,7.0,2,1071,87,21778,2355,241462,263240,12/09/2020
2020-08-29,65,31330,5374,495806,527136,6.0,2527.0,8.0,2115.0,1.0,336.0,76.0,11.0,6.0,2,1073,51,21829,1867,243329,265158,12/09/2020
2020-08-30,66,31396,4323,500129,531525,7.0,2534.0,4.0,2119.0,0.0,336.0,79.0,9.0,5.0,2,1075,48,21877,1937,245266,267143,12/09/2020
2020-08-31,105,31501,4863,504992,536493,12.0,2546.0,16.0,2135.0,0.0,336.0,75.0,8.0,4.0,1,1076,81,21958,2133,247399,269357,12/09/2020
2020-09-01,99,31600,7109,512101,543701,6.0,2552.0,9.0,2144.0,1.0,337.0,71.0,7.0,4.0,2,1078,66,22024,2319,249718,271742,12/09/2020
2020-09-02,125,31725,10529,522630,554355,9.0,2561.0,10.0,2154.0,1.0,338.0,69.0,8.0,4.0,2,1080,104,22128,2975,252693,274821,12/09/2020
2020-09-03,90,31815,11080,533710,565525,8.0,2569.0,8.0,2162.0,0.0,338.0,69.0,9.0,4.0,3,1083,73,22201,2504,255197,277398,12/09/2020
2020-09-04,103,31918,8963,542673,574591,11.0,2580.0,4.0,2166.0,0.0,338.0,76.0,9.0,4.0,1,1084,83,22284,2302,257499,279783,12/09/2020
2020-09-05,52,31970,6309,548982,580952,6.0,2586.0,9.0,2175.0,0.0,338.0,73.0,8.0,3.0,1,1085,42,22326,1559,259058,281384,12/09/2020
2020-09-06,88,32058,4325,553307,585365,4.0,2590.0,8.0,2183.0,1.0,339.0,68.0,6.0,3.0,1,1086,65,22391,1894,260952,283343,12/09/2020
2020-09-07,35,32093,3002,556309,588402,11.0,2601.0,3.0,2186.0,0.0,339.0,76.0,5.0,3.0,1,1087,26,22417,622,261574,283991,12/09/2020
2020-09-08,74,32167,6381,562690,594857,6.0,2607.0,12.0,2198.0,1.0,340.0,69.0,6.0,3.0,2,1089,66,22483,1545,263119,285602,12/09/2020
2020-09-09,118,32285,8650,571340,603625,10.0,2617.0,5.0,2203.0,1.0,341.0,73.0,9.0,3.0,1,1090,102,22585,2074,265193,287778,12/09/2020
2020-09-10,164,32449,11334,582674,615123,9.0,2626.0,8.0,2211.0,0.0,341.0,74.0,10.0,3.0,1,1091,111,22696,2200,267393,290089,12/09/2020
2020-09-11,120,32569,9454,592128,624697,11.0,2637.0,11.0,2222.0,0.0,341.0,74.0,10.0,5.0,0,1091,97,22793,1902,269295,292088,12/09/2020
2020-09-12,110,32679,6174,598302,630981,8.0,2645.0,5.0,2227.0,2.0,343.0,75.0,9.0,5.0,3,1094,97,22890,1470,270765,293655,12/09/2020
2020-09-13,58,32737,2717,601019,633756,4.0,2649.0,3.0,2230.0,0.0,343.0,76.0,10.0,5.0,0,1094,54,22944,835,271600,294544,12/09/2020
2020-09-14,104,32841,6446,607465,640306,6.0,2655.0,3.0,2233.0,2.0,345.0,77.0,10.0,5.0,2,1096,95,23039,1670,273270,296309,12/09/2020
2020-09-15,122,32963,8470,615935,648898,7.0,2662.0,2.0,2235.0,1.0,346.0,81.0,10.0,5.0,2,1098,124,23163,2132,275402,298565,12/09/2020
2020-09-16,137,33100,9716,625651,658751,7.0,2669.0,7.0,2242.0,2.0,348.0,79.0,9.0,6.0,5,1103,118,23281,1913,277315,300596,12/09/2020
2020-09-17,125,33225,9239,634890,668115,7.0,2676.0,15.0,2257.0,0.0,348.0,71.0,8.0,4.0,0,1103,154,23435,1890,279205,302640,12/09/2020
2020-09-18,132,33357,10045,644935,678292,7.0,2683.0,7.0,2264.0,1.0,349.0,70.0,11.0,6.0,2,1105,132,23567,1873,281078,304645,12/09/2020
2020-09-19,115,33472,8297,653232,686704,7.0,2690.0,3.0,2267.0,0.0,349.0,74.0,10.0,6.0,4,1109,112,23679,1657,282735,306414,12/09/2020
2020-09-20,60,33532,3676,656908,690440,7.0,2697.0,6.0,2273.0,2.0,351.0,73.0,9.0,8.0,4,1113,49,23728,1293,284028,307756,12/09/2020
2020-09-21,102,33634,7018,663926,697560,12.0,2709.0,3.0,2276.0,2.0,353.0,80.0,8.0,6.0,2,1115,94,23822,2349,286377,310199,12/09/2020
2020-09-22,154,33788,9287,673213,707001,12.0,2721.0,3.0,2279.0,1.0,354.0,88.0,7.0,5.0,1,1116,124,23946,2130,288507,312453,12/09/2020
2020-09-23,136,33924,10651,683864,717788,12.0,2733.0,7.0,2286.0,0.0,354.0,93.0,6.0,5.0,0,1116,127,24073,2145,290652,314725,12/09/2020
2020-09-24,120,34044,12480,696344,730388,8.0,2741.0,9.0,2295.0,1.0,355.0,91.0,7.0,5.0,1,1117,120,24193,3089,293741,317934,12/09/2020
2020-09-25,150,34194,10553,706897,741091,9.0,2750.0,10.0,2305.0,0.0,355.0,90.0,6.0,5.0,1,1118,143,24336,2933,296674,321010,12/09/2020
2020-09-26,147,34341,10560,717457,751798,12.0,2762.0,9.0,2314.0,0.0,355.0,93.0,6.0,5.0,1,1119,120,24456,2369,299043,323499,12/09/2020
2020-09-27,43,34384,2764,720221,754605,7.0,2769.0,5.0,2319.0,0.0,355.0,95.0,9.0,5.0,0,1119,34,24490,825,299868,324358,12/09/2020
2020-09-28,156,34540,7307,727528,762068,7.0,2776.0,7.0,2326.0,2.0,357.0,93.0,7.0,5.0,2,1121,138,24628,2199,302067,326695,12/09/2020
2020-09-29,203,34743,11046,738574,773317,12.0,2788.0,18.0,2344.0,1.0,358.0,86.0,6.0,6.0,1,1122,185,24813,2758,304825,329638,12/09/2020
2020-09-30,223,34966,12230,750804,785770,6.0,2794.0,6.0,2350.0,0.0,358.0,86.0,6.0,6.0,1,1123,189,25002,2509,307334,332336,12/09/2020
2020-10-01,185,35151,12503,763307,798458,17.0,2811.0,13.0,2363.0,1.0,359.0,89.0,6.0,4.0,2,1125,166,25168,2340,309674,334842,12/09/2020
2020-10-02,209,35360,12154,775461,810821,14.0,2825.0,13.0,2376.0,1.0,360.0,89.0,8.0,5.0,2,1127,181,25349,2437,312111,337460,12/09/2020
2020-10-03,157,35517,9313,784774,820291,9.0,2834.0,9.0,2385.0,2.0,362.0,87.0,9.0,4.0,2,1129,131,25480,1972,314083,339563,12/09/2020
2020-10-04,81,35598,2369,787143,822741,11.0,2845.0,9.0,2394.0,1.0,363.0,88.0,8.0,5.0,2,1131,77,25557,929,315012,340569,12/09/2020
2020-10-05,174,35772,8982,796125,831897,30.0,2875.0,10.0,2404.0,2.0,365.0,106.0,9.0,6.0,4,1135,160,25717,2963,317975,343692,12/09/2020
2020-10-06,187,35959,11186,807311,843270,11.0,2886.0,4.0,2408.0,0.0,365.0,113.0,11.0,7.0,0,1135,188,25905,2828,320803,346708,12/09/2020
2020-10-07,242,36201,12442,819753,855954,13.0,2899.0,14.0,2422.0,2.0,367.0,110.0,9.0,7.0,2,1137,244,26149,3454,324257,350406,12/09/2020
2020-10-08,279,36480,15231,834984,871464,17.0,2916.0,13.0,2435.0,2.0,369.0,112.0,7.0,5.0,4,1141,277,26426,4133,328390,354816,12/09/2020
2020-10-09,229,36709,13745,848729,885438,21.0,2937.0,12.0,2447.0,0.0,369.0,121.0,10.0,7.0,3,1144,200,26626,4207,332597,359223,12/09/2020
2020-10-10,231,36940,13832,862561,899501,19.0,2956.0,10.0,2457.0,1.0,370.0,129.0,13.0,7.0,2,1146,192,26818,3709,336306,363124,12/09/2020
2020-10-11,97,37037,3263,865824,902861,12.0,2968.0,9.0,2466.0,1.0,371.0,131.0,14.0,5.0,6,1152,87,26905,1138,337444,364349,12/09/2020
2020-10-12,169,37206,6440,872264,909470,19.0,2987.0,15.0,2481.0,2.0,373.0,133.0,14.0,5.0,4,1156,157,27062,1684,339128,366190,12/09/2020
2020-10-13,213,37419,8522,880786,918205,15.0,3002.0,13.0,2494.0,4.0,377.0,131.0,13.0,5.0,7,1163,207,27269,2269,341397,368666,12/09/2020
2020-10-14,322,37741,15039,895825,933566,17.0,3019.0,7.0,2501.0,0.0,377.0,141.0,15.0,5.0,2,1165,299,27568,3941,345338,372906,12/09/2020
2020-10-15,262,38003,14639,910464,948467,12.0,3031.0,16.0,2517.0,1.0,378.0,136.0,13.0,5.0,2,1167,253,27821,3490,348828,376649,12/09/2020
2020-10-16,279,38282,15011,925475,963757,13.0,3044.0,18.0,2535.0,1.0,379.0,130.0,13.0,4.0,2,1169,275,28096,3299,352127,380223,12/09/2020
2020-10-17,354,38636,14069,939544,978180,19.0,3063.0,11.0,2546.0,1.0,380.0,137.0,17.0,4.0,2,1171,309,28405,3189,355316,383721,12/09/2020
2020-10-18,155,38791,4039,943583,982374,18.0,3081.0,11.0,2557.0,0.0,380.0,144.0,17.0,6.0,2,1173,126,28531,1278,356594,385125,12/09/2020
2020-10-19,388,39179,8491,952074,991253,21.0,3102.0,22.0,2579.0,2.0,382.0,141.0,15.0,6.0,1,1174,323,28854,2502,359096,387950,12/09/2020
2020-10-20,439,39618,13242,965316,1004934,23.0,3125.0,17.0,2596.0,0.0,382.0,147.0,14.0,8.0,3,1177,387,29241,2937,362033,391274,12/09/2020
2020-10-21,544,40162,17463,982779,1022941,23.0,3148.0,8.0,2604.0,2.0,384.0,160.0,15.0,9.0,3,1180,472,29713,3416,365449,395162,12/09/2020
2020-10-22,538,40700,15863,998642,1039342,24.0,3172.0,20.0,2624.0,3.0,387.0,161.0,14.0,9.0,3,1183,489,30202,3109,368558,398760,12/09/2020
2020-10-23,514,41214,16634,1015276,1056490,22.0,3194.0,22.0,2646.0,1.0,388.0,160.0,15.0,9.0,3,1186,458,30660,2823,371381,402041,12/09/2020
2020-10-24,359,41573,10249,1025525,1067098,17.0,3211.0,11.0,2657.0,0.0,388.0,166.0,14.0,8.0,1,1187,338,30998,2210,373591,404589,12/09/2020
2020-10-25,233,41806,4760,1030285,1072091,16.0,3227.0,15.0,2672.0,1.0,389.0,166.0,15.0,8.0,2,1189,209,31207,1415,375006,406213,12/09/2020
2020-10-26,454,42260,9174,1039459,1081719,27.0,3254.0,15.0,2687.0,2.0,391.0,176.0,18.0,8.0,3,1192,403,31610,2906,377912,409522,12/09/2020
2020-10-27,517,42777,13995,1053454,1096231,29.0,3283.0,15.0,2702.0,2.0,393.0,188.0,18.0,9.0,4,1196,453,32063,2341,380253,412316,12/09/2020
2020-10-28,469,43246,15229,1068683,1111929,25.0,3308.0,26.0,2728.0,1.0,394.0,186.0,17.0,9.0,3,1199,411,32474,2635,382888,415362,12/09/2020
2020-10-29,609,43855,16259,1084942,1128797,20.0,3328.0,22.0,2750.0,3.0,397.0,181.0,19.0,11.0,4,1203,526,33000,3063,385951,418951,12/09/2020
2020-10-30,565,44420,14863,1099805,1144225,21.0,3349.0,21.0,2771.0,5.0,402.0,176.0,19.0,9.0,4,1207,467,33467,2884,388835,422302,12/09/2020
2020-10-31,599,45019,11820,1111625,1156644,31.0,3380.0,13.0,2784.0,1.0,403.0,193.0,22.0,9.0,3,1210,483,33950,2359,391194,425144,12/09/2020
2020-11-01,330,45349,5091,1116716,1162065,22.0,3402.0,15.0,2799.0,1.0,404.0,199.0,26.0,12.0,4,1214,273,34223,1243,392437,426660,12/09/2020
2020-11-02,521,45870,9930,1126646,1172516,38.0,3440.0,27.0,2826.0,3.0,407.0,207.0,24.0,12.0,5,1219,455,34678,2871,395308,429986,12/09/2020
2020-11-03,602,46472,13040,1139686,1186158,33.0,3473.0,25.0,2851.0,1.0,408.0,214.0,24.0,12.0,1,1220,529,35207,2457,397765,432972,12/09/2020
2020-11-04,688,47160,16100,1155786,1202946,34.0,3507.0,27.0,2878.0,2.0,410.0,219.0,25.0,12.0,4,1224,632,35839,2873,400638,436477,12/09/2020
2020-11-05,768,47928,16593,1172379,1220307,46.0,3553.0,35.0,2913.0,1.0,411.0,229.0,24.0,14.0,3,1227,682,36521,2797,403435,439956,12/09/2020
2020-11-06,769,48697,16022,1188401,1237098,43.0,3596.0,31.0,2944.0,1.0,412.0,240.0,28.0,17.0,5,1232,691,37212,2988,406423,443635,12/09/2020
2020-11-07,604,49301,13650,1202051,1251352,34.0,3630.0,25.0,2969.0,1.0,413.0,248.0,31.0,18.0,1,1233,576,37788,2417,408840,446628,12/09/2020
2020-11-08,337,49638,4160,1206211,1255849,33.0,3663.0,26.0,2995.0,1.0,414.0,254.0,30.0,19.0,4,1237,321,38109,1253,410093,448202,12/09/2020
2020-11-09,807,50445,9040,1215251,1265696,40.0,3703.0,33.0,3028.0,2.0,416.0,259.0,28.0,18.0,3,1240,763,38872,2278,412371,451243,12/09/2020
2020-11-10,1053,51498,12982,1228233,1279731,45.0,3748.0,37.0,3065.0,0.0,416.0,267.0,31.0,18.0,6,1246,979,39851,2846,415217,455068,12/09/2020
2020-11-11,1087,52585,19741,1247974,1300559,42.0,3790.0,24.0,3089.0,5.0,421.0,280.0,30.0,15.0,7,1253,1001,40852,2639,417856,458708,12/09/2020
2020-11-12,893,53478,13902,1261876,1315354,39.0,3829.0,31.0,3120.0,3.0,424.0,285.0,28.0,15.0,5,1258,811,41663,2172,420028,461691,12/09/2020
2020-11-13,1165,54643,16390,1278266,1332909,39.0,3868.0,31.0,3151.0,0.0,424.0,293.0,27.0,15.0,2,1260,1115,42778,3058,423086,465864,12/09/2020
2020-11-14,782,55425,13517,1291783,1347208,42.0,3910.0,26.0,3177.0,5.0,429.0,304.0,25.0,13.0,10,1270,738,43516,2434,425520,469036,12/09/2020
2020-11-15,578,56003,6173,1297956,1353959,46.0,3956.0,21.0,3198.0,5.0,434.0,324.0,28.0,11.0,7,1277,495,44011,1401,426921,470932,12/09/2020
2020-11-16,738,56741,9614,1307570,1364311,56.0,4012.0,39.0,3237.0,3.0,437.0,338.0,26.0,13.0,5,1282,673,44684,2595,429516,474200,12/09/2020
2020-11-17,1538,58279,18173,1325743,1384022,59.0,4071.0,45.0,3282.0,2.0,439.0,350.0,30.0,13.0,5,1287,1401,46085,4079,433595,479680,12/09/2020
2020-11-18,1124,59403,16029,1341772,1401175,38.0,4109.0,38.0,3320.0,5.0,444.0,345.0,29.0,15.0,7,1294,1012,47097,3153,436748,483845,12/09/2020
2020-11-19,1128,60531,13170,1354942,1415473,46.0,4155.0,42.0,3362.0,4.0,448.0,345.0,30.0,18.0,5,1299,1034,48131,3370,440118,488249,12/09/2020
2020-11-20,1456,61987,22224,1377166,1439153,49.0,4204.0,48.0,3410.0,3.0,451.0,343.0,33.0,14.0,6,1305,1293,49424,4287,444405,493829,12/09/2020
2020-11-21,854,62841,17370,1394536,1457377,43.0,4247.0,34.0,3444.0,5.0,456.0,347.0,35.0,14.0,7,1312,755,50179,3125,447530,497709,12/09/2020
2020-11-22,571,63412,7531,1402067,1465479,64.0,4311.0,28.0,3472.0,4.0,460.0,379.0,33.0,15.0,11,1323,486,50665,1792,449322,499987,12/09/2020
2020-11-23,980,64392,11033,1413100,1477492,72.0,4383.0,40.0,3512.0,0.0,460.0,411.0,40.0,18.0,10,1333,885,51550,3404,452726,504276,12/09/2020
2020-11-24,1045,65437,14581,1427681,1493118,47.0,4430.0,59.0,3571.0,6.0,466.0,393.0,42.0,22.0,10,1343,937,52487,2807,455533,508020,12/09/2020
2020-11-25,1265,66702,18794,1446475,1513177,57.0,4487.0,58.0,3629.0,4.0,470.0,388.0,43.0,26.0,7,1350,1176,53663,3538,459071,512734,12/09/2020
2020-11-26,547,67249,6484,1452959,1520208,51.0,4538.0,36.0,3665.0,4.0,474.0,399.0,46.0,25.0,12,1362,468,54131,1564,460635,514766,12/09/2020
2020-11-27,1033,68282,9734,1462693,1530975,53.0,4591.0,49.0,3714.0,7.0,481.0,396.0,47.0,22.0,6,1368,960,55091,2546,463181,518272,12/09/2020
2020-11-28,1175,69457,11975,1474668,1544125,63.0,4654.0,40.0,3754.0,0.0,481.0,419.0,48.0,22.0,3,1371,1086,56177,2843,466024,522201,12/09/2020
2020-11-29,822,70279,6936,1481604,1551883,62.0,4716.0,36.0,3790.0,3.0,484.0,442.0,49.0,24.0,8,1379,752,56929,2346,468370,525299,12/09/2020
2020-11-30,1277,71556,9933,1491537,1563093,67.0,4783.0,60.0,3850.0,2.0,486.0,447.0,52.0,30.0,6,1385,1152,58081,2841,471211,529292,12/09/2020
2020-12-01,1554,73110,13950,1505487,1578597,58.0,4841.0,55.0,3905.0,4.0,490.0,446.0,51.0,31.0,12,1397,1413,59494,3412,474623,534117,12/09/2020
2020-12-02,1563,74673,15596,1521083,1595756,55.0,4896.0,53.0,3958.0,7.0,497.0,441.0,52.0,30.0,14,1411,1421,60915,3287,477910,538825,12/09/2020
2020-12-03,1767,76440,14651,1535734,1612174,63.0,4959.0,76.0,4034.0,5.0,502.0,423.0,48.0,31.0,9,1420,1634,62549,3363,481273,543822,12/09/2020
2020-12-04,1644,78084,16527,1552261,1630345,62.0,5021.0,49.0,4083.0,7.0,509.0,429.0,44.0,29.0,11,1431,1512,64061,3851,485124,549185,12/09/2020
2020-12-05,1209,79293,12629,1564890,1644183,66.0,5087.0,41.0,4124.0,4.0,513.0,450.0,46.0,29.0,11,1442,1051,65112,2929,488053,553165,12/09/2020
2020-12-06,1131,80424,7837,1572727,1653151,64.0,5151.0,50.0,4174.0,9.0,522.0,455.0,44.0,24.0,12,1454,973,66085,2585,490638,556723,12/09/2020
2020-12-07,1365,81789,10628,1583355,1665144,65.0,5216.0,53.0,4227.0,6.0,528.0,461.0,42.0,24.0,17,1471,982,67067,3376,494014,561081,12/09/2020
2020-12-08,1375,83164,14810,1598165,1681329,,,,,,,,,,13,1484,1232,68299,3716,497730,566029,12/09/2020
2020-02-27,0,0,0,0,0,1.0,1.0,0.0,0.0,0.0,0.0,1.0,0.0,0.0,0,0,0,0,0,0,0,12/10/2020
2020-02-28,0,0,0,0,0,0.0,1.0,0.0,0.0,0.0,0.0,1.0,1.0,0.0,0,0,0,0,0,0,0,12/10/2020
2020-02-29,0,0,0,0,0,0.0,1.0,0.0,0.0,0.0,0.0,1.0,1.0,0.0,0,0,0,0,0,0,0,12/10/2020
2020-03-01,2,2,2,2,4,0.0,1.0,0.0,0.0,0.0,0.0,1.0,1.0,1.0,0,0,2,2,2,2,4,12/10/2020
2020-03-02,0,2,1,3,5,1.0,2.0,0.0,0.0,0.0,0.0,2.0,2.0,2.0,0,0,0,2,0,2,4,12/10/2020
2020-03-03,0,2,2,5,7,0.0,2.0,0.0,0.0,0.0,0.0,2.0,2.0,2.0,0,0,0,2,1,3,5,12/10/2020
2020-03-04,0,2,12,17,19,1.0,3.0,0.0,0.0,0.0,0.0,3.0,2.0,2.0,0,0,0,2,10,13,15,12/10/2020
2020-03-05,0,2,4,21,23,0.0,3.0,0.0,0.0,0.0,0.0,3.0,2.0,2.0,0,0,1,3,4,17,20,12/10/2020
2020-03-06,1,3,12,33,36,0.0,3.0,0.0,0.0,0.0,0.0,3.0,2.0,2.0,0,0,0,3,11,28,31,12/10/2020
2020-03-07,0,3,19,52,55,0.0,3.0,0.0,0.0,0.0,0.0,3.0,2.0,1.0,0,0,0,3,19,47,50,12/10/2020
2020-03-08,0,3,18,70,73,0.0,3.0,0.0,0.0,0.0,0.0,3.0,2.0,1.0,0,0,0,3,18,65,68,12/10/2020
2020-03-09,1,4,15,85,89,0.0,3.0,0.0,0.0,0.0,0.0,3.0,2.0,1.0,0,0,1,4,14,79,83,12/10/2020
2020-03-10,2,6,25,110,116,0.0,3.0,0.0,0.0,0.0,0.0,3.0,2.0,1.0,0,0,1,5,23,102,107,12/10/2020
2020-03-11,0,6,34,144,150,1.0,4.0,0.0,0.0,0.0,0.0,4.0,1.0,1.0,0,0,0,5,34,136,141,12/10/2020
2020-03-12,9,15,41,185,200,1.0,5.0,0.0,0.0,0.0,0.0,5.0,1.0,1.0,0,0,7,12,38,174,186,12/10/2020
2020-03-13,6,21,50,235,256,4.0,9.0,1.0,1.0,0.0,0.0,8.0,1.0,1.0,0,0,6,18,47,221,239,12/10/2020
2020-03-14,0,21,90,325,346,0.0,9.0,0.0,1.0,0.0,0.0,8.0,1.0,1.0,0,0,0,18,83,304,322,12/10/2020
2020-03-15,1,22,54,379,401,1.0,10.0,0.0,1.0,0.0,0.0,9.0,2.0,1.0,0,0,1,19,53,357,376,12/10/2020
2020-03-16,2,24,95,474,498,2.0,12.0,0.0,1.0,0.0,0.0,11.0,2.0,0.0,0,0,2,21,90,447,468,12/10/2020
2020-03-17,12,36,162,636,672,6.0,18.0,0.0,1.0,0.0,0.0,17.0,2.0,0.0,0,0,11,32,144,591,623,12/10/2020
2020-03-18,9,45,116,752,797,3.0,21.0,0.0,1.0,0.0,0.0,20.0,2.0,0.0,0,0,11,43,105,696,739,12/10/2020
2020-03-19,15,60,262,1014,1074,2.0,23.0,1.0,2.0,0.0,0.0,21.0,3.0,0.0,1,1,17,60,245,941,1001,12/10/2020
2020-03-20,13,73,197,1211,1284,5.0,28.0,0.0,2.0,0.0,0.0,26.0,4.0,0.0,0,1,13,73,183,1124,1197,12/10/2020
2020-03-21,12,85,126,1337,1422,3.0,31.0,2.0,4.0,0.0,0.0,27.0,5.0,0.0,0,1,14,87,119,1243,1330,12/10/2020
2020-03-22,27,112,282,1619,1731,2.0,33.0,0.0,4.0,0.0,0.0,29.0,5.0,0.0,0,1,25,112,252,1495,1607,12/10/2020
2020-03-23,14,126,169,1788,1914,15.0,48.0,1.0,5.0,0.0,0.0,43.0,9.0,3.0,0,1,16,128,158,1653,1781,12/10/2020
2020-03-24,20,146,242,2030,2176,8.0,56.0,0.0,5.0,0.0,0.0,51.0,10.0,5.0,0,1,19,147,222,1875,2022,12/10/2020
2020-03-25,26,172,182,2212,2384,5.0,61.0,2.0,7.0,0.0,0.0,54.0,11.0,3.0,0,1,28,175,158,2033,2208,12/10/2020
2020-03-26,35,207,181,2393,2600,9.0,70.0,5.0,12.0,0.0,0.0,58.0,14.0,5.0,0,1,41,216,167,2200,2416,12/10/2020
2020-03-27,27,234,214,2607,2841,9.0,79.0,1.0,13.0,1.0,1.0,65.0,16.0,6.0,2,3,31,247,188,2388,2635,12/10/2020
2020-03-28,59,293,260,2867,3160,11.0,90.0,2.0,15.0,1.0,2.0,73.0,15.0,6.0,1,4,64,311,235,2623,2934,12/10/2020
2020-03-29,100,393,350,3217,3610,8.0,98.0,3.0,18.0,1.0,3.0,77.0,18.0,8.0,2,6,105,416,296,2919,3335,12/10/2020
2020-03-30,62,455,222,3439,3894,19.0,117.0,5.0,23.0,0.0,3.0,91.0,19.0,11.0,3,9,78,494,173,3092,3586,12/10/2020
2020-03-31,71,526,369,3808,4334,11.0,128.0,7.0,30.0,1.0,4.0,94.0,21.0,13.0,2,11,73,567,286,3378,3945,12/10/2020
2020-04-01,99,625,698,4506,5131,18.0,146.0,7.0,37.0,0.0,4.0,105.0,29.0,15.0,1,12,100,667,597,3975,4642,12/10/2020
2020-04-02,52,677,477,4983,5660,22.0,168.0,6.0,43.0,2.0,6.0,119.0,35.0,21.0,4,16,62,729,414,4389,5118,12/10/2020
2020-04-03,108,785,774,5757,6542,23.0,191.0,7.0,50.0,0.0,6.0,135.0,42.0,25.0,3,19,100,829,668,5057,5886,12/10/2020
2020-04-04,143,928,660,6417,7345,22.0,213.0,4.0,54.0,5.0,11.0,148.0,40.0,29.0,9,28,138,967,579,5636,6603,12/10/2020
2020-04-05,187,1115,1156,7573,8688,20.0,233.0,9.0,63.0,1.0,12.0,158.0,43.0,35.0,2,30,181,1148,989,6625,7773,12/10/2020
2020-04-06,218,1333,1706,9279,10612,26.0,259.0,7.0,70.0,0.0,12.0,177.0,47.0,39.0,7,37,207,1355,1470,8095,9450,12/10/2020
2020-04-07,284,1617,1629,10908,12525,20.0,279.0,4.0,74.0,2.0,14.0,191.0,49.0,41.0,5,42,260,1615,1396,9491,11106,12/10/2020
2020-04-08,290,1907,1720,12628,14535,19.0,298.0,8.0,82.0,5.0,19.0,197.0,49.0,37.0,10,52,271,1886,1466,10957,12843,12/10/2020
2020-04-09,283,2190,1516,14144,16334,32.0,330.0,8.0,90.0,4.0,23.0,217.0,53.0,40.0,7,59,277,2163,1282,12239,14402,12/10/2020
2020-04-10,419,2609,2574,16718,19327,29.0,359.0,17.0,107.0,5.0,28.0,224.0,59.0,41.0,11,70,400,2563,2241,14480,17043,12/10/2020
2020-04-11,297,2906,1905,18623,21529,29.0,388.0,11.0,118.0,2.0,30.0,240.0,61.0,48.0,12,82,280,2843,1633,16113,18956,12/10/2020
2020-04-12,314,3220,1670,20293,23513,35.0,423.0,13.0,131.0,5.0,35.0,257.0,59.0,49.0,9,91,286,3129,1314,17427,20556,12/10/2020
2020-04-13,161,3381,935,21228,24609,35.0,458.0,13.0,144.0,3.0,38.0,276.0,64.0,54.0,9,100,187,3316,796,18223,21539,12/10/2020
2020-04-14,289,3670,1787,23015,26685,27.0,485.0,18.0,162.0,5.0,43.0,280.0,72.0,53.0,8,108,261,3577,1433,19656,23233,12/10/2020
2020-04-15,351,4021,1799,24814,28835,31.0,516.0,20.0,182.0,3.0,46.0,288.0,72.0,54.0,17,125,306,3883,1431,21087,24970,12/10/2020
2020-04-16,447,4468,2494,27308,31776,36.0,552.0,25.0,207.0,6.0,52.0,293.0,72.0,53.0,14,139,387,4270,1922,23009,27279,12/10/2020
2020-04-17,304,4772,1821,29129,33901,32.0,584.0,20.0,227.0,7.0,59.0,298.0,66.0,45.0,21,160,290,4560,1340,24349,28909,12/10/2020
2020-04-18,321,5093,1725,30854,35947,26.0,610.0,18.0,245.0,4.0,63.0,302.0,63.0,49.0,15,175,284,4844,1242,25591,30435,12/10/2020
2020-04-19,381,5474,2047,32901,38375,23.0,633.0,26.0,271.0,1.0,64.0,298.0,65.0,55.0,11,186,337,5181,1653,27244,32425,12/10/2020
2020-04-20,394,5868,1907,34808,40676,46.0,679.0,29.0,300.0,2.0,66.0,313.0,75.0,56.0,10,196,376,5557,1487,28731,34288,12/10/2020
2020-04-21,444,6312,2110,36918,43230,45.0,724.0,32.0,332.0,5.0,71.0,321.0,72.0,56.0,18,214,383,5940,1620,30351,36291,12/10/2020
2020-04-22,418,6730,2390,39308,46038,41.0,765.0,32.0,364.0,5.0,76.0,325.0,73.0,58.0,18,232,379,6319,1789,32140,38459,12/10/2020
2020-04-23,479,7209,2469,41777,48986,32.0,797.0,28.0,392.0,5.0,81.0,324.0,76.0,62.0,15,247,412,6731,1737,33877,40608,12/10/2020
2020-04-24,491,7700,3284,45061,52761,35.0,832.0,26.0,418.0,4.0,85.0,329.0,85.0,63.0,15,262,407,7138,2412,36289,43427,12/10/2020
2020-04-25,393,8093,2206,47267,55360,34.0,866.0,17.0,435.0,5.0,90.0,341.0,85.0,62.0,14,276,299,7437,1615,37904,45341,12/10/2020
2020-04-26,316,8409,2309,49576,57985,33.0,899.0,15.0,450.0,3.0,93.0,356.0,86.0,59.0,14,290,274,7711,1739,39643,47354,12/10/2020
2020-04-27,249,8658,1620,51196,59854,29.0,928.0,21.0,471.0,4.0,97.0,360.0,86.0,61.0,10,300,206,7917,1081,40724,48641,12/10/2020
2020-04-28,410,9068,2263,53459,62527,44.0,972.0,24.0,495.0,3.0,100.0,377.0,88.0,59.0,22,322,331,8248,1568,42292,50540,12/10/2020
2020-04-29,476,9544,3343,56802,66346,36.0,1008.0,38.0,533.0,11.0,111.0,364.0,78.0,53.0,18,340,370,8618,2207,44499,53117,12/10/2020
2020-04-30,432,9976,2769,59571,69547,33.0,1041.0,38.0,571.0,6.0,117.0,353.0,83.0,57.0,24,364,351,8969,1736,46235,55204,12/10/2020
2020-05-01,454,10430,3086,62657,73087,52.0,1093.0,38.0,609.0,3.0,120.0,364.0,84.0,58.0,14,378,323,9292,1955,48190,57482,12/10/2020
2020-05-02,257,10687,1926,64583,75270,36.0,1129.0,39.0,648.0,5.0,125.0,356.0,93.0,63.0,24,402,193,9485,1194,49384,58869,12/10/2020
2020-05-03,283,10970,2160,66743,77713,31.0,1160.0,26.0,674.0,8.0,133.0,353.0,91.0,61.0,21,423,183,9668,1455,50839,60507,12/10/2020
2020-05-04,387,11357,2098,68841,80198,30.0,1190.0,31.0,705.0,6.0,139.0,346.0,89.0,58.0,18,441,290,9958,1468,52307,62265,12/10/2020
2020-05-05,433,11790,2873,71714,83504,29.0,1219.0,32.0,737.0,6.0,145.0,337.0,83.0,55.0,16,457,299,10257,1844,54151,64408,12/10/2020
2020-05-06,488,12278,2830,74544,86822,28.0,1247.0,44.0,781.0,9.0,154.0,312.0,80.0,55.0,21,478,340,10597,1805,55956,66553,12/10/2020
2020-05-07,425,12703,2969,77513,90216,36.0,1283.0,44.0,825.0,5.0,159.0,299.0,72.0,53.0,21,499,270,10867,1831,57787,68654,12/10/2020
2020-05-08,359,13062,2598,80111,93173,30.0,1313.0,29.0,854.0,5.0,164.0,295.0,72.0,54.0,22,521,230,11097,1578,59365,70462,12/10/2020
2020-05-09,467,13529,3346,83457,96986,22.0,1335.0,21.0,875.0,4.0,168.0,292.0,70.0,52.0,15,536,289,11386,2110,61475,72861,12/10/2020
2020-05-10,285,13814,2117,85574,99388,20.0,1355.0,23.0,898.0,6.0,174.0,283.0,71.0,50.0,14,550,190,11576,1411,62886,74462,12/10/2020
2020-05-11,257,14071,1857,87431,101502,31.0,1386.0,16.0,914.0,6.0,180.0,292.0,72.0,50.0,15,565,173,11749,1229,64115,75864,12/10/2020
2020-05-12,387,14458,2611,90042,104500,23.0,1409.0,18.0,932.0,4.0,184.0,293.0,70.0,49.0,22,587,224,11973,1544,65659,77632,12/10/2020
2020-05-13,351,14809,3630,93672,108481,23.0,1432.0,25.0,957.0,1.0,185.0,290.0,70.0,50.0,13,600,199,12172,1845,67504,79676,12/10/2020
2020-05-14,329,15138,3408,97080,112218,19.0,1451.0,27.0,984.0,3.0,188.0,279.0,65.0,46.0,15,615,232,12404,1866,69370,81774,12/10/2020
2020-05-15,381,15519,3458,100538,116057,24.0,1475.0,41.0,1025.0,5.0,193.0,257.0,63.0,46.0,14,629,232,12636,1716,71086,83722,12/10/2020
2020-05-16,449,15968,4156,104694,120662,25.0,1500.0,15.0,1040.0,5.0,198.0,262.0,62.0,47.0,15,644,247,12883,1832,72918,85801,12/10/2020
2020-05-17,240,16208,2768,107462,123670,17.0,1517.0,9.0,1049.0,5.0,203.0,265.0,60.0,46.0,10,654,126,13009,1445,74363,87372,12/10/2020
2020-05-18,250,16458,2001,109463,125921,19.0,1536.0,16.0,1065.0,5.0,208.0,263.0,58.0,41.0,18,672,135,13144,1305,75668,88812,12/10/2020
2020-05-19,415,16873,3168,112631,129504,23.0,1559.0,33.0,1098.0,5.0,213.0,248.0,57.0,39.0,11,683,215,13359,1831,77499,90858,12/10/2020
2020-05-20,326,17199,2771,115402,132601,19.0,1578.0,23.0,1121.0,7.0,220.0,237.0,53.0,34.0,22,705,184,13543,1453,78952,92495,12/10/2020
2020-05-21,374,17573,3757,119159,136732,25.0,1603.0,15.0,1136.0,3.0,223.0,244.0,54.0,30.0,20,725,168,13711,1849,80801,94512,12/10/2020
2020-05-22,351,17924,3161,122320,140244,20.0,1623.0,28.0,1164.0,5.0,228.0,231.0,53.0,30.0,11,736,206,13917,1516,82317,96234,12/10/2020
2020-05-23,253,18177,2742,125062,143239,19.0,1642.0,11.0,1175.0,3.0,231.0,236.0,53.0,33.0,13,749,109,14026,1211,83528,97554,12/10/2020
2020-05-24,163,18340,1370,126432,144772,13.0,1655.0,14.0,1189.0,2.0,233.0,233.0,54.0,36.0,8,757,83,14109,741,84269,98378,12/10/2020
2020-05-25,147,18487,1385,127817,146304,14.0,1669.0,14.0,1203.0,0.0,233.0,233.0,54.0,34.0,10,767,76,14185,699,84968,99153,12/10/2020
2020-05-26,285,18772,2620,130437,149209,24.0,1693.0,21.0,1224.0,5.0,238.0,231.0,49.0,33.0,15,782,158,14343,1574,86542,100885,12/10/2020
2020-05-27,276,19048,2057,132494,151542,20.0,1713.0,18.0,1242.0,3.0,241.0,230.0,51.0,33.0,10,792,132,14475,1086,87628,102103,12/10/2020
2020-05-28,348,19396,3359,135853,155249,17.0,1730.0,29.0,1271.0,4.0,245.0,214.0,47.0,32.0,8,800,130,14605,1057,88685,103290,12/10/2020
2020-05-29,410,19806,3915,139768,159574,19.0,1749.0,26.0,1297.0,7.0,252.0,200.0,43.0,31.0,12,812,174,14779,1477,90162,104941,12/10/2020
2020-05-30,225,20031,3915,143683,163714,16.0,1765.0,19.0,1316.0,4.0,256.0,193.0,41.0,29.0,12,824,109,14888,1643,91805,106693,12/10/2020
2020-05-31,155,20186,1690,145373,165559,11.0,1776.0,11.0,1327.0,1.0,257.0,192.0,44.0,26.0,3,827,78,14966,790,92595,107561,12/10/2020
2020-06-01,212,20398,2792,148165,168563,8.0,1784.0,14.0,1341.0,1.0,258.0,185.0,45.0,29.0,5,832,93,15059,1321,93916,108975,12/10/2020
2020-06-02,273,20671,3022,151187,171858,8.0,1792.0,9.0,1350.0,3.0,261.0,181.0,38.0,25.0,10,842,98,15157,1366,95282,110439,12/10/2020
2020-06-03,254,20925,3486,154673,175598,14.0,1806.0,18.0,1368.0,6.0,267.0,171.0,34.0,25.0,11,853,99,15256,1575,96857,112113,12/10/2020
2020-06-04,276,21201,4471,159144,180345,7.0,1813.0,26.0,1394.0,4.0,271.0,148.0,31.0,24.0,12,865,107,15363,1915,98772,114135,12/10/2020
2020-06-05,215,21416,3513,162657,184073,15.0,1828.0,13.0,1407.0,6.0,277.0,144.0,27.0,21.0,11,876,99,15462,1464,100236,115698,12/10/2020
2020-06-06,201,21617,2616,165273,186890,10.0,1838.0,7.0,1414.0,2.0,279.0,145.0,29.0,19.0,6,882,67,15529,1067,101303,116832,12/10/2020
2020-06-07,83,21700,1625,166898,188598,11.0,1849.0,7.0,1421.0,1.0,280.0,148.0,25.0,17.0,4,886,51,15580,767,102070,117650,12/10/2020
2020-06-08,119,21819,1849,168747,190566,15.0,1864.0,13.0,1434.0,2.0,282.0,148.0,27.0,18.0,4,890,45,15625,917,102987,118612,12/10/2020
2020-06-09,223,22042,2673,171420,193462,10.0,1874.0,19.0,1453.0,0.0,282.0,139.0,28.0,21.0,1,891,64,15689,1203,104190,119879,12/10/2020
2020-06-10,209,22251,2987,174407,196658,13.0,1887.0,12.0,1465.0,2.0,284.0,138.0,24.0,17.0,4,895,100,15789,1413,105603,121392,12/10/2020
2020-06-11,195,22446,3513,177920,200366,7.0,1894.0,15.0,1480.0,1.0,285.0,129.0,25.0,16.0,6,901,88,15877,1461,107064,122941,12/10/2020
2020-06-12,209,22655,4601,182521,205176,9.0,1903.0,16.0,1496.0,1.0,286.0,121.0,24.0,16.0,2,903,78,15955,2010,109074,125029,12/10/2020
2020-06-13,113,22768,3036,185557,208325,6.0,1909.0,5.0,1501.0,0.0,286.0,122.0,20.0,15.0,3,906,49,16004,1272,110346,126350,12/10/2020
2020-06-14,81,22849,2046,187603,210452,7.0,1916.0,8.0,1509.0,1.0,287.0,120.0,20.0,14.0,3,909,33,16037,933,111279,127316,12/10/2020
2020-06-15,188,23037,3108,190711,213748,14.0,1930.0,19.0,1528.0,0.0,287.0,115.0,20.0,16.0,5,914,75,16112,1714,112993,129105,12/10/2020
2020-06-16,110,23147,3017,193728,216875,11.0,1941.0,9.0,1537.0,1.0,288.0,116.0,22.0,16.0,8,922,50,16162,1478,114471,130633,12/10/2020
2020-06-17,127,23274,2835,196563,219837,15.0,1956.0,20.0,1557.0,4.0,292.0,107.0,18.0,14.0,6,928,51,16213,1261,115732,131945,12/10/2020
2020-06-18,149,23423,3048,199611,223034,9.0,1965.0,15.0,1572.0,1.0,293.0,100.0,19.0,16.0,7,935,70,16283,1266,116998,133281,12/10/2020
2020-06-19,141,23564,3769,203380,226944,12.0,1977.0,12.0,1584.0,1.0,294.0,99.0,20.0,17.0,3,938,59,16342,1309,118307,134649,12/10/2020
2020-06-20,84,23648,1891,205271,228919,9.0,1986.0,12.0,1596.0,0.0,294.0,96.0,20.0,18.0,4,942,36,16378,786,119093,135471,12/10/2020
2020-06-21,37,23685,1064,206335,230020,8.0,1994.0,5.0,1601.0,0.0,294.0,99.0,20.0,18.0,2,944,30,16408,657,119750,136158,12/10/2020
2020-06-22,138,23823,3730,210065,233888,12.0,2006.0,17.0,1618.0,0.0,294.0,94.0,19.0,18.0,2,946,65,16473,1645,121395,137868,12/10/2020
2020-06-23,163,23986,3831,213896,237882,3.0,2009.0,13.0,1631.0,3.0,297.0,81.0,18.0,18.0,7,953,81,16554,1719,123114,139668,12/10/2020
2020-06-24,120,24106,3502,217398,241504,9.0,2018.0,10.0,1641.0,1.0,298.0,79.0,18.0,18.0,5,958,44,16598,1614,124728,141326,12/10/2020
2020-06-25,103,24209,2883,220281,244490,6.0,2024.0,14.0,1655.0,1.0,299.0,70.0,17.0,17.0,1,959,50,16648,1444,126172,142820,12/10/2020
2020-06-26,94,24303,2488,222769,247072,2.0,2026.0,10.0,1665.0,0.0,299.0,62.0,18.0,18.0,1,960,60,16708,1276,127448,144156,12/10/2020
2020-06-27,84,24387,3216,225985,250372,5.0,2031.0,3.0,1668.0,1.0,300.0,63.0,17.0,17.0,5,965,37,16745,1169,128617,145362,12/10/2020
2020-06-28,39,24426,1469,227454,251880,4.0,2035.0,4.0,1672.0,4.0,304.0,59.0,15.0,14.0,6,971,17,16762,577,129194,145956,12/10/2020
2020-06-29,85,24511,3697,231151,255662,4.0,2039.0,5.0,1677.0,0.0,304.0,58.0,14.0,14.0,1,972,39,16801,1308,130502,147303,12/10/2020
2020-06-30,57,24568,1958,233109,257677,1.0,2040.0,5.0,1682.0,1.0,305.0,53.0,12.0,11.0,4,976,32,16833,963,131465,148298,12/10/2020
2020-07-01,144,24712,4098,237207,261919,8.0,2048.0,10.0,1692.0,0.0,305.0,51.0,11.0,11.0,1,977,79,16912,1864,133329,150241,12/10/2020
2020-07-02,103,24815,2803,240010,264825,5.0,2053.0,5.0,1697.0,1.0,306.0,50.0,10.0,10.0,3,980,59,16971,1041,134370,151341,12/10/2020
2020-07-03,50,24865,2079,242089,266954,9.0,2062.0,6.0,1703.0,0.0,306.0,53.0,9.0,9.0,3,983,25,16996,758,135128,152124,12/10/2020
2020-07-04,57,24922,2345,244434,269356,2.0,2064.0,4.0,1707.0,1.0,307.0,50.0,10.0,9.0,2,985,33,17029,967,136095,153124,12/10/2020
2020-07-05,49,24971,2932,247366,272337,1.0,2065.0,2.0,1709.0,1.0,308.0,48.0,8.0,8.0,2,987,26,17055,1377,137472,154527,12/10/2020
2020-07-06,101,25072,2814,250180,275252,6.0,2071.0,6.0,1715.0,0.0,308.0,48.0,9.0,9.0,4,991,57,17112,1507,138979,156091,12/10/2020
2020-07-07,81,25153,3457,253637,278790,5.0,2076.0,7.0,1722.0,0.0,308.0,46.0,8.0,8.0,2,993,47,17159,1495,140474,157633,12/10/2020
2020-07-08,105,25258,3409,257046,282304,4.0,2080.0,2.0,1724.0,0.0,308.0,48.0,9.0,8.0,0,993,64,17223,1359,141833,159056,12/10/2020
2020-07-09,94,25352,3714,260760,286112,9.0,2089.0,3.0,1727.0,0.0,308.0,54.0,9.0,8.0,0,993,50,17273,1561,143394,160667,12/10/2020
2020-07-10,132,25484,4437,265197,290681,6.0,2095.0,3.0,1730.0,2.0,310.0,55.0,7.0,7.0,3,996,80,17353,2000,145394,162747,12/10/2020
2020-07-11,63,25547,2938,268135,293682,6.0,2101.0,3.0,1733.0,1.0,311.0,57.0,6.0,6.0,3,999,36,17389,1270,146664,164053,12/10/2020
2020-07-12,47,25594,1838,269973,295567,1.0,2102.0,3.0,1736.0,1.0,312.0,54.0,6.0,5.0,3,1002,34,17423,915,147579,165002,12/10/2020
2020-07-13,84,25678,3209,273182,298860,8.0,2110.0,10.0,1746.0,0.0,312.0,52.0,6.0,5.0,1,1003,61,17484,1455,149034,166518,12/10/2020
2020-07-14,74,25752,3298,276480,302232,7.0,2117.0,4.0,1750.0,0.0,312.0,55.0,5.0,5.0,1,1004,44,17528,1336,150370,167898,12/10/2020
2020-07-15,130,25882,4181,280661,306543,5.0,2122.0,7.0,1757.0,0.0,312.0,53.0,5.0,4.0,0,1004,100,17628,1691,152061,169689,12/10/2020
2020-07-16,103,25985,3740,284401,310386,6.0,2128.0,9.0,1766.0,0.0,312.0,50.0,6.0,5.0,1,1005,76,17704,1555,153616,171320,12/10/2020
2020-07-17,156,26141,4239,288640,314781,14.0,2142.0,3.0,1769.0,1.0,313.0,60.0,5.0,5.0,2,1007,79,17783,1790,155406,173189,12/10/2020
2020-07-18,85,26226,3272,291912,318138,5.0,2147.0,9.0,1778.0,1.0,314.0,55.0,5.0,4.0,4,1011,70,17853,1350,156756,174609,12/10/2020
2020-07-19,82,26308,2696,294608,320916,7.0,2154.0,3.0,1781.0,0.0,314.0,59.0,6.0,4.0,2,1013,57,17910,1102,157858,175768,12/10/2020
2020-07-20,71,26379,2666,297274,323653,9.0,2163.0,7.0,1788.0,0.0,314.0,61.0,7.0,5.0,2,1015,68,17978,1408,159266,177244,12/10/2020
2020-07-21,130,26509,4304,301578,328087,9.0,2172.0,11.0,1799.0,0.0,314.0,59.0,9.0,6.0,1,1016,108,18086,1862,161128,179214,12/10/2020
2020-07-22,130,26639,3928,305506,332145,7.0,2179.0,8.0,1807.0,1.0,315.0,57.0,7.0,6.0,1,1017,86,18172,1614,162742,180914,12/10/2020
2020-07-23,141,26780,4415,309921,336701,8.0,2187.0,6.0,1813.0,0.0,315.0,59.0,8.0,7.0,0,1017,115,18287,1904,164646,182933,12/10/2020
2020-07-24,172,26952,5966,315887,342839,15.0,2202.0,12.0,1825.0,0.0,315.0,62.0,9.0,7.0,0,1017,119,18406,2236,166882,185288,12/10/2020
2020-07-25,134,27086,4398,320285,347371,7.0,2209.0,7.0,1832.0,0.0,315.0,62.0,10.0,8.0,3,1020,108,18514,2032,168914,187428,12/10/2020
2020-07-26,62,27148,3033,323318,350466,8.0,2217.0,9.0,1841.0,0.0,315.0,61.0,11.0,7.0,1,1021,54,18568,1296,170210,188778,12/10/2020
2020-07-27,188,27336,4191,327509,354845,12.0,2229.0,7.0,1848.0,0.0,315.0,66.0,13.0,8.0,1,1022,138,18706,2262,172472,191178,12/10/2020
2020-07-28,105,27441,3840,331349,358790,5.0,2234.0,5.0,1853.0,0.0,315.0,66.0,14.0,7.0,1,1023,95,18801,1587,174059,192860,12/10/2020
2020-07-29,190,27631,5139,336488,364119,9.0,2243.0,10.0,1863.0,0.0,315.0,65.0,15.0,7.0,0,1023,154,18955,2224,176283,195238,12/10/2020
2020-07-30,121,27752,4345,340833,368585,6.0,2249.0,2.0,1865.0,1.0,316.0,68.0,15.0,6.0,1,1024,97,19052,1569,177852,196904,12/10/2020
2020-07-31,131,27883,5512,346345,374228,7.0,2256.0,9.0,1874.0,0.0,316.0,66.0,15.0,7.0,1,1025,89,19141,1777,179629,198770,12/10/2020
2020-08-01,109,27992,4294,350639,378631,7.0,2263.0,2.0,1876.0,0.0,316.0,71.0,14.0,7.0,1,1026,89,19230,1506,181135,200365,12/10/2020
2020-08-02,84,28076,2804,353443,381519,12.0,2275.0,12.0,1888.0,2.0,318.0,69.0,14.0,8.0,2,1028,62,19292,1234,182369,201661,12/10/2020
2020-08-03,188,28264,5248,358691,386955,11.0,2286.0,10.0,1898.0,0.0,318.0,70.0,16.0,7.0,1,1029,150,19442,2129,184498,203940,12/10/2020
2020-08-04,125,28389,3691,362382,390771,8.0,2294.0,5.0,1903.0,1.0,319.0,72.0,12.0,5.0,2,1031,99,19541,1713,186211,205752,12/10/2020
2020-08-05,147,28536,5935,368317,396853,11.0,2305.0,9.0,1912.0,1.0,320.0,73.0,10.0,5.0,2,1033,119,19660,2379,188590,208250,12/10/2020
2020-08-06,169,28705,5546,373863,402568,7.0,2312.0,9.0,1921.0,0.0,320.0,71.0,9.0,4.0,0,1033,120,19780,2313,190903,210683,12/10/2020
2020-08-07,123,28828,4851,378714,407542,12.0,2324.0,9.0,1930.0,1.0,321.0,73.0,9.0,3.0,2,1035,87,19867,2063,192966,212833,12/10/2020
2020-08-08,123,28951,4112,382826,411777,19.0,2343.0,6.0,1936.0,1.0,322.0,85.0,8.0,3.0,1,1036,91,19958,1724,194690,214648,12/10/2020
2020-08-09,42,28993,1727,384553,413546,6.0,2349.0,8.0,1944.0,0.0,322.0,83.0,9.0,4.0,0,1036,35,19993,1034,195724,215717,12/10/2020
2020-08-10,149,29142,4587,389140,418282,8.0,2357.0,9.0,1953.0,0.0,322.0,82.0,9.0,4.0,1,1037,113,20106,1955,197679,217785,12/10/2020
2020-08-11,106,29248,4334,393474,422722,5.0,2362.0,13.0,1966.0,0.0,322.0,74.0,10.0,4.0,3,1040,92,20198,2202,199881,220079,12/10/2020
2020-08-12,121,29369,5188,398662,428031,8.0,2370.0,11.0,1977.0,0.0,322.0,71.0,9.0,3.0,1,1041,101,20299,2529,202410,222709,12/10/2020
2020-08-13,135,29504,4196,402858,432362,13.0,2383.0,12.0,1989.0,0.0,322.0,72.0,11.0,3.0,0,1041,95,20394,1841,204251,224645,12/10/2020
2020-08-14,145,29649,5498,408356,438005,13.0,2396.0,11.0,2000.0,0.0,322.0,74.0,11.0,4.0,3,1044,98,20492,1911,206162,226654,12/10/2020
2020-08-15,106,29755,4534,412890,442645,9.0,2405.0,11.0,2011.0,1.0,323.0,71.0,11.0,5.0,0,1044,88,20580,1634,207796,228376,12/10/2020
2020-08-16,83,29838,2477,415367,445205,6.0,2411.0,5.0,2016.0,4.0,327.0,68.0,8.0,4.0,6,1050,70,20650,925,208721,229371,12/10/2020
2020-08-17,106,29944,4575,419942,449886,8.0,2419.0,6.0,2022.0,0.0,327.0,70.0,8.0,5.0,2,1052,87,20737,2320,211041,231778,12/10/2020
2020-08-18,128,30072,4911,424853,454925,11.0,2430.0,8.0,2030.0,1.0,328.0,72.0,8.0,4.0,5,1057,94,20831,2665,213706,234537,12/10/2020
2020-08-19,113,30185,5077,429930,460115,8.0,2438.0,9.0,2039.0,1.0,329.0,70.0,9.0,5.0,0,1057,90,20921,2565,216271,237192,12/10/2020
2020-08-20,173,30358,7411,437341,467699,12.0,2450.0,6.0,2045.0,2.0,331.0,74.0,10.0,5.0,3,1060,139,21060,3423,219694,240754,12/10/2020
2020-08-21,152,30510,6577,443918,474428,8.0,2458.0,5.0,2050.0,1.0,332.0,76.0,9.0,4.0,2,1062,125,21185,2844,222538,243723,12/10/2020
2020-08-22,96,30606,5550,449468,480074,11.0,2469.0,12.0,2062.0,0.0,332.0,75.0,11.0,4.0,1,1063,84,21269,2514,225052,246321,12/10/2020
2020-08-23,72,30678,4375,453843,484521,11.0,2480.0,6.0,2068.0,0.0,332.0,80.0,12.0,2.0,1,1064,56,21325,2420,227472,248797,12/10/2020
2020-08-24,105,30783,5784,459627,490410,7.0,2487.0,10.0,2078.0,1.0,333.0,76.0,14.0,4.0,1,1065,77,21402,3064,230536,251938,12/10/2020
2020-08-25,108,30891,4764,464391,495282,10.0,2497.0,4.0,2082.0,1.0,334.0,81.0,12.0,4.0,1,1066,92,21494,2231,232767,254261,12/10/2020
2020-08-26,170,31061,9482,473873,504934,4.0,2501.0,8.0,2090.0,0.0,334.0,77.0,10.0,5.0,1,1067,127,21621,3003,235770,257391,12/10/2020
2020-08-27,91,31152,8565,482438,513590,6.0,2507.0,13.0,2103.0,1.0,335.0,69.0,7.0,5.0,2,1069,70,21691,3059,238829,260520,12/10/2020
2020-08-28,113,31265,7994,490432,521697,14.0,2521.0,4.0,2107.0,0.0,335.0,79.0,10.0,7.0,2,1071,87,21778,2354,241183,262961,12/10/2020
2020-08-29,65,31330,5374,495806,527136,6.0,2527.0,8.0,2115.0,1.0,336.0,76.0,11.0,6.0,2,1073,51,21829,1866,243049,264878,12/10/2020
2020-08-30,66,31396,4323,500129,531525,7.0,2534.0,4.0,2119.0,0.0,336.0,79.0,9.0,5.0,2,1075,48,21877,1936,244985,266862,12/10/2020
2020-08-31,105,31501,4863,504992,536493,12.0,2546.0,16.0,2135.0,0.0,336.0,75.0,8.0,4.0,1,1076,81,21958,2132,247117,269075,12/10/2020
2020-09-01,99,31600,7109,512101,543701,6.0,2552.0,9.0,2144.0,1.0,337.0,71.0,7.0,4.0,2,1078,66,22024,2318,249435,271459,12/10/2020
2020-09-02,125,31725,10529,522630,554355,9.0,2561.0,10.0,2154.0,1.0,338.0,69.0,8.0,4.0,2,1080,104,22128,2974,252409,274537,12/10/2020
2020-09-03,90,31815,11080,533710,565525,8.0,2569.0,8.0,2162.0,0.0,338.0,69.0,9.0,4.0,3,1083,73,22201,2504,254913,277114,12/10/2020
2020-09-04,103,31918,8963,542673,574591,11.0,2580.0,4.0,2166.0,0.0,338.0,76.0,9.0,4.0,1,1084,83,22284,2302,257215,279499,12/10/2020
2020-09-05,52,31970,6309,548982,580952,6.0,2586.0,9.0,2175.0,0.0,338.0,73.0,8.0,3.0,1,1085,42,22326,1556,258771,281097,12/10/2020
2020-09-06,88,32058,4325,553307,585365,4.0,2590.0,8.0,2183.0,1.0,339.0,68.0,6.0,3.0,1,1086,65,22391,1893,260664,283055,12/10/2020
2020-09-07,35,32093,3002,556309,588402,11.0,2601.0,3.0,2186.0,0.0,339.0,76.0,5.0,3.0,1,1087,26,22417,622,261286,283703,12/10/2020
2020-09-08,74,32167,6381,562690,594857,6.0,2607.0,12.0,2198.0,1.0,340.0,69.0,6.0,3.0,2,1089,66,22483,1544,262830,285313,12/10/2020
2020-09-09,118,32285,8650,571340,603625,10.0,2617.0,5.0,2203.0,1.0,341.0,73.0,9.0,3.0,1,1090,102,22585,2072,264902,287487,12/10/2020
2020-09-10,164,32449,11334,582674,615123,9.0,2626.0,8.0,2211.0,0.0,341.0,74.0,10.0,3.0,1,1091,111,22696,2197,267099,289795,12/10/2020
2020-09-11,120,32569,9454,592128,624697,11.0,2637.0,11.0,2222.0,0.0,341.0,74.0,10.0,5.0,0,1091,97,22793,1902,269001,291794,12/10/2020
2020-09-12,110,32679,6174,598302,630981,8.0,2645.0,5.0,2227.0,2.0,343.0,75.0,9.0,5.0,3,1094,97,22890,1469,270470,293360,12/10/2020
2020-09-13,58,32737,2717,601019,633756,4.0,2649.0,3.0,2230.0,0.0,343.0,76.0,10.0,5.0,0,1094,54,22944,833,271303,294247,12/10/2020
2020-09-14,104,32841,6446,607465,640306,6.0,2655.0,3.0,2233.0,2.0,345.0,77.0,10.0,5.0,2,1096,95,23039,1669,272972,296011,12/10/2020
2020-09-15,122,32963,8470,615935,648898,7.0,2662.0,2.0,2235.0,1.0,346.0,81.0,10.0,5.0,2,1098,124,23163,2131,275103,298266,12/10/2020
2020-09-16,137,33100,9716,625651,658751,7.0,2669.0,7.0,2242.0,2.0,348.0,79.0,9.0,6.0,5,1103,118,23281,1912,277015,300296,12/10/2020
2020-09-17,125,33225,9239,634890,668115,7.0,2676.0,15.0,2257.0,0.0,348.0,71.0,8.0,4.0,0,1103,154,23435,1889,278904,302339,12/10/2020
2020-09-18,132,33357,10045,644935,678292,7.0,2683.0,7.0,2264.0,1.0,349.0,70.0,11.0,6.0,2,1105,132,23567,1871,280775,304342,12/10/2020
2020-09-19,115,33472,8297,653232,686704,7.0,2690.0,3.0,2267.0,0.0,349.0,74.0,10.0,6.0,4,1109,112,23679,1657,282432,306111,12/10/2020
2020-09-20,60,33532,3676,656908,690440,7.0,2697.0,6.0,2273.0,2.0,351.0,73.0,9.0,8.0,4,1113,49,23728,1292,283724,307452,12/10/2020
2020-09-21,102,33634,7018,663926,697560,12.0,2709.0,3.0,2276.0,2.0,353.0,80.0,8.0,6.0,2,1115,94,23822,2348,286072,309894,12/10/2020
2020-09-22,154,33788,9287,673213,707001,12.0,2721.0,3.0,2279.0,1.0,354.0,88.0,7.0,5.0,1,1116,124,23946,2129,288201,312147,12/10/2020
2020-09-23,136,33924,10651,683864,717788,12.0,2733.0,7.0,2286.0,0.0,354.0,93.0,6.0,5.0,0,1116,127,24073,2143,290344,314417,12/10/2020
2020-09-24,120,34044,12480,696344,730388,8.0,2741.0,9.0,2295.0,1.0,355.0,91.0,7.0,5.0,1,1117,120,24193,3089,293433,317626,12/10/2020
2020-09-25,150,34194,10553,706897,741091,9.0,2750.0,10.0,2305.0,0.0,355.0,90.0,6.0,5.0,1,1118,143,24336,2932,296365,320701,12/10/2020
2020-09-26,147,34341,10560,717457,751798,12.0,2762.0,9.0,2314.0,0.0,355.0,93.0,6.0,5.0,1,1119,120,24456,2368,298733,323189,12/10/2020
2020-09-27,43,34384,2764,720221,754605,7.0,2769.0,5.0,2319.0,0.0,355.0,95.0,9.0,5.0,0,1119,34,24490,825,299558,324048,12/10/2020
2020-09-28,156,34540,7307,727528,762068,7.0,2776.0,7.0,2326.0,2.0,357.0,93.0,7.0,5.0,2,1121,138,24628,2197,301755,326383,12/10/2020
2020-09-29,203,34743,11046,738574,773317,12.0,2788.0,18.0,2344.0,1.0,358.0,86.0,6.0,6.0,1,1122,185,24813,2754,304509,329322,12/10/2020
2020-09-30,223,34966,12230,750804,785770,6.0,2794.0,6.0,2350.0,0.0,358.0,86.0,6.0,6.0,1,1123,189,25002,2505,307014,332016,12/10/2020
2020-10-01,185,35151,12503,763307,798458,17.0,2811.0,13.0,2363.0,1.0,359.0,89.0,6.0,4.0,2,1125,166,25168,2339,309353,334521,12/10/2020
2020-10-02,209,35360,12154,775461,810821,14.0,2825.0,13.0,2376.0,1.0,360.0,89.0,8.0,5.0,2,1127,181,25349,2435,311788,337137,12/10/2020
2020-10-03,157,35517,9313,784774,820291,9.0,2834.0,9.0,2385.0,2.0,362.0,87.0,9.0,4.0,2,1129,131,25480,1969,313757,339237,12/10/2020
2020-10-04,81,35598,2369,787143,822741,11.0,2845.0,9.0,2394.0,1.0,363.0,88.0,8.0,5.0,2,1131,77,25557,929,314686,340243,12/10/2020
2020-10-05,174,35772,8982,796125,831897,30.0,2875.0,10.0,2404.0,2.0,365.0,106.0,9.0,6.0,4,1135,160,25717,2961,317647,343364,12/10/2020
2020-10-06,187,35959,11186,807311,843270,11.0,2886.0,4.0,2408.0,0.0,365.0,113.0,11.0,7.0,0,1135,188,25905,2827,320474,346379,12/10/2020
2020-10-07,242,36201,12442,819753,855954,13.0,2899.0,14.0,2422.0,2.0,367.0,110.0,9.0,7.0,2,1137,244,26149,3452,323926,350075,12/10/2020
2020-10-08,279,36480,15231,834984,871464,17.0,2916.0,13.0,2435.0,2.0,369.0,112.0,7.0,5.0,4,1141,277,26426,4130,328056,354482,12/10/2020
2020-10-09,229,36709,13745,848729,885438,21.0,2937.0,12.0,2447.0,0.0,369.0,121.0,10.0,7.0,3,1144,200,26626,4202,332258,358884,12/10/2020
2020-10-10,231,36940,13832,862561,899501,19.0,2956.0,10.0,2457.0,1.0,370.0,129.0,13.0,7.0,2,1146,192,26818,3707,335965,362783,12/10/2020
2020-10-11,97,37037,3263,865824,902861,12.0,2968.0,9.0,2466.0,1.0,371.0,131.0,14.0,5.0,6,1152,87,26905,1138,337103,364008,12/10/2020
2020-10-12,169,37206,6440,872264,909470,19.0,2987.0,15.0,2481.0,2.0,373.0,133.0,14.0,5.0,4,1156,157,27062,1681,338784,365846,12/10/2020
2020-10-13,213,37419,8522,880786,918205,15.0,3002.0,13.0,2494.0,4.0,377.0,131.0,13.0,5.0,7,1163,207,27269,2269,341053,368322,12/10/2020
2020-10-14,322,37741,15039,895825,933566,17.0,3019.0,7.0,2501.0,0.0,377.0,141.0,15.0,5.0,2,1165,299,27568,3938,344991,372559,12/10/2020
2020-10-15,262,38003,14639,910464,948467,12.0,3031.0,16.0,2517.0,1.0,378.0,136.0,13.0,5.0,2,1167,253,27821,3487,348478,376299,12/10/2020
2020-10-16,279,38282,15011,925475,963757,13.0,3044.0,18.0,2535.0,1.0,379.0,130.0,13.0,4.0,2,1169,275,28096,3294,351772,379868,12/10/2020
2020-10-17,354,38636,14069,939544,978180,19.0,3063.0,11.0,2546.0,1.0,380.0,137.0,17.0,4.0,2,1171,309,28405,3187,354959,383364,12/10/2020
2020-10-18,155,38791,4039,943583,982374,18.0,3081.0,11.0,2557.0,0.0,380.0,144.0,17.0,6.0,2,1173,126,28531,1278,356237,384768,12/10/2020
2020-10-19,388,39179,8491,952074,991253,21.0,3102.0,22.0,2579.0,2.0,382.0,141.0,15.0,6.0,1,1174,323,28854,2499,358736,387590,12/10/2020
2020-10-20,439,39618,13242,965316,1004934,23.0,3125.0,17.0,2596.0,0.0,382.0,147.0,14.0,8.0,3,1177,387,29241,2935,361671,390912,12/10/2020
2020-10-21,544,40162,17463,982779,1022941,23.0,3148.0,8.0,2604.0,2.0,384.0,160.0,15.0,9.0,3,1180,472,29713,3411,365082,394795,12/10/2020
2020-10-22,538,40700,15863,998642,1039342,24.0,3172.0,20.0,2624.0,3.0,387.0,161.0,14.0,9.0,3,1183,489,30202,3107,368189,398391,12/10/2020
2020-10-23,514,41214,16634,1015276,1056490,22.0,3194.0,22.0,2646.0,1.0,388.0,160.0,15.0,9.0,3,1186,458,30660,2821,371010,401670,12/10/2020
2020-10-24,359,41573,10249,1025525,1067098,17.0,3211.0,11.0,2657.0,0.0,388.0,166.0,14.0,8.0,1,1187,338,30998,2207,373217,404215,12/10/2020
2020-10-25,233,41806,4760,1030285,1072091,16.0,3227.0,15.0,2672.0,1.0,389.0,166.0,15.0,8.0,2,1189,209,31207,1412,374629,405836,12/10/2020
2020-10-26,454,42260,9174,1039459,1081719,27.0,3254.0,15.0,2687.0,2.0,391.0,176.0,18.0,8.0,3,1192,403,31610,2906,377535,409145,12/10/2020
2020-10-27,517,42777,13995,1053454,1096231,29.0,3283.0,15.0,2702.0,2.0,393.0,188.0,18.0,9.0,4,1196,453,32063,2340,379875,411938,12/10/2020
2020-10-28,469,43246,15229,1068683,1111929,25.0,3308.0,26.0,2728.0,1.0,394.0,186.0,17.0,9.0,3,1199,411,32474,2631,382506,414980,12/10/2020
2020-10-29,609,43855,16259,1084942,1128797,20.0,3328.0,22.0,2750.0,3.0,397.0,181.0,19.0,11.0,4,1203,526,33000,3061,385567,418567,12/10/2020
2020-10-30,565,44420,14863,1099805,1144225,21.0,3349.0,21.0,2771.0,5.0,402.0,176.0,19.0,9.0,4,1207,467,33467,2883,388450,421917,12/10/2020
2020-10-31,599,45019,11820,1111625,1156644,31.0,3380.0,13.0,2784.0,1.0,403.0,193.0,22.0,9.0,3,1210,483,33950,2357,390807,424757,12/10/2020
2020-11-01,330,45349,5091,1116716,1162065,22.0,3402.0,15.0,2799.0,1.0,404.0,199.0,26.0,12.0,4,1214,273,34223,1242,392049,426272,12/10/2020
2020-11-02,521,45870,9930,1126646,1172516,38.0,3440.0,27.0,2826.0,3.0,407.0,207.0,24.0,12.0,5,1219,455,34678,2866,394915,429593,12/10/2020
2020-11-03,602,46472,13040,1139686,1186158,33.0,3473.0,25.0,2851.0,1.0,408.0,214.0,24.0,12.0,1,1220,529,35207,2455,397370,432577,12/10/2020
2020-11-04,688,47160,16100,1155786,1202946,34.0,3507.0,27.0,2878.0,2.0,410.0,219.0,25.0,12.0,4,1224,632,35839,2871,400241,436080,12/10/2020
2020-11-05,768,47928,16593,1172379,1220307,46.0,3553.0,35.0,2913.0,1.0,411.0,229.0,24.0,14.0,3,1227,682,36521,2795,403036,439557,12/10/2020
2020-11-06,769,48697,16022,1188401,1237098,43.0,3596.0,31.0,2944.0,1.0,412.0,240.0,28.0,17.0,5,1232,691,37212,2984,406020,443232,12/10/2020
2020-11-07,604,49301,13650,1202051,1251352,34.0,3630.0,25.0,2969.0,1.0,413.0,248.0,31.0,18.0,1,1233,576,37788,2414,408434,446222,12/10/2020
2020-11-08,337,49638,4160,1206211,1255849,33.0,3663.0,26.0,2995.0,1.0,414.0,254.0,30.0,19.0,4,1237,321,38109,1253,409687,447796,12/10/2020
2020-11-09,807,50445,9040,1215251,1265696,40.0,3703.0,33.0,3028.0,2.0,416.0,259.0,28.0,18.0,3,1240,763,38872,2275,411962,450834,12/10/2020
2020-11-10,1053,51498,12982,1228233,1279731,45.0,3748.0,37.0,3065.0,0.0,416.0,267.0,31.0,18.0,6,1246,979,39851,2839,414801,454652,12/10/2020
2020-11-11,1087,52585,19741,1247974,1300559,42.0,3790.0,24.0,3089.0,5.0,421.0,280.0,30.0,15.0,7,1253,1001,40852,2637,417438,458290,12/10/2020
2020-11-12,893,53478,13902,1261876,1315354,39.0,3829.0,31.0,3120.0,3.0,424.0,285.0,28.0,15.0,5,1258,811,41663,2170,419608,461271,12/10/2020
2020-11-13,1165,54643,16390,1278266,1332909,39.0,3868.0,31.0,3151.0,0.0,424.0,293.0,27.0,15.0,2,1260,1115,42778,3054,422662,465440,12/10/2020
2020-11-14,782,55425,13517,1291783,1347208,42.0,3910.0,26.0,3177.0,5.0,429.0,304.0,25.0,13.0,10,1270,738,43516,2431,425093,468609,12/10/2020
2020-11-15,578,56003,6173,1297956,1353959,46.0,3956.0,21.0,3198.0,5.0,434.0,324.0,28.0,11.0,7,1277,495,44011,1399,426492,470503,12/10/2020
2020-11-16,738,56741,9614,1307570,1364311,56.0,4012.0,39.0,3237.0,3.0,437.0,338.0,26.0,13.0,5,1282,673,44684,2592,429084,473768,12/10/2020
2020-11-17,1538,58279,18173,1325743,1384022,59.0,4071.0,45.0,3282.0,2.0,439.0,350.0,30.0,13.0,5,1287,1401,46085,4076,433160,479245,12/10/2020
2020-11-18,1124,59403,16029,1341772,1401175,38.0,4109.0,38.0,3320.0,5.0,444.0,345.0,29.0,15.0,7,1294,1012,47097,3149,436309,483406,12/10/2020
2020-11-19,1128,60531,13170,1354942,1415473,46.0,4155.0,42.0,3362.0,4.0,448.0,345.0,30.0,18.0,5,1299,1034,48131,3367,439676,487807,12/10/2020
2020-11-20,1456,61987,22223,1377165,1439152,49.0,4204.0,48.0,3410.0,3.0,451.0,343.0,33.0,14.0,6,1305,1293,49424,4272,443948,493372,12/10/2020
2020-11-21,853,62840,17370,1394535,1457375,43.0,4247.0,34.0,3444.0,5.0,456.0,347.0,35.0,14.0,7,1312,755,50179,3113,447061,497240,12/10/2020
2020-11-22,571,63411,7519,1402054,1465465,64.0,4311.0,28.0,3472.0,4.0,460.0,379.0,33.0,15.0,11,1323,486,50665,1779,448840,499505,12/10/2020
2020-11-23,980,64391,11025,1413079,1477470,72.0,4383.0,39.0,3511.0,0.0,460.0,412.0,40.0,18.0,10,1333,885,51550,3389,452229,503779,12/10/2020
2020-11-24,1045,65436,14578,1427657,1493093,47.0,4430.0,60.0,3571.0,6.0,466.0,393.0,42.0,22.0,10,1343,937,52487,2752,454981,507468,12/10/2020
2020-11-25,1265,66701,18788,1446445,1513146,59.0,4489.0,58.0,3629.0,4.0,470.0,390.0,43.0,26.0,7,1350,1176,53663,3523,458504,512167,12/10/2020
2020-11-26,547,67248,6483,1452928,1520176,51.0,4540.0,36.0,3665.0,4.0,474.0,401.0,46.0,25.0,12,1362,468,54131,1563,460067,514198,12/10/2020
2020-11-27,1031,68279,9718,1462646,1530925,54.0,4594.0,50.0,3715.0,7.0,481.0,398.0,47.0,22.0,6,1368,960,55091,2515,462582,517673,12/10/2020
2020-11-28,1173,69452,11951,1474597,1544049,64.0,4658.0,40.0,3755.0,0.0,481.0,422.0,48.0,22.0,3,1371,1086,56177,2802,465384,521561,12/10/2020
2020-11-29,818,70270,6935,1481532,1551802,62.0,4720.0,35.0,3790.0,3.0,484.0,446.0,49.0,24.0,8,1379,752,56929,2310,467694,524623,12/10/2020
2020-11-30,1276,71546,9916,1491448,1562994,67.0,4787.0,60.0,3850.0,2.0,486.0,451.0,52.0,30.0,6,1385,1152,58081,2800,470494,528575,12/10/2020
2020-12-01,1548,73094,13945,1505393,1578487,58.0,4845.0,55.0,3905.0,4.0,490.0,450.0,51.0,31.0,12,1397,1413,59494,3376,473870,533364,12/10/2020
2020-12-02,1556,74650,15568,1520961,1595611,55.0,4900.0,53.0,3958.0,7.0,497.0,445.0,52.0,30.0,14,1411,1421,60915,3255,477125,538040,12/10/2020
2020-12-03,1760,76410,14626,1535587,1611997,64.0,4964.0,76.0,4034.0,5.0,502.0,428.0,48.0,31.0,10,1421,1634,62549,3326,480451,543000,12/10/2020
2020-12-04,1650,78060,16515,1552102,1630162,65.0,5029.0,50.0,4084.0,7.0,509.0,436.0,44.0,29.0,11,1432,1512,64061,3815,484266,548327,12/10/2020
2020-12-05,1201,79261,12606,1564708,1643969,69.0,5098.0,41.0,4125.0,4.0,513.0,460.0,47.0,29.0,11,1443,1051,65112,2898,487164,552276,12/10/2020
2020-12-06,1125,80386,7833,1572541,1652927,65.0,5163.0,50.0,4175.0,10.0,523.0,465.0,47.0,24.0,14,1457,973,66085,2516,489680,555765,12/10/2020
2020-12-07,1354,81740,10605,1583146,1664886,73.0,5236.0,56.0,4231.0,6.0,529.0,476.0,45.0,24.0,18,1475,982,67067,3332,493012,560079,12/10/2020
2020-12-08,1384,83124,14934,1598080,1681204,52.0,5288.0,57.0,4288.0,5.0,534.0,466.0,48.0,25.0,14,1489,1232,68299,3546,496558,564857,12/10/2020
2020-12-09,1068,84192,12530,1610610,1694802,,,,,,,,,,9,1498,948,69247,2399,498957,568204,12/10/2020
2020-02-27,0,0,0,0,0,1.0,1.0,0.0,0.0,0.0,0.0,1.0,0.0,0.0,0,0,0,0,0,0,0,12/11/2020
2020-02-28,0,0,0,0,0,0.0,1.0,0.0,0.0,0.0,0.0,1.0,1.0,0.0,0,0,0,0,0,0,0,12/11/2020
2020-02-29,0,0,0,0,0,0.0,1.0,0.0,0.0,0.0,0.0,1.0,1.0,0.0,0,0,0,0,0,0,0,12/11/2020
2020-03-01,2,2,2,2,4,0.0,1.0,0.0,0.0,0.0,0.0,1.0,1.0,1.0,0,0,2,2,2,2,4,12/11/2020
2020-03-02,0,2,1,3,5,1.0,2.0,0.0,0.0,0.0,0.0,2.0,2.0,2.0,0,0,0,2,0,2,4,12/11/2020
2020-03-03,0,2,2,5,7,0.0,2.0,0.0,0.0,0.0,0.0,2.0,2.0,2.0,0,0,0,2,1,3,5,12/11/2020
2020-03-04,0,2,12,17,19,1.0,3.0,0.0,0.0,0.0,0.0,3.0,2.0,2.0,0,0,0,2,10,13,15,12/11/2020
2020-03-05,0,2,4,21,23,0.0,3.0,0.0,0.0,0.0,0.0,3.0,2.0,2.0,0,0,1,3,4,17,20,12/11/2020
2020-03-06,1,3,12,33,36,0.0,3.0,0.0,0.0,0.0,0.0,3.0,2.0,2.0,0,0,0,3,11,28,31,12/11/2020
2020-03-07,0,3,19,52,55,0.0,3.0,0.0,0.0,0.0,0.0,3.0,2.0,1.0,0,0,0,3,19,47,50,12/11/2020
2020-03-08,0,3,18,70,73,0.0,3.0,0.0,0.0,0.0,0.0,3.0,2.0,1.0,0,0,0,3,18,65,68,12/11/2020
2020-03-09,1,4,15,85,89,0.0,3.0,0.0,0.0,0.0,0.0,3.0,2.0,1.0,0,0,1,4,14,79,83,12/11/2020
2020-03-10,2,6,25,110,116,0.0,3.0,0.0,0.0,0.0,0.0,3.0,2.0,1.0,0,0,1,5,23,102,107,12/11/2020
2020-03-11,0,6,34,144,150,1.0,4.0,0.0,0.0,0.0,0.0,4.0,1.0,1.0,0,0,0,5,34,136,141,12/11/2020
2020-03-12,9,15,41,185,200,1.0,5.0,0.0,0.0,0.0,0.0,5.0,1.0,1.0,0,0,7,12,38,174,186,12/11/2020
2020-03-13,6,21,50,235,256,4.0,9.0,1.0,1.0,0.0,0.0,8.0,1.0,1.0,0,0,6,18,47,221,239,12/11/2020
2020-03-14,0,21,90,325,346,0.0,9.0,0.0,1.0,0.0,0.0,8.0,1.0,1.0,0,0,0,18,83,304,322,12/11/2020
2020-03-15,1,22,54,379,401,1.0,10.0,0.0,1.0,0.0,0.0,9.0,2.0,1.0,0,0,1,19,53,357,376,12/11/2020
2020-03-16,2,24,95,474,498,2.0,12.0,0.0,1.0,0.0,0.0,11.0,2.0,0.0,0,0,2,21,90,447,468,12/11/2020
2020-03-17,12,36,162,636,672,6.0,18.0,0.0,1.0,0.0,0.0,17.0,2.0,0.0,0,0,11,32,143,590,622,12/11/2020
2020-03-18,9,45,116,752,797,3.0,21.0,0.0,1.0,0.0,0.0,20.0,2.0,0.0,0,0,11,43,105,695,738,12/11/2020
2020-03-19,15,60,262,1014,1074,2.0,23.0,1.0,2.0,0.0,0.0,21.0,3.0,0.0,1,1,17,60,245,940,1000,12/11/2020
2020-03-20,13,73,197,1211,1284,5.0,28.0,0.0,2.0,0.0,0.0,26.0,4.0,0.0,0,1,13,73,183,1123,1196,12/11/2020
2020-03-21,12,85,126,1337,1422,3.0,31.0,2.0,4.0,0.0,0.0,27.0,5.0,0.0,0,1,14,87,119,1242,1329,12/11/2020
2020-03-22,27,112,282,1619,1731,2.0,33.0,0.0,4.0,0.0,0.0,29.0,5.0,0.0,0,1,25,112,252,1494,1606,12/11/2020
2020-03-23,14,126,169,1788,1914,15.0,48.0,1.0,5.0,0.0,0.0,43.0,9.0,3.0,0,1,16,128,158,1652,1780,12/11/2020
2020-03-24,20,146,242,2030,2176,8.0,56.0,0.0,5.0,0.0,0.0,51.0,10.0,5.0,0,1,19,147,222,1874,2021,12/11/2020
2020-03-25,26,172,182,2212,2384,5.0,61.0,2.0,7.0,0.0,0.0,54.0,11.0,3.0,0,1,28,175,158,2032,2207,12/11/2020
2020-03-26,35,207,181,2393,2600,9.0,70.0,5.0,12.0,0.0,0.0,58.0,14.0,5.0,0,1,41,216,166,2198,2414,12/11/2020
2020-03-27,27,234,214,2607,2841,9.0,79.0,1.0,13.0,1.0,1.0,65.0,16.0,6.0,2,3,31,247,188,2386,2633,12/11/2020
2020-03-28,59,293,260,2867,3160,11.0,90.0,2.0,15.0,1.0,2.0,73.0,15.0,6.0,1,4,64,311,235,2621,2932,12/11/2020
2020-03-29,100,393,350,3217,3610,8.0,98.0,3.0,18.0,1.0,3.0,77.0,18.0,8.0,2,6,105,416,294,2915,3331,12/11/2020
2020-03-30,62,455,222,3439,3894,19.0,117.0,5.0,23.0,0.0,3.0,91.0,19.0,11.0,3,9,78,494,173,3088,3582,12/11/2020
2020-03-31,71,526,369,3808,4334,11.0,128.0,7.0,30.0,1.0,4.0,94.0,21.0,13.0,2,11,73,567,286,3374,3941,12/11/2020
2020-04-01,99,625,698,4506,5131,18.0,146.0,7.0,37.0,0.0,4.0,105.0,29.0,15.0,1,12,100,667,595,3969,4636,12/11/2020
2020-04-02,52,677,477,4983,5660,22.0,168.0,6.0,43.0,2.0,6.0,119.0,35.0,21.0,4,16,62,729,411,4380,5109,12/11/2020
2020-04-03,108,785,774,5757,6542,23.0,191.0,7.0,50.0,0.0,6.0,135.0,42.0,25.0,3,19,100,829,667,5047,5876,12/11/2020
2020-04-04,143,928,660,6417,7345,22.0,213.0,4.0,54.0,5.0,11.0,148.0,40.0,29.0,9,28,138,967,577,5624,6591,12/11/2020
2020-04-05,187,1115,1156,7573,8688,20.0,233.0,9.0,63.0,1.0,12.0,158.0,43.0,35.0,2,30,181,1148,987,6611,7759,12/11/2020
2020-04-06,218,1333,1706,9279,10612,26.0,259.0,7.0,70.0,0.0,12.0,177.0,47.0,39.0,7,37,207,1355,1464,8075,9430,12/11/2020
2020-04-07,284,1617,1629,10908,12525,20.0,279.0,4.0,74.0,2.0,14.0,191.0,49.0,41.0,5,42,260,1615,1395,9470,11085,12/11/2020
2020-04-08,290,1907,1720,12628,14535,19.0,298.0,8.0,82.0,5.0,19.0,197.0,49.0,37.0,10,52,271,1886,1465,10935,12821,12/11/2020
2020-04-09,283,2190,1516,14144,16334,32.0,330.0,8.0,90.0,4.0,23.0,217.0,53.0,40.0,7,59,277,2163,1278,12213,14376,12/11/2020
2020-04-10,419,2609,2574,16718,19327,29.0,359.0,17.0,107.0,5.0,28.0,224.0,59.0,41.0,11,70,400,2563,2238,14451,17014,12/11/2020
2020-04-11,297,2906,1905,18623,21529,29.0,388.0,11.0,118.0,2.0,30.0,240.0,61.0,48.0,12,82,280,2843,1631,16082,18925,12/11/2020
2020-04-12,314,3220,1670,20293,23513,35.0,423.0,13.0,131.0,5.0,35.0,257.0,59.0,49.0,9,91,286,3129,1310,17392,20521,12/11/2020
2020-04-13,161,3381,935,21228,24609,35.0,458.0,13.0,144.0,3.0,38.0,276.0,64.0,54.0,9,100,187,3316,796,18188,21504,12/11/2020
2020-04-14,289,3670,1787,23015,26685,27.0,485.0,18.0,162.0,5.0,43.0,280.0,72.0,53.0,8,108,261,3577,1430,19618,23195,12/11/2020
2020-04-15,351,4021,1799,24814,28835,31.0,516.0,20.0,182.0,3.0,46.0,288.0,72.0,54.0,17,125,306,3883,1428,21046,24929,12/11/2020
2020-04-16,447,4468,2494,27308,31776,36.0,552.0,25.0,207.0,6.0,52.0,293.0,72.0,53.0,14,139,387,4270,1918,22964,27234,12/11/2020
2020-04-17,304,4772,1821,29129,33901,32.0,584.0,20.0,227.0,7.0,59.0,298.0,66.0,45.0,21,160,290,4560,1335,24299,28859,12/11/2020
2020-04-18,321,5093,1725,30854,35947,26.0,610.0,18.0,245.0,4.0,63.0,302.0,63.0,49.0,15,175,284,4844,1241,25540,30384,12/11/2020
2020-04-19,381,5474,2047,32901,38375,23.0,633.0,26.0,271.0,1.0,64.0,298.0,65.0,55.0,11,186,337,5181,1647,27187,32368,12/11/2020
2020-04-20,394,5868,1907,34808,40676,46.0,679.0,29.0,300.0,2.0,66.0,313.0,75.0,56.0,10,196,376,5557,1481,28668,34225,12/11/2020
2020-04-21,444,6312,2110,36918,43230,45.0,724.0,32.0,332.0,5.0,71.0,321.0,72.0,56.0,18,214,383,5940,1614,30282,36222,12/11/2020
2020-04-22,418,6730,2390,39308,46038,41.0,765.0,32.0,364.0,5.0,76.0,325.0,73.0,58.0,18,232,379,6319,1781,32063,38382,12/11/2020
2020-04-23,479,7209,2469,41777,48986,32.0,797.0,28.0,392.0,5.0,81.0,324.0,76.0,62.0,15,247,412,6731,1735,33798,40529,12/11/2020
2020-04-24,491,7700,3284,45061,52761,35.0,832.0,26.0,418.0,4.0,85.0,329.0,85.0,63.0,15,262,407,7138,2407,36205,43343,12/11/2020
2020-04-25,393,8093,2206,47267,55360,34.0,866.0,17.0,435.0,5.0,90.0,341.0,85.0,62.0,14,276,299,7437,1608,37813,45250,12/11/2020
2020-04-26,316,8409,2309,49576,57985,33.0,899.0,15.0,450.0,3.0,93.0,356.0,86.0,59.0,14,290,274,7711,1734,39547,47258,12/11/2020
2020-04-27,249,8658,1620,51196,59854,29.0,928.0,21.0,471.0,4.0,97.0,360.0,86.0,61.0,10,300,206,7917,1079,40626,48543,12/11/2020
2020-04-28,410,9068,2263,53459,62527,44.0,972.0,24.0,495.0,3.0,100.0,377.0,88.0,59.0,22,322,331,8248,1562,42188,50436,12/11/2020
2020-04-29,476,9544,3343,56802,66346,36.0,1008.0,38.0,533.0,11.0,111.0,364.0,78.0,53.0,18,340,370,8618,2199,44387,53005,12/11/2020
2020-04-30,432,9976,2769,59571,69547,33.0,1041.0,38.0,571.0,6.0,117.0,353.0,83.0,57.0,24,364,351,8969,1734,46121,55090,12/11/2020
2020-05-01,454,10430,3086,62657,73087,52.0,1093.0,38.0,609.0,3.0,120.0,364.0,84.0,58.0,14,378,323,9292,1950,48071,57363,12/11/2020
2020-05-02,257,10687,1926,64583,75270,36.0,1129.0,39.0,648.0,5.0,125.0,356.0,93.0,63.0,24,402,193,9485,1187,49258,58743,12/11/2020
2020-05-03,283,10970,2160,66743,77713,31.0,1160.0,26.0,674.0,8.0,133.0,353.0,91.0,61.0,21,423,183,9668,1441,50699,60367,12/11/2020
2020-05-04,387,11357,2098,68841,80198,30.0,1190.0,31.0,705.0,6.0,139.0,346.0,89.0,58.0,18,441,290,9958,1464,52163,62121,12/11/2020
2020-05-05,433,11790,2873,71714,83504,29.0,1219.0,32.0,737.0,6.0,145.0,337.0,83.0,55.0,16,457,299,10257,1841,54004,64261,12/11/2020
2020-05-06,488,12278,2830,74544,86822,28.0,1247.0,44.0,781.0,9.0,154.0,312.0,80.0,55.0,21,478,340,10597,1804,55808,66405,12/11/2020
2020-05-07,425,12703,2969,77513,90216,36.0,1283.0,44.0,825.0,5.0,159.0,299.0,72.0,53.0,21,499,270,10867,1829,57637,68504,12/11/2020
2020-05-08,359,13062,2598,80111,93173,30.0,1313.0,29.0,854.0,5.0,164.0,295.0,72.0,54.0,22,521,230,11097,1576,59213,70310,12/11/2020
2020-05-09,467,13529,3346,83457,96986,22.0,1335.0,21.0,875.0,4.0,168.0,292.0,70.0,52.0,15,536,289,11386,2108,61321,72707,12/11/2020
2020-05-10,285,13814,2117,85574,99388,20.0,1355.0,23.0,898.0,6.0,174.0,283.0,71.0,50.0,14,550,190,11576,1410,62731,74307,12/11/2020
2020-05-11,257,14071,1857,87431,101502,31.0,1386.0,16.0,914.0,6.0,180.0,292.0,72.0,50.0,15,565,173,11749,1223,63954,75703,12/11/2020
2020-05-12,387,14458,2611,90042,104500,23.0,1409.0,18.0,932.0,4.0,184.0,293.0,70.0,49.0,22,587,224,11973,1539,65493,77466,12/11/2020
2020-05-13,351,14809,3630,93672,108481,23.0,1432.0,25.0,957.0,1.0,185.0,290.0,70.0,50.0,13,600,199,12172,1839,67332,79504,12/11/2020
2020-05-14,329,15138,3408,97080,112218,19.0,1451.0,27.0,984.0,3.0,188.0,279.0,65.0,46.0,15,615,232,12404,1862,69194,81598,12/11/2020
2020-05-15,381,15519,3458,100538,116057,24.0,1475.0,41.0,1025.0,5.0,193.0,257.0,63.0,46.0,14,629,232,12636,1711,70905,83541,12/11/2020
2020-05-16,449,15968,4156,104694,120662,25.0,1500.0,15.0,1040.0,5.0,198.0,262.0,62.0,47.0,15,644,247,12883,1826,72731,85614,12/11/2020
2020-05-17,240,16208,2768,107462,123670,17.0,1517.0,9.0,1049.0,5.0,203.0,265.0,60.0,46.0,10,654,126,13009,1440,74171,87180,12/11/2020
2020-05-18,250,16458,2001,109463,125921,19.0,1536.0,16.0,1065.0,5.0,208.0,263.0,58.0,41.0,18,672,135,13144,1302,75473,88617,12/11/2020
2020-05-19,415,16873,3168,112631,129504,23.0,1559.0,33.0,1098.0,5.0,213.0,248.0,57.0,39.0,11,683,215,13359,1825,77298,90657,12/11/2020
2020-05-20,326,17199,2771,115402,132601,19.0,1578.0,23.0,1121.0,7.0,220.0,237.0,53.0,34.0,22,705,184,13543,1448,78746,92289,12/11/2020
2020-05-21,374,17573,3757,119159,136732,25.0,1603.0,15.0,1136.0,3.0,223.0,244.0,54.0,30.0,20,725,168,13711,1848,80594,94305,12/11/2020
2020-05-22,351,17924,3161,122320,140244,20.0,1623.0,28.0,1164.0,5.0,228.0,231.0,53.0,30.0,11,736,206,13917,1512,82106,96023,12/11/2020
2020-05-23,253,18177,2742,125062,143239,19.0,1642.0,11.0,1175.0,3.0,231.0,236.0,53.0,33.0,13,749,109,14026,1208,83314,97340,12/11/2020
2020-05-24,163,18340,1370,126432,144772,13.0,1655.0,14.0,1189.0,2.0,233.0,233.0,54.0,36.0,8,757,83,14109,739,84053,98162,12/11/2020
2020-05-25,147,18487,1385,127817,146304,14.0,1669.0,14.0,1203.0,0.0,233.0,233.0,54.0,34.0,10,767,76,14185,696,84749,98934,12/11/2020
2020-05-26,285,18772,2620,130437,149209,24.0,1693.0,21.0,1224.0,5.0,238.0,231.0,49.0,33.0,15,782,158,14343,1572,86321,100664,12/11/2020
2020-05-27,276,19048,2057,132494,151542,20.0,1713.0,18.0,1242.0,3.0,241.0,230.0,51.0,33.0,10,792,132,14475,1084,87405,101880,12/11/2020
2020-05-28,348,19396,3359,135853,155249,17.0,1730.0,29.0,1271.0,4.0,245.0,214.0,47.0,32.0,8,800,130,14605,1054,88459,103064,12/11/2020
2020-05-29,410,19806,3915,139768,159574,19.0,1749.0,26.0,1297.0,7.0,252.0,200.0,43.0,31.0,12,812,174,14779,1476,89935,104714,12/11/2020
2020-05-30,225,20031,3915,143683,163714,16.0,1765.0,19.0,1316.0,4.0,256.0,193.0,41.0,29.0,12,824,109,14888,1639,91574,106462,12/11/2020
2020-05-31,155,20186,1690,145373,165559,11.0,1776.0,11.0,1327.0,1.0,257.0,192.0,44.0,26.0,3,827,78,14966,789,92363,107329,12/11/2020
2020-06-01,212,20398,2792,148165,168563,8.0,1784.0,14.0,1341.0,1.0,258.0,185.0,45.0,29.0,5,832,93,15059,1321,93684,108743,12/11/2020
2020-06-02,273,20671,3022,151187,171858,8.0,1792.0,9.0,1350.0,3.0,261.0,181.0,38.0,25.0,10,842,98,15157,1360,95044,110201,12/11/2020
2020-06-03,254,20925,3486,154673,175598,14.0,1806.0,18.0,1368.0,6.0,267.0,171.0,34.0,25.0,11,853,99,15256,1574,96618,111874,12/11/2020
2020-06-04,276,21201,4471,159144,180345,7.0,1813.0,26.0,1394.0,4.0,271.0,148.0,31.0,24.0,12,865,107,15363,1910,98528,113891,12/11/2020
2020-06-05,215,21416,3513,162657,184073,15.0,1828.0,13.0,1407.0,6.0,277.0,144.0,27.0,21.0,11,876,99,15462,1460,99988,115450,12/11/2020
2020-06-06,201,21617,2616,165273,186890,10.0,1838.0,7.0,1414.0,2.0,279.0,145.0,29.0,19.0,6,882,67,15529,1065,101053,116582,12/11/2020
2020-06-07,83,21700,1625,166898,188598,11.0,1849.0,7.0,1421.0,1.0,280.0,148.0,25.0,17.0,4,886,51,15580,766,101819,117399,12/11/2020
2020-06-08,119,21819,1849,168747,190566,15.0,1864.0,13.0,1434.0,2.0,282.0,148.0,27.0,18.0,4,890,45,15625,915,102734,118359,12/11/2020
2020-06-09,223,22042,2673,171420,193462,10.0,1874.0,19.0,1453.0,0.0,282.0,139.0,28.0,21.0,1,891,64,15689,1203,103937,119626,12/11/2020
2020-06-10,209,22251,2987,174407,196658,13.0,1887.0,12.0,1465.0,2.0,284.0,138.0,24.0,17.0,4,895,100,15789,1412,105349,121138,12/11/2020
2020-06-11,195,22446,3513,177920,200366,7.0,1894.0,15.0,1480.0,1.0,285.0,129.0,25.0,16.0,6,901,88,15877,1460,106809,122686,12/11/2020
2020-06-12,209,22655,4601,182521,205176,9.0,1903.0,16.0,1496.0,1.0,286.0,121.0,24.0,16.0,2,903,78,15955,2006,108815,124770,12/11/2020
2020-06-13,113,22768,3036,185557,208325,6.0,1909.0,5.0,1501.0,0.0,286.0,122.0,20.0,15.0,3,906,49,16004,1270,110085,126089,12/11/2020
2020-06-14,81,22849,2046,187603,210452,7.0,1916.0,8.0,1509.0,1.0,287.0,120.0,20.0,14.0,3,909,33,16037,932,111017,127054,12/11/2020
2020-06-15,188,23037,3108,190711,213748,14.0,1930.0,19.0,1528.0,0.0,287.0,115.0,20.0,16.0,5,914,75,16112,1712,112729,128841,12/11/2020
2020-06-16,110,23147,3017,193728,216875,11.0,1941.0,9.0,1537.0,1.0,288.0,116.0,22.0,16.0,8,922,50,16162,1472,114201,130363,12/11/2020
2020-06-17,127,23274,2835,196563,219837,15.0,1956.0,20.0,1557.0,4.0,292.0,107.0,18.0,14.0,6,928,51,16213,1261,115462,131675,12/11/2020
2020-06-18,149,23423,3048,199611,223034,9.0,1965.0,15.0,1572.0,1.0,293.0,100.0,19.0,16.0,7,935,70,16283,1264,116726,133009,12/11/2020
2020-06-19,141,23564,3769,203380,226944,12.0,1977.0,12.0,1584.0,1.0,294.0,99.0,20.0,17.0,3,938,59,16342,1306,118032,134374,12/11/2020
2020-06-20,84,23648,1891,205271,228919,9.0,1986.0,12.0,1596.0,0.0,294.0,96.0,20.0,18.0,4,942,36,16378,783,118815,135193,12/11/2020
2020-06-21,37,23685,1064,206335,230020,8.0,1994.0,5.0,1601.0,0.0,294.0,99.0,20.0,18.0,2,944,30,16408,656,119471,135879,12/11/2020
2020-06-22,138,23823,3730,210065,233888,12.0,2006.0,17.0,1618.0,0.0,294.0,94.0,19.0,18.0,2,946,65,16473,1641,121112,137585,12/11/2020
2020-06-23,163,23986,3831,213896,237882,3.0,2009.0,13.0,1631.0,3.0,297.0,81.0,18.0,18.0,7,953,81,16554,1715,122827,139381,12/11/2020
2020-06-24,120,24106,3502,217398,241504,9.0,2018.0,10.0,1641.0,1.0,298.0,79.0,18.0,18.0,5,958,44,16598,1613,124440,141038,12/11/2020
2020-06-25,103,24209,2883,220281,244490,6.0,2024.0,14.0,1655.0,1.0,299.0,70.0,17.0,17.0,1,959,50,16648,1440,125880,142528,12/11/2020
2020-06-26,94,24303,2488,222769,247072,2.0,2026.0,10.0,1665.0,0.0,299.0,62.0,18.0,18.0,1,960,60,16708,1275,127155,143863,12/11/2020
2020-06-27,84,24387,3216,225985,250372,5.0,2031.0,3.0,1668.0,1.0,300.0,63.0,17.0,17.0,5,965,37,16745,1165,128320,145065,12/11/2020
2020-06-28,39,24426,1469,227454,251880,4.0,2035.0,4.0,1672.0,4.0,304.0,59.0,15.0,14.0,6,971,17,16762,576,128896,145658,12/11/2020
2020-06-29,85,24511,3697,231151,255662,4.0,2039.0,5.0,1677.0,0.0,304.0,58.0,14.0,14.0,1,972,39,16801,1303,130199,147000,12/11/2020
2020-06-30,57,24568,1958,233109,257677,1.0,2040.0,5.0,1682.0,1.0,305.0,53.0,12.0,11.0,4,976,32,16833,962,131161,147994,12/11/2020
2020-07-01,144,24712,4098,237207,261919,8.0,2048.0,10.0,1692.0,0.0,305.0,51.0,11.0,11.0,1,977,79,16912,1862,133023,149935,12/11/2020
2020-07-02,103,24815,2803,240010,264825,5.0,2053.0,5.0,1697.0,1.0,306.0,50.0,10.0,10.0,3,980,59,16971,1040,134063,151034,12/11/2020
2020-07-03,50,24865,2079,242089,266954,9.0,2062.0,6.0,1703.0,0.0,306.0,53.0,9.0,9.0,3,983,25,16996,755,134818,151814,12/11/2020
2020-07-04,57,24922,2345,244434,269356,2.0,2064.0,4.0,1707.0,1.0,307.0,50.0,10.0,9.0,2,985,33,17029,967,135785,152814,12/11/2020
2020-07-05,49,24971,2932,247366,272337,1.0,2065.0,2.0,1709.0,1.0,308.0,48.0,8.0,8.0,2,987,26,17055,1374,137159,154214,12/11/2020
2020-07-06,101,25072,2814,250180,275252,6.0,2071.0,6.0,1715.0,0.0,308.0,48.0,9.0,9.0,4,991,57,17112,1501,138660,155772,12/11/2020
2020-07-07,81,25153,3457,253637,278790,5.0,2076.0,7.0,1722.0,0.0,308.0,46.0,8.0,8.0,2,993,47,17159,1492,140152,157311,12/11/2020
2020-07-08,105,25258,3409,257046,282304,4.0,2080.0,2.0,1724.0,0.0,308.0,48.0,9.0,8.0,0,993,64,17223,1356,141508,158731,12/11/2020
2020-07-09,94,25352,3714,260760,286112,9.0,2089.0,3.0,1727.0,0.0,308.0,54.0,9.0,8.0,0,993,50,17273,1559,143067,160340,12/11/2020
2020-07-10,132,25484,4437,265197,290681,6.0,2095.0,3.0,1730.0,2.0,310.0,55.0,7.0,7.0,3,996,80,17353,1998,145065,162418,12/11/2020
2020-07-11,63,25547,2938,268135,293682,6.0,2101.0,3.0,1733.0,1.0,311.0,57.0,6.0,6.0,3,999,36,17389,1267,146332,163721,12/11/2020
2020-07-12,47,25594,1838,269973,295567,1.0,2102.0,3.0,1736.0,1.0,312.0,54.0,6.0,5.0,3,1002,34,17423,912,147244,164667,12/11/2020
2020-07-13,84,25678,3209,273182,298860,8.0,2110.0,10.0,1746.0,0.0,312.0,52.0,6.0,5.0,1,1003,61,17484,1453,148697,166181,12/11/2020
2020-07-14,74,25752,3298,276480,302232,7.0,2117.0,4.0,1750.0,0.0,312.0,55.0,5.0,5.0,1,1004,44,17528,1336,150033,167561,12/11/2020
2020-07-15,130,25882,4181,280661,306543,5.0,2122.0,7.0,1757.0,0.0,312.0,53.0,5.0,4.0,0,1004,100,17628,1689,151722,169350,12/11/2020
2020-07-16,103,25985,3740,284401,310386,6.0,2128.0,9.0,1766.0,0.0,312.0,50.0,6.0,5.0,1,1005,76,17704,1552,153274,170978,12/11/2020
2020-07-17,156,26141,4239,288640,314781,14.0,2142.0,3.0,1769.0,1.0,313.0,60.0,5.0,5.0,2,1007,79,17783,1788,155062,172845,12/11/2020
2020-07-18,85,26226,3272,291912,318138,5.0,2147.0,9.0,1778.0,1.0,314.0,55.0,5.0,4.0,4,1011,70,17853,1348,156410,174263,12/11/2020
2020-07-19,82,26308,2696,294608,320916,7.0,2154.0,3.0,1781.0,0.0,314.0,59.0,6.0,4.0,2,1013,57,17910,1099,157509,175419,12/11/2020
2020-07-20,71,26379,2666,297274,323653,9.0,2163.0,7.0,1788.0,0.0,314.0,61.0,7.0,5.0,2,1015,68,17978,1406,158915,176893,12/11/2020
2020-07-21,130,26509,4304,301578,328087,9.0,2172.0,11.0,1799.0,0.0,314.0,59.0,9.0,6.0,1,1016,108,18086,1855,160770,178856,12/11/2020
2020-07-22,130,26639,3928,305506,332145,7.0,2179.0,8.0,1807.0,1.0,315.0,57.0,7.0,6.0,1,1017,86,18172,1613,162383,180555,12/11/2020
2020-07-23,141,26780,4415,309921,336701,8.0,2187.0,6.0,1813.0,0.0,315.0,59.0,8.0,7.0,0,1017,115,18287,1902,164285,182572,12/11/2020
2020-07-24,172,26952,5966,315887,342839,15.0,2202.0,12.0,1825.0,0.0,315.0,62.0,9.0,7.0,0,1017,119,18406,2233,166518,184924,12/11/2020
2020-07-25,134,27086,4398,320285,347371,7.0,2209.0,7.0,1832.0,0.0,315.0,62.0,10.0,8.0,3,1020,108,18514,2030,168548,187062,12/11/2020
2020-07-26,62,27148,3033,323318,350466,8.0,2217.0,9.0,1841.0,0.0,315.0,61.0,11.0,7.0,1,1021,54,18568,1295,169843,188411,12/11/2020
2020-07-27,188,27336,4191,327509,354845,12.0,2229.0,7.0,1848.0,0.0,315.0,66.0,13.0,8.0,1,1022,138,18706,2259,172102,190808,12/11/2020
2020-07-28,105,27441,3840,331349,358790,5.0,2234.0,5.0,1853.0,0.0,315.0,66.0,14.0,7.0,1,1023,95,18801,1586,173688,192489,12/11/2020
2020-07-29,190,27631,5139,336488,364119,9.0,2243.0,10.0,1863.0,0.0,315.0,65.0,15.0,7.0,0,1023,154,18955,2222,175910,194865,12/11/2020
2020-07-30,121,27752,4345,340833,368585,6.0,2249.0,2.0,1865.0,1.0,316.0,68.0,15.0,6.0,1,1024,97,19052,1568,177478,196530,12/11/2020
2020-07-31,131,27883,5512,346345,374228,7.0,2256.0,9.0,1874.0,0.0,316.0,66.0,15.0,7.0,1,1025,89,19141,1775,179253,198394,12/11/2020
2020-08-01,109,27992,4294,350639,378631,7.0,2263.0,2.0,1876.0,0.0,316.0,71.0,14.0,7.0,1,1026,89,19230,1501,180754,199984,12/11/2020
2020-08-02,84,28076,2804,353443,381519,12.0,2275.0,12.0,1888.0,2.0,318.0,69.0,14.0,8.0,2,1028,62,19292,1231,181985,201277,12/11/2020
2020-08-03,188,28264,5248,358691,386955,11.0,2286.0,10.0,1898.0,0.0,318.0,70.0,16.0,7.0,1,1029,150,19442,2125,184110,203552,12/11/2020
2020-08-04,125,28389,3691,362382,390771,8.0,2294.0,5.0,1903.0,1.0,319.0,72.0,12.0,5.0,2,1031,99,19541,1712,185822,205363,12/11/2020
2020-08-05,147,28536,5935,368317,396853,11.0,2305.0,9.0,1912.0,1.0,320.0,73.0,10.0,5.0,2,1033,119,19660,2379,188201,207861,12/11/2020
2020-08-06,169,28705,5546,373863,402568,7.0,2312.0,9.0,1921.0,0.0,320.0,71.0,9.0,4.0,0,1033,120,19780,2307,190508,210288,12/11/2020
2020-08-07,123,28828,4851,378714,407542,12.0,2324.0,9.0,1930.0,1.0,321.0,73.0,9.0,3.0,2,1035,87,19867,2059,192567,212434,12/11/2020
2020-08-08,123,28951,4112,382826,411777,19.0,2343.0,6.0,1936.0,1.0,322.0,85.0,8.0,3.0,1,1036,91,19958,1720,194287,214245,12/11/2020
2020-08-09,42,28993,1727,384553,413546,6.0,2349.0,8.0,1944.0,0.0,322.0,83.0,9.0,4.0,0,1036,35,19993,1029,195316,215309,12/11/2020
2020-08-10,149,29142,4587,389140,418282,8.0,2357.0,9.0,1953.0,0.0,322.0,82.0,9.0,4.0,1,1037,113,20106,1954,197270,217376,12/11/2020
2020-08-11,106,29248,4334,393474,422722,5.0,2362.0,13.0,1966.0,0.0,322.0,74.0,10.0,4.0,3,1040,92,20198,2196,199466,219664,12/11/2020
2020-08-12,121,29369,5188,398662,428031,8.0,2370.0,11.0,1977.0,0.0,322.0,71.0,9.0,3.0,1,1041,101,20299,2527,201993,222292,12/11/2020
2020-08-13,135,29504,4196,402858,432362,13.0,2383.0,12.0,1989.0,0.0,322.0,72.0,11.0,3.0,0,1041,95,20394,1840,203833,224227,12/11/2020
2020-08-14,145,29649,5498,408356,438005,13.0,2396.0,11.0,2000.0,0.0,322.0,74.0,11.0,4.0,3,1044,98,20492,1910,205743,226235,12/11/2020
2020-08-15,106,29755,4534,412890,442645,9.0,2405.0,11.0,2011.0,1.0,323.0,71.0,11.0,5.0,0,1044,88,20580,1632,207375,227955,12/11/2020
2020-08-16,83,29838,2477,415367,445205,6.0,2411.0,5.0,2016.0,4.0,327.0,68.0,8.0,4.0,6,1050,70,20650,925,208300,228950,12/11/2020
2020-08-17,106,29944,4575,419942,449886,8.0,2419.0,6.0,2022.0,0.0,327.0,70.0,8.0,5.0,2,1052,87,20737,2315,210615,231352,12/11/2020
2020-08-18,128,30072,4911,424853,454925,11.0,2430.0,8.0,2030.0,1.0,328.0,72.0,8.0,4.0,5,1057,94,20831,2663,213278,234109,12/11/2020
2020-08-19,113,30185,5077,429930,460115,8.0,2438.0,9.0,2039.0,1.0,329.0,70.0,9.0,5.0,0,1057,90,20921,2562,215840,236761,12/11/2020
2020-08-20,173,30358,7411,437341,467699,12.0,2450.0,6.0,2045.0,2.0,331.0,74.0,10.0,5.0,3,1060,139,21060,3418,219258,240318,12/11/2020
2020-08-21,152,30510,6577,443918,474428,8.0,2458.0,5.0,2050.0,1.0,332.0,76.0,9.0,4.0,2,1062,125,21185,2842,222100,243285,12/11/2020
2020-08-22,96,30606,5550,449468,480074,11.0,2469.0,12.0,2062.0,0.0,332.0,75.0,11.0,4.0,1,1063,84,21269,2513,224613,245882,12/11/2020
2020-08-23,72,30678,4375,453843,484521,11.0,2480.0,6.0,2068.0,0.0,332.0,80.0,12.0,2.0,1,1064,56,21325,2417,227030,248355,12/11/2020
2020-08-24,105,30783,5784,459627,490410,7.0,2487.0,10.0,2078.0,1.0,333.0,76.0,14.0,4.0,1,1065,77,21402,3060,230090,251492,12/11/2020
2020-08-25,108,30891,4764,464391,495282,10.0,2497.0,4.0,2082.0,1.0,334.0,81.0,12.0,4.0,1,1066,92,21494,2228,232318,253812,12/11/2020
2020-08-26,170,31061,9482,473873,504934,4.0,2501.0,8.0,2090.0,0.0,334.0,77.0,10.0,5.0,1,1067,127,21621,2998,235316,256937,12/11/2020
2020-08-27,91,31152,8565,482438,513590,6.0,2507.0,13.0,2103.0,1.0,335.0,69.0,7.0,5.0,2,1069,70,21691,3056,238372,260063,12/11/2020
2020-08-28,113,31265,7994,490432,521697,14.0,2521.0,4.0,2107.0,0.0,335.0,79.0,10.0,7.0,2,1071,87,21778,2351,240723,262501,12/11/2020
2020-08-29,65,31330,5374,495806,527136,6.0,2527.0,8.0,2115.0,1.0,336.0,76.0,11.0,6.0,2,1073,51,21829,1862,242585,264414,12/11/2020
2020-08-30,66,31396,4323,500129,531525,7.0,2534.0,4.0,2119.0,0.0,336.0,79.0,9.0,5.0,2,1075,48,21877,1934,244519,266396,12/11/2020
2020-08-31,105,31501,4863,504992,536493,12.0,2546.0,16.0,2135.0,0.0,336.0,75.0,8.0,4.0,1,1076,81,21958,2128,246647,268605,12/11/2020
2020-09-01,99,31600,7109,512101,543701,6.0,2552.0,9.0,2144.0,1.0,337.0,71.0,7.0,4.0,2,1078,66,22024,2314,248961,270985,12/11/2020
2020-09-02,125,31725,10529,522630,554355,9.0,2561.0,10.0,2154.0,1.0,338.0,69.0,8.0,4.0,2,1080,104,22128,2968,251929,274057,12/11/2020
2020-09-03,90,31815,11080,533710,565525,8.0,2569.0,8.0,2162.0,0.0,338.0,69.0,9.0,4.0,3,1083,73,22201,2499,254428,276629,12/11/2020
2020-09-04,103,31918,8963,542673,574591,11.0,2580.0,4.0,2166.0,0.0,338.0,76.0,9.0,4.0,1,1084,83,22284,2300,256728,279012,12/11/2020
2020-09-05,52,31970,6309,548982,580952,6.0,2586.0,9.0,2175.0,0.0,338.0,73.0,8.0,3.0,1,1085,42,22326,1553,258281,280607,12/11/2020
2020-09-06,88,32058,4325,553307,585365,4.0,2590.0,8.0,2183.0,1.0,339.0,68.0,6.0,3.0,1,1086,65,22391,1888,260169,282560,12/11/2020
2020-09-07,35,32093,3002,556309,588402,11.0,2601.0,3.0,2186.0,0.0,339.0,76.0,5.0,3.0,1,1087,26,22417,622,260791,283208,12/11/2020
2020-09-08,74,32167,6381,562690,594857,6.0,2607.0,12.0,2198.0,1.0,340.0,69.0,6.0,3.0,2,1089,66,22483,1538,262329,284812,12/11/2020
2020-09-09,118,32285,8650,571340,603625,10.0,2617.0,5.0,2203.0,1.0,341.0,73.0,9.0,3.0,1,1090,102,22585,2067,264396,286981,12/11/2020
2020-09-10,164,32449,11334,582674,615123,9.0,2626.0,8.0,2211.0,0.0,341.0,74.0,10.0,3.0,1,1091,111,22696,2192,266588,289284,12/11/2020
2020-09-11,120,32569,9454,592128,624697,11.0,2637.0,11.0,2222.0,0.0,341.0,74.0,10.0,5.0,0,1091,97,22793,1900,268488,291281,12/11/2020
2020-09-12,110,32679,6174,598302,630981,8.0,2645.0,5.0,2227.0,2.0,343.0,75.0,9.0,5.0,3,1094,97,22890,1469,269957,292847,12/11/2020
2020-09-13,58,32737,2717,601019,633756,4.0,2649.0,3.0,2230.0,0.0,343.0,76.0,10.0,5.0,0,1094,54,22944,831,270788,293732,12/11/2020
2020-09-14,104,32841,6446,607465,640306,6.0,2655.0,3.0,2233.0,2.0,345.0,77.0,10.0,5.0,2,1096,95,23039,1666,272454,295493,12/11/2020
2020-09-15,122,32963,8470,615935,648898,7.0,2662.0,2.0,2235.0,1.0,346.0,81.0,10.0,5.0,2,1098,124,23163,2126,274580,297743,12/11/2020
2020-09-16,137,33100,9716,625651,658751,7.0,2669.0,7.0,2242.0,2.0,348.0,79.0,9.0,6.0,5,1103,118,23281,1911,276491,299772,12/11/2020
2020-09-17,125,33225,9239,634890,668115,7.0,2676.0,15.0,2257.0,0.0,348.0,71.0,8.0,4.0,0,1103,154,23435,1884,278375,301810,12/11/2020
2020-09-18,132,33357,10045,644935,678292,7.0,2683.0,7.0,2264.0,1.0,349.0,70.0,11.0,6.0,2,1105,132,23567,1867,280242,303809,12/11/2020
2020-09-19,115,33472,8297,653232,686704,7.0,2690.0,3.0,2267.0,0.0,349.0,74.0,10.0,6.0,4,1109,112,23679,1653,281895,305574,12/11/2020
2020-09-20,60,33532,3676,656908,690440,7.0,2697.0,6.0,2273.0,2.0,351.0,73.0,9.0,8.0,4,1113,49,23728,1289,283184,306912,12/11/2020
2020-09-21,102,33634,7018,663926,697560,12.0,2709.0,3.0,2276.0,2.0,353.0,80.0,8.0,6.0,2,1115,94,23822,2345,285529,309351,12/11/2020
2020-09-22,154,33788,9287,673213,707001,12.0,2721.0,3.0,2279.0,1.0,354.0,88.0,7.0,5.0,1,1116,124,23946,2126,287655,311601,12/11/2020
2020-09-23,136,33924,10651,683864,717788,12.0,2733.0,7.0,2286.0,0.0,354.0,93.0,6.0,5.0,0,1116,127,24073,2140,289795,313868,12/11/2020
2020-09-24,120,34044,12480,696344,730388,8.0,2741.0,9.0,2295.0,1.0,355.0,91.0,7.0,5.0,1,1117,120,24193,3086,292881,317074,12/11/2020
2020-09-25,150,34194,10553,706897,741091,9.0,2750.0,10.0,2305.0,0.0,355.0,90.0,6.0,5.0,1,1118,143,24336,2931,295812,320148,12/11/2020
2020-09-26,147,34341,10560,717457,751798,12.0,2762.0,9.0,2314.0,0.0,355.0,93.0,6.0,5.0,1,1119,120,24456,2363,298175,322631,12/11/2020
2020-09-27,43,34384,2764,720221,754605,7.0,2769.0,5.0,2319.0,0.0,355.0,95.0,9.0,5.0,0,1119,34,24490,822,298997,323487,12/11/2020
2020-09-28,156,34540,7307,727528,762068,7.0,2776.0,7.0,2326.0,2.0,357.0,93.0,7.0,5.0,2,1121,138,24628,2195,301192,325820,12/11/2020
2020-09-29,203,34743,11046,738574,773317,12.0,2788.0,18.0,2344.0,1.0,358.0,86.0,6.0,6.0,1,1122,185,24813,2753,303945,328758,12/11/2020
2020-09-30,223,34966,12230,750804,785770,6.0,2794.0,6.0,2350.0,0.0,358.0,86.0,6.0,6.0,1,1123,189,25002,2503,306448,331450,12/11/2020
2020-10-01,185,35151,12503,763307,798458,17.0,2811.0,13.0,2363.0,1.0,359.0,89.0,6.0,4.0,2,1125,166,25168,2338,308786,333954,12/11/2020
2020-10-02,209,35360,12154,775461,810821,14.0,2825.0,13.0,2376.0,1.0,360.0,89.0,8.0,5.0,2,1127,181,25349,2433,311219,336568,12/11/2020
2020-10-03,157,35517,9313,784774,820291,9.0,2834.0,9.0,2385.0,2.0,362.0,87.0,9.0,4.0,2,1129,131,25480,1966,313185,338665,12/11/2020
2020-10-04,81,35598,2369,787143,822741,11.0,2845.0,9.0,2394.0,1.0,363.0,88.0,8.0,5.0,2,1131,77,25557,926,314111,339668,12/11/2020
2020-10-05,174,35772,8982,796125,831897,30.0,2875.0,10.0,2404.0,2.0,365.0,106.0,9.0,6.0,4,1135,160,25717,2959,317070,342787,12/11/2020
2020-10-06,188,35960,11186,807311,843271,11.0,2886.0,4.0,2408.0,0.0,365.0,113.0,11.0,7.0,0,1135,188,25905,2823,319893,345798,12/11/2020
2020-10-07,243,36203,12442,819753,855956,13.0,2899.0,14.0,2422.0,2.0,367.0,110.0,9.0,7.0,2,1137,244,26149,3449,323342,349491,12/11/2020
2020-10-08,279,36482,15231,834984,871466,17.0,2916.0,13.0,2435.0,2.0,369.0,112.0,7.0,5.0,4,1141,277,26426,4123,327465,353891,12/11/2020
2020-10-09,229,36711,13745,848729,885440,21.0,2937.0,12.0,2447.0,0.0,369.0,121.0,10.0,7.0,3,1144,200,26626,4196,331661,358287,12/11/2020
2020-10-10,231,36942,13832,862561,899503,19.0,2956.0,10.0,2457.0,1.0,370.0,129.0,13.0,7.0,2,1146,192,26818,3702,335363,362181,12/11/2020
2020-10-11,98,37040,3263,865824,902864,12.0,2968.0,9.0,2466.0,1.0,371.0,131.0,14.0,5.0,6,1152,87,26905,1137,336500,363405,12/11/2020
2020-10-12,169,37209,6440,872264,909473,19.0,2987.0,15.0,2481.0,2.0,373.0,133.0,14.0,5.0,4,1156,157,27062,1680,338180,365242,12/11/2020
2020-10-13,215,37424,8522,880786,918210,15.0,3002.0,13.0,2494.0,4.0,377.0,131.0,13.0,5.0,7,1163,207,27269,2264,340444,367713,12/11/2020
2020-10-14,326,37750,15039,895825,933575,17.0,3019.0,7.0,2501.0,0.0,377.0,141.0,15.0,5.0,2,1165,299,27568,3931,344375,371943,12/11/2020
2020-10-15,271,38021,14639,910464,948485,12.0,3031.0,16.0,2517.0,1.0,378.0,136.0,13.0,5.0,2,1167,253,27821,3483,347858,375679,12/11/2020
2020-10-16,288,38309,15010,925474,963783,13.0,3044.0,18.0,2535.0,1.0,379.0,130.0,13.0,4.0,2,1169,275,28096,3287,351145,379241,12/11/2020
2020-10-17,361,38670,14069,939543,978213,19.0,3063.0,11.0,2546.0,1.0,380.0,137.0,17.0,4.0,2,1171,309,28405,3184,354329,382734,12/11/2020
2020-10-18,155,38825,4039,943582,982407,18.0,3081.0,11.0,2557.0,0.0,380.0,144.0,17.0,6.0,2,1173,126,28531,1274,355603,384134,12/11/2020
2020-10-19,385,39210,8491,952073,991283,21.0,3102.0,22.0,2579.0,2.0,382.0,141.0,15.0,6.0,1,1174,323,28854,2496,358099,386953,12/11/2020
2020-10-20,439,39649,13242,965315,1004964,23.0,3125.0,17.0,2596.0,0.0,382.0,147.0,14.0,8.0,3,1177,387,29241,2930,361029,390270,12/11/2020
2020-10-21,544,40193,17463,982778,1022971,23.0,3148.0,8.0,2604.0,2.0,384.0,160.0,15.0,9.0,3,1180,472,29713,3402,364431,394144,12/11/2020
2020-10-22,538,40731,15863,998641,1039372,24.0,3172.0,20.0,2624.0,3.0,387.0,161.0,14.0,9.0,3,1183,489,30202,3102,367533,397735,12/11/2020
2020-10-23,514,41245,16634,1015275,1056520,22.0,3194.0,22.0,2646.0,1.0,388.0,160.0,15.0,9.0,3,1186,458,30660,2816,370349,401009,12/11/2020
2020-10-24,359,41604,10249,1025524,1067128,17.0,3211.0,11.0,2657.0,0.0,388.0,166.0,14.0,8.0,1,1187,338,30998,2199,372548,403546,12/11/2020
2020-10-25,233,41837,4760,1030284,1072121,16.0,3227.0,15.0,2672.0,1.0,389.0,166.0,15.0,8.0,2,1189,209,31207,1411,373959,405166,12/11/2020
2020-10-26,454,42291,9174,1039458,1081749,27.0,3254.0,15.0,2687.0,2.0,391.0,176.0,18.0,8.0,3,1192,403,31610,2904,376863,408473,12/11/2020
2020-10-27,517,42808,13995,1053453,1096261,29.0,3283.0,15.0,2702.0,2.0,393.0,188.0,18.0,9.0,4,1196,453,32063,2337,379200,411263,12/11/2020
2020-10-28,469,43277,15229,1068682,1111959,25.0,3308.0,26.0,2728.0,1.0,394.0,186.0,17.0,9.0,3,1199,411,32474,2628,381828,414302,12/11/2020
2020-10-29,609,43886,16259,1084941,1128827,20.0,3328.0,22.0,2750.0,3.0,397.0,181.0,19.0,11.0,4,1203,526,33000,3060,384888,417888,12/11/2020
2020-10-30,565,44451,14863,1099804,1144255,21.0,3349.0,21.0,2771.0,5.0,402.0,176.0,19.0,9.0,4,1207,467,33467,2878,387766,421233,12/11/2020
2020-10-31,599,45050,11820,1111624,1156674,31.0,3380.0,13.0,2784.0,1.0,403.0,193.0,22.0,9.0,3,1210,483,33950,2355,390121,424071,12/11/2020
2020-11-01,330,45380,5091,1116715,1162095,22.0,3402.0,15.0,2799.0,1.0,404.0,199.0,26.0,12.0,4,1214,273,34223,1238,391359,425582,12/11/2020
2020-11-02,521,45901,9930,1126645,1172546,38.0,3440.0,27.0,2826.0,3.0,407.0,207.0,24.0,12.0,5,1219,455,34678,2861,394220,428898,12/11/2020
2020-11-03,602,46503,13040,1139685,1186188,33.0,3473.0,25.0,2851.0,1.0,408.0,214.0,24.0,12.0,1,1220,529,35207,2452,396672,431879,12/11/2020
2020-11-04,688,47191,16100,1155785,1202976,34.0,3507.0,27.0,2878.0,2.0,410.0,219.0,25.0,12.0,4,1224,632,35839,2863,399535,435374,12/11/2020
2020-11-05,768,47959,16593,1172378,1220337,46.0,3553.0,35.0,2913.0,1.0,411.0,229.0,24.0,14.0,3,1227,682,36521,2792,402327,438848,12/11/2020
2020-11-06,769,48728,16022,1188400,1237128,43.0,3596.0,31.0,2944.0,1.0,412.0,240.0,28.0,17.0,5,1232,691,37212,2979,405306,442518,12/11/2020
2020-11-07,604,49332,13650,1202050,1251382,34.0,3630.0,25.0,2969.0,1.0,413.0,248.0,31.0,18.0,1,1233,576,37788,2412,407718,445506,12/11/2020
2020-11-08,337,49669,4160,1206210,1255879,33.0,3663.0,26.0,2995.0,1.0,414.0,254.0,30.0,19.0,4,1237,321,38109,1252,408970,447079,12/11/2020
2020-11-09,808,50477,9054,1215264,1265741,40.0,3703.0,33.0,3028.0,2.0,416.0,259.0,28.0,18.0,3,1240,763,38872,2282,411252,450124,12/11/2020
2020-11-10,1053,51530,12982,1228246,1279776,45.0,3748.0,37.0,3065.0,0.0,416.0,267.0,31.0,18.0,6,1246,979,39851,2835,414087,453938,12/11/2020
2020-11-11,1087,52617,19741,1247987,1300604,42.0,3790.0,24.0,3089.0,5.0,421.0,280.0,30.0,15.0,7,1253,1001,40852,2635,416722,457574,12/11/2020
2020-11-12,893,53510,13906,1261893,1315403,39.0,3829.0,31.0,3120.0,3.0,424.0,285.0,28.0,15.0,5,1258,811,41663,2166,418888,460551,12/11/2020
2020-11-13,1165,54675,16390,1278283,1332958,39.0,3868.0,31.0,3151.0,0.0,424.0,293.0,27.0,15.0,2,1260,1115,42778,3045,421933,464711,12/11/2020
2020-11-14,782,55457,13517,1291800,1347257,42.0,3910.0,26.0,3177.0,5.0,429.0,304.0,25.0,13.0,10,1270,738,43516,2429,424362,467878,12/11/2020
2020-11-15,578,56035,6173,1297973,1354008,46.0,3956.0,21.0,3198.0,5.0,434.0,324.0,28.0,11.0,7,1277,495,44011,1397,425759,469770,12/11/2020
2020-11-16,738,56773,9615,1307588,1364361,56.0,4012.0,39.0,3237.0,3.0,437.0,338.0,26.0,13.0,5,1282,673,44684,2589,428348,473032,12/11/2020
2020-11-17,1538,58311,18176,1325764,1384075,59.0,4071.0,45.0,3282.0,2.0,439.0,350.0,30.0,13.0,5,1287,1401,46085,4068,432416,478501,12/11/2020
2020-11-18,1125,59436,16045,1341809,1401245,38.0,4109.0,38.0,3320.0,5.0,444.0,345.0,29.0,15.0,7,1294,1012,47097,3159,435575,482672,12/11/2020
2020-11-19,1128,60564,13169,1354978,1415542,46.0,4155.0,42.0,3362.0,4.0,448.0,345.0,30.0,18.0,5,1299,1034,48131,3364,438939,487070,12/11/2020
2020-11-20,1456,62020,22223,1377201,1439221,49.0,4204.0,48.0,3410.0,3.0,451.0,343.0,33.0,14.0,6,1305,1293,49424,4269,443208,492632,12/11/2020
2020-11-21,853,62873,17370,1394571,1457444,43.0,4247.0,34.0,3444.0,5.0,456.0,347.0,35.0,14.0,7,1312,755,50179,3109,446317,496496,12/11/2020
2020-11-22,571,63444,7519,1402090,1465534,64.0,4311.0,28.0,3472.0,4.0,460.0,379.0,33.0,15.0,11,1323,486,50665,1775,448092,498757,12/11/2020
2020-11-23,980,64424,11027,1413117,1477541,72.0,4383.0,39.0,3511.0,0.0,460.0,412.0,40.0,18.0,10,1333,885,51550,3383,451475,503025,12/11/2020
2020-11-24,1045,65469,14581,1427698,1493167,47.0,4430.0,60.0,3571.0,6.0,466.0,393.0,42.0,22.0,10,1343,937,52487,2747,454222,506709,12/11/2020
2020-11-25,1265,66734,18789,1446487,1513221,59.0,4489.0,58.0,3629.0,4.0,470.0,390.0,43.0,26.0,7,1350,1176,53663,3521,457743,511406,12/11/2020
2020-11-26,547,67281,6483,1452970,1520251,51.0,4540.0,36.0,3665.0,4.0,474.0,401.0,46.0,25.0,12,1362,468,54131,1560,459303,513434,12/11/2020
2020-11-27,1031,68312,9718,1462688,1531000,54.0,4594.0,50.0,3715.0,7.0,481.0,398.0,47.0,22.0,6,1368,960,55091,2509,461812,516903,12/11/2020
2020-11-28,1173,69485,11952,1474640,1544125,64.0,4658.0,40.0,3755.0,0.0,481.0,422.0,48.0,22.0,3,1371,1086,56177,2793,464605,520782,12/11/2020
2020-11-29,818,70303,6935,1481575,1551878,62.0,4720.0,35.0,3790.0,3.0,484.0,446.0,49.0,24.0,8,1379,752,56929,2307,466912,523841,12/11/2020
2020-11-30,1276,71579,9916,1491491,1563070,67.0,4787.0,60.0,3850.0,2.0,486.0,451.0,52.0,30.0,6,1385,1152,58081,2796,469708,527789,12/11/2020
2020-12-01,1548,73127,13945,1505436,1578563,58.0,4845.0,55.0,3905.0,4.0,490.0,450.0,51.0,31.0,12,1397,1413,59494,3366,473074,532568,12/11/2020
2020-12-02,1556,74683,15568,1521004,1595687,55.0,4900.0,53.0,3958.0,7.0,497.0,445.0,52.0,30.0,14,1411,1421,60915,3249,476323,537238,12/11/2020
2020-12-03,1762,76445,14628,1535632,1612077,64.0,4964.0,76.0,4034.0,5.0,502.0,428.0,48.0,31.0,10,1421,1634,62549,3322,479645,542194,12/11/2020
2020-12-04,1649,78094,16515,1552147,1630241,65.0,5029.0,50.0,4084.0,7.0,509.0,436.0,44.0,29.0,11,1432,1512,64061,3799,483444,547505,12/11/2020
2020-12-05,1201,79295,12608,1564755,1644050,69.0,5098.0,41.0,4125.0,4.0,513.0,460.0,47.0,29.0,11,1443,1051,65112,2895,486339,551451,12/11/2020
2020-12-06,1125,80420,7834,1572589,1653009,65.0,5163.0,50.0,4175.0,10.0,523.0,465.0,47.0,24.0,14,1457,973,66085,2508,488847,554932,12/11/2020
2020-12-07,1357,81777,10606,1583195,1664972,73.0,5236.0,56.0,4231.0,6.0,529.0,476.0,45.0,24.0,18,1475,982,67067,3329,492176,559243,12/11/2020
2020-12-08,1407,83184,15187,1598382,1681566,52.0,5288.0,57.0,4288.0,5.0,534.0,466.0,48.0,25.0,14,1489,1253,68320,3552,495728,564048,12/11/2020
2020-12-09,1462,84646,16222,1614604,1699250,,,,,,,,,,9,1498,1282,69602,3201,498929,568531,12/11/2020
2020-12-10,1434,86080,16883,1631487,1717567,,,,,,,,,,11,1509,1216,70818,3942,502871,573689,12/11/2020
2020-02-27,0,0,0,0,0,1.0,1.0,0.0,0.0,0.0,0.0,1.0,0.0,0.0,0,0,0,0,0,0,0,12/14/2020
2020-02-28,0,0,0,0,0,0.0,1.0,0.0,0.0,0.0,0.0,1.0,1.0,0.0,0,0,0,0,0,0,0,12/14/2020
2020-02-29,0,0,0,0,0,0.0,1.0,0.0,0.0,0.0,0.0,1.0,1.0,0.0,0,0,0,0,0,0,0,12/14/2020
2020-03-01,2,2,2,2,4,0.0,1.0,0.0,0.0,0.0,0.0,1.0,1.0,1.0,0,0,2,2,2,2,4,12/14/2020
2020-03-02,0,2,1,3,5,1.0,2.0,0.0,0.0,0.0,0.0,2.0,2.0,2.0,0,0,0,2,0,2,4,12/14/2020
2020-03-03,0,2,2,5,7,0.0,2.0,0.0,0.0,0.0,0.0,2.0,2.0,2.0,0,0,0,2,1,3,5,12/14/2020
2020-03-04,0,2,12,17,19,1.0,3.0,0.0,0.0,0.0,0.0,3.0,2.0,2.0,0,0,0,2,10,13,15,12/14/2020
2020-03-05,0,2,4,21,23,0.0,3.0,0.0,0.0,0.0,0.0,3.0,2.0,2.0,0,0,1,3,4,17,20,12/14/2020
2020-03-06,1,3,12,33,36,0.0,3.0,0.0,0.0,0.0,0.0,3.0,2.0,2.0,0,0,0,3,11,28,31,12/14/2020
2020-03-07,0,3,19,52,55,0.0,3.0,0.0,0.0,0.0,0.0,3.0,2.0,1.0,0,0,0,3,19,47,50,12/14/2020
2020-03-08,0,3,18,70,73,0.0,3.0,0.0,0.0,0.0,0.0,3.0,2.0,1.0,0,0,0,3,18,65,68,12/14/2020
2020-03-09,1,4,15,85,89,0.0,3.0,0.0,0.0,0.0,0.0,3.0,2.0,1.0,0,0,1,4,14,79,83,12/14/2020
2020-03-10,2,6,25,110,116,0.0,3.0,0.0,0.0,0.0,0.0,3.0,2.0,1.0,0,0,1,5,23,102,107,12/14/2020
2020-03-11,0,6,34,144,150,1.0,4.0,0.0,0.0,0.0,0.0,4.0,1.0,1.0,0,0,0,5,34,136,141,12/14/2020
2020-03-12,9,15,41,185,200,1.0,5.0,0.0,0.0,0.0,0.0,5.0,1.0,1.0,0,0,7,12,38,174,186,12/14/2020
2020-03-13,6,21,50,235,256,4.0,9.0,1.0,1.0,0.0,0.0,8.0,1.0,1.0,0,0,6,18,47,221,239,12/14/2020
2020-03-14,0,21,90,325,346,0.0,9.0,0.0,1.0,0.0,0.0,8.0,1.0,1.0,0,0,0,18,83,304,322,12/14/2020
2020-03-15,1,22,54,379,401,1.0,10.0,0.0,1.0,0.0,0.0,9.0,2.0,1.0,0,0,1,19,53,357,376,12/14/2020
2020-03-16,2,24,95,474,498,2.0,12.0,0.0,1.0,0.0,0.0,11.0,2.0,0.0,0,0,2,21,89,446,467,12/14/2020
2020-03-17,12,36,162,636,672,6.0,18.0,0.0,1.0,0.0,0.0,17.0,2.0,0.0,0,0,11,32,142,588,620,12/14/2020
2020-03-18,9,45,116,752,797,3.0,21.0,0.0,1.0,0.0,0.0,20.0,2.0,0.0,0,0,11,43,104,692,735,12/14/2020
2020-03-19,15,60,262,1014,1074,2.0,23.0,1.0,2.0,0.0,0.0,21.0,3.0,0.0,1,1,17,60,245,937,997,12/14/2020
2020-03-20,13,73,197,1211,1284,5.0,28.0,0.0,2.0,0.0,0.0,26.0,4.0,0.0,0,1,13,73,183,1120,1193,12/14/2020
2020-03-21,12,85,126,1337,1422,3.0,31.0,2.0,4.0,0.0,0.0,27.0,5.0,0.0,0,1,14,87,117,1237,1324,12/14/2020
2020-03-22,27,112,282,1619,1731,2.0,33.0,0.0,4.0,0.0,0.0,29.0,5.0,0.0,0,1,25,112,250,1487,1599,12/14/2020
2020-03-23,14,126,169,1788,1914,15.0,48.0,1.0,5.0,0.0,0.0,43.0,9.0,3.0,0,1,16,128,157,1644,1772,12/14/2020
2020-03-24,20,146,242,2030,2176,8.0,56.0,0.0,5.0,0.0,0.0,51.0,10.0,5.0,0,1,19,147,220,1864,2011,12/14/2020
2020-03-25,26,172,182,2212,2384,5.0,61.0,2.0,7.0,0.0,0.0,54.0,11.0,3.0,0,1,28,175,158,2022,2197,12/14/2020
2020-03-26,35,207,181,2393,2600,9.0,70.0,5.0,12.0,0.0,0.0,58.0,14.0,5.0,0,1,41,216,164,2186,2402,12/14/2020
2020-03-27,27,234,214,2607,2841,9.0,79.0,1.0,13.0,1.0,1.0,65.0,16.0,6.0,2,3,31,247,187,2373,2620,12/14/2020
2020-03-28,59,293,260,2867,3160,11.0,90.0,2.0,15.0,1.0,2.0,73.0,15.0,6.0,1,4,64,311,234,2607,2918,12/14/2020
2020-03-29,100,393,350,3217,3610,8.0,98.0,3.0,18.0,1.0,3.0,77.0,18.0,8.0,2,6,105,416,293,2900,3316,12/14/2020
2020-03-30,62,455,222,3439,3894,19.0,117.0,5.0,23.0,0.0,3.0,91.0,19.0,11.0,3,9,78,494,172,3072,3566,12/14/2020
2020-03-31,71,526,369,3808,4334,11.0,128.0,7.0,30.0,1.0,4.0,94.0,21.0,13.0,2,11,73,567,286,3358,3925,12/14/2020
2020-04-01,99,625,698,4506,5131,18.0,146.0,7.0,37.0,0.0,4.0,105.0,29.0,15.0,1,12,100,667,594,3952,4619,12/14/2020
2020-04-02,52,677,477,4983,5660,22.0,168.0,6.0,43.0,2.0,6.0,119.0,35.0,21.0,4,16,62,729,410,4362,5091,12/14/2020
2020-04-03,108,785,774,5757,6542,23.0,191.0,7.0,50.0,0.0,6.0,135.0,42.0,25.0,3,19,100,829,666,5028,5857,12/14/2020
2020-04-04,143,928,660,6417,7345,22.0,213.0,4.0,54.0,5.0,11.0,148.0,40.0,29.0,9,28,138,967,577,5605,6572,12/14/2020
2020-04-05,187,1115,1156,7573,8688,20.0,233.0,9.0,63.0,1.0,12.0,158.0,43.0,35.0,2,30,181,1148,983,6588,7736,12/14/2020
2020-04-06,218,1333,1706,9279,10612,26.0,259.0,7.0,70.0,0.0,12.0,177.0,47.0,39.0,7,37,207,1355,1455,8043,9398,12/14/2020
2020-04-07,284,1617,1629,10908,12525,20.0,279.0,4.0,74.0,2.0,14.0,191.0,49.0,41.0,5,42,260,1615,1391,9434,11049,12/14/2020
2020-04-08,290,1907,1720,12628,14535,19.0,298.0,8.0,82.0,5.0,19.0,197.0,49.0,37.0,10,52,271,1886,1462,10896,12782,12/14/2020
2020-04-09,283,2190,1516,14144,16334,32.0,330.0,8.0,90.0,4.0,23.0,217.0,53.0,40.0,7,59,277,2163,1271,12167,14330,12/14/2020
2020-04-10,419,2609,2574,16718,19327,29.0,359.0,17.0,107.0,5.0,28.0,224.0,59.0,41.0,11,70,400,2563,2236,14403,16966,12/14/2020
2020-04-11,297,2906,1905,18623,21529,29.0,388.0,11.0,118.0,2.0,30.0,240.0,61.0,48.0,12,82,280,2843,1624,16027,18870,12/14/2020
2020-04-12,314,3220,1670,20293,23513,35.0,423.0,13.0,131.0,5.0,35.0,257.0,59.0,49.0,9,91,286,3129,1305,17332,20461,12/14/2020
2020-04-13,161,3381,935,21228,24609,35.0,458.0,13.0,144.0,3.0,38.0,276.0,64.0,54.0,9,100,187,3316,792,18124,21440,12/14/2020
2020-04-14,289,3670,1787,23015,26685,27.0,485.0,18.0,162.0,5.0,43.0,280.0,72.0,53.0,8,108,261,3577,1423,19547,23124,12/14/2020
2020-04-15,351,4021,1799,24814,28835,31.0,516.0,20.0,182.0,3.0,46.0,288.0,72.0,54.0,17,125,306,3883,1423,20970,24853,12/14/2020
2020-04-16,447,4468,2494,27308,31776,36.0,552.0,25.0,207.0,6.0,52.0,293.0,72.0,53.0,14,139,387,4270,1912,22882,27152,12/14/2020
2020-04-17,304,4772,1821,29129,33901,32.0,584.0,20.0,227.0,7.0,59.0,298.0,66.0,45.0,21,160,290,4560,1328,24210,28770,12/14/2020
2020-04-18,321,5093,1725,30854,35947,26.0,610.0,18.0,245.0,4.0,63.0,302.0,63.0,49.0,15,175,284,4844,1237,25447,30291,12/14/2020
2020-04-19,381,5474,2047,32901,38375,23.0,633.0,26.0,271.0,1.0,64.0,298.0,65.0,55.0,11,186,337,5181,1640,27087,32268,12/14/2020
2020-04-20,394,5868,1907,34808,40676,46.0,679.0,29.0,300.0,2.0,66.0,313.0,75.0,56.0,10,196,376,5557,1477,28564,34121,12/14/2020
2020-04-21,444,6312,2110,36918,43230,45.0,724.0,32.0,332.0,5.0,71.0,321.0,72.0,56.0,18,214,383,5940,1607,30171,36111,12/14/2020
2020-04-22,418,6730,2390,39308,46038,41.0,765.0,32.0,364.0,5.0,76.0,325.0,73.0,58.0,18,232,379,6319,1773,31944,38263,12/14/2020
2020-04-23,479,7209,2469,41777,48986,32.0,797.0,28.0,392.0,5.0,81.0,324.0,76.0,62.0,15,247,412,6731,1728,33672,40403,12/14/2020
2020-04-24,491,7700,3284,45061,52761,35.0,832.0,26.0,418.0,4.0,85.0,329.0,85.0,63.0,15,262,407,7138,2390,36062,43200,12/14/2020
2020-04-25,393,8093,2206,47267,55360,34.0,866.0,17.0,435.0,5.0,90.0,341.0,85.0,62.0,14,276,299,7437,1605,37667,45104,12/14/2020
2020-04-26,316,8409,2309,49576,57985,33.0,899.0,15.0,450.0,3.0,93.0,356.0,86.0,59.0,14,290,274,7711,1724,39391,47102,12/14/2020
2020-04-27,249,8658,1620,51196,59854,29.0,928.0,21.0,471.0,4.0,97.0,360.0,86.0,61.0,10,300,206,7917,1077,40468,48385,12/14/2020
2020-04-28,410,9068,2263,53459,62527,44.0,972.0,24.0,495.0,3.0,100.0,377.0,88.0,59.0,22,322,331,8248,1550,42018,50266,12/14/2020
2020-04-29,476,9544,3343,56802,66346,36.0,1008.0,38.0,533.0,11.0,111.0,364.0,78.0,53.0,18,340,371,8619,2189,44207,52826,12/14/2020
2020-04-30,432,9976,2769,59571,69547,33.0,1041.0,38.0,571.0,6.0,117.0,353.0,83.0,57.0,24,364,351,8970,1728,45935,54905,12/14/2020
2020-05-01,454,10430,3086,62657,73087,52.0,1093.0,39.0,610.0,3.0,120.0,363.0,84.0,58.0,14,378,323,9293,1941,47876,57169,12/14/2020
2020-05-02,257,10687,1926,64583,75270,36.0,1129.0,38.0,648.0,5.0,125.0,356.0,93.0,63.0,24,402,193,9486,1182,49058,58544,12/14/2020
2020-05-03,283,10970,2160,66743,77713,31.0,1160.0,27.0,675.0,8.0,133.0,352.0,91.0,61.0,21,423,183,9669,1426,50484,60153,12/14/2020
2020-05-04,387,11357,2098,68841,80198,30.0,1190.0,31.0,706.0,5.0,138.0,346.0,89.0,58.0,18,441,290,9959,1458,51942,61901,12/14/2020
2020-05-05,433,11790,2873,71714,83504,29.0,1219.0,32.0,738.0,6.0,144.0,337.0,83.0,55.0,16,457,299,10258,1834,53776,64034,12/14/2020
2020-05-06,488,12278,2830,74544,86822,28.0,1247.0,44.0,782.0,9.0,153.0,312.0,80.0,55.0,21,478,340,10598,1792,55568,66166,12/14/2020
2020-05-07,425,12703,2969,77513,90216,36.0,1283.0,44.0,826.0,5.0,158.0,299.0,72.0,53.0,21,499,270,10868,1811,57379,68247,12/14/2020
2020-05-08,359,13062,2598,80111,93173,30.0,1313.0,29.0,855.0,5.0,163.0,295.0,72.0,54.0,22,521,230,11098,1562,58941,70039,12/14/2020
2020-05-09,467,13529,3346,83457,96986,22.0,1335.0,21.0,876.0,4.0,167.0,292.0,70.0,52.0,15,536,289,11387,2094,61035,72422,12/14/2020
2020-05-10,285,13814,2117,85574,99388,20.0,1355.0,23.0,899.0,6.0,173.0,283.0,71.0,50.0,14,550,190,11577,1405,62440,74017,12/14/2020
2020-05-11,257,14071,1857,87431,101502,31.0,1386.0,16.0,915.0,6.0,179.0,292.0,72.0,50.0,15,565,173,11750,1220,63660,75410,12/14/2020
2020-05-12,387,14458,2611,90042,104500,23.0,1409.0,18.0,933.0,4.0,183.0,293.0,70.0,49.0,22,587,224,11974,1532,65192,77166,12/14/2020
2020-05-13,351,14809,3630,93672,108481,23.0,1432.0,25.0,958.0,1.0,184.0,290.0,70.0,50.0,13,600,199,12173,1830,67022,79195,12/14/2020
2020-05-14,329,15138,3408,97080,112218,19.0,1451.0,27.0,985.0,3.0,187.0,279.0,65.0,46.0,15,615,232,12405,1856,68878,81283,12/14/2020
2020-05-15,381,15519,3458,100538,116057,24.0,1475.0,41.0,1026.0,5.0,192.0,257.0,63.0,46.0,14,629,232,12637,1704,70582,83219,12/14/2020
2020-05-16,449,15968,4156,104694,120662,25.0,1500.0,15.0,1041.0,5.0,197.0,262.0,62.0,47.0,15,644,247,12884,1819,72401,85285,12/14/2020
2020-05-17,240,16208,2768,107462,123670,17.0,1517.0,9.0,1050.0,5.0,202.0,265.0,60.0,46.0,10,654,126,13010,1436,73837,86847,12/14/2020
2020-05-18,250,16458,2001,109463,125921,19.0,1536.0,16.0,1066.0,5.0,207.0,263.0,58.0,41.0,18,672,135,13145,1301,75138,88283,12/14/2020
2020-05-19,415,16873,3168,112631,129504,23.0,1559.0,33.0,1099.0,5.0,212.0,248.0,57.0,39.0,11,683,215,13360,1820,76958,90318,12/14/2020
2020-05-20,326,17199,2771,115402,132601,19.0,1578.0,23.0,1122.0,7.0,219.0,237.0,53.0,34.0,22,705,183,13543,1439,78397,91940,12/14/2020
2020-05-21,374,17573,3757,119159,136732,25.0,1603.0,15.0,1137.0,3.0,222.0,244.0,54.0,30.0,20,725,168,13711,1843,80240,93951,12/14/2020
2020-05-22,351,17924,3161,122320,140244,20.0,1623.0,28.0,1165.0,5.0,227.0,231.0,53.0,30.0,11,736,206,13917,1503,81743,95660,12/14/2020
2020-05-23,253,18177,2742,125062,143239,19.0,1642.0,11.0,1176.0,3.0,230.0,236.0,53.0,33.0,13,749,109,14026,1205,82948,96974,12/14/2020
2020-05-24,163,18340,1370,126432,144772,13.0,1655.0,14.0,1190.0,2.0,232.0,233.0,54.0,36.0,8,757,83,14109,736,83684,97793,12/14/2020
2020-05-25,147,18487,1385,127817,146304,14.0,1669.0,14.0,1204.0,0.0,232.0,233.0,54.0,34.0,10,767,76,14185,688,84372,98557,12/14/2020
2020-05-26,285,18772,2620,130437,149209,24.0,1693.0,21.0,1225.0,5.0,237.0,231.0,49.0,33.0,15,782,158,14343,1563,85935,100278,12/14/2020
2020-05-27,276,19048,2057,132494,151542,20.0,1713.0,18.0,1243.0,3.0,240.0,230.0,51.0,33.0,10,792,132,14475,1082,87017,101492,12/14/2020
2020-05-28,348,19396,3359,135853,155249,17.0,1730.0,29.0,1272.0,4.0,244.0,214.0,47.0,32.0,8,800,130,14605,1047,88064,102669,12/14/2020
2020-05-29,410,19806,3915,139768,159574,19.0,1749.0,26.0,1298.0,7.0,251.0,200.0,43.0,31.0,12,812,174,14779,1472,89536,104315,12/14/2020
2020-05-30,225,20031,3915,143683,163714,16.0,1765.0,19.0,1317.0,4.0,255.0,193.0,41.0,29.0,12,824,109,14888,1635,91171,106059,12/14/2020
2020-05-31,155,20186,1690,145373,165559,11.0,1776.0,11.0,1328.0,1.0,256.0,192.0,44.0,26.0,3,827,78,14966,785,91956,106922,12/14/2020
2020-06-01,212,20398,2792,148165,168563,8.0,1784.0,14.0,1342.0,1.0,257.0,185.0,45.0,29.0,5,832,93,15059,1315,93271,108330,12/14/2020
2020-06-02,273,20671,3022,151187,171858,8.0,1792.0,9.0,1351.0,3.0,260.0,181.0,38.0,25.0,10,842,98,15157,1356,94627,109784,12/14/2020
2020-06-03,254,20925,3486,154673,175598,14.0,1806.0,18.0,1369.0,6.0,266.0,171.0,34.0,25.0,11,853,99,15256,1568,96195,111451,12/14/2020
2020-06-04,276,21201,4471,159144,180345,7.0,1813.0,26.0,1395.0,4.0,270.0,148.0,31.0,24.0,12,865,107,15363,1905,98100,113463,12/14/2020
2020-06-05,215,21416,3513,162657,184073,15.0,1828.0,13.0,1408.0,6.0,276.0,144.0,27.0,21.0,11,876,99,15462,1452,99552,115014,12/14/2020
2020-06-06,201,21617,2616,165273,186890,10.0,1838.0,7.0,1415.0,2.0,278.0,145.0,29.0,19.0,6,882,67,15529,1065,100617,116146,12/14/2020
2020-06-07,83,21700,1625,166898,188598,11.0,1849.0,7.0,1422.0,1.0,279.0,148.0,25.0,17.0,4,886,51,15580,761,101378,116958,12/14/2020
2020-06-08,119,21819,1849,168747,190566,15.0,1864.0,13.0,1435.0,2.0,281.0,148.0,27.0,18.0,4,890,45,15625,912,102290,117915,12/14/2020
2020-06-09,223,22042,2673,171420,193462,10.0,1874.0,19.0,1454.0,0.0,281.0,139.0,28.0,21.0,1,891,64,15689,1199,103489,119178,12/14/2020
2020-06-10,209,22251,2987,174407,196658,13.0,1887.0,12.0,1466.0,2.0,283.0,138.0,24.0,17.0,4,895,100,15789,1409,104898,120687,12/14/2020
2020-06-11,195,22446,3513,177920,200366,7.0,1894.0,15.0,1481.0,1.0,284.0,129.0,25.0,16.0,6,901,88,15877,1457,106355,122232,12/14/2020
2020-06-12,209,22655,4601,182521,205176,9.0,1903.0,16.0,1497.0,1.0,285.0,121.0,24.0,16.0,2,903,78,15955,2003,108358,124313,12/14/2020
2020-06-13,113,22768,3036,185557,208325,6.0,1909.0,5.0,1502.0,0.0,285.0,122.0,20.0,15.0,3,906,49,16004,1269,109627,125631,12/14/2020
2020-06-14,81,22849,2046,187603,210452,7.0,1916.0,8.0,1510.0,1.0,286.0,120.0,20.0,14.0,3,909,33,16037,928,110555,126592,12/14/2020
2020-06-15,188,23037,3108,190711,213748,14.0,1930.0,19.0,1529.0,0.0,286.0,115.0,20.0,16.0,5,914,75,16112,1706,112261,128373,12/14/2020
2020-06-16,110,23147,3017,193728,216875,11.0,1941.0,9.0,1538.0,1.0,287.0,116.0,22.0,16.0,8,922,50,16162,1466,113727,129889,12/14/2020
2020-06-17,127,23274,2835,196563,219837,15.0,1956.0,20.0,1558.0,4.0,291.0,107.0,18.0,14.0,6,928,51,16213,1258,114985,131198,12/14/2020
2020-06-18,149,23423,3048,199611,223034,9.0,1965.0,15.0,1573.0,1.0,292.0,100.0,19.0,16.0,7,935,70,16283,1254,116239,132522,12/14/2020
2020-06-19,141,23564,3769,203380,226944,12.0,1977.0,12.0,1585.0,1.0,293.0,99.0,20.0,17.0,3,938,59,16342,1304,117543,133885,12/14/2020
2020-06-20,84,23648,1891,205271,228919,9.0,1986.0,12.0,1597.0,0.0,293.0,96.0,20.0,18.0,4,942,36,16378,778,118321,134699,12/14/2020
2020-06-21,37,23685,1064,206335,230020,8.0,1994.0,5.0,1602.0,0.0,293.0,99.0,20.0,18.0,2,944,30,16408,656,118977,135385,12/14/2020
2020-06-22,138,23823,3730,210065,233888,12.0,2006.0,17.0,1619.0,0.0,293.0,94.0,19.0,18.0,2,946,65,16473,1633,120610,137083,12/14/2020
2020-06-23,163,23986,3831,213896,237882,3.0,2009.0,13.0,1632.0,3.0,296.0,81.0,18.0,18.0,7,953,81,16554,1712,122322,138876,12/14/2020
2020-06-24,120,24106,3502,217398,241504,9.0,2018.0,10.0,1642.0,1.0,297.0,79.0,18.0,18.0,5,958,44,16598,1607,123929,140527,12/14/2020
2020-06-25,103,24209,2883,220281,244490,6.0,2024.0,14.0,1656.0,1.0,298.0,70.0,17.0,17.0,1,959,51,16649,1432,125361,142010,12/14/2020
2020-06-26,94,24303,2488,222769,247072,2.0,2026.0,10.0,1666.0,0.0,298.0,62.0,18.0,18.0,1,960,60,16709,1273,126634,143343,12/14/2020
2020-06-27,84,24387,3216,225985,250372,5.0,2031.0,3.0,1669.0,1.0,299.0,63.0,17.0,17.0,5,965,37,16746,1164,127798,144544,12/14/2020
2020-06-28,39,24426,1469,227454,251880,4.0,2035.0,4.0,1673.0,4.0,303.0,59.0,15.0,14.0,6,971,17,16763,575,128373,145136,12/14/2020
2020-06-29,85,24511,3697,231151,255662,4.0,2039.0,5.0,1678.0,0.0,303.0,58.0,14.0,14.0,1,972,39,16802,1300,129673,146475,12/14/2020
2020-06-30,57,24568,1958,233109,257677,1.0,2040.0,5.0,1683.0,1.0,304.0,53.0,12.0,11.0,4,976,32,16834,957,130630,147464,12/14/2020
2020-07-01,144,24712,4098,237207,261919,8.0,2048.0,10.0,1693.0,0.0,304.0,51.0,11.0,11.0,1,977,79,16913,1855,132485,149398,12/14/2020
2020-07-02,103,24815,2803,240010,264825,5.0,2053.0,5.0,1698.0,1.0,305.0,50.0,10.0,10.0,3,980,59,16972,1037,133522,150494,12/14/2020
2020-07-03,50,24865,2079,242089,266954,9.0,2062.0,6.0,1704.0,0.0,305.0,53.0,9.0,9.0,3,983,25,16997,751,134273,151270,12/14/2020
2020-07-04,57,24922,2345,244434,269356,2.0,2064.0,4.0,1708.0,1.0,306.0,50.0,10.0,9.0,2,985,33,17030,964,135237,152267,12/14/2020
2020-07-05,49,24971,2932,247366,272337,1.0,2065.0,2.0,1710.0,1.0,307.0,48.0,8.0,8.0,2,987,26,17056,1368,136605,153661,12/14/2020
2020-07-06,101,25072,2814,250180,275252,6.0,2071.0,6.0,1716.0,0.0,307.0,48.0,9.0,9.0,4,991,57,17113,1498,138103,155216,12/14/2020
2020-07-07,81,25153,3457,253637,278790,5.0,2076.0,7.0,1723.0,0.0,307.0,46.0,8.0,8.0,2,993,47,17160,1488,139591,156751,12/14/2020
2020-07-08,105,25258,3409,257046,282304,4.0,2080.0,2.0,1725.0,0.0,307.0,48.0,9.0,8.0,0,993,64,17224,1353,140944,158168,12/14/2020
2020-07-09,94,25352,3714,260760,286112,9.0,2089.0,3.0,1728.0,0.0,307.0,54.0,9.0,8.0,0,993,50,17274,1555,142499,159773,12/14/2020
2020-07-10,132,25484,4437,265197,290681,6.0,2095.0,3.0,1731.0,2.0,309.0,55.0,7.0,7.0,3,996,80,17354,1991,144490,161844,12/14/2020
2020-07-11,63,25547,2938,268135,293682,6.0,2101.0,3.0,1734.0,1.0,310.0,57.0,6.0,6.0,3,999,36,17390,1267,145757,163147,12/14/2020
2020-07-12,47,25594,1838,269973,295567,1.0,2102.0,3.0,1737.0,1.0,311.0,54.0,6.0,5.0,3,1002,34,17424,910,146667,164091,12/14/2020
2020-07-13,84,25678,3209,273182,298860,8.0,2110.0,10.0,1747.0,0.0,311.0,52.0,6.0,5.0,1,1003,61,17485,1449,148116,165601,12/14/2020
2020-07-14,74,25752,3298,276480,302232,7.0,2117.0,4.0,1751.0,0.0,311.0,55.0,5.0,5.0,1,1004,44,17529,1334,149450,166979,12/14/2020
2020-07-15,130,25882,4181,280661,306543,5.0,2122.0,7.0,1758.0,0.0,311.0,53.0,5.0,4.0,0,1004,100,17629,1686,151136,168765,12/14/2020
2020-07-16,103,25985,3740,284401,310386,6.0,2128.0,9.0,1767.0,0.0,311.0,50.0,6.0,5.0,1,1005,76,17705,1544,152680,170385,12/14/2020
2020-07-17,156,26141,4239,288640,314781,14.0,2142.0,3.0,1770.0,1.0,312.0,60.0,5.0,5.0,2,1007,79,17784,1779,154459,172243,12/14/2020
2020-07-18,85,26226,3272,291912,318138,5.0,2147.0,9.0,1779.0,1.0,313.0,55.0,5.0,4.0,4,1011,70,17854,1344,155803,173657,12/14/2020
2020-07-19,82,26308,2696,294608,320916,7.0,2154.0,3.0,1782.0,0.0,313.0,59.0,6.0,4.0,2,1013,57,17911,1096,156899,174810,12/14/2020
2020-07-20,71,26379,2666,297274,323653,9.0,2163.0,7.0,1789.0,0.0,313.0,61.0,7.0,5.0,2,1015,68,17979,1402,158301,176280,12/14/2020
2020-07-21,130,26509,4304,301578,328087,9.0,2172.0,11.0,1800.0,0.0,313.0,59.0,9.0,6.0,1,1016,108,18087,1849,160150,178237,12/14/2020
2020-07-22,130,26639,3928,305506,332145,7.0,2179.0,8.0,1808.0,1.0,314.0,57.0,7.0,6.0,1,1017,86,18173,1607,161757,179930,12/14/2020
2020-07-23,141,26780,4415,309921,336701,8.0,2187.0,6.0,1814.0,0.0,314.0,59.0,8.0,7.0,0,1017,115,18288,1898,163655,181943,12/14/2020
2020-07-24,172,26952,5966,315887,342839,15.0,2202.0,12.0,1826.0,0.0,314.0,62.0,9.0,7.0,0,1017,119,18407,2227,165882,184289,12/14/2020
2020-07-25,134,27086,4398,320285,347371,7.0,2209.0,7.0,1833.0,0.0,314.0,62.0,10.0,8.0,3,1020,108,18515,2025,167907,186422,12/14/2020
2020-07-26,62,27148,3033,323318,350466,8.0,2217.0,9.0,1842.0,0.0,314.0,61.0,11.0,7.0,1,1021,54,18569,1290,169197,187766,12/14/2020
2020-07-27,188,27336,4191,327509,354845,12.0,2229.0,7.0,1849.0,0.0,314.0,66.0,13.0,8.0,1,1022,138,18707,2250,171447,190154,12/14/2020
2020-07-28,105,27441,3840,331349,358790,5.0,2234.0,5.0,1854.0,0.0,314.0,66.0,14.0,7.0,1,1023,95,18802,1579,173026,191828,12/14/2020
2020-07-29,190,27631,5139,336488,364119,9.0,2243.0,10.0,1864.0,0.0,314.0,65.0,15.0,7.0,0,1023,154,18956,2219,175245,194201,12/14/2020
2020-07-30,121,27752,4345,340833,368585,6.0,2249.0,2.0,1866.0,1.0,315.0,68.0,15.0,6.0,1,1024,97,19053,1564,176809,195862,12/14/2020
2020-07-31,131,27883,5512,346345,374228,7.0,2256.0,9.0,1875.0,0.0,315.0,66.0,15.0,7.0,1,1025,89,19142,1772,178581,197723,12/14/2020
2020-08-01,109,27992,4294,350639,378631,7.0,2263.0,2.0,1877.0,0.0,315.0,71.0,14.0,7.0,1,1026,89,19231,1498,180079,199310,12/14/2020
2020-08-02,84,28076,2804,353443,381519,12.0,2275.0,12.0,1889.0,2.0,317.0,69.0,14.0,8.0,2,1028,62,19293,1228,181307,200600,12/14/2020
2020-08-03,188,28264,5248,358691,386955,11.0,2286.0,10.0,1899.0,0.0,317.0,70.0,16.0,7.0,1,1029,150,19443,2121,183428,202871,12/14/2020
2020-08-04,125,28389,3691,362382,390771,8.0,2294.0,5.0,1904.0,1.0,318.0,72.0,12.0,5.0,2,1031,99,19542,1710,185138,204680,12/14/2020
2020-08-05,147,28536,5935,368317,396853,11.0,2305.0,9.0,1913.0,1.0,319.0,73.0,10.0,5.0,2,1033,119,19661,2375,187513,207174,12/14/2020
2020-08-06,169,28705,5546,373863,402568,7.0,2312.0,9.0,1922.0,0.0,319.0,71.0,9.0,4.0,0,1033,120,19781,2296,189809,209590,12/14/2020
2020-08-07,123,28828,4851,378714,407542,12.0,2324.0,9.0,1931.0,1.0,320.0,73.0,9.0,3.0,2,1035,87,19868,2058,191867,211735,12/14/2020
2020-08-08,123,28951,4112,382826,411777,19.0,2343.0,6.0,1937.0,1.0,321.0,85.0,8.0,3.0,1,1036,91,19959,1715,193582,213541,12/14/2020
2020-08-09,42,28993,1727,384553,413546,6.0,2349.0,8.0,1945.0,0.0,321.0,83.0,9.0,4.0,0,1036,35,19994,1022,194604,214598,12/14/2020
2020-08-10,149,29142,4587,389140,418282,8.0,2357.0,9.0,1954.0,0.0,321.0,82.0,9.0,4.0,1,1037,113,20107,1950,196554,216661,12/14/2020
2020-08-11,106,29248,4334,393474,422722,5.0,2362.0,13.0,1967.0,0.0,321.0,74.0,10.0,4.0,3,1040,92,20199,2191,198745,218944,12/14/2020
2020-08-12,121,29369,5188,398662,428031,8.0,2370.0,11.0,1978.0,0.0,321.0,71.0,9.0,3.0,1,1041,101,20300,2522,201267,221567,12/14/2020
2020-08-13,135,29504,4196,402858,432362,13.0,2383.0,12.0,1990.0,0.0,321.0,72.0,11.0,3.0,0,1041,95,20395,1832,203099,223494,12/14/2020
2020-08-14,145,29649,5498,408356,438005,13.0,2396.0,11.0,2001.0,0.0,321.0,74.0,11.0,4.0,3,1044,98,20493,1905,205004,225497,12/14/2020
2020-08-15,106,29755,4534,412890,442645,9.0,2405.0,11.0,2012.0,1.0,322.0,71.0,11.0,5.0,0,1044,88,20581,1628,206632,227213,12/14/2020
2020-08-16,83,29838,2477,415367,445205,6.0,2411.0,5.0,2017.0,4.0,326.0,68.0,8.0,4.0,6,1050,70,20651,922,207554,228205,12/14/2020
2020-08-17,106,29944,4575,419942,449886,8.0,2419.0,6.0,2023.0,0.0,326.0,70.0,8.0,5.0,2,1052,87,20738,2309,209863,230601,12/14/2020
2020-08-18,128,30072,4911,424853,454925,11.0,2430.0,8.0,2031.0,1.0,327.0,72.0,8.0,4.0,5,1057,94,20832,2661,212524,233356,12/14/2020
2020-08-19,113,30185,5077,429930,460115,8.0,2438.0,9.0,2040.0,1.0,328.0,70.0,9.0,5.0,0,1057,90,20922,2560,215084,236006,12/14/2020
2020-08-20,173,30358,7411,437341,467699,12.0,2450.0,6.0,2046.0,2.0,330.0,74.0,10.0,5.0,3,1060,139,21061,3408,218492,239553,12/14/2020
2020-08-21,152,30510,6577,443918,474428,8.0,2458.0,5.0,2051.0,1.0,331.0,76.0,9.0,4.0,2,1062,125,21186,2829,221321,242507,12/14/2020
2020-08-22,96,30606,5550,449468,480074,11.0,2469.0,12.0,2063.0,0.0,331.0,75.0,11.0,4.0,1,1063,84,21270,2509,223830,245100,12/14/2020
2020-08-23,72,30678,4375,453843,484521,11.0,2480.0,6.0,2069.0,0.0,331.0,80.0,12.0,2.0,1,1064,56,21326,2415,226245,247571,12/14/2020
2020-08-24,105,30783,5784,459627,490410,7.0,2487.0,10.0,2079.0,1.0,332.0,76.0,14.0,4.0,1,1065,77,21403,3057,229302,250705,12/14/2020
2020-08-25,108,30891,4764,464391,495282,10.0,2497.0,4.0,2083.0,1.0,333.0,81.0,12.0,4.0,1,1066,92,21495,2223,231525,253020,12/14/2020
2020-08-26,170,31061,9482,473873,504934,4.0,2501.0,8.0,2091.0,0.0,333.0,77.0,10.0,5.0,1,1067,127,21622,2991,234516,256138,12/14/2020
2020-08-27,91,31152,8565,482438,513590,6.0,2507.0,13.0,2104.0,1.0,334.0,69.0,7.0,5.0,2,1069,70,21692,3049,237565,259257,12/14/2020
2020-08-28,113,31265,7994,490432,521697,14.0,2521.0,4.0,2108.0,0.0,334.0,79.0,10.0,7.0,2,1071,87,21779,2342,239907,261686,12/14/2020
2020-08-29,65,31330,5374,495806,527136,6.0,2527.0,8.0,2116.0,1.0,335.0,76.0,11.0,6.0,2,1073,51,21830,1857,241764,263594,12/14/2020
2020-08-30,66,31396,4323,500129,531525,7.0,2534.0,4.0,2120.0,0.0,335.0,79.0,9.0,5.0,2,1075,48,21878,1932,243696,265574,12/14/2020
2020-08-31,105,31501,4863,504992,536493,12.0,2546.0,16.0,2136.0,0.0,335.0,75.0,8.0,4.0,1,1076,81,21959,2126,245822,267781,12/14/2020
2020-09-01,99,31600,7109,512101,543701,6.0,2552.0,9.0,2145.0,1.0,336.0,71.0,7.0,4.0,2,1078,66,22025,2307,248129,270154,12/14/2020
2020-09-02,125,31725,10529,522630,554355,9.0,2561.0,10.0,2155.0,1.0,337.0,69.0,8.0,4.0,2,1080,104,22129,2963,251092,273221,12/14/2020
2020-09-03,90,31815,11080,533710,565525,8.0,2569.0,8.0,2163.0,0.0,337.0,69.0,9.0,4.0,3,1083,73,22202,2494,253586,275788,12/14/2020
2020-09-04,103,31918,8963,542673,574591,11.0,2580.0,4.0,2167.0,0.0,337.0,76.0,9.0,4.0,1,1084,83,22285,2295,255881,278166,12/14/2020
2020-09-05,52,31970,6309,548982,580952,6.0,2586.0,9.0,2176.0,0.0,337.0,73.0,8.0,3.0,1,1085,42,22327,1552,257433,279760,12/14/2020
2020-09-06,88,32058,4325,553307,585365,4.0,2590.0,8.0,2184.0,1.0,338.0,68.0,6.0,3.0,1,1086,65,22392,1888,259321,281713,12/14/2020
2020-09-07,35,32093,3002,556309,588402,11.0,2601.0,3.0,2187.0,0.0,338.0,76.0,5.0,3.0,1,1087,26,22418,620,259941,282359,12/14/2020
2020-09-08,74,32167,6381,562690,594857,6.0,2607.0,12.0,2199.0,1.0,339.0,69.0,6.0,3.0,2,1089,66,22484,1534,261475,283959,12/14/2020
2020-09-09,118,32285,8650,571340,603625,10.0,2617.0,5.0,2204.0,1.0,340.0,73.0,9.0,3.0,1,1090,102,22586,2060,263535,286121,12/14/2020
2020-09-10,164,32449,11334,582674,615123,9.0,2626.0,8.0,2212.0,0.0,340.0,74.0,10.0,3.0,1,1091,111,22697,2186,265721,288418,12/14/2020
2020-09-11,120,32569,9454,592128,624697,11.0,2637.0,11.0,2223.0,0.0,340.0,74.0,10.0,5.0,0,1091,96,22793,1895,267616,290409,12/14/2020
2020-09-12,110,32679,6174,598302,630981,8.0,2645.0,5.0,2228.0,2.0,342.0,75.0,9.0,5.0,3,1094,97,22890,1466,269082,291972,12/14/2020
2020-09-13,58,32737,2717,601019,633756,4.0,2649.0,3.0,2231.0,0.0,342.0,76.0,10.0,5.0,0,1094,54,22944,829,269911,292855,12/14/2020
2020-09-14,104,32841,6446,607465,640306,6.0,2655.0,3.0,2234.0,2.0,344.0,77.0,10.0,5.0,2,1096,95,23039,1663,271574,294613,12/14/2020
2020-09-15,122,32963,8470,615935,648898,7.0,2662.0,2.0,2236.0,1.0,345.0,81.0,10.0,5.0,2,1098,124,23163,2123,273697,296860,12/14/2020
2020-09-16,137,33100,9716,625651,658751,7.0,2669.0,7.0,2243.0,2.0,347.0,79.0,9.0,6.0,5,1103,118,23281,1910,275607,298888,12/14/2020
2020-09-17,125,33225,9239,634890,668115,7.0,2676.0,15.0,2258.0,0.0,347.0,71.0,8.0,4.0,0,1103,154,23435,1881,277488,300923,12/14/2020
2020-09-18,132,33357,10045,644935,678292,7.0,2683.0,7.0,2265.0,1.0,348.0,70.0,11.0,6.0,2,1105,132,23567,1861,279349,302916,12/14/2020
2020-09-19,115,33472,8297,653232,686704,7.0,2690.0,3.0,2268.0,0.0,348.0,74.0,10.0,6.0,4,1109,112,23679,1650,280999,304678,12/14/2020
2020-09-20,60,33532,3676,656908,690440,7.0,2697.0,6.0,2274.0,2.0,350.0,73.0,9.0,8.0,4,1113,49,23728,1286,282285,306013,12/14/2020
2020-09-21,102,33634,7018,663926,697560,12.0,2709.0,3.0,2277.0,2.0,352.0,80.0,8.0,6.0,2,1115,94,23822,2342,284627,308449,12/14/2020
2020-09-22,154,33788,9287,673213,707001,12.0,2721.0,3.0,2280.0,1.0,353.0,88.0,7.0,5.0,1,1116,124,23946,2123,286750,310696,12/14/2020
2020-09-23,136,33924,10651,683864,717788,13.0,2734.0,7.0,2287.0,0.0,353.0,94.0,6.0,5.0,0,1116,127,24073,2136,288886,312959,12/14/2020
2020-09-24,120,34044,12480,696344,730388,8.0,2742.0,9.0,2296.0,1.0,354.0,92.0,7.0,5.0,1,1117,120,24193,3081,291967,316160,12/14/2020
2020-09-25,150,34194,10553,706897,741091,9.0,2751.0,10.0,2306.0,0.0,354.0,91.0,6.0,5.0,1,1118,143,24336,2930,294897,319233,12/14/2020
2020-09-26,147,34341,10560,717457,751798,12.0,2763.0,9.0,2315.0,0.0,354.0,94.0,6.0,5.0,1,1119,120,24456,2358,297255,321711,12/14/2020
2020-09-27,43,34384,2764,720221,754605,7.0,2770.0,5.0,2320.0,0.0,354.0,96.0,9.0,5.0,0,1119,34,24490,820,298075,322565,12/14/2020
2020-09-28,156,34540,7307,727528,762068,7.0,2777.0,7.0,2327.0,2.0,356.0,94.0,7.0,5.0,2,1121,138,24628,2190,300265,324893,12/14/2020
2020-09-29,203,34743,11046,738574,773317,12.0,2789.0,18.0,2345.0,1.0,357.0,87.0,6.0,6.0,1,1122,185,24813,2742,303007,327820,12/14/2020
2020-09-30,223,34966,12230,750804,785770,6.0,2795.0,6.0,2351.0,0.0,357.0,87.0,6.0,6.0,1,1123,189,25002,2499,305506,330508,12/14/2020
2020-10-01,185,35151,12503,763307,798458,17.0,2812.0,13.0,2364.0,1.0,358.0,90.0,6.0,4.0,2,1125,166,25168,2330,307836,333004,12/14/2020
2020-10-02,209,35360,12154,775461,810821,14.0,2826.0,13.0,2377.0,1.0,359.0,90.0,8.0,5.0,2,1127,181,25349,2429,310265,335614,12/14/2020
2020-10-03,157,35517,9313,784774,820291,9.0,2835.0,9.0,2386.0,2.0,361.0,88.0,9.0,4.0,2,1129,131,25480,1960,312225,337705,12/14/2020
2020-10-04,81,35598,2369,787143,822741,11.0,2846.0,9.0,2395.0,1.0,362.0,89.0,8.0,5.0,2,1131,76,25556,926,313151,338707,12/14/2020
2020-10-05,174,35772,8985,796128,831900,30.0,2876.0,10.0,2405.0,2.0,364.0,107.0,9.0,6.0,4,1135,160,25716,2955,316106,341822,12/14/2020
2020-10-06,189,35961,11186,807314,843275,11.0,2887.0,4.0,2409.0,0.0,364.0,114.0,11.0,7.0,0,1135,188,25904,2818,318924,344828,12/14/2020
2020-10-07,244,36205,12444,819758,855963,13.0,2900.0,14.0,2423.0,2.0,366.0,111.0,9.0,7.0,2,1137,245,26149,3440,322364,348513,12/14/2020
2020-10-08,281,36486,15233,834991,871477,17.0,2917.0,13.0,2436.0,2.0,368.0,113.0,7.0,5.0,4,1141,276,26425,4117,326481,352906,12/14/2020
2020-10-09,229,36715,13745,848736,885451,21.0,2938.0,12.0,2448.0,0.0,368.0,122.0,10.0,7.0,3,1144,200,26625,4186,330667,357292,12/14/2020
2020-10-10,231,36946,13832,862568,899514,19.0,2957.0,10.0,2458.0,1.0,369.0,130.0,13.0,7.0,2,1146,192,26817,3693,334360,361177,12/14/2020
2020-10-11,99,37045,3263,865831,902876,12.0,2969.0,9.0,2467.0,1.0,370.0,132.0,14.0,5.0,6,1152,89,26906,1133,335493,362399,12/14/2020
2020-10-12,169,37214,6440,872271,909485,19.0,2988.0,15.0,2482.0,2.0,372.0,134.0,14.0,5.0,4,1156,156,27062,1679,337172,364234,12/14/2020
2020-10-13,223,37437,8522,880793,918230,15.0,3003.0,13.0,2495.0,4.0,376.0,132.0,13.0,5.0,7,1163,212,27274,2263,339435,366709,12/14/2020
2020-10-14,335,37772,15042,895835,933607,17.0,3020.0,7.0,2502.0,0.0,376.0,142.0,15.0,5.0,2,1165,304,27578,3923,343358,370936,12/14/2020
2020-10-15,269,38041,14642,910477,948518,12.0,3032.0,16.0,2518.0,1.0,377.0,137.0,13.0,5.0,2,1167,253,27831,3480,346838,374669,12/14/2020
2020-10-16,288,38329,15012,925489,963818,13.0,3045.0,18.0,2536.0,1.0,378.0,131.0,13.0,4.0,2,1169,276,28107,3280,350118,378225,12/14/2020
2020-10-17,360,38689,14069,939558,978247,19.0,3064.0,11.0,2547.0,1.0,379.0,138.0,17.0,4.0,2,1171,309,28416,3170,353288,381704,12/14/2020
2020-10-18,155,38844,4039,943597,982441,18.0,3082.0,11.0,2558.0,0.0,379.0,145.0,17.0,6.0,2,1173,125,28541,1273,354561,383102,12/14/2020
2020-10-19,385,39229,8492,952089,991318,21.0,3103.0,22.0,2580.0,2.0,381.0,142.0,15.0,6.0,1,1174,320,28861,2489,357050,385911,12/14/2020
2020-10-20,439,39668,13244,965333,1005001,23.0,3126.0,17.0,2597.0,0.0,381.0,148.0,14.0,8.0,3,1177,383,29244,2924,359974,389218,12/14/2020
2020-10-21,544,40212,17464,982797,1023009,23.0,3149.0,8.0,2605.0,2.0,383.0,161.0,15.0,9.0,3,1180,471,29715,3396,363370,393085,12/14/2020
2020-10-22,538,40750,15864,998661,1039411,24.0,3173.0,20.0,2625.0,3.0,386.0,162.0,14.0,9.0,3,1183,489,30204,3094,366464,396668,12/14/2020
2020-10-23,514,41264,16637,1015298,1056562,22.0,3195.0,22.0,2647.0,1.0,387.0,161.0,15.0,9.0,3,1186,457,30661,2806,369270,399931,12/14/2020
2020-10-24,359,41623,10249,1025547,1067170,17.0,3212.0,11.0,2658.0,0.0,387.0,167.0,14.0,8.0,1,1187,337,30998,2195,371465,402463,12/14/2020
2020-10-25,233,41856,4760,1030307,1072163,16.0,3228.0,15.0,2673.0,1.0,388.0,167.0,15.0,8.0,2,1189,210,31208,1409,372874,404082,12/14/2020
2020-10-26,454,42310,9174,1039481,1081791,28.0,3256.0,15.0,2688.0,2.0,390.0,178.0,18.0,8.0,3,1192,403,31611,2893,375767,407378,12/14/2020
2020-10-27,517,42827,13995,1053476,1096303,29.0,3285.0,15.0,2703.0,2.0,392.0,190.0,18.0,9.0,4,1196,455,32066,2331,378098,410164,12/14/2020
2020-10-28,469,43296,15230,1068706,1112002,25.0,3310.0,26.0,2729.0,1.0,393.0,188.0,17.0,9.0,3,1199,412,32478,2622,380720,413198,12/14/2020
2020-10-29,609,43905,16260,1084966,1128871,20.0,3330.0,22.0,2751.0,3.0,396.0,183.0,19.0,11.0,4,1203,529,33007,3056,383776,416783,12/14/2020
2020-10-30,565,44470,14864,1099830,1144300,21.0,3351.0,21.0,2772.0,5.0,401.0,178.0,19.0,9.0,4,1207,470,33477,2869,386645,420122,12/14/2020
2020-10-31,599,45069,11820,1111650,1156719,31.0,3382.0,13.0,2785.0,1.0,402.0,195.0,22.0,9.0,3,1210,486,33963,2352,388997,422960,12/14/2020
2020-11-01,330,45399,5091,1116741,1162140,22.0,3404.0,15.0,2800.0,1.0,403.0,201.0,26.0,12.0,4,1214,277,34240,1233,390230,424470,12/14/2020
2020-11-02,522,45921,9935,1126676,1172597,38.0,3442.0,27.0,2827.0,3.0,406.0,209.0,24.0,12.0,5,1219,459,34699,2854,393084,427783,12/14/2020
2020-11-03,601,46522,13041,1139717,1186239,33.0,3475.0,25.0,2852.0,1.0,407.0,216.0,24.0,12.0,1,1220,530,35229,2446,395530,430759,12/14/2020
2020-11-04,688,47210,16101,1155818,1203028,34.0,3509.0,27.0,2879.0,2.0,409.0,221.0,25.0,12.0,4,1224,640,35869,2856,398386,434255,12/14/2020
2020-11-05,768,47978,16593,1172411,1220389,46.0,3555.0,35.0,2914.0,1.0,410.0,231.0,24.0,14.0,3,1227,685,36554,2787,401173,437727,12/14/2020
2020-11-06,769,48747,16026,1188437,1237184,43.0,3598.0,31.0,2945.0,1.0,411.0,242.0,28.0,17.0,5,1232,691,37245,2971,404144,441389,12/14/2020
2020-11-07,604,49351,13649,1202086,1251437,34.0,3632.0,25.0,2970.0,1.0,412.0,250.0,31.0,18.0,1,1233,578,37823,2408,406552,444375,12/14/2020
2020-11-08,337,49688,4166,1206252,1255940,33.0,3665.0,26.0,2996.0,1.0,413.0,256.0,30.0,19.0,4,1237,322,38145,1251,407803,445948,12/14/2020
2020-11-09,808,50496,9063,1215315,1265811,40.0,3705.0,33.0,3029.0,2.0,415.0,261.0,28.0,18.0,3,1240,766,38911,2277,410080,448991,12/14/2020
2020-11-10,1053,51549,12982,1228297,1279846,45.0,3750.0,37.0,3066.0,0.0,415.0,269.0,31.0,18.0,6,1246,982,39893,2827,412907,452800,12/14/2020
2020-11-11,1087,52636,19738,1248035,1300671,42.0,3792.0,24.0,3090.0,5.0,420.0,282.0,30.0,15.0,7,1253,1003,40896,2626,415533,456429,12/14/2020
2020-11-12,893,53529,13911,1261946,1315475,39.0,3831.0,31.0,3121.0,3.0,423.0,287.0,28.0,15.0,5,1258,813,41709,2158,417691,459400,12/14/2020
2020-11-13,1165,54694,16389,1278335,1333029,39.0,3870.0,31.0,3152.0,0.0,423.0,295.0,27.0,15.0,2,1260,1115,42824,3033,420724,463548,12/14/2020
2020-11-14,782,55476,13517,1291852,1347328,42.0,3912.0,26.0,3178.0,5.0,428.0,306.0,25.0,13.0,10,1270,738,43562,2422,423146,466708,12/14/2020
2020-11-15,578,56054,6173,1298025,1354079,46.0,3958.0,21.0,3199.0,5.0,433.0,326.0,28.0,11.0,7,1277,495,44057,1393,424539,468596,12/14/2020
2020-11-16,738,56792,9616,1307641,1364433,56.0,4014.0,39.0,3238.0,3.0,436.0,340.0,26.0,13.0,5,1282,674,44731,2583,427122,471853,12/14/2020
2020-11-17,1538,58330,18177,1325818,1384148,59.0,4073.0,45.0,3283.0,2.0,438.0,352.0,30.0,13.0,5,1287,1401,46132,4062,431184,477316,12/14/2020
2020-11-18,1136,59466,16044,1341862,1401328,38.0,4111.0,38.0,3321.0,5.0,443.0,347.0,29.0,15.0,7,1294,1020,47152,3151,434335,481487,12/14/2020
2020-11-19,1128,60594,13169,1355031,1415625,46.0,4157.0,42.0,3363.0,4.0,447.0,347.0,30.0,18.0,5,1299,1032,48184,3359,437694,485878,12/14/2020
2020-11-20,1457,62051,22226,1377257,1439308,49.0,4206.0,48.0,3411.0,3.0,450.0,345.0,33.0,14.0,6,1305,1293,49477,4261,441955,491432,12/14/2020
2020-11-21,854,62905,17370,1394627,1457532,43.0,4249.0,34.0,3445.0,5.0,455.0,349.0,35.0,14.0,7,1312,756,50233,3099,445054,495287,12/14/2020
2020-11-22,571,63476,7519,1402146,1465622,65.0,4314.0,28.0,3473.0,4.0,459.0,382.0,33.0,15.0,11,1323,486,50719,1769,446823,497542,12/14/2020
2020-11-23,994,64470,11029,1413175,1477645,74.0,4388.0,39.0,3512.0,0.0,459.0,417.0,40.0,18.0,10,1333,893,51612,3371,450194,501806,12/14/2020
2020-11-24,1050,65520,14578,1427753,1493273,47.0,4435.0,60.0,3572.0,6.0,465.0,398.0,42.0,22.0,10,1343,940,52552,2739,452933,505485,12/14/2020
2020-11-25,1266,66786,18790,1446543,1513329,59.0,4494.0,58.0,3630.0,4.0,469.0,395.0,43.0,26.0,7,1350,1180,53732,3514,456447,510179,12/14/2020
2020-11-26,547,67333,6482,1453025,1520358,51.0,4545.0,36.0,3666.0,4.0,473.0,406.0,46.0,25.0,12,1362,467,54199,1556,458003,512202,12/14/2020
2020-11-27,1044,68377,9724,1462749,1531126,55.0,4600.0,49.0,3715.0,7.0,480.0,405.0,48.0,22.0,6,1368,969,55168,2503,460506,515674,12/14/2020
2020-11-28,1182,69559,11960,1474709,1544268,64.0,4664.0,40.0,3755.0,0.0,480.0,429.0,48.0,22.0,3,1371,1099,56267,2785,463291,519558,12/14/2020
2020-11-29,822,70381,6935,1481644,1552025,62.0,4726.0,36.0,3791.0,3.0,483.0,452.0,49.0,24.0,8,1379,754,57021,2300,465591,522612,12/14/2020
2020-11-30,1284,71665,9927,1491571,1563236,67.0,4793.0,59.0,3850.0,2.0,485.0,458.0,52.0,30.0,6,1385,1161,58182,2786,468377,526559,12/14/2020
2020-12-01,1555,73220,13950,1505521,1578741,61.0,4854.0,55.0,3905.0,4.0,489.0,460.0,50.0,31.0,12,1397,1423,59605,3356,471733,531338,12/14/2020
2020-12-02,1563,74783,15563,1521084,1595867,56.0,4910.0,53.0,3958.0,7.0,496.0,456.0,51.0,30.0,14,1411,1426,61031,3236,474969,536000,12/14/2020
2020-12-03,1773,76556,14631,1535715,1612271,63.0,4973.0,77.0,4035.0,5.0,501.0,437.0,47.0,31.0,10,1421,1642,62673,3311,478280,540953,12/14/2020
2020-12-04,1649,78205,16509,1552224,1630429,67.0,5040.0,50.0,4085.0,7.0,508.0,447.0,43.0,30.0,11,1432,1520,64193,3777,482057,546250,12/14/2020
2020-12-05,1200,79405,12609,1564833,1644238,70.0,5110.0,42.0,4127.0,4.0,512.0,471.0,46.0,29.0,11,1443,1068,65261,2885,484942,550203,12/14/2020
2020-12-06,1125,80530,7839,1572672,1653202,66.0,5176.0,50.0,4177.0,10.0,522.0,477.0,48.0,25.0,14,1457,980,66241,2482,487424,553665,12/14/2020
2020-12-07,1390,81920,10623,1583295,1665215,74.0,5250.0,58.0,4235.0,6.0,528.0,487.0,45.0,25.0,19,1476,1253,67494,3317,490741,558235,12/14/2020
2020-12-08,1462,83382,15283,1598578,1681960,56.0,5306.0,57.0,4292.0,5.0,533.0,481.0,48.0,27.0,16,1492,1317,68811,3564,494305,563116,12/14/2020
2020-12-09,1496,84878,16354,1614932,1699810,52.0,5358.0,62.0,4354.0,9.0,542.0,462.0,46.0,29.0,10,1502,1339,70150,3239,497544,567694,12/14/2020
2020-12-10,1471,86349,17169,1632101,1718450,58.0,5416.0,57.0,4411.0,6.0,548.0,457.0,52.0,29.0,13,1515,1248,71398,4058,501602,573000,12/14/2020
2020-12-11,1468,87817,17278,1649379,1737196,70.0,5486.0,80.0,4491.0,7.0,555.0,440.0,55.0,32.0,11,1526,1251,72649,3606,505208,577857,12/14/2020
2020-12-12,1091,88908,13023,1662402,1751310,48.0,5534.0,46.0,4537.0,9.0,564.0,433.0,47.0,31.0,12,1538,870,73519,3115,508323,581842,12/14/2020
2020-12-13,670,89578,6978,1669380,1758958,,,,,,,,,,17,1555,552,74071,1973,510296,584367,12/14/2020
2020-02-27,0,0,0,0,0,1.0,1.0,0.0,0.0,0.0,0.0,1.0,0.0,0.0,0,0,0,0,0,0,0,12/15/2020
2020-02-28,0,0,0,0,0,0.0,1.0,0.0,0.0,0.0,0.0,1.0,1.0,0.0,0,0,0,0,0,0,0,12/15/2020
2020-02-29,0,0,0,0,0,0.0,1.0,0.0,0.0,0.0,0.0,1.0,1.0,0.0,0,0,0,0,0,0,0,12/15/2020
2020-03-01,2,2,2,2,4,0.0,1.0,0.0,0.0,0.0,0.0,1.0,1.0,1.0,0,0,2,2,2,2,4,12/15/2020
2020-03-02,0,2,1,3,5,1.0,2.0,0.0,0.0,0.0,0.0,2.0,2.0,2.0,0,0,0,2,0,2,4,12/15/2020
2020-03-03,0,2,2,5,7,0.0,2.0,0.0,0.0,0.0,0.0,2.0,2.0,2.0,0,0,0,2,1,3,5,12/15/2020
2020-03-04,0,2,12,17,19,1.0,3.0,0.0,0.0,0.0,0.0,3.0,2.0,2.0,0,0,0,2,10,13,15,12/15/2020
2020-03-05,0,2,4,21,23,0.0,3.0,0.0,0.0,0.0,0.0,3.0,2.0,2.0,0,0,1,3,4,17,20,12/15/2020
2020-03-06,1,3,12,33,36,0.0,3.0,0.0,0.0,0.0,0.0,3.0,2.0,2.0,0,0,0,3,11,28,31,12/15/2020
2020-03-07,0,3,19,52,55,0.0,3.0,0.0,0.0,0.0,0.0,3.0,2.0,1.0,0,0,0,3,19,47,50,12/15/2020
2020-03-08,0,3,18,70,73,0.0,3.0,0.0,0.0,0.0,0.0,3.0,2.0,1.0,0,0,0,3,18,65,68,12/15/2020
2020-03-09,1,4,15,85,89,0.0,3.0,0.0,0.0,0.0,0.0,3.0,2.0,1.0,0,0,1,4,14,79,83,12/15/2020
2020-03-10,2,6,25,110,116,0.0,3.0,0.0,0.0,0.0,0.0,3.0,2.0,1.0,0,0,1,5,23,102,107,12/15/2020
2020-03-11,0,6,34,144,150,1.0,4.0,0.0,0.0,0.0,0.0,4.0,1.0,1.0,0,0,0,5,34,136,141,12/15/2020
2020-03-12,9,15,41,185,200,1.0,5.0,0.0,0.0,0.0,0.0,5.0,1.0,1.0,0,0,7,12,38,174,186,12/15/2020
2020-03-13,6,21,50,235,256,4.0,9.0,1.0,1.0,0.0,0.0,8.0,1.0,1.0,0,0,6,18,47,221,239,12/15/2020
2020-03-14,0,21,90,325,346,0.0,9.0,0.0,1.0,0.0,0.0,8.0,1.0,1.0,0,0,0,18,83,304,322,12/15/2020
2020-03-15,1,22,54,379,401,1.0,10.0,0.0,1.0,0.0,0.0,9.0,2.0,1.0,0,0,1,19,53,357,376,12/15/2020
2020-03-16,2,24,95,474,498,2.0,12.0,0.0,1.0,0.0,0.0,11.0,2.0,0.0,0,0,2,21,89,446,467,12/15/2020
2020-03-17,12,36,162,636,672,6.0,18.0,0.0,1.0,0.0,0.0,17.0,2.0,0.0,0,0,11,32,142,588,620,12/15/2020
2020-03-18,9,45,116,752,797,3.0,21.0,0.0,1.0,0.0,0.0,20.0,2.0,0.0,0,0,11,43,104,692,735,12/15/2020
2020-03-19,15,60,262,1014,1074,2.0,23.0,1.0,2.0,0.0,0.0,21.0,3.0,0.0,1,1,17,60,245,937,997,12/15/2020
2020-03-20,13,73,197,1211,1284,5.0,28.0,0.0,2.0,0.0,0.0,26.0,4.0,0.0,0,1,13,73,183,1120,1193,12/15/2020
2020-03-21,12,85,126,1337,1422,3.0,31.0,2.0,4.0,0.0,0.0,27.0,5.0,0.0,0,1,14,87,117,1237,1324,12/15/2020
2020-03-22,27,112,282,1619,1731,2.0,33.0,0.0,4.0,0.0,0.0,29.0,5.0,0.0,0,1,25,112,250,1487,1599,12/15/2020
2020-03-23,14,126,169,1788,1914,15.0,48.0,1.0,5.0,0.0,0.0,43.0,9.0,3.0,0,1,16,128,157,1644,1772,12/15/2020
2020-03-24,20,146,242,2030,2176,8.0,56.0,0.0,5.0,0.0,0.0,51.0,10.0,5.0,0,1,19,147,220,1864,2011,12/15/2020
2020-03-25,26,172,182,2212,2384,5.0,61.0,2.0,7.0,0.0,0.0,54.0,11.0,3.0,0,1,28,175,158,2022,2197,12/15/2020
2020-03-26,35,207,181,2393,2600,9.0,70.0,5.0,12.0,0.0,0.0,58.0,14.0,5.0,0,1,41,216,164,2186,2402,12/15/2020
2020-03-27,27,234,214,2607,2841,9.0,79.0,1.0,13.0,1.0,1.0,65.0,16.0,6.0,2,3,31,247,187,2373,2620,12/15/2020
2020-03-28,59,293,260,2867,3160,11.0,90.0,2.0,15.0,1.0,2.0,73.0,15.0,6.0,1,4,64,311,234,2607,2918,12/15/2020
2020-03-29,100,393,350,3217,3610,8.0,98.0,3.0,18.0,1.0,3.0,77.0,18.0,8.0,2,6,105,416,293,2900,3316,12/15/2020
2020-03-30,62,455,222,3439,3894,19.0,117.0,5.0,23.0,0.0,3.0,91.0,19.0,11.0,3,9,78,494,172,3072,3566,12/15/2020
2020-03-31,71,526,369,3808,4334,11.0,128.0,7.0,30.0,1.0,4.0,94.0,21.0,13.0,2,11,73,567,285,3357,3924,12/15/2020
2020-04-01,99,625,698,4506,5131,18.0,146.0,7.0,37.0,0.0,4.0,105.0,29.0,15.0,1,12,100,667,593,3950,4617,12/15/2020
2020-04-02,52,677,477,4983,5660,22.0,168.0,6.0,43.0,2.0,6.0,119.0,35.0,21.0,4,16,62,729,409,4359,5088,12/15/2020
2020-04-03,108,785,774,5757,6542,23.0,191.0,7.0,50.0,0.0,6.0,135.0,42.0,25.0,3,19,100,829,666,5025,5854,12/15/2020
2020-04-04,143,928,660,6417,7345,22.0,213.0,4.0,54.0,5.0,11.0,148.0,40.0,29.0,9,28,138,967,577,5602,6569,12/15/2020
2020-04-05,187,1115,1156,7573,8688,20.0,233.0,9.0,63.0,1.0,12.0,158.0,43.0,35.0,2,30,181,1148,980,6582,7730,12/15/2020
2020-04-06,218,1333,1706,9279,10612,26.0,259.0,7.0,70.0,0.0,12.0,177.0,47.0,39.0,7,37,207,1355,1453,8035,9390,12/15/2020
2020-04-07,284,1617,1629,10908,12525,20.0,279.0,4.0,74.0,2.0,14.0,191.0,49.0,41.0,5,42,260,1615,1390,9425,11040,12/15/2020
2020-04-08,290,1907,1720,12628,14535,19.0,298.0,8.0,82.0,5.0,19.0,197.0,49.0,37.0,10,52,271,1886,1461,10886,12772,12/15/2020
2020-04-09,283,2190,1516,14144,16334,32.0,330.0,8.0,90.0,4.0,23.0,217.0,53.0,40.0,7,59,277,2163,1269,12155,14318,12/15/2020
2020-04-10,419,2609,2574,16718,19327,29.0,359.0,17.0,107.0,5.0,28.0,224.0,59.0,41.0,11,70,400,2563,2231,14386,16949,12/15/2020
2020-04-11,297,2906,1905,18623,21529,29.0,388.0,11.0,118.0,2.0,30.0,240.0,61.0,48.0,12,82,280,2843,1624,16010,18853,12/15/2020
2020-04-12,314,3220,1670,20293,23513,35.0,423.0,13.0,131.0,5.0,35.0,257.0,59.0,49.0,9,91,286,3129,1305,17315,20444,12/15/2020
2020-04-13,161,3381,935,21228,24609,35.0,458.0,13.0,144.0,3.0,38.0,276.0,64.0,54.0,9,100,187,3316,789,18104,21420,12/15/2020
2020-04-14,289,3670,1787,23015,26685,27.0,485.0,18.0,162.0,5.0,43.0,280.0,72.0,53.0,8,108,261,3577,1421,19525,23102,12/15/2020
2020-04-15,351,4021,1799,24814,28835,31.0,516.0,20.0,182.0,3.0,46.0,288.0,72.0,54.0,17,125,306,3883,1420,20945,24828,12/15/2020
2020-04-16,447,4468,2494,27308,31776,36.0,552.0,25.0,207.0,6.0,52.0,293.0,72.0,53.0,14,139,387,4270,1908,22853,27123,12/15/2020
2020-04-17,304,4772,1821,29129,33901,32.0,584.0,20.0,227.0,7.0,59.0,298.0,66.0,45.0,21,160,290,4560,1327,24180,28740,12/15/2020
2020-04-18,321,5093,1725,30854,35947,26.0,610.0,18.0,245.0,4.0,63.0,302.0,63.0,49.0,15,175,284,4844,1235,25415,30259,12/15/2020
2020-04-19,381,5474,2047,32901,38375,23.0,633.0,26.0,271.0,1.0,64.0,298.0,65.0,55.0,11,186,337,5181,1640,27055,32236,12/15/2020
2020-04-20,394,5868,1907,34808,40676,46.0,679.0,29.0,300.0,2.0,66.0,313.0,75.0,56.0,10,196,376,5557,1472,28527,34084,12/15/2020
2020-04-21,444,6312,2110,36918,43230,45.0,724.0,32.0,332.0,5.0,71.0,321.0,72.0,56.0,18,214,383,5940,1605,30132,36072,12/15/2020
2020-04-22,418,6730,2390,39308,46038,41.0,765.0,32.0,364.0,5.0,76.0,325.0,73.0,58.0,18,232,379,6319,1772,31904,38223,12/15/2020
2020-04-23,479,7209,2469,41777,48986,32.0,797.0,28.0,392.0,5.0,81.0,324.0,76.0,62.0,15,247,412,6731,1725,33629,40360,12/15/2020
2020-04-24,491,7700,3284,45061,52761,35.0,832.0,26.0,418.0,4.0,85.0,329.0,85.0,63.0,15,262,407,7138,2389,36018,43156,12/15/2020
2020-04-25,393,8093,2206,47267,55360,34.0,866.0,17.0,435.0,5.0,90.0,341.0,85.0,62.0,14,276,299,7437,1604,37622,45059,12/15/2020
2020-04-26,316,8409,2309,49576,57985,33.0,899.0,15.0,450.0,3.0,93.0,356.0,86.0,59.0,14,290,274,7711,1723,39345,47056,12/15/2020
2020-04-27,249,8658,1620,51196,59854,29.0,928.0,21.0,471.0,4.0,97.0,360.0,86.0,61.0,10,300,206,7917,1076,40421,48338,12/15/2020
2020-04-28,410,9068,2263,53459,62527,44.0,972.0,24.0,495.0,3.0,100.0,377.0,88.0,59.0,22,322,331,8248,1549,41970,50218,12/15/2020
2020-04-29,476,9544,3343,56802,66346,36.0,1008.0,38.0,533.0,11.0,111.0,364.0,78.0,53.0,18,340,371,8619,2187,44157,52776,12/15/2020
2020-04-30,432,9976,2769,59571,69547,33.0,1041.0,38.0,571.0,6.0,117.0,353.0,83.0,57.0,24,364,351,8970,1727,45884,54854,12/15/2020
2020-05-01,454,10430,3086,62657,73087,52.0,1093.0,38.0,609.0,3.0,120.0,364.0,84.0,58.0,14,378,323,9293,1940,47824,57117,12/15/2020
2020-05-02,257,10687,1926,64583,75270,36.0,1129.0,39.0,648.0,5.0,125.0,356.0,93.0,63.0,24,402,193,9486,1180,49004,58490,12/15/2020
2020-05-03,283,10970,2160,66743,77713,31.0,1160.0,27.0,675.0,8.0,133.0,352.0,91.0,61.0,21,423,183,9669,1425,50429,60098,12/15/2020
2020-05-04,387,11357,2098,68841,80198,30.0,1190.0,31.0,706.0,5.0,138.0,346.0,89.0,58.0,18,441,290,9959,1456,51885,61844,12/15/2020
2020-05-05,433,11790,2873,71714,83504,29.0,1219.0,32.0,738.0,6.0,144.0,337.0,83.0,55.0,16,457,299,10258,1833,53718,63976,12/15/2020
2020-05-06,488,12278,2830,74544,86822,28.0,1247.0,44.0,782.0,9.0,153.0,312.0,80.0,55.0,21,478,340,10598,1792,55510,66108,12/15/2020
2020-05-07,425,12703,2969,77513,90216,36.0,1283.0,44.0,826.0,5.0,158.0,299.0,72.0,53.0,21,499,270,10868,1810,57320,68188,12/15/2020
2020-05-08,359,13062,2598,80111,93173,30.0,1313.0,29.0,855.0,5.0,163.0,295.0,72.0,54.0,22,521,230,11098,1561,58881,69979,12/15/2020
2020-05-09,467,13529,3346,83457,96986,22.0,1335.0,21.0,876.0,4.0,167.0,292.0,70.0,52.0,15,536,289,11387,2092,60973,72360,12/15/2020
2020-05-10,285,13814,2117,85574,99388,20.0,1355.0,23.0,899.0,6.0,173.0,283.0,71.0,50.0,14,550,190,11577,1405,62378,73955,12/15/2020
2020-05-11,257,14071,1857,87431,101502,31.0,1386.0,16.0,915.0,6.0,179.0,292.0,72.0,50.0,15,565,173,11750,1220,63598,75348,12/15/2020
2020-05-12,387,14458,2611,90042,104500,23.0,1409.0,18.0,933.0,4.0,183.0,293.0,70.0,49.0,22,587,224,11974,1531,65129,77103,12/15/2020
2020-05-13,351,14809,3630,93672,108481,23.0,1432.0,25.0,958.0,1.0,184.0,290.0,70.0,50.0,13,600,199,12173,1828,66957,79130,12/15/2020
2020-05-14,329,15138,3408,97080,112218,19.0,1451.0,27.0,985.0,3.0,187.0,279.0,65.0,46.0,15,615,232,12405,1855,68812,81217,12/15/2020
2020-05-15,381,15519,3458,100538,116057,24.0,1475.0,41.0,1026.0,5.0,192.0,257.0,63.0,46.0,14,629,232,12637,1700,70512,83149,12/15/2020
2020-05-16,449,15968,4156,104694,120662,25.0,1500.0,15.0,1041.0,5.0,197.0,262.0,62.0,47.0,15,644,247,12884,1815,72327,85211,12/15/2020
2020-05-17,240,16208,2768,107462,123670,17.0,1517.0,9.0,1050.0,5.0,202.0,265.0,60.0,46.0,10,654,126,13010,1435,73762,86772,12/15/2020
2020-05-18,250,16458,2001,109463,125921,19.0,1536.0,16.0,1066.0,5.0,207.0,263.0,58.0,41.0,18,672,135,13145,1301,75063,88208,12/15/2020
2020-05-19,415,16873,3168,112631,129504,23.0,1559.0,33.0,1099.0,5.0,212.0,248.0,57.0,39.0,11,683,215,13360,1815,76878,90238,12/15/2020
2020-05-20,326,17199,2771,115402,132601,19.0,1578.0,23.0,1122.0,7.0,219.0,237.0,53.0,34.0,22,705,183,13543,1437,78315,91858,12/15/2020
2020-05-21,374,17573,3757,119159,136732,25.0,1603.0,15.0,1137.0,3.0,222.0,244.0,54.0,30.0,20,725,168,13711,1840,80155,93866,12/15/2020
2020-05-22,351,17924,3161,122320,140244,20.0,1623.0,28.0,1165.0,5.0,227.0,231.0,53.0,30.0,11,736,206,13917,1503,81658,95575,12/15/2020
2020-05-23,253,18177,2742,125062,143239,19.0,1642.0,11.0,1176.0,3.0,230.0,236.0,53.0,33.0,13,749,109,14026,1204,82862,96888,12/15/2020
2020-05-24,163,18340,1370,126432,144772,13.0,1655.0,14.0,1190.0,2.0,232.0,233.0,54.0,36.0,8,757,83,14109,736,83598,97707,12/15/2020
2020-05-25,147,18487,1385,127817,146304,14.0,1669.0,14.0,1204.0,0.0,232.0,233.0,54.0,34.0,10,767,76,14185,687,84285,98470,12/15/2020
2020-05-26,285,18772,2620,130437,149209,24.0,1693.0,21.0,1225.0,5.0,237.0,231.0,49.0,33.0,15,782,158,14343,1556,85841,100184,12/15/2020
2020-05-27,276,19048,2057,132494,151542,20.0,1713.0,18.0,1243.0,3.0,240.0,230.0,51.0,33.0,10,792,132,14475,1082,86923,101398,12/15/2020
2020-05-28,348,19396,3359,135853,155249,17.0,1730.0,29.0,1272.0,4.0,244.0,214.0,47.0,32.0,8,800,130,14605,1046,87969,102574,12/15/2020
2020-05-29,410,19806,3915,139768,159574,19.0,1749.0,26.0,1298.0,7.0,251.0,200.0,43.0,31.0,12,812,174,14779,1471,89440,104219,12/15/2020
2020-05-30,225,20031,3915,143683,163714,16.0,1765.0,19.0,1317.0,4.0,255.0,193.0,41.0,29.0,12,824,109,14888,1633,91073,105961,12/15/2020
2020-05-31,155,20186,1690,145373,165559,11.0,1776.0,11.0,1328.0,1.0,256.0,192.0,44.0,26.0,3,827,78,14966,785,91858,106824,12/15/2020
2020-06-01,212,20398,2792,148165,168563,8.0,1784.0,14.0,1342.0,1.0,257.0,185.0,45.0,29.0,5,832,93,15059,1314,93172,108231,12/15/2020
2020-06-02,273,20671,3022,151187,171858,8.0,1792.0,9.0,1351.0,3.0,260.0,181.0,38.0,25.0,10,842,98,15157,1356,94528,109685,12/15/2020
2020-06-03,254,20925,3486,154673,175598,14.0,1806.0,18.0,1369.0,6.0,266.0,171.0,34.0,25.0,11,853,99,15256,1568,96096,111352,12/15/2020
2020-06-04,276,21201,4471,159144,180345,7.0,1813.0,26.0,1395.0,4.0,270.0,148.0,31.0,24.0,12,865,107,15363,1903,97999,113362,12/15/2020
2020-06-05,215,21416,3513,162657,184073,15.0,1828.0,13.0,1408.0,6.0,276.0,144.0,27.0,21.0,11,876,99,15462,1452,99451,114913,12/15/2020
2020-06-06,201,21617,2616,165273,186890,10.0,1838.0,7.0,1415.0,2.0,278.0,145.0,29.0,19.0,6,882,67,15529,1065,100516,116045,12/15/2020
2020-06-07,83,21700,1625,166898,188598,11.0,1849.0,7.0,1422.0,1.0,279.0,148.0,25.0,17.0,4,886,51,15580,761,101277,116857,12/15/2020
2020-06-08,119,21819,1849,168747,190566,15.0,1864.0,13.0,1435.0,2.0,281.0,148.0,27.0,18.0,4,890,45,15625,909,102186,117811,12/15/2020
2020-06-09,223,22042,2673,171420,193462,10.0,1874.0,19.0,1454.0,0.0,281.0,139.0,28.0,21.0,1,891,64,15689,1199,103385,119074,12/15/2020
2020-06-10,209,22251,2987,174407,196658,13.0,1887.0,12.0,1466.0,2.0,283.0,138.0,24.0,17.0,4,895,100,15789,1407,104792,120581,12/15/2020
2020-06-11,195,22446,3513,177920,200366,7.0,1894.0,15.0,1481.0,1.0,284.0,129.0,25.0,16.0,6,901,88,15877,1456,106248,122125,12/15/2020
2020-06-12,209,22655,4601,182521,205176,9.0,1903.0,16.0,1497.0,1.0,285.0,121.0,24.0,16.0,2,903,78,15955,2001,108249,124204,12/15/2020
2020-06-13,113,22768,3036,185557,208325,6.0,1909.0,5.0,1502.0,0.0,285.0,122.0,20.0,15.0,3,906,49,16004,1268,109517,125521,12/15/2020
2020-06-14,81,22849,2046,187603,210452,7.0,1916.0,8.0,1510.0,1.0,286.0,120.0,20.0,14.0,3,909,33,16037,926,110443,126480,12/15/2020
2020-06-15,188,23037,3108,190711,213748,14.0,1930.0,19.0,1529.0,0.0,286.0,115.0,20.0,16.0,5,914,75,16112,1704,112147,128259,12/15/2020
2020-06-16,110,23147,3017,193728,216875,11.0,1941.0,9.0,1538.0,1.0,287.0,116.0,22.0,16.0,8,922,50,16162,1466,113613,129775,12/15/2020
2020-06-17,127,23274,2835,196563,219837,15.0,1956.0,20.0,1558.0,4.0,291.0,107.0,18.0,14.0,6,928,51,16213,1258,114871,131084,12/15/2020
2020-06-18,149,23423,3048,199611,223034,9.0,1965.0,15.0,1573.0,1.0,292.0,100.0,19.0,16.0,7,935,70,16283,1252,116123,132406,12/15/2020
2020-06-19,141,23564,3769,203380,226944,12.0,1977.0,12.0,1585.0,1.0,293.0,99.0,20.0,17.0,3,938,59,16342,1302,117425,133767,12/15/2020
2020-06-20,84,23648,1891,205271,228919,9.0,1986.0,12.0,1597.0,0.0,293.0,96.0,20.0,18.0,4,942,36,16378,778,118203,134581,12/15/2020
2020-06-21,37,23685,1064,206335,230020,8.0,1994.0,5.0,1602.0,0.0,293.0,99.0,20.0,18.0,2,944,30,16408,656,118859,135267,12/15/2020
2020-06-22,138,23823,3730,210065,233888,12.0,2006.0,17.0,1619.0,0.0,293.0,94.0,19.0,18.0,2,946,65,16473,1632,120491,136964,12/15/2020
2020-06-23,163,23986,3831,213896,237882,3.0,2009.0,13.0,1632.0,3.0,296.0,81.0,18.0,18.0,7,953,81,16554,1711,122202,138756,12/15/2020
2020-06-24,120,24106,3502,217398,241504,9.0,2018.0,10.0,1642.0,1.0,297.0,79.0,18.0,18.0,5,958,44,16598,1604,123806,140404,12/15/2020
2020-06-25,103,24209,2883,220281,244490,6.0,2024.0,14.0,1656.0,1.0,298.0,70.0,17.0,17.0,1,959,51,16649,1431,125237,141886,12/15/2020
2020-06-26,94,24303,2488,222769,247072,2.0,2026.0,10.0,1666.0,0.0,298.0,62.0,18.0,18.0,1,960,60,16709,1272,126509,143218,12/15/2020
2020-06-27,84,24387,3216,225985,250372,5.0,2031.0,3.0,1669.0,1.0,299.0,63.0,17.0,17.0,5,965,37,16746,1163,127672,144418,12/15/2020
2020-06-28,39,24426,1469,227454,251880,4.0,2035.0,4.0,1673.0,4.0,303.0,59.0,15.0,14.0,6,971,17,16763,575,128247,145010,12/15/2020
2020-06-29,85,24511,3697,231151,255662,4.0,2039.0,5.0,1678.0,0.0,303.0,58.0,14.0,14.0,1,972,39,16802,1299,129546,146348,12/15/2020
2020-06-30,57,24568,1958,233109,257677,1.0,2040.0,5.0,1683.0,1.0,304.0,53.0,12.0,11.0,4,976,32,16834,957,130503,147337,12/15/2020
2020-07-01,144,24712,4098,237207,261919,8.0,2048.0,10.0,1693.0,0.0,304.0,51.0,11.0,11.0,1,977,79,16913,1852,132355,149268,12/15/2020
2020-07-02,103,24815,2803,240010,264825,5.0,2053.0,5.0,1698.0,1.0,305.0,50.0,10.0,10.0,3,980,59,16972,1036,133391,150363,12/15/2020
2020-07-03,50,24865,2079,242089,266954,9.0,2062.0,6.0,1704.0,0.0,305.0,53.0,9.0,9.0,3,983,25,16997,750,134141,151138,12/15/2020
2020-07-04,57,24922,2345,244434,269356,2.0,2064.0,4.0,1708.0,1.0,306.0,50.0,10.0,9.0,2,985,33,17030,964,135105,152135,12/15/2020
2020-07-05,49,24971,2932,247366,272337,1.0,2065.0,2.0,1710.0,1.0,307.0,48.0,8.0,8.0,2,987,26,17056,1364,136469,153525,12/15/2020
2020-07-06,101,25072,2814,250180,275252,6.0,2071.0,6.0,1716.0,0.0,307.0,48.0,9.0,9.0,4,991,57,17113,1497,137966,155079,12/15/2020
2020-07-07,81,25153,3457,253637,278790,5.0,2076.0,7.0,1723.0,0.0,307.0,46.0,8.0,8.0,2,993,47,17160,1487,139453,156613,12/15/2020
2020-07-08,105,25258,3409,257046,282304,4.0,2080.0,2.0,1725.0,0.0,307.0,48.0,9.0,8.0,0,993,64,17224,1351,140804,158028,12/15/2020
2020-07-09,94,25352,3714,260760,286112,9.0,2089.0,3.0,1728.0,0.0,307.0,54.0,9.0,8.0,0,993,50,17274,1555,142359,159633,12/15/2020
2020-07-10,132,25484,4437,265197,290681,6.0,2095.0,3.0,1731.0,2.0,309.0,55.0,7.0,7.0,3,996,80,17354,1988,144347,161701,12/15/2020
2020-07-11,63,25547,2938,268135,293682,6.0,2101.0,3.0,1734.0,1.0,310.0,57.0,6.0,6.0,3,999,36,17390,1265,145612,163002,12/15/2020
2020-07-12,47,25594,1838,269973,295567,1.0,2102.0,3.0,1737.0,1.0,311.0,54.0,6.0,5.0,3,1002,34,17424,910,146522,163946,12/15/2020
2020-07-13,84,25678,3209,273182,298860,8.0,2110.0,10.0,1747.0,0.0,311.0,52.0,6.0,5.0,1,1003,61,17485,1448,147970,165455,12/15/2020
2020-07-14,74,25752,3298,276480,302232,7.0,2117.0,4.0,1751.0,0.0,311.0,55.0,5.0,5.0,1,1004,44,17529,1334,149304,166833,12/15/2020
2020-07-15,130,25882,4181,280661,306543,5.0,2122.0,7.0,1758.0,0.0,311.0,53.0,5.0,4.0,0,1004,100,17629,1681,150985,168614,12/15/2020
2020-07-16,103,25985,3740,284401,310386,6.0,2128.0,9.0,1767.0,0.0,311.0,50.0,6.0,5.0,1,1005,76,17705,1541,152526,170231,12/15/2020
2020-07-17,156,26141,4239,288640,314781,14.0,2142.0,3.0,1770.0,1.0,312.0,60.0,5.0,5.0,2,1007,79,17784,1776,154302,172086,12/15/2020
2020-07-18,85,26226,3272,291912,318138,5.0,2147.0,9.0,1779.0,1.0,313.0,55.0,5.0,4.0,4,1011,70,17854,1342,155644,173498,12/15/2020
2020-07-19,82,26308,2696,294608,320916,7.0,2154.0,3.0,1782.0,0.0,313.0,59.0,6.0,4.0,2,1013,57,17911,1093,156737,174648,12/15/2020
2020-07-20,71,26379,2666,297274,323653,9.0,2163.0,7.0,1789.0,0.0,313.0,61.0,7.0,5.0,2,1015,68,17979,1399,158136,176115,12/15/2020
2020-07-21,130,26509,4304,301578,328087,9.0,2172.0,11.0,1800.0,0.0,313.0,59.0,9.0,6.0,1,1016,108,18087,1848,159984,178071,12/15/2020
2020-07-22,130,26639,3928,305506,332145,7.0,2179.0,8.0,1808.0,1.0,314.0,57.0,7.0,6.0,1,1017,86,18173,1606,161590,179763,12/15/2020
2020-07-23,141,26780,4415,309921,336701,8.0,2187.0,6.0,1814.0,0.0,314.0,59.0,8.0,7.0,0,1017,115,18288,1897,163487,181775,12/15/2020
2020-07-24,172,26952,5966,315887,342839,15.0,2202.0,12.0,1826.0,0.0,314.0,62.0,9.0,7.0,0,1017,119,18407,2226,165713,184120,12/15/2020
2020-07-25,134,27086,4398,320285,347371,7.0,2209.0,7.0,1833.0,0.0,314.0,62.0,10.0,8.0,3,1020,108,18515,2024,167737,186252,12/15/2020
2020-07-26,62,27148,3033,323318,350466,8.0,2217.0,9.0,1842.0,0.0,314.0,61.0,11.0,7.0,1,1021,54,18569,1288,169025,187594,12/15/2020
2020-07-27,188,27336,4191,327509,354845,12.0,2229.0,7.0,1849.0,0.0,314.0,66.0,13.0,8.0,1,1022,138,18707,2249,171274,189981,12/15/2020
2020-07-28,105,27441,3840,331349,358790,5.0,2234.0,5.0,1854.0,0.0,314.0,66.0,14.0,7.0,1,1023,95,18802,1576,172850,191652,12/15/2020
2020-07-29,190,27631,5139,336488,364119,9.0,2243.0,10.0,1864.0,0.0,314.0,65.0,15.0,7.0,0,1023,154,18956,2215,175065,194021,12/15/2020
2020-07-30,121,27752,4345,340833,368585,6.0,2249.0,2.0,1866.0,1.0,315.0,68.0,15.0,6.0,1,1024,97,19053,1563,176628,195681,12/15/2020
2020-07-31,131,27883,5512,346345,374228,7.0,2256.0,9.0,1875.0,0.0,315.0,66.0,15.0,7.0,1,1025,89,19142,1772,178400,197542,12/15/2020
2020-08-01,109,27992,4294,350639,378631,7.0,2263.0,2.0,1877.0,0.0,315.0,71.0,14.0,7.0,1,1026,89,19231,1493,179893,199124,12/15/2020
2020-08-02,84,28076,2804,353443,381519,12.0,2275.0,12.0,1889.0,2.0,317.0,69.0,14.0,8.0,2,1028,62,19293,1227,181120,200413,12/15/2020
2020-08-03,188,28264,5248,358691,386955,11.0,2286.0,10.0,1899.0,0.0,317.0,70.0,16.0,7.0,1,1029,150,19443,2120,183240,202683,12/15/2020
2020-08-04,125,28389,3691,362382,390771,8.0,2294.0,5.0,1904.0,1.0,318.0,72.0,12.0,5.0,2,1031,99,19542,1708,184948,204490,12/15/2020
2020-08-05,147,28536,5935,368317,396853,11.0,2305.0,9.0,1913.0,1.0,319.0,73.0,10.0,5.0,2,1033,119,19661,2371,187319,206980,12/15/2020
2020-08-06,169,28705,5546,373863,402568,7.0,2312.0,9.0,1922.0,0.0,319.0,71.0,9.0,4.0,0,1033,120,19781,2291,189610,209391,12/15/2020
2020-08-07,123,28828,4851,378714,407542,12.0,2324.0,9.0,1931.0,1.0,320.0,73.0,9.0,3.0,2,1035,87,19868,2057,191667,211535,12/15/2020
2020-08-08,123,28951,4112,382826,411777,19.0,2343.0,6.0,1937.0,1.0,321.0,85.0,8.0,3.0,1,1036,91,19959,1714,193381,213340,12/15/2020
2020-08-09,42,28993,1727,384553,413546,6.0,2349.0,8.0,1945.0,0.0,321.0,83.0,9.0,4.0,0,1036,35,19994,1022,194403,214397,12/15/2020
2020-08-10,149,29142,4587,389140,418282,8.0,2357.0,9.0,1954.0,0.0,321.0,82.0,9.0,4.0,1,1037,113,20107,1950,196353,216460,12/15/2020
2020-08-11,106,29248,4334,393474,422722,5.0,2362.0,13.0,1967.0,0.0,321.0,74.0,10.0,4.0,3,1040,92,20199,2186,198539,218738,12/15/2020
2020-08-12,121,29369,5188,398662,428031,8.0,2370.0,11.0,1978.0,0.0,321.0,71.0,9.0,3.0,1,1041,101,20300,2517,201056,221356,12/15/2020
2020-08-13,135,29504,4196,402858,432362,13.0,2383.0,12.0,1990.0,0.0,321.0,72.0,11.0,3.0,0,1041,95,20395,1832,202888,223283,12/15/2020
2020-08-14,145,29649,5498,408356,438005,13.0,2396.0,11.0,2001.0,0.0,321.0,74.0,11.0,4.0,3,1044,98,20493,1903,204791,225284,12/15/2020
2020-08-15,106,29755,4534,412890,442645,9.0,2405.0,11.0,2012.0,1.0,322.0,71.0,11.0,5.0,0,1044,88,20581,1628,206419,227000,12/15/2020
2020-08-16,83,29838,2477,415367,445205,6.0,2411.0,5.0,2017.0,4.0,326.0,68.0,8.0,4.0,6,1050,70,20651,920,207339,227990,12/15/2020
2020-08-17,106,29944,4575,419942,449886,8.0,2419.0,6.0,2023.0,0.0,326.0,70.0,8.0,5.0,2,1052,87,20738,2306,209645,230383,12/15/2020
2020-08-18,128,30072,4911,424853,454925,11.0,2430.0,8.0,2031.0,1.0,327.0,72.0,8.0,4.0,5,1057,94,20832,2660,212305,233137,12/15/2020
2020-08-19,113,30185,5077,429930,460115,8.0,2438.0,9.0,2040.0,1.0,328.0,70.0,9.0,5.0,0,1057,90,20922,2556,214861,235783,12/15/2020
2020-08-20,173,30358,7411,437341,467699,12.0,2450.0,6.0,2046.0,2.0,330.0,74.0,10.0,5.0,3,1060,139,21061,3406,218267,239328,12/15/2020
2020-08-21,152,30510,6577,443918,474428,8.0,2458.0,5.0,2051.0,1.0,331.0,76.0,9.0,4.0,2,1062,125,21186,2827,221094,242280,12/15/2020
2020-08-22,96,30606,5550,449468,480074,11.0,2469.0,12.0,2063.0,0.0,331.0,75.0,11.0,4.0,1,1063,84,21270,2508,223602,244872,12/15/2020
2020-08-23,72,30678,4375,453843,484521,11.0,2480.0,6.0,2069.0,0.0,331.0,80.0,12.0,2.0,1,1064,56,21326,2413,226015,247341,12/15/2020
2020-08-24,105,30783,5784,459627,490410,7.0,2487.0,10.0,2079.0,1.0,332.0,76.0,14.0,4.0,1,1065,77,21403,3056,229071,250474,12/15/2020
2020-08-25,108,30891,4764,464391,495282,10.0,2497.0,4.0,2083.0,1.0,333.0,81.0,12.0,4.0,1,1066,92,21495,2220,231291,252786,12/15/2020
2020-08-26,170,31061,9482,473873,504934,4.0,2501.0,8.0,2091.0,0.0,333.0,77.0,10.0,5.0,1,1067,127,21622,2989,234280,255902,12/15/2020
2020-08-27,91,31152,8565,482438,513590,6.0,2507.0,13.0,2104.0,1.0,334.0,69.0,7.0,5.0,2,1069,70,21692,3048,237328,259020,12/15/2020
2020-08-28,113,31265,7994,490432,521697,14.0,2521.0,4.0,2108.0,0.0,334.0,79.0,10.0,7.0,2,1071,87,21779,2341,239669,261448,12/15/2020
2020-08-29,65,31330,5374,495806,527136,6.0,2527.0,8.0,2116.0,1.0,335.0,76.0,11.0,6.0,2,1073,51,21830,1857,241526,263356,12/15/2020
2020-08-30,66,31396,4323,500129,531525,7.0,2534.0,4.0,2120.0,0.0,335.0,79.0,9.0,5.0,2,1075,48,21878,1932,243458,265336,12/15/2020
2020-08-31,105,31501,4863,504992,536493,12.0,2546.0,16.0,2136.0,0.0,335.0,75.0,8.0,4.0,1,1076,81,21959,2125,245583,267542,12/15/2020
2020-09-01,99,31600,7109,512101,543701,6.0,2552.0,9.0,2145.0,1.0,336.0,71.0,7.0,4.0,2,1078,66,22025,2305,247888,269913,12/15/2020
2020-09-02,125,31725,10529,522630,554355,9.0,2561.0,10.0,2155.0,1.0,337.0,69.0,8.0,4.0,2,1080,104,22129,2963,250851,272980,12/15/2020
2020-09-03,90,31815,11080,533710,565525,8.0,2569.0,8.0,2163.0,0.0,337.0,69.0,9.0,4.0,3,1083,73,22202,2490,253341,275543,12/15/2020
2020-09-04,103,31918,8963,542673,574591,11.0,2580.0,4.0,2167.0,0.0,337.0,76.0,9.0,4.0,1,1084,83,22285,2293,255634,277919,12/15/2020
2020-09-05,52,31970,6309,548982,580952,6.0,2586.0,9.0,2176.0,0.0,337.0,73.0,8.0,3.0,1,1085,42,22327,1552,257186,279513,12/15/2020
2020-09-06,88,32058,4325,553307,585365,4.0,2590.0,8.0,2184.0,1.0,338.0,68.0,6.0,3.0,1,1086,65,22392,1885,259071,281463,12/15/2020
2020-09-07,35,32093,3002,556309,588402,11.0,2601.0,3.0,2187.0,0.0,338.0,76.0,5.0,3.0,1,1087,26,22418,619,259690,282108,12/15/2020
2020-09-08,74,32167,6381,562690,594857,6.0,2607.0,12.0,2199.0,1.0,339.0,69.0,6.0,3.0,2,1089,66,22484,1534,261224,283708,12/15/2020
2020-09-09,118,32285,8650,571340,603625,10.0,2617.0,5.0,2204.0,1.0,340.0,73.0,9.0,3.0,1,1090,102,22586,2057,263281,285867,12/15/2020
2020-09-10,164,32449,11334,582674,615123,9.0,2626.0,8.0,2212.0,0.0,340.0,74.0,10.0,3.0,1,1091,111,22697,2183,265464,288161,12/15/2020
2020-09-11,120,32569,9454,592128,624697,11.0,2637.0,11.0,2223.0,0.0,340.0,74.0,10.0,5.0,0,1091,96,22793,1894,267358,290151,12/15/2020
2020-09-12,110,32679,6174,598302,630981,8.0,2645.0,5.0,2228.0,2.0,342.0,75.0,9.0,5.0,3,1094,97,22890,1465,268823,291713,12/15/2020
2020-09-13,58,32737,2717,601019,633756,4.0,2649.0,3.0,2231.0,0.0,342.0,76.0,10.0,5.0,0,1094,54,22944,828,269651,292595,12/15/2020
2020-09-14,104,32841,6446,607465,640306,6.0,2655.0,3.0,2234.0,2.0,344.0,77.0,10.0,5.0,2,1096,95,23039,1660,271311,294350,12/15/2020
2020-09-15,122,32963,8470,615935,648898,7.0,2662.0,2.0,2236.0,1.0,345.0,81.0,10.0,5.0,2,1098,124,23163,2122,273433,296596,12/15/2020
2020-09-16,137,33100,9716,625651,658751,7.0,2669.0,7.0,2243.0,2.0,347.0,79.0,9.0,6.0,5,1103,118,23281,1909,275342,298623,12/15/2020
2020-09-17,125,33225,9239,634890,668115,7.0,2676.0,15.0,2258.0,0.0,347.0,71.0,8.0,4.0,0,1103,154,23435,1879,277221,300656,12/15/2020
2020-09-18,132,33357,10045,644935,678292,7.0,2683.0,7.0,2265.0,1.0,348.0,70.0,11.0,6.0,2,1105,132,23567,1860,279081,302648,12/15/2020
2020-09-19,115,33472,8297,653232,686704,7.0,2690.0,3.0,2268.0,0.0,348.0,74.0,10.0,6.0,4,1109,112,23679,1646,280727,304406,12/15/2020
2020-09-20,60,33532,3676,656908,690440,7.0,2697.0,6.0,2274.0,2.0,350.0,73.0,9.0,8.0,4,1113,49,23728,1286,282013,305741,12/15/2020
2020-09-21,102,33634,7018,663926,697560,12.0,2709.0,3.0,2277.0,2.0,352.0,80.0,8.0,6.0,2,1115,94,23822,2338,284351,308173,12/15/2020
2020-09-22,154,33788,9287,673213,707001,12.0,2721.0,3.0,2280.0,1.0,353.0,88.0,7.0,5.0,1,1116,124,23946,2121,286472,310418,12/15/2020
2020-09-23,136,33924,10651,683864,717788,13.0,2734.0,7.0,2287.0,0.0,353.0,94.0,6.0,5.0,0,1116,127,24073,2135,288607,312680,12/15/2020
2020-09-24,120,34044,12480,696344,730388,8.0,2742.0,9.0,2296.0,1.0,354.0,92.0,7.0,5.0,1,1117,120,24193,3079,291686,315879,12/15/2020
2020-09-25,150,34194,10553,706897,741091,9.0,2751.0,10.0,2306.0,0.0,354.0,91.0,6.0,5.0,1,1118,143,24336,2929,294615,318951,12/15/2020
2020-09-26,147,34341,10560,717457,751798,12.0,2763.0,9.0,2315.0,0.0,354.0,94.0,6.0,5.0,1,1119,120,24456,2354,296969,321425,12/15/2020
2020-09-27,43,34384,2764,720221,754605,7.0,2770.0,5.0,2320.0,0.0,354.0,96.0,9.0,5.0,0,1119,34,24490,820,297789,322279,12/15/2020
2020-09-28,156,34540,7307,727528,762068,7.0,2777.0,7.0,2327.0,2.0,356.0,94.0,7.0,5.0,2,1121,138,24628,2188,299977,324605,12/15/2020
2020-09-29,203,34743,11046,738574,773317,12.0,2789.0,18.0,2345.0,1.0,357.0,87.0,6.0,6.0,1,1122,185,24813,2741,302718,327531,12/15/2020
2020-09-30,223,34966,12230,750804,785770,6.0,2795.0,6.0,2351.0,0.0,357.0,87.0,6.0,6.0,1,1123,189,25002,2498,305216,330218,12/15/2020
2020-10-01,185,35151,12503,763307,798458,17.0,2812.0,13.0,2364.0,1.0,358.0,90.0,6.0,4.0,2,1125,166,25168,2329,307545,332713,12/15/2020
2020-10-02,209,35360,12154,775461,810821,14.0,2826.0,13.0,2377.0,1.0,359.0,90.0,8.0,5.0,2,1127,181,25349,2427,309972,335321,12/15/2020
2020-10-03,157,35517,9313,784774,820291,9.0,2835.0,9.0,2386.0,2.0,361.0,88.0,9.0,4.0,2,1129,131,25480,1957,311929,337409,12/15/2020
2020-10-04,81,35598,2369,787143,822741,11.0,2846.0,9.0,2395.0,1.0,362.0,89.0,8.0,5.0,2,1131,76,25556,926,312855,338411,12/15/2020
2020-10-05,174,35772,8985,796128,831900,30.0,2876.0,10.0,2405.0,2.0,364.0,107.0,9.0,6.0,4,1135,160,25716,2952,315807,341523,12/15/2020
2020-10-06,189,35961,11186,807314,843275,11.0,2887.0,4.0,2409.0,0.0,364.0,114.0,11.0,7.0,0,1135,188,25904,2814,318621,344525,12/15/2020
2020-10-07,244,36205,12444,819758,855963,13.0,2900.0,14.0,2423.0,2.0,366.0,111.0,9.0,7.0,2,1137,245,26149,3436,322057,348206,12/15/2020
2020-10-08,282,36487,15233,834991,871478,17.0,2917.0,13.0,2436.0,2.0,368.0,113.0,7.0,5.0,4,1141,276,26425,4110,326167,352592,12/15/2020
2020-10-09,229,36716,13745,848736,885452,21.0,2938.0,12.0,2448.0,0.0,368.0,122.0,10.0,7.0,3,1144,200,26625,4184,330351,356976,12/15/2020
2020-10-10,231,36947,13832,862568,899515,19.0,2957.0,10.0,2458.0,1.0,369.0,130.0,13.0,7.0,2,1146,192,26817,3692,334043,360860,12/15/2020
2020-10-11,99,37046,3263,865831,902877,12.0,2969.0,9.0,2467.0,1.0,370.0,132.0,14.0,5.0,6,1152,89,26906,1132,335175,362081,12/15/2020
2020-10-12,169,37215,6440,872271,909486,19.0,2988.0,15.0,2482.0,2.0,372.0,134.0,14.0,5.0,4,1156,156,27062,1677,336852,363914,12/15/2020
2020-10-13,224,37439,8522,880793,918232,15.0,3003.0,13.0,2495.0,4.0,376.0,132.0,13.0,5.0,7,1163,212,27274,2262,339114,366388,12/15/2020
2020-10-14,335,37774,15042,895835,933609,17.0,3020.0,7.0,2502.0,0.0,376.0,142.0,15.0,5.0,2,1165,304,27578,3920,343034,370612,12/15/2020
2020-10-15,269,38043,14642,910477,948520,12.0,3032.0,16.0,2518.0,1.0,377.0,137.0,13.0,5.0,2,1167,253,27831,3477,346511,374342,12/15/2020
2020-10-16,288,38331,15012,925489,963820,13.0,3045.0,18.0,2536.0,1.0,378.0,131.0,13.0,4.0,2,1169,276,28107,3279,349790,377897,12/15/2020
2020-10-17,360,38691,14069,939558,978249,19.0,3064.0,11.0,2547.0,1.0,379.0,138.0,17.0,4.0,2,1171,309,28416,3167,352957,381373,12/15/2020
2020-10-18,155,38846,4039,943597,982443,18.0,3082.0,11.0,2558.0,0.0,379.0,145.0,17.0,6.0,2,1173,125,28541,1271,354228,382769,12/15/2020
2020-10-19,385,39231,8492,952089,991320,21.0,3103.0,22.0,2580.0,2.0,381.0,142.0,15.0,6.0,1,1174,320,28861,2486,356714,385575,12/15/2020
2020-10-20,439,39670,13245,965334,1005004,23.0,3126.0,17.0,2597.0,0.0,381.0,148.0,14.0,8.0,3,1177,383,29244,2923,359637,388881,12/15/2020
2020-10-21,544,40214,17464,982798,1023012,23.0,3149.0,8.0,2605.0,2.0,383.0,161.0,15.0,9.0,3,1180,471,29715,3392,363029,392744,12/15/2020
2020-10-22,538,40752,15864,998662,1039414,24.0,3173.0,20.0,2625.0,3.0,386.0,162.0,14.0,9.0,3,1183,489,30204,3091,366120,396324,12/15/2020
2020-10-23,514,41266,16637,1015299,1056565,22.0,3195.0,22.0,2647.0,1.0,387.0,161.0,15.0,9.0,3,1186,458,30662,2803,368923,399585,12/15/2020
2020-10-24,359,41625,10249,1025548,1067173,17.0,3212.0,11.0,2658.0,0.0,387.0,167.0,14.0,8.0,1,1187,337,30999,2188,371111,402110,12/15/2020
2020-10-25,233,41858,4760,1030308,1072166,16.0,3228.0,15.0,2673.0,1.0,388.0,167.0,15.0,8.0,2,1189,210,31209,1406,372517,403726,12/15/2020
2020-10-26,454,42312,9174,1039482,1081794,28.0,3256.0,15.0,2688.0,2.0,390.0,178.0,18.0,8.0,3,1192,402,31611,2890,375407,407018,12/15/2020
2020-10-27,517,42829,13995,1053477,1096306,29.0,3285.0,15.0,2703.0,2.0,392.0,190.0,18.0,9.0,4,1196,455,32066,2328,377735,409801,12/15/2020
2020-10-28,469,43298,15230,1068707,1112005,25.0,3310.0,26.0,2729.0,1.0,393.0,188.0,17.0,9.0,3,1199,412,32478,2618,380353,412831,12/15/2020
2020-10-29,609,43907,16260,1084967,1128874,20.0,3330.0,22.0,2751.0,3.0,396.0,183.0,19.0,11.0,4,1203,529,33007,3050,383403,416410,12/15/2020
2020-10-30,565,44472,14864,1099831,1144303,21.0,3351.0,21.0,2772.0,5.0,401.0,178.0,19.0,9.0,4,1207,470,33477,2866,386269,419746,12/15/2020
2020-10-31,599,45071,11820,1111651,1156722,31.0,3382.0,13.0,2785.0,1.0,402.0,195.0,22.0,9.0,3,1210,486,33963,2350,388619,422582,12/15/2020
2020-11-01,330,45401,5091,1116742,1162143,22.0,3404.0,15.0,2800.0,1.0,403.0,201.0,26.0,12.0,4,1214,277,34240,1233,389852,424092,12/15/2020
2020-11-02,522,45923,9935,1126677,1172600,38.0,3442.0,27.0,2827.0,3.0,406.0,209.0,24.0,12.0,5,1219,459,34699,2852,392704,427403,12/15/2020
2020-11-03,601,46524,13041,1139718,1186242,33.0,3475.0,25.0,2852.0,1.0,407.0,216.0,24.0,12.0,1,1220,530,35229,2444,395148,430377,12/15/2020
2020-11-04,688,47212,16101,1155819,1203031,34.0,3509.0,27.0,2879.0,2.0,409.0,221.0,25.0,12.0,4,1224,640,35869,2854,398002,433871,12/15/2020
2020-11-05,768,47980,16593,1172412,1220392,46.0,3555.0,35.0,2914.0,1.0,410.0,231.0,24.0,14.0,3,1227,685,36554,2787,400789,437343,12/15/2020
2020-11-06,769,48749,16026,1188438,1237187,43.0,3598.0,31.0,2945.0,1.0,411.0,242.0,28.0,17.0,5,1232,691,37245,2967,403756,441001,12/15/2020
2020-11-07,604,49353,13649,1202087,1251440,34.0,3632.0,25.0,2970.0,1.0,412.0,250.0,31.0,18.0,1,1233,578,37823,2406,406162,443985,12/15/2020
2020-11-08,337,49690,4166,1206253,1255943,33.0,3665.0,26.0,2996.0,1.0,413.0,256.0,30.0,19.0,4,1237,322,38145,1250,407412,445557,12/15/2020
2020-11-09,808,50498,9063,1215316,1265814,40.0,3705.0,33.0,3029.0,2.0,415.0,261.0,28.0,18.0,3,1240,766,38911,2275,409687,448598,12/15/2020
2020-11-10,1053,51551,12982,1228298,1279849,45.0,3750.0,37.0,3066.0,0.0,415.0,269.0,31.0,18.0,6,1246,982,39893,2825,412512,452405,12/15/2020
2020-11-11,1087,52638,19738,1248036,1300674,42.0,3792.0,24.0,3090.0,5.0,420.0,282.0,30.0,15.0,7,1253,1003,40896,2621,415133,456029,12/15/2020
2020-11-12,893,53531,13911,1261947,1315478,39.0,3831.0,31.0,3121.0,3.0,423.0,287.0,28.0,15.0,5,1258,813,41709,2156,417289,458998,12/15/2020
2020-11-13,1165,54696,16393,1278340,1333036,39.0,3870.0,31.0,3152.0,0.0,423.0,295.0,27.0,15.0,2,1260,1115,42824,3033,420322,463146,12/15/2020
2020-11-14,782,55478,13519,1291859,1347337,42.0,3912.0,26.0,3178.0,5.0,428.0,306.0,25.0,13.0,10,1270,738,43562,2420,422742,466304,12/15/2020
2020-11-15,578,56056,6173,1298032,1354088,46.0,3958.0,21.0,3199.0,5.0,433.0,326.0,28.0,11.0,7,1277,495,44057,1393,424135,468192,12/15/2020
2020-11-16,739,56795,9647,1307679,1364474,56.0,4014.0,39.0,3238.0,3.0,436.0,340.0,26.0,13.0,5,1282,674,44731,2607,426742,471473,12/15/2020
2020-11-17,1538,58333,18176,1325855,1384188,59.0,4073.0,45.0,3283.0,2.0,438.0,352.0,30.0,13.0,5,1287,1401,46132,4056,430798,476930,12/15/2020
2020-11-18,1136,59469,16044,1341899,1401368,38.0,4111.0,38.0,3321.0,5.0,443.0,347.0,29.0,15.0,7,1294,1020,47152,3149,433947,481099,12/15/2020
2020-11-19,1128,60597,13169,1355068,1415665,46.0,4157.0,42.0,3363.0,4.0,447.0,347.0,30.0,18.0,5,1299,1032,48184,3355,437302,485486,12/15/2020
2020-11-20,1457,62054,22226,1377294,1439348,49.0,4206.0,48.0,3411.0,3.0,450.0,345.0,33.0,14.0,6,1305,1293,49477,4260,441562,491039,12/15/2020
2020-11-21,854,62908,17370,1394664,1457572,43.0,4249.0,34.0,3445.0,5.0,455.0,349.0,35.0,14.0,7,1312,756,50233,3096,444658,494891,12/15/2020
2020-11-22,571,63479,7519,1402183,1465662,65.0,4314.0,28.0,3473.0,4.0,459.0,382.0,33.0,15.0,11,1323,486,50719,1766,446424,497143,12/15/2020
2020-11-23,994,64473,11029,1413212,1477685,74.0,4388.0,40.0,3513.0,0.0,459.0,416.0,40.0,18.0,10,1333,893,51612,3365,449789,501401,12/15/2020
2020-11-24,1050,65523,14578,1427790,1493313,47.0,4435.0,59.0,3572.0,6.0,465.0,398.0,42.0,22.0,10,1343,940,52552,2737,452526,505078,12/15/2020
2020-11-25,1266,66789,18790,1446580,1513369,59.0,4494.0,58.0,3630.0,4.0,469.0,395.0,43.0,26.0,7,1350,1179,53731,3508,456034,509765,12/15/2020
2020-11-26,547,67336,6482,1453062,1520398,51.0,4545.0,36.0,3666.0,4.0,473.0,406.0,46.0,25.0,12,1362,467,54198,1556,457590,511788,12/15/2020
2020-11-27,1044,68380,9723,1462785,1531165,55.0,4600.0,50.0,3716.0,7.0,480.0,404.0,48.0,22.0,6,1368,969,55167,2500,460090,515257,12/15/2020
2020-11-28,1182,69562,11960,1474745,1544307,64.0,4664.0,40.0,3756.0,0.0,480.0,428.0,48.0,22.0,3,1371,1097,56264,2782,462872,519136,12/15/2020
2020-11-29,822,70384,6935,1481680,1552064,62.0,4726.0,35.0,3791.0,3.0,483.0,452.0,49.0,24.0,8,1379,754,57018,2294,465166,522184,12/15/2020
2020-11-30,1284,71668,9926,1491606,1563274,67.0,4793.0,60.0,3851.0,2.0,485.0,457.0,52.0,30.0,6,1385,1159,58177,2783,467949,526126,12/15/2020
2020-12-01,1555,73223,13949,1505555,1578778,61.0,4854.0,55.0,3906.0,4.0,489.0,459.0,51.0,31.0,12,1397,1422,59599,3352,471301,530900,12/15/2020
2020-12-02,1563,74786,15563,1521118,1595904,56.0,4910.0,53.0,3959.0,7.0,496.0,455.0,52.0,30.0,14,1411,1426,61025,3233,474534,535559,12/15/2020
2020-12-03,1773,76559,14631,1535749,1612308,63.0,4973.0,76.0,4035.0,5.0,501.0,437.0,48.0,31.0,10,1421,1642,62667,3305,477839,540506,12/15/2020
2020-12-04,1649,78208,16510,1552259,1630467,68.0,5041.0,50.0,4085.0,7.0,508.0,448.0,44.0,30.0,11,1432,1519,64186,3767,481606,545792,12/15/2020
2020-12-05,1200,79408,12609,1564868,1644276,71.0,5112.0,42.0,4127.0,4.0,512.0,473.0,46.0,29.0,11,1443,1067,65253,2881,484487,549740,12/15/2020
2020-12-06,1125,80533,7840,1572708,1653241,64.0,5176.0,50.0,4177.0,10.0,522.0,477.0,48.0,25.0,14,1457,981,66234,2474,486961,553195,12/15/2020
2020-12-07,1391,81924,10630,1583338,1665262,74.0,5250.0,58.0,4235.0,6.0,528.0,487.0,45.0,25.0,19,1476,1252,67486,3309,490270,557756,12/15/2020
2020-12-08,1463,83387,15285,1598623,1682010,57.0,5307.0,57.0,4292.0,5.0,533.0,482.0,48.0,27.0,16,1492,1317,68803,3553,493823,562626,12/15/2020
2020-12-09,1501,84888,16356,1614979,1699867,54.0,5361.0,62.0,4354.0,9.0,542.0,465.0,46.0,29.0,11,1503,1343,70146,3229,497052,567198,12/15/2020
2020-12-10,1475,86363,17178,1632157,1718520,59.0,5420.0,58.0,4412.0,6.0,548.0,460.0,54.0,29.0,13,1516,1254,71400,4049,501101,572501,12/15/2020
2020-12-11,1470,87833,17287,1649444,1737277,72.0,5492.0,82.0,4494.0,7.0,555.0,443.0,59.0,32.0,11,1527,1280,72680,3602,504703,577383,12/15/2020
2020-12-12,1096,88929,13026,1662470,1751399,60.0,5552.0,53.0,4547.0,9.0,564.0,441.0,51.0,32.0,13,1540,915,73595,3115,507818,581413,12/15/2020
2020-12-13,675,89604,7131,1669601,1759205,64.0,5616.0,38.0,4585.0,12.0,576.0,455.0,53.0,29.0,19,1559,558,74153,2016,509834,583987,12/15/2020
2020-12-14,1275,90879,10954,1680555,1771434,,,,,,,,,,11,1570,1084,75237,3318,513152,588389,12/15/2020
2020-02-27,0,0,0,0,0,1.0,1.0,0.0,0.0,0.0,0.0,1.0,0.0,0.0,0,0,0,0,0,0,0,12/16/2020
2020-02-28,0,0,0,0,0,0.0,1.0,0.0,0.0,0.0,0.0,1.0,1.0,0.0,0,0,0,0,0,0,0,12/16/2020
2020-02-29,0,0,0,0,0,0.0,1.0,0.0,0.0,0.0,0.0,1.0,1.0,0.0,0,0,0,0,0,0,0,12/16/2020
2020-03-01,2,2,2,2,4,0.0,1.0,0.0,0.0,0.0,0.0,1.0,1.0,1.0,0,0,2,2,2,2,4,12/16/2020
2020-03-02,0,2,1,3,5,1.0,2.0,0.0,0.0,0.0,0.0,2.0,2.0,2.0,0,0,0,2,0,2,4,12/16/2020
2020-03-03,0,2,2,5,7,0.0,2.0,0.0,0.0,0.0,0.0,2.0,2.0,2.0,0,0,0,2,1,3,5,12/16/2020
2020-03-04,0,2,12,17,19,1.0,3.0,0.0,0.0,0.0,0.0,3.0,2.0,2.0,0,0,0,2,10,13,15,12/16/2020
2020-03-05,0,2,4,21,23,0.0,3.0,0.0,0.0,0.0,0.0,3.0,2.0,2.0,0,0,1,3,4,17,20,12/16/2020
2020-03-06,1,3,12,33,36,0.0,3.0,0.0,0.0,0.0,0.0,3.0,2.0,2.0,0,0,0,3,11,28,31,12/16/2020
2020-03-07,0,3,19,52,55,0.0,3.0,0.0,0.0,0.0,0.0,3.0,2.0,1.0,0,0,0,3,19,47,50,12/16/2020
2020-03-08,0,3,18,70,73,0.0,3.0,0.0,0.0,0.0,0.0,3.0,2.0,1.0,0,0,0,3,18,65,68,12/16/2020
2020-03-09,1,4,15,85,89,0.0,3.0,0.0,0.0,0.0,0.0,3.0,2.0,1.0,0,0,1,4,14,79,83,12/16/2020
2020-03-10,2,6,25,110,116,0.0,3.0,0.0,0.0,0.0,0.0,3.0,2.0,1.0,0,0,1,5,23,102,107,12/16/2020
2020-03-11,0,6,34,144,150,1.0,4.0,0.0,0.0,0.0,0.0,4.0,1.0,1.0,0,0,0,5,34,136,141,12/16/2020
2020-03-12,9,15,41,185,200,1.0,5.0,0.0,0.0,0.0,0.0,5.0,1.0,1.0,0,0,7,12,38,174,186,12/16/2020
2020-03-13,6,21,50,235,256,4.0,9.0,1.0,1.0,0.0,0.0,8.0,1.0,1.0,0,0,6,18,47,221,239,12/16/2020
2020-03-14,0,21,90,325,346,0.0,9.0,0.0,1.0,0.0,0.0,8.0,1.0,1.0,0,0,0,18,83,304,322,12/16/2020
2020-03-15,1,22,54,379,401,1.0,10.0,0.0,1.0,0.0,0.0,9.0,2.0,1.0,0,0,1,19,53,357,376,12/16/2020
2020-03-16,2,24,95,474,498,2.0,12.0,0.0,1.0,0.0,0.0,11.0,2.0,0.0,0,0,2,21,89,446,467,12/16/2020
2020-03-17,12,36,162,636,672,6.0,18.0,0.0,1.0,0.0,0.0,17.0,2.0,0.0,0,0,11,32,142,588,620,12/16/2020
2020-03-18,9,45,116,752,797,3.0,21.0,0.0,1.0,0.0,0.0,20.0,2.0,0.0,0,0,11,43,104,692,735,12/16/2020
2020-03-19,15,60,262,1014,1074,2.0,23.0,1.0,2.0,0.0,0.0,21.0,3.0,0.0,1,1,17,60,245,937,997,12/16/2020
2020-03-20,13,73,197,1211,1284,5.0,28.0,0.0,2.0,0.0,0.0,26.0,4.0,0.0,0,1,13,73,182,1119,1192,12/16/2020
2020-03-21,12,85,126,1337,1422,3.0,31.0,2.0,4.0,0.0,0.0,27.0,5.0,0.0,0,1,14,87,117,1236,1323,12/16/2020
2020-03-22,27,112,282,1619,1731,2.0,33.0,0.0,4.0,0.0,0.0,29.0,5.0,0.0,0,1,25,112,250,1486,1598,12/16/2020
2020-03-23,14,126,169,1788,1914,15.0,48.0,1.0,5.0,0.0,0.0,43.0,9.0,3.0,0,1,16,128,157,1643,1771,12/16/2020
2020-03-24,20,146,242,2030,2176,8.0,56.0,0.0,5.0,0.0,0.0,51.0,10.0,5.0,0,1,19,147,220,1863,2010,12/16/2020
2020-03-25,26,172,182,2212,2384,5.0,61.0,2.0,7.0,0.0,0.0,54.0,11.0,3.0,0,1,28,175,158,2021,2196,12/16/2020
2020-03-26,35,207,181,2393,2600,9.0,70.0,5.0,12.0,0.0,0.0,58.0,14.0,5.0,0,1,41,216,163,2184,2400,12/16/2020
2020-03-27,27,234,214,2607,2841,9.0,79.0,1.0,13.0,1.0,1.0,65.0,16.0,6.0,2,3,31,247,186,2370,2617,12/16/2020
2020-03-28,59,293,260,2867,3160,11.0,90.0,2.0,15.0,1.0,2.0,73.0,15.0,6.0,1,4,64,311,233,2603,2914,12/16/2020
2020-03-29,100,393,350,3217,3610,8.0,98.0,3.0,18.0,1.0,3.0,77.0,18.0,8.0,2,6,105,416,293,2896,3312,12/16/2020
2020-03-30,62,455,222,3439,3894,19.0,117.0,5.0,23.0,0.0,3.0,91.0,19.0,11.0,3,9,78,494,172,3068,3562,12/16/2020
2020-03-31,71,526,369,3808,4334,11.0,128.0,7.0,30.0,1.0,4.0,94.0,21.0,13.0,2,11,73,567,285,3353,3920,12/16/2020
2020-04-01,99,625,698,4506,5131,18.0,146.0,7.0,37.0,0.0,4.0,105.0,29.0,15.0,1,12,100,667,593,3946,4613,12/16/2020
2020-04-02,52,677,477,4983,5660,22.0,168.0,6.0,43.0,2.0,6.0,119.0,35.0,21.0,4,16,62,729,409,4355,5084,12/16/2020
2020-04-03,108,785,774,5757,6542,23.0,191.0,7.0,50.0,0.0,6.0,135.0,42.0,25.0,3,19,100,829,666,5021,5850,12/16/2020
2020-04-04,143,928,660,6417,7345,22.0,213.0,4.0,54.0,5.0,11.0,148.0,40.0,29.0,9,28,138,967,577,5598,6565,12/16/2020
2020-04-05,187,1115,1156,7573,8688,20.0,233.0,9.0,63.0,1.0,12.0,158.0,43.0,35.0,2,30,181,1148,979,6577,7725,12/16/2020
2020-04-06,218,1333,1706,9279,10612,26.0,259.0,7.0,70.0,0.0,12.0,177.0,47.0,39.0,7,37,207,1355,1453,8030,9385,12/16/2020
2020-04-07,284,1617,1629,10908,12525,20.0,279.0,4.0,74.0,2.0,14.0,191.0,49.0,41.0,5,42,260,1615,1390,9420,11035,12/16/2020
2020-04-08,290,1907,1720,12628,14535,19.0,298.0,8.0,82.0,5.0,19.0,197.0,49.0,37.0,10,52,271,1886,1458,10878,12764,12/16/2020
2020-04-09,283,2190,1516,14144,16334,32.0,330.0,8.0,90.0,4.0,23.0,217.0,53.0,40.0,7,59,277,2163,1269,12147,14310,12/16/2020
2020-04-10,419,2609,2574,16718,19327,29.0,359.0,17.0,107.0,5.0,28.0,224.0,59.0,41.0,11,70,400,2563,2226,14373,16936,12/16/2020
2020-04-11,298,2907,1905,18623,21530,29.0,388.0,11.0,118.0,2.0,30.0,240.0,61.0,48.0,12,82,280,2843,1622,15995,18838,12/16/2020
2020-04-12,314,3221,1670,20293,23514,35.0,423.0,13.0,131.0,5.0,35.0,257.0,59.0,49.0,9,91,286,3129,1304,17299,20428,12/16/2020
2020-04-13,161,3382,935,21228,24610,35.0,458.0,13.0,144.0,3.0,38.0,276.0,64.0,54.0,9,100,187,3316,787,18086,21402,12/16/2020
2020-04-14,290,3672,1787,23015,26687,27.0,485.0,18.0,162.0,5.0,43.0,280.0,72.0,53.0,8,108,261,3577,1421,19507,23084,12/16/2020
2020-04-15,350,4022,1799,24814,28836,31.0,516.0,20.0,182.0,3.0,46.0,288.0,72.0,54.0,17,125,306,3883,1419,20926,24809,12/16/2020
2020-04-16,447,4469,2494,27308,31777,36.0,552.0,25.0,207.0,6.0,52.0,293.0,72.0,53.0,14,139,387,4270,1905,22831,27101,12/16/2020
2020-04-17,304,4773,1821,29129,33902,32.0,584.0,20.0,227.0,7.0,59.0,298.0,66.0,45.0,21,160,290,4560,1323,24154,28714,12/16/2020
2020-04-18,321,5094,1725,30854,35948,26.0,610.0,18.0,245.0,4.0,63.0,302.0,63.0,49.0,15,175,284,4844,1234,25388,30232,12/16/2020
2020-04-19,381,5475,2047,32901,38376,23.0,633.0,26.0,271.0,1.0,64.0,298.0,65.0,55.0,11,186,337,5181,1637,27025,32206,12/16/2020
2020-04-20,394,5869,1907,34808,40677,46.0,679.0,29.0,300.0,2.0,66.0,313.0,75.0,56.0,10,196,376,5557,1469,28494,34051,12/16/2020
2020-04-21,444,6313,2110,36918,43231,45.0,724.0,32.0,332.0,5.0,71.0,321.0,72.0,56.0,18,214,383,5940,1600,30094,36034,12/16/2020
2020-04-22,418,6731,2390,39308,46039,41.0,765.0,32.0,364.0,5.0,76.0,325.0,73.0,58.0,18,232,379,6319,1770,31864,38183,12/16/2020
2020-04-23,479,7210,2469,41777,48987,32.0,797.0,28.0,392.0,5.0,81.0,324.0,76.0,62.0,15,247,412,6731,1721,33585,40316,12/16/2020
2020-04-24,491,7701,3284,45061,52762,35.0,832.0,26.0,418.0,4.0,85.0,329.0,85.0,63.0,15,262,407,7138,2383,35968,43106,12/16/2020
2020-04-25,393,8094,2206,47267,55361,34.0,866.0,17.0,435.0,5.0,90.0,341.0,85.0,62.0,14,276,299,7437,1601,37569,45006,12/16/2020
2020-04-26,316,8410,2309,49576,57986,33.0,899.0,15.0,450.0,3.0,93.0,356.0,86.0,59.0,14,290,274,7711,1722,39291,47002,12/16/2020
2020-04-27,249,8659,1620,51196,59855,29.0,928.0,21.0,471.0,4.0,97.0,360.0,86.0,61.0,10,300,206,7917,1075,40366,48283,12/16/2020
2020-04-28,410,9069,2263,53459,62528,44.0,972.0,24.0,495.0,3.0,100.0,377.0,88.0,59.0,22,322,331,8248,1544,41910,50158,12/16/2020
2020-04-29,476,9545,3343,56802,66347,36.0,1008.0,38.0,533.0,11.0,111.0,364.0,78.0,53.0,18,340,371,8619,2185,44095,52714,12/16/2020
2020-04-30,432,9977,2769,59571,69548,33.0,1041.0,38.0,571.0,6.0,117.0,353.0,83.0,57.0,24,364,351,8970,1723,45818,54788,12/16/2020
2020-05-01,454,10431,3086,62657,73088,52.0,1093.0,39.0,610.0,3.0,120.0,363.0,84.0,58.0,14,378,323,9293,1939,47757,57050,12/16/2020
2020-05-02,257,10688,1926,64583,75271,36.0,1129.0,38.0,648.0,5.0,125.0,356.0,93.0,63.0,24,402,193,9486,1179,48936,58422,12/16/2020
2020-05-03,283,10971,2160,66743,77714,31.0,1160.0,27.0,675.0,8.0,133.0,352.0,91.0,61.0,21,423,183,9669,1423,50359,60028,12/16/2020
2020-05-04,387,11358,2098,68841,80199,30.0,1190.0,31.0,706.0,5.0,138.0,346.0,89.0,58.0,18,441,290,9959,1454,51813,61772,12/16/2020
2020-05-05,433,11791,2873,71714,83505,29.0,1219.0,32.0,738.0,6.0,144.0,337.0,83.0,55.0,16,457,299,10258,1832,53645,63903,12/16/2020
2020-05-06,488,12279,2830,74544,86823,28.0,1247.0,44.0,782.0,9.0,153.0,312.0,80.0,55.0,21,478,340,10598,1790,55435,66033,12/16/2020
2020-05-07,425,12704,2969,77513,90217,36.0,1283.0,44.0,826.0,5.0,158.0,299.0,72.0,53.0,21,499,270,10868,1803,57238,68106,12/16/2020
2020-05-08,359,13063,2598,80111,93174,30.0,1313.0,29.0,855.0,5.0,163.0,295.0,72.0,54.0,22,521,230,11098,1557,58795,69893,12/16/2020
2020-05-09,467,13530,3346,83457,96987,22.0,1335.0,21.0,876.0,4.0,167.0,292.0,70.0,52.0,15,536,288,11386,2088,60883,72269,12/16/2020
2020-05-10,285,13815,2117,85574,99389,20.0,1355.0,23.0,899.0,6.0,173.0,283.0,71.0,50.0,14,550,190,11576,1402,62285,73861,12/16/2020
2020-05-11,257,14072,1857,87431,101503,31.0,1386.0,16.0,915.0,6.0,179.0,292.0,72.0,50.0,15,565,173,11749,1219,63504,75253,12/16/2020
2020-05-12,387,14459,2611,90042,104501,23.0,1409.0,18.0,933.0,4.0,183.0,293.0,70.0,49.0,22,587,224,11973,1528,65032,77005,12/16/2020
2020-05-13,351,14810,3630,93672,108482,23.0,1432.0,25.0,958.0,1.0,184.0,290.0,70.0,50.0,13,600,199,12172,1825,66857,79029,12/16/2020
2020-05-14,329,15139,3408,97080,112219,19.0,1451.0,27.0,985.0,3.0,187.0,279.0,65.0,46.0,15,615,232,12404,1851,68708,81112,12/16/2020
2020-05-15,381,15520,3458,100538,116058,24.0,1475.0,41.0,1026.0,5.0,192.0,257.0,63.0,46.0,14,629,232,12636,1697,70405,83041,12/16/2020
2020-05-16,449,15969,4156,104694,120663,25.0,1500.0,15.0,1041.0,5.0,197.0,262.0,62.0,47.0,15,644,247,12883,1814,72219,85102,12/16/2020
2020-05-17,240,16209,2768,107462,123671,17.0,1517.0,9.0,1050.0,5.0,202.0,265.0,60.0,46.0,10,654,126,13009,1436,73655,86664,12/16/2020
2020-05-18,250,16459,2001,109463,125922,19.0,1536.0,16.0,1066.0,5.0,207.0,263.0,58.0,41.0,18,672,135,13144,1299,74954,88098,12/16/2020
2020-05-19,415,16874,3168,112631,129505,23.0,1559.0,33.0,1099.0,5.0,212.0,248.0,57.0,39.0,11,683,215,13359,1814,76768,90127,12/16/2020
2020-05-20,326,17200,2771,115402,132602,19.0,1578.0,23.0,1122.0,7.0,219.0,237.0,53.0,34.0,22,705,183,13542,1434,78202,91744,12/16/2020
2020-05-21,374,17574,3757,119159,136733,25.0,1603.0,15.0,1137.0,3.0,222.0,244.0,54.0,30.0,20,725,168,13710,1837,80039,93749,12/16/2020
2020-05-22,351,17925,3161,122320,140245,20.0,1623.0,28.0,1165.0,5.0,227.0,231.0,53.0,30.0,11,736,206,13916,1502,81541,95457,12/16/2020
2020-05-23,253,18178,2742,125062,143240,19.0,1642.0,11.0,1176.0,3.0,230.0,236.0,53.0,33.0,13,749,109,14025,1204,82745,96770,12/16/2020
2020-05-24,163,18341,1370,126432,144773,13.0,1655.0,14.0,1190.0,2.0,232.0,233.0,54.0,36.0,8,757,83,14108,734,83479,97587,12/16/2020
2020-05-25,147,18488,1385,127817,146305,14.0,1669.0,14.0,1204.0,0.0,232.0,233.0,54.0,34.0,10,767,76,14184,686,84165,98349,12/16/2020
2020-05-26,285,18773,2620,130437,149210,24.0,1693.0,21.0,1225.0,5.0,237.0,231.0,49.0,33.0,15,782,158,14342,1553,85718,100060,12/16/2020
2020-05-27,276,19049,2057,132494,151543,20.0,1713.0,18.0,1243.0,3.0,240.0,230.0,51.0,33.0,10,792,132,14474,1082,86800,101274,12/16/2020
2020-05-28,348,19397,3359,135853,155250,17.0,1730.0,29.0,1272.0,4.0,244.0,214.0,47.0,32.0,8,800,130,14604,1044,87844,102448,12/16/2020
2020-05-29,410,19807,3915,139768,159575,19.0,1749.0,26.0,1298.0,7.0,251.0,200.0,43.0,31.0,12,812,174,14778,1468,89312,104090,12/16/2020
2020-05-30,225,20032,3915,143683,163715,16.0,1765.0,19.0,1317.0,4.0,255.0,193.0,41.0,29.0,12,824,109,14887,1632,90944,105831,12/16/2020
2020-05-31,155,20187,1690,145373,165560,11.0,1776.0,11.0,1328.0,1.0,256.0,192.0,44.0,26.0,3,827,78,14965,784,91728,106693,12/16/2020
2020-06-01,212,20399,2792,148165,168564,8.0,1784.0,14.0,1342.0,1.0,257.0,185.0,45.0,29.0,5,832,93,15058,1311,93039,108097,12/16/2020
2020-06-02,273,20672,3022,151187,171859,8.0,1792.0,9.0,1351.0,3.0,260.0,181.0,38.0,25.0,10,842,98,15156,1356,94395,109551,12/16/2020
2020-06-03,254,20926,3486,154673,175599,14.0,1806.0,18.0,1369.0,6.0,266.0,171.0,34.0,25.0,11,853,99,15255,1568,95963,111218,12/16/2020
2020-06-04,276,21202,4471,159144,180346,7.0,1813.0,26.0,1395.0,4.0,270.0,148.0,31.0,24.0,12,865,107,15362,1902,97865,113227,12/16/2020
2020-06-05,215,21417,3513,162657,184074,15.0,1828.0,13.0,1408.0,6.0,276.0,144.0,27.0,21.0,11,876,99,15461,1452,99317,114778,12/16/2020
2020-06-06,201,21618,2616,165273,186891,10.0,1838.0,7.0,1415.0,2.0,278.0,145.0,29.0,19.0,6,882,67,15528,1062,100379,115907,12/16/2020
2020-06-07,83,21701,1625,166898,188599,11.0,1849.0,7.0,1422.0,1.0,279.0,148.0,25.0,17.0,4,886,51,15579,761,101140,116719,12/16/2020
2020-06-08,119,21820,1849,168747,190567,15.0,1864.0,13.0,1435.0,2.0,281.0,148.0,27.0,18.0,4,890,45,15624,906,102046,117670,12/16/2020
2020-06-09,223,22043,2673,171420,193463,10.0,1874.0,19.0,1454.0,0.0,281.0,139.0,28.0,21.0,1,891,64,15688,1198,103244,118932,12/16/2020
2020-06-10,209,22252,2987,174407,196659,13.0,1887.0,12.0,1466.0,2.0,283.0,138.0,24.0,17.0,4,895,100,15788,1405,104649,120437,12/16/2020
2020-06-11,195,22447,3513,177920,200367,7.0,1894.0,15.0,1481.0,1.0,284.0,129.0,25.0,16.0,6,901,88,15876,1454,106103,121979,12/16/2020
2020-06-12,209,22656,4601,182521,205177,9.0,1903.0,16.0,1497.0,1.0,285.0,121.0,24.0,16.0,2,903,78,15954,1998,108101,124055,12/16/2020
2020-06-13,113,22769,3036,185557,208326,6.0,1909.0,5.0,1502.0,0.0,285.0,122.0,20.0,15.0,3,906,49,16003,1267,109368,125371,12/16/2020
2020-06-14,81,22850,2046,187603,210453,7.0,1916.0,8.0,1510.0,1.0,286.0,120.0,20.0,14.0,3,909,33,16036,925,110293,126329,12/16/2020
2020-06-15,188,23038,3108,190711,213749,14.0,1930.0,19.0,1529.0,0.0,286.0,115.0,20.0,16.0,5,914,75,16111,1702,111995,128106,12/16/2020
2020-06-16,110,23148,3017,193728,216876,11.0,1941.0,9.0,1538.0,1.0,287.0,116.0,22.0,16.0,8,922,50,16161,1465,113460,129621,12/16/2020
2020-06-17,127,23275,2835,196563,219838,15.0,1956.0,20.0,1558.0,4.0,291.0,107.0,18.0,14.0,6,928,51,16212,1257,114717,130929,12/16/2020
2020-06-18,149,23424,3048,199611,223035,9.0,1965.0,15.0,1573.0,1.0,292.0,100.0,19.0,16.0,7,935,70,16282,1251,115968,132250,12/16/2020
2020-06-19,141,23565,3769,203380,226945,12.0,1977.0,12.0,1585.0,1.0,293.0,99.0,20.0,17.0,3,938,59,16341,1302,117270,133611,12/16/2020
2020-06-20,84,23649,1891,205271,228920,9.0,1986.0,12.0,1597.0,0.0,293.0,96.0,20.0,18.0,4,942,36,16377,777,118047,134424,12/16/2020
2020-06-21,37,23686,1064,206335,230021,8.0,1994.0,5.0,1602.0,0.0,293.0,99.0,20.0,18.0,2,944,30,16407,656,118703,135110,12/16/2020
2020-06-22,138,23824,3730,210065,233889,12.0,2006.0,17.0,1619.0,0.0,293.0,94.0,19.0,18.0,2,946,65,16472,1632,120335,136807,12/16/2020
2020-06-23,163,23987,3831,213896,237883,3.0,2009.0,13.0,1632.0,3.0,296.0,81.0,18.0,18.0,7,953,81,16553,1708,122043,138596,12/16/2020
2020-06-24,120,24107,3502,217398,241505,9.0,2018.0,10.0,1642.0,1.0,297.0,79.0,18.0,18.0,5,958,45,16598,1599,123642,140240,12/16/2020
2020-06-25,103,24210,2883,220281,244491,6.0,2024.0,14.0,1656.0,1.0,298.0,70.0,17.0,17.0,1,959,51,16649,1428,125070,141719,12/16/2020
2020-06-26,94,24304,2488,222769,247073,2.0,2026.0,10.0,1666.0,0.0,298.0,62.0,18.0,18.0,1,960,60,16709,1271,126341,143050,12/16/2020
2020-06-27,84,24388,3216,225985,250373,5.0,2031.0,3.0,1669.0,1.0,299.0,63.0,17.0,17.0,5,965,37,16746,1161,127502,144248,12/16/2020
2020-06-28,39,24427,1469,227454,251881,4.0,2035.0,4.0,1673.0,4.0,303.0,59.0,15.0,14.0,6,971,17,16763,574,128076,144839,12/16/2020
2020-06-29,85,24512,3697,231151,255663,4.0,2039.0,5.0,1678.0,0.0,303.0,58.0,14.0,14.0,1,972,39,16802,1299,129375,146177,12/16/2020
2020-06-30,57,24569,1958,233109,257678,1.0,2040.0,5.0,1683.0,1.0,304.0,53.0,12.0,11.0,4,976,32,16834,956,130331,147165,12/16/2020
2020-07-01,144,24713,4098,237207,261920,8.0,2048.0,10.0,1693.0,0.0,304.0,51.0,11.0,11.0,1,977,79,16913,1851,132182,149095,12/16/2020
2020-07-02,103,24816,2803,240010,264826,5.0,2053.0,5.0,1698.0,1.0,305.0,50.0,10.0,10.0,3,980,59,16972,1035,133217,150189,12/16/2020
2020-07-03,50,24866,2079,242089,266955,9.0,2062.0,6.0,1704.0,0.0,305.0,53.0,9.0,9.0,3,983,24,16996,750,133967,150963,12/16/2020
2020-07-04,57,24923,2345,244434,269357,2.0,2064.0,4.0,1708.0,1.0,306.0,50.0,10.0,9.0,2,985,33,17029,964,134931,151960,12/16/2020
2020-07-05,49,24972,2932,247366,272338,1.0,2065.0,2.0,1710.0,1.0,307.0,48.0,8.0,8.0,2,987,26,17055,1363,136294,153349,12/16/2020
2020-07-06,101,25073,2814,250180,275253,6.0,2071.0,6.0,1716.0,0.0,307.0,48.0,9.0,9.0,4,991,57,17112,1497,137791,154903,12/16/2020
2020-07-07,81,25154,3457,253637,278791,5.0,2076.0,7.0,1723.0,0.0,307.0,46.0,8.0,8.0,2,993,47,17159,1484,139275,156434,12/16/2020
2020-07-08,105,25259,3409,257046,282305,4.0,2080.0,2.0,1725.0,0.0,307.0,48.0,9.0,8.0,0,993,64,17223,1350,140625,157848,12/16/2020
2020-07-09,94,25353,3714,260760,286113,9.0,2089.0,3.0,1728.0,0.0,307.0,54.0,9.0,8.0,0,993,50,17273,1553,142178,159451,12/16/2020
2020-07-10,132,25485,4437,265197,290682,6.0,2095.0,3.0,1731.0,2.0,309.0,55.0,7.0,7.0,3,996,80,17353,1988,144166,161519,12/16/2020
2020-07-11,63,25548,2938,268135,293683,6.0,2101.0,3.0,1734.0,1.0,310.0,57.0,6.0,6.0,3,999,36,17389,1265,145431,162820,12/16/2020
2020-07-12,47,25595,1838,269973,295568,1.0,2102.0,3.0,1737.0,1.0,311.0,54.0,6.0,5.0,3,1002,34,17423,909,146340,163763,12/16/2020
2020-07-13,84,25679,3209,273182,298861,8.0,2110.0,10.0,1747.0,0.0,311.0,52.0,6.0,5.0,1,1003,61,17484,1446,147786,165270,12/16/2020
2020-07-14,74,25753,3298,276480,302233,7.0,2117.0,4.0,1751.0,0.0,311.0,55.0,5.0,5.0,1,1004,44,17528,1333,149119,166647,12/16/2020
2020-07-15,130,25883,4181,280661,306544,5.0,2122.0,7.0,1758.0,0.0,311.0,53.0,5.0,4.0,0,1004,100,17628,1680,150799,168427,12/16/2020
2020-07-16,103,25986,3740,284401,310387,6.0,2128.0,9.0,1767.0,0.0,311.0,50.0,6.0,5.0,1,1005,76,17704,1539,152338,170042,12/16/2020
2020-07-17,156,26142,4239,288640,314782,14.0,2142.0,3.0,1770.0,1.0,312.0,60.0,5.0,5.0,2,1007,79,17783,1775,154113,171896,12/16/2020
2020-07-18,85,26227,3272,291912,318139,5.0,2147.0,9.0,1779.0,1.0,313.0,55.0,5.0,4.0,4,1011,70,17853,1341,155454,173307,12/16/2020
2020-07-19,82,26309,2696,294608,320917,7.0,2154.0,3.0,1782.0,0.0,313.0,59.0,6.0,4.0,2,1013,57,17910,1093,156547,174457,12/16/2020
2020-07-20,71,26380,2666,297274,323654,9.0,2163.0,7.0,1789.0,0.0,313.0,61.0,7.0,5.0,2,1015,68,17978,1396,157943,175921,12/16/2020
2020-07-21,130,26510,4304,301578,328088,9.0,2172.0,11.0,1800.0,0.0,313.0,59.0,9.0,6.0,1,1016,108,18086,1843,159786,177872,12/16/2020
2020-07-22,130,26640,3928,305506,332146,7.0,2179.0,8.0,1808.0,1.0,314.0,57.0,7.0,6.0,1,1017,86,18172,1600,161386,179558,12/16/2020
2020-07-23,141,26781,4415,309921,336702,8.0,2187.0,6.0,1814.0,0.0,314.0,59.0,8.0,7.0,0,1017,115,18287,1893,163279,181566,12/16/2020
2020-07-24,172,26953,5966,315887,342840,15.0,2202.0,12.0,1826.0,0.0,314.0,62.0,9.0,7.0,0,1017,119,18406,2226,165505,183911,12/16/2020
2020-07-25,134,27087,4398,320285,347372,7.0,2209.0,7.0,1833.0,0.0,314.0,62.0,10.0,8.0,3,1020,108,18514,2023,167528,186042,12/16/2020
2020-07-26,62,27149,3033,323318,350467,8.0,2217.0,9.0,1842.0,0.0,314.0,61.0,11.0,7.0,1,1021,54,18568,1288,168816,187384,12/16/2020
2020-07-27,188,27337,4191,327509,354846,12.0,2229.0,7.0,1849.0,0.0,314.0,66.0,13.0,8.0,1,1022,138,18706,2244,171060,189766,12/16/2020
2020-07-28,105,27442,3840,331349,358791,5.0,2234.0,5.0,1854.0,0.0,314.0,66.0,14.0,7.0,1,1023,95,18801,1575,172635,191436,12/16/2020
2020-07-29,190,27632,5139,336488,364120,9.0,2243.0,10.0,1864.0,0.0,314.0,65.0,15.0,7.0,0,1023,154,18955,2214,174849,193804,12/16/2020
2020-07-30,121,27753,4345,340833,368586,6.0,2249.0,2.0,1866.0,1.0,315.0,68.0,15.0,6.0,1,1024,97,19052,1562,176411,195463,12/16/2020
2020-07-31,131,27884,5512,346345,374229,7.0,2256.0,9.0,1875.0,0.0,315.0,66.0,15.0,7.0,1,1025,89,19141,1770,178181,197322,12/16/2020
2020-08-01,109,27993,4294,350639,378632,7.0,2263.0,2.0,1877.0,0.0,315.0,71.0,14.0,7.0,1,1026,89,19230,1492,179673,198903,12/16/2020
2020-08-02,84,28077,2804,353443,381520,12.0,2275.0,12.0,1889.0,2.0,317.0,69.0,14.0,8.0,2,1028,62,19292,1225,180898,200190,12/16/2020
2020-08-03,188,28265,5248,358691,386956,11.0,2286.0,10.0,1899.0,0.0,317.0,70.0,16.0,7.0,1,1029,150,19442,2120,183018,202460,12/16/2020
2020-08-04,125,28390,3691,362382,390772,8.0,2294.0,5.0,1904.0,1.0,318.0,72.0,12.0,5.0,2,1031,99,19541,1707,184725,204266,12/16/2020
2020-08-05,147,28537,5935,368317,396854,11.0,2305.0,9.0,1913.0,1.0,319.0,73.0,10.0,5.0,2,1033,119,19660,2369,187094,206754,12/16/2020
2020-08-06,169,28706,5546,373863,402569,7.0,2312.0,9.0,1922.0,0.0,319.0,71.0,9.0,4.0,0,1033,120,19780,2288,189382,209162,12/16/2020
2020-08-07,123,28829,4851,378714,407543,12.0,2324.0,9.0,1931.0,1.0,320.0,73.0,9.0,3.0,2,1035,87,19867,2053,191435,211302,12/16/2020
2020-08-08,123,28952,4112,382826,411778,19.0,2343.0,6.0,1937.0,1.0,321.0,85.0,8.0,3.0,1,1036,91,19958,1712,193147,213105,12/16/2020
2020-08-09,42,28994,1727,384553,413547,6.0,2349.0,8.0,1945.0,0.0,321.0,83.0,9.0,4.0,0,1036,35,19993,1020,194167,214160,12/16/2020
2020-08-10,149,29143,4587,389140,418283,8.0,2357.0,9.0,1954.0,0.0,321.0,82.0,9.0,4.0,1,1037,113,20106,1947,196114,216220,12/16/2020
2020-08-11,106,29249,4334,393474,422723,5.0,2362.0,13.0,1967.0,0.0,321.0,74.0,10.0,4.0,3,1040,92,20198,2186,198300,218498,12/16/2020
2020-08-12,121,29370,5188,398662,428032,8.0,2370.0,11.0,1978.0,0.0,321.0,71.0,9.0,3.0,1,1041,101,20299,2515,200815,221114,12/16/2020
2020-08-13,135,29505,4196,402858,432363,13.0,2383.0,12.0,1990.0,0.0,321.0,72.0,11.0,3.0,0,1041,95,20394,1831,202646,223040,12/16/2020
2020-08-14,145,29650,5498,408356,438006,13.0,2396.0,11.0,2001.0,0.0,321.0,74.0,11.0,4.0,3,1044,98,20492,1901,204547,225039,12/16/2020
2020-08-15,106,29756,4534,412890,442646,9.0,2405.0,11.0,2012.0,1.0,322.0,71.0,11.0,5.0,0,1044,88,20580,1626,206173,226753,12/16/2020
2020-08-16,83,29839,2477,415367,445206,6.0,2411.0,5.0,2017.0,4.0,326.0,68.0,8.0,4.0,6,1050,70,20650,920,207093,227743,12/16/2020
2020-08-17,106,29945,4575,419942,449887,8.0,2419.0,6.0,2023.0,0.0,326.0,70.0,8.0,5.0,2,1052,87,20737,2305,209398,230135,12/16/2020
2020-08-18,128,30073,4911,424853,454926,11.0,2430.0,8.0,2031.0,1.0,327.0,72.0,8.0,4.0,5,1057,94,20831,2660,212058,232889,12/16/2020
2020-08-19,113,30186,5077,429930,460116,8.0,2438.0,9.0,2040.0,1.0,328.0,70.0,9.0,5.0,0,1057,90,20921,2552,214610,235531,12/16/2020
2020-08-20,173,30359,7411,437341,467700,12.0,2450.0,6.0,2046.0,2.0,330.0,74.0,10.0,5.0,3,1060,139,21060,3403,218013,239073,12/16/2020
2020-08-21,152,30511,6577,443918,474429,8.0,2458.0,5.0,2051.0,1.0,331.0,76.0,9.0,4.0,2,1062,125,21185,2825,220838,242023,12/16/2020
2020-08-22,96,30607,5550,449468,480075,11.0,2469.0,12.0,2063.0,0.0,331.0,75.0,11.0,4.0,1,1063,84,21269,2506,223344,244613,12/16/2020
2020-08-23,72,30679,4375,453843,484522,11.0,2480.0,6.0,2069.0,0.0,331.0,80.0,12.0,2.0,1,1064,56,21325,2412,225756,247081,12/16/2020
2020-08-24,105,30784,5784,459627,490411,7.0,2487.0,10.0,2079.0,1.0,332.0,76.0,14.0,4.0,1,1065,77,21402,3054,228810,250212,12/16/2020
2020-08-25,108,30892,4764,464391,495283,10.0,2497.0,4.0,2083.0,1.0,333.0,81.0,12.0,4.0,1,1066,92,21494,2219,231029,252523,12/16/2020
2020-08-26,170,31062,9482,473873,504935,4.0,2501.0,8.0,2091.0,0.0,333.0,77.0,10.0,5.0,1,1067,127,21621,2989,234018,255639,12/16/2020
2020-08-27,91,31153,8565,482438,513591,6.0,2507.0,13.0,2104.0,1.0,334.0,69.0,7.0,5.0,2,1069,70,21691,3044,237062,258753,12/16/2020
2020-08-28,113,31266,7994,490432,521698,14.0,2521.0,4.0,2108.0,0.0,334.0,79.0,10.0,7.0,2,1071,87,21778,2341,239403,261181,12/16/2020
2020-08-29,65,31331,5374,495806,527137,6.0,2527.0,8.0,2116.0,1.0,335.0,76.0,11.0,6.0,2,1073,51,21829,1856,241259,263088,12/16/2020
2020-08-30,66,31397,4323,500129,531526,7.0,2534.0,4.0,2120.0,0.0,335.0,79.0,9.0,5.0,2,1075,48,21877,1932,243191,265068,12/16/2020
2020-08-31,105,31502,4863,504992,536494,12.0,2546.0,16.0,2136.0,0.0,335.0,75.0,8.0,4.0,1,1076,81,21958,2122,245313,267271,12/16/2020
2020-09-01,99,31601,7109,512101,543702,6.0,2552.0,9.0,2145.0,1.0,336.0,71.0,7.0,4.0,2,1078,66,22024,2303,247616,269640,12/16/2020
2020-09-02,125,31726,10529,522630,554356,9.0,2561.0,10.0,2155.0,1.0,337.0,69.0,8.0,4.0,2,1080,104,22128,2959,250575,272703,12/16/2020
2020-09-03,90,31816,11080,533710,565526,8.0,2569.0,8.0,2163.0,0.0,337.0,69.0,9.0,4.0,3,1083,73,22201,2489,253064,275265,12/16/2020
2020-09-04,103,31919,8963,542673,574592,11.0,2580.0,4.0,2167.0,0.0,337.0,76.0,9.0,4.0,1,1084,83,22284,2292,255356,277640,12/16/2020
2020-09-05,52,31971,6309,548982,580953,6.0,2586.0,9.0,2176.0,0.0,337.0,73.0,8.0,3.0,1,1085,42,22326,1550,256906,279232,12/16/2020
2020-09-06,88,32059,4325,553307,585366,4.0,2590.0,8.0,2184.0,1.0,338.0,68.0,6.0,3.0,1,1086,65,22391,1883,258789,281180,12/16/2020
2020-09-07,35,32094,3002,556309,588403,11.0,2601.0,3.0,2187.0,0.0,338.0,76.0,5.0,3.0,1,1087,26,22417,619,259408,281825,12/16/2020
2020-09-08,74,32168,6381,562690,594858,6.0,2607.0,12.0,2199.0,1.0,339.0,69.0,6.0,3.0,2,1089,66,22483,1534,260942,283425,12/16/2020
2020-09-09,118,32286,8650,571340,603626,10.0,2617.0,5.0,2204.0,1.0,340.0,73.0,9.0,3.0,1,1090,102,22585,2056,262998,285583,12/16/2020
2020-09-10,164,32450,11334,582674,615124,9.0,2626.0,8.0,2212.0,0.0,340.0,74.0,10.0,3.0,1,1091,111,22696,2182,265180,287876,12/16/2020
2020-09-11,120,32570,9454,592128,624698,11.0,2637.0,11.0,2223.0,0.0,340.0,74.0,10.0,5.0,0,1091,96,22792,1890,267070,289862,12/16/2020
2020-09-12,110,32680,6174,598302,630982,8.0,2645.0,5.0,2228.0,2.0,342.0,75.0,9.0,5.0,3,1094,97,22889,1462,268532,291421,12/16/2020
2020-09-13,58,32738,2717,601019,633757,4.0,2649.0,3.0,2231.0,0.0,342.0,76.0,10.0,5.0,0,1094,54,22943,828,269360,292303,12/16/2020
2020-09-14,104,32842,6446,607465,640307,6.0,2655.0,3.0,2234.0,2.0,344.0,77.0,10.0,5.0,2,1096,95,23038,1655,271015,294053,12/16/2020
2020-09-15,122,32964,8470,615935,648899,7.0,2662.0,2.0,2236.0,1.0,345.0,81.0,10.0,5.0,2,1098,124,23162,2121,273136,296298,12/16/2020
2020-09-16,137,33101,9716,625651,658752,7.0,2669.0,7.0,2243.0,2.0,347.0,79.0,9.0,6.0,5,1103,118,23280,1909,275045,298325,12/16/2020
2020-09-17,125,33226,9239,634890,668116,7.0,2676.0,15.0,2258.0,0.0,347.0,71.0,8.0,4.0,0,1103,154,23434,1878,276923,300357,12/16/2020
2020-09-18,132,33358,10045,644935,678293,7.0,2683.0,7.0,2265.0,1.0,348.0,70.0,11.0,6.0,2,1105,132,23566,1853,278776,302342,12/16/2020
2020-09-19,115,33473,8297,653232,686705,7.0,2690.0,3.0,2268.0,0.0,348.0,74.0,10.0,6.0,4,1109,112,23678,1645,280421,304099,12/16/2020
2020-09-20,60,33533,3676,656908,690441,7.0,2697.0,6.0,2274.0,2.0,350.0,73.0,9.0,8.0,4,1113,49,23727,1283,281704,305431,12/16/2020
2020-09-21,102,33635,7018,663926,697561,12.0,2709.0,3.0,2277.0,2.0,352.0,80.0,8.0,6.0,2,1115,94,23821,2336,284040,307861,12/16/2020
2020-09-22,154,33789,9287,673213,707002,12.0,2721.0,3.0,2280.0,1.0,353.0,88.0,7.0,5.0,1,1116,124,23945,2121,286161,310106,12/16/2020
2020-09-23,136,33925,10651,683864,717789,13.0,2734.0,7.0,2287.0,0.0,353.0,94.0,6.0,5.0,0,1116,127,24072,2134,288295,312367,12/16/2020
2020-09-24,120,34045,12480,696344,730389,8.0,2742.0,9.0,2296.0,1.0,354.0,92.0,7.0,5.0,1,1117,120,24192,3079,291374,315566,12/16/2020
2020-09-25,150,34195,10553,706897,741092,9.0,2751.0,10.0,2306.0,0.0,354.0,91.0,6.0,5.0,1,1118,143,24335,2927,294301,318636,12/16/2020
2020-09-26,147,34342,10560,717457,751799,12.0,2763.0,9.0,2315.0,0.0,354.0,94.0,6.0,5.0,1,1119,120,24455,2353,296654,321109,12/16/2020
2020-09-27,43,34385,2764,720221,754606,7.0,2770.0,5.0,2320.0,0.0,354.0,96.0,9.0,5.0,0,1119,34,24489,820,297474,321963,12/16/2020
2020-09-28,156,34541,7307,727528,762069,7.0,2777.0,7.0,2327.0,2.0,356.0,94.0,7.0,5.0,2,1121,138,24627,2188,299662,324289,12/16/2020
2020-09-29,203,34744,11046,738574,773318,12.0,2789.0,18.0,2345.0,1.0,357.0,87.0,6.0,6.0,1,1122,185,24812,2741,302403,327215,12/16/2020
2020-09-30,223,34967,12230,750804,785771,6.0,2795.0,6.0,2351.0,0.0,357.0,87.0,6.0,6.0,1,1123,189,25001,2497,304900,329901,12/16/2020
2020-10-01,185,35152,12503,763307,798459,17.0,2812.0,13.0,2364.0,1.0,358.0,90.0,6.0,4.0,2,1125,166,25167,2329,307229,332396,12/16/2020
2020-10-02,209,35361,12154,775461,810822,14.0,2826.0,13.0,2377.0,1.0,359.0,90.0,8.0,5.0,2,1127,181,25348,2424,309653,335001,12/16/2020
2020-10-03,157,35518,9313,784774,820292,9.0,2835.0,9.0,2386.0,2.0,361.0,88.0,9.0,4.0,2,1129,131,25479,1956,311609,337088,12/16/2020
2020-10-04,81,35599,2369,787143,822742,11.0,2846.0,9.0,2395.0,1.0,362.0,89.0,8.0,5.0,2,1131,76,25555,926,312535,338090,12/16/2020
2020-10-05,174,35773,8985,796128,831901,30.0,2876.0,10.0,2405.0,2.0,364.0,107.0,9.0,6.0,4,1135,160,25715,2951,315486,341201,12/16/2020
2020-10-06,189,35962,11186,807314,843276,11.0,2887.0,4.0,2409.0,0.0,364.0,114.0,11.0,7.0,0,1135,188,25903,2812,318298,344201,12/16/2020
2020-10-07,244,36206,12444,819758,855964,13.0,2900.0,14.0,2423.0,2.0,366.0,111.0,9.0,7.0,2,1137,245,26148,3434,321732,347880,12/16/2020
2020-10-08,282,36488,15233,834991,871479,17.0,2917.0,13.0,2436.0,2.0,368.0,113.0,7.0,5.0,4,1141,276,26424,4107,325839,352263,12/16/2020
2020-10-09,229,36717,13745,848736,885453,21.0,2938.0,12.0,2448.0,0.0,368.0,122.0,10.0,7.0,3,1144,201,26625,4179,330018,356643,12/16/2020
2020-10-10,231,36948,13832,862568,899516,19.0,2957.0,10.0,2458.0,1.0,369.0,130.0,13.0,7.0,2,1146,192,26817,3692,333710,360527,12/16/2020
2020-10-11,99,37047,3263,865831,902878,12.0,2969.0,9.0,2467.0,1.0,370.0,132.0,14.0,5.0,6,1152,89,26906,1132,334842,361748,12/16/2020
2020-10-12,169,37216,6440,872271,909487,19.0,2988.0,15.0,2482.0,2.0,372.0,134.0,14.0,5.0,4,1156,156,27062,1677,336519,363581,12/16/2020
2020-10-13,224,37440,8522,880793,918233,15.0,3003.0,13.0,2495.0,4.0,376.0,132.0,13.0,5.0,7,1163,212,27274,2262,338781,366055,12/16/2020
2020-10-14,335,37775,15042,895835,933610,17.0,3020.0,7.0,2502.0,0.0,376.0,142.0,15.0,5.0,2,1165,304,27578,3919,342700,370278,12/16/2020
2020-10-15,269,38044,14642,910477,948521,12.0,3032.0,16.0,2518.0,1.0,377.0,137.0,13.0,5.0,2,1167,253,27831,3475,346175,374006,12/16/2020
2020-10-16,288,38332,15012,925489,963821,13.0,3045.0,18.0,2536.0,1.0,378.0,131.0,13.0,4.0,2,1169,276,28107,3277,349452,377559,12/16/2020
2020-10-17,360,38692,14069,939558,978250,19.0,3064.0,11.0,2547.0,1.0,379.0,138.0,17.0,4.0,2,1171,309,28416,3163,352615,381031,12/16/2020
2020-10-18,155,38847,4039,943597,982444,18.0,3082.0,11.0,2558.0,0.0,379.0,145.0,17.0,6.0,2,1173,125,28541,1269,353884,382425,12/16/2020
2020-10-19,385,39232,8492,952089,991321,21.0,3103.0,22.0,2580.0,2.0,381.0,142.0,15.0,6.0,1,1174,320,28861,2485,356369,385230,12/16/2020
2020-10-20,439,39671,13245,965334,1005005,23.0,3126.0,17.0,2597.0,0.0,381.0,148.0,14.0,8.0,3,1177,383,29244,2918,359287,388531,12/16/2020
2020-10-21,544,40215,17464,982798,1023013,23.0,3149.0,8.0,2605.0,2.0,383.0,161.0,15.0,9.0,3,1180,471,29715,3385,362672,392387,12/16/2020
2020-10-22,538,40753,15864,998662,1039415,24.0,3173.0,20.0,2625.0,3.0,386.0,162.0,14.0,9.0,3,1183,489,30204,3088,365760,395964,12/16/2020
2020-10-23,514,41267,16637,1015299,1056566,22.0,3195.0,22.0,2647.0,1.0,387.0,161.0,15.0,9.0,3,1186,458,30662,2799,368559,399221,12/16/2020
2020-10-24,359,41626,10249,1025548,1067174,17.0,3212.0,11.0,2658.0,0.0,387.0,167.0,14.0,8.0,1,1187,337,30999,2186,370745,401744,12/16/2020
2020-10-25,233,41859,4760,1030308,1072167,16.0,3228.0,15.0,2673.0,1.0,388.0,167.0,15.0,8.0,2,1189,210,31209,1405,372150,403359,12/16/2020
2020-10-26,454,42313,9174,1039482,1081795,28.0,3256.0,15.0,2688.0,2.0,390.0,178.0,18.0,8.0,3,1192,402,31611,2889,375039,406650,12/16/2020
2020-10-27,517,42830,13995,1053477,1096307,29.0,3285.0,15.0,2703.0,2.0,392.0,190.0,18.0,9.0,4,1196,455,32066,2328,377367,409433,12/16/2020
2020-10-28,469,43299,15230,1068707,1112006,25.0,3310.0,26.0,2729.0,1.0,393.0,188.0,17.0,9.0,3,1199,412,32478,2616,379983,412461,12/16/2020
2020-10-29,609,43908,16260,1084967,1128875,20.0,3330.0,22.0,2751.0,3.0,396.0,183.0,19.0,11.0,4,1203,529,33007,3040,383023,416030,12/16/2020
2020-10-30,565,44473,14865,1099832,1144305,21.0,3351.0,21.0,2772.0,5.0,401.0,178.0,19.0,9.0,4,1207,470,33477,2860,385883,419360,12/16/2020
2020-10-31,599,45072,11819,1111651,1156723,31.0,3382.0,13.0,2785.0,1.0,402.0,195.0,22.0,9.0,3,1210,486,33963,2348,388231,422194,12/16/2020
2020-11-01,330,45402,5091,1116742,1162144,22.0,3404.0,15.0,2800.0,1.0,403.0,201.0,26.0,12.0,4,1214,277,34240,1231,389462,423702,12/16/2020
2020-11-02,522,45924,9935,1126677,1172601,38.0,3442.0,27.0,2827.0,3.0,406.0,209.0,24.0,12.0,5,1219,459,34699,2850,392312,427011,12/16/2020
2020-11-03,601,46525,13041,1139718,1186243,33.0,3475.0,25.0,2852.0,1.0,407.0,216.0,24.0,12.0,1,1220,530,35229,2444,394756,429985,12/16/2020
2020-11-04,688,47213,16101,1155819,1203032,34.0,3509.0,27.0,2879.0,2.0,409.0,221.0,25.0,12.0,4,1224,641,35870,2848,397604,433474,12/16/2020
2020-11-05,768,47981,16593,1172412,1220393,46.0,3555.0,35.0,2914.0,1.0,410.0,231.0,24.0,14.0,3,1227,685,36555,2785,400389,436944,12/16/2020
2020-11-06,769,48750,16026,1188438,1237188,43.0,3598.0,31.0,2945.0,1.0,411.0,242.0,28.0,17.0,5,1232,691,37246,2967,403356,440602,12/16/2020
2020-11-07,604,49354,13649,1202087,1251441,34.0,3632.0,25.0,2970.0,1.0,412.0,250.0,31.0,18.0,1,1233,578,37824,2405,405761,443585,12/16/2020
2020-11-08,337,49691,4166,1206253,1255944,33.0,3665.0,26.0,2996.0,1.0,413.0,256.0,30.0,19.0,4,1237,322,38146,1248,407009,445155,12/16/2020
2020-11-09,808,50499,9063,1215316,1265815,40.0,3705.0,33.0,3029.0,2.0,415.0,261.0,28.0,18.0,3,1240,766,38912,2272,409281,448193,12/16/2020
2020-11-10,1053,51552,12982,1228298,1279850,45.0,3750.0,37.0,3066.0,0.0,415.0,269.0,31.0,18.0,6,1246,982,39894,2822,412103,451997,12/16/2020
2020-11-11,1087,52639,19738,1248036,1300675,42.0,3792.0,24.0,3090.0,5.0,420.0,282.0,30.0,15.0,7,1253,1003,40897,2616,414719,455616,12/16/2020
2020-11-12,893,53532,13912,1261948,1315480,39.0,3831.0,31.0,3121.0,3.0,423.0,287.0,28.0,15.0,5,1258,813,41710,2156,416875,458585,12/16/2020
2020-11-13,1165,54697,16392,1278340,1333037,39.0,3870.0,31.0,3152.0,0.0,423.0,295.0,27.0,15.0,2,1260,1115,42825,3032,419907,462732,12/16/2020
2020-11-14,782,55479,13519,1291859,1347338,42.0,3912.0,26.0,3178.0,5.0,428.0,306.0,25.0,13.0,10,1270,738,43563,2419,422326,465889,12/16/2020
2020-11-15,578,56057,6173,1298032,1354089,46.0,3958.0,21.0,3199.0,5.0,433.0,326.0,28.0,11.0,7,1277,495,44058,1392,423718,467776,12/16/2020
2020-11-16,739,56796,9647,1307679,1364475,56.0,4014.0,39.0,3238.0,3.0,436.0,340.0,26.0,13.0,5,1282,674,44732,2602,426320,471052,12/16/2020
2020-11-17,1538,58334,18176,1325855,1384189,59.0,4073.0,45.0,3283.0,2.0,438.0,352.0,30.0,13.0,5,1287,1401,46133,4054,430374,476507,12/16/2020
2020-11-18,1136,59470,16044,1341899,1401369,38.0,4111.0,38.0,3321.0,5.0,443.0,347.0,29.0,15.0,7,1294,1020,47153,3146,433520,480673,12/16/2020
2020-11-19,1128,60598,13170,1355069,1415667,46.0,4157.0,42.0,3363.0,4.0,447.0,347.0,30.0,18.0,5,1299,1032,48185,3352,436872,485057,12/16/2020
2020-11-20,1457,62055,22226,1377295,1439350,49.0,4206.0,48.0,3411.0,3.0,450.0,345.0,33.0,14.0,6,1305,1294,49479,4255,441127,490606,12/16/2020
2020-11-21,854,62909,17370,1394665,1457574,43.0,4249.0,34.0,3445.0,5.0,455.0,349.0,35.0,14.0,7,1312,756,50235,3093,444220,494455,12/16/2020
2020-11-22,571,63480,7519,1402184,1465664,65.0,4314.0,28.0,3473.0,4.0,459.0,382.0,33.0,15.0,11,1323,486,50721,1766,445986,496707,12/16/2020
2020-11-23,994,64474,11029,1413213,1477687,75.0,4389.0,40.0,3513.0,0.0,459.0,417.0,40.0,18.0,10,1333,893,51614,3359,449345,500959,12/16/2020
2020-11-24,1050,65524,14579,1427792,1493316,47.0,4436.0,60.0,3573.0,6.0,465.0,398.0,42.0,22.0,10,1343,940,52554,2734,452079,504633,12/16/2020
2020-11-25,1266,66790,18790,1446582,1513372,59.0,4495.0,58.0,3631.0,4.0,469.0,395.0,43.0,26.0,7,1350,1178,53732,3506,455585,509317,12/16/2020
2020-11-26,547,67337,6482,1453064,1520401,51.0,4546.0,35.0,3666.0,4.0,473.0,407.0,46.0,25.0,12,1362,467,54199,1553,457138,511337,12/16/2020
2020-11-27,1044,68381,9724,1462788,1531169,55.0,4601.0,49.0,3715.0,7.0,480.0,406.0,48.0,22.0,6,1368,969,55168,2497,459635,514803,12/16/2020
2020-11-28,1182,69563,11960,1474748,1544311,64.0,4665.0,40.0,3755.0,0.0,480.0,430.0,48.0,22.0,3,1371,1097,56265,2778,462413,518678,12/16/2020
2020-11-29,822,70385,6935,1481683,1552068,62.0,4727.0,36.0,3791.0,3.0,483.0,453.0,49.0,24.0,8,1379,753,57018,2291,464704,521722,12/16/2020
2020-11-30,1283,71668,9925,1491608,1563276,67.0,4794.0,60.0,3851.0,2.0,485.0,458.0,52.0,30.0,6,1385,1159,58177,2782,467486,525663,12/16/2020
2020-12-01,1555,73223,13949,1505557,1578780,61.0,4855.0,55.0,3906.0,4.0,489.0,460.0,51.0,31.0,12,1397,1421,59598,3349,470835,530433,12/16/2020
2020-12-02,1561,74784,15557,1521114,1595898,56.0,4911.0,53.0,3959.0,7.0,496.0,456.0,52.0,30.0,14,1411,1424,61022,3230,474065,535087,12/16/2020
2020-12-03,1772,76556,14624,1535738,1612294,63.0,4974.0,76.0,4035.0,5.0,501.0,438.0,48.0,31.0,10,1421,1639,62661,3300,477365,540026,12/16/2020
2020-12-04,1647,78203,16506,1552244,1630447,68.0,5042.0,50.0,4085.0,7.0,508.0,449.0,44.0,30.0,11,1432,1519,64180,3762,481127,545307,12/16/2020
2020-12-05,1200,79403,12609,1564853,1644256,71.0,5113.0,42.0,4127.0,4.0,512.0,474.0,46.0,29.0,11,1443,1067,65247,2876,484003,549250,12/16/2020
2020-12-06,1125,80528,7842,1572695,1653223,64.0,5177.0,50.0,4177.0,10.0,522.0,478.0,48.0,25.0,14,1457,981,66228,2468,486471,552699,12/16/2020
2020-12-07,1391,81919,10627,1583322,1665241,74.0,5251.0,58.0,4235.0,6.0,528.0,488.0,45.0,25.0,19,1476,1252,67480,3298,489769,557249,12/16/2020
2020-12-08,1463,83382,15284,1598606,1681988,57.0,5308.0,57.0,4292.0,5.0,533.0,483.0,48.0,27.0,17,1493,1317,68797,3545,493314,562111,12/16/2020
2020-12-09,1499,84881,16351,1614957,1699838,55.0,5363.0,62.0,4354.0,9.0,542.0,467.0,46.0,29.0,12,1505,1343,70140,3226,496540,566680,12/16/2020
2020-12-10,1474,86355,17191,1632148,1718503,60.0,5423.0,58.0,4412.0,6.0,548.0,463.0,54.0,29.0,15,1520,1257,71397,4054,500594,571991,12/16/2020
2020-12-11,1469,87824,17305,1649453,1737277,73.0,5496.0,82.0,4494.0,7.0,555.0,447.0,59.0,32.0,13,1533,1276,72673,3605,504199,576872,12/16/2020
2020-12-12,1096,88920,13041,1662494,1751414,64.0,5560.0,53.0,4547.0,9.0,564.0,449.0,51.0,32.0,14,1547,915,73588,3117,507316,580904,12/16/2020
2020-12-13,674,89594,7130,1669624,1759218,70.0,5630.0,38.0,4585.0,12.0,576.0,469.0,53.0,29.0,22,1569,562,74150,2014,509330,583480,12/16/2020
2020-12-14,1298,90892,11099,1680723,1771615,70.0,5700.0,61.0,4646.0,9.0,585.0,469.0,62.0,30.0,11,1580,1106,75256,3367,512697,587953,12/16/2020
2020-12-15,1144,92036,13904,1694627,1786663,,,,,,,,,,10,1590,953,76209,2792,515489,591698,12/16/2020
2020-02-27,0,0,0,0,0,1.0,1.0,0.0,0.0,0.0,0.0,1.0,0.0,0.0,0,0,0,0,0,0,0,12/17/2020
2020-02-28,0,0,0,0,0,0.0,1.0,0.0,0.0,0.0,0.0,1.0,1.0,0.0,0,0,0,0,0,0,0,12/17/2020
2020-02-29,0,0,0,0,0,0.0,1.0,0.0,0.0,0.0,0.0,1.0,1.0,0.0,0,0,0,0,0,0,0,12/17/2020
2020-03-01,2,2,2,2,4,0.0,1.0,0.0,0.0,0.0,0.0,1.0,1.0,1.0,0,0,2,2,2,2,4,12/17/2020
2020-03-02,0,2,1,3,5,1.0,2.0,0.0,0.0,0.0,0.0,2.0,2.0,2.0,0,0,0,2,0,2,4,12/17/2020
2020-03-03,0,2,2,5,7,0.0,2.0,0.0,0.0,0.0,0.0,2.0,2.0,2.0,0,0,0,2,1,3,5,12/17/2020
2020-03-04,0,2,12,17,19,1.0,3.0,0.0,0.0,0.0,0.0,3.0,2.0,2.0,0,0,0,2,10,13,15,12/17/2020
2020-03-05,0,2,4,21,23,0.0,3.0,0.0,0.0,0.0,0.0,3.0,2.0,2.0,0,0,1,3,4,17,20,12/17/2020
2020-03-06,1,3,12,33,36,0.0,3.0,0.0,0.0,0.0,0.0,3.0,2.0,2.0,0,0,0,3,11,28,31,12/17/2020
2020-03-07,0,3,19,52,55,0.0,3.0,0.0,0.0,0.0,0.0,3.0,2.0,1.0,0,0,0,3,19,47,50,12/17/2020
2020-03-08,0,3,18,70,73,0.0,3.0,0.0,0.0,0.0,0.0,3.0,2.0,1.0,0,0,0,3,18,65,68,12/17/2020
2020-03-09,1,4,15,85,89,0.0,3.0,0.0,0.0,0.0,0.0,3.0,2.0,1.0,0,0,1,4,14,79,83,12/17/2020
2020-03-10,2,6,25,110,116,0.0,3.0,0.0,0.0,0.0,0.0,3.0,2.0,1.0,0,0,1,5,23,102,107,12/17/2020
2020-03-11,0,6,34,144,150,1.0,4.0,0.0,0.0,0.0,0.0,4.0,1.0,1.0,0,0,0,5,34,136,141,12/17/2020
2020-03-12,9,15,41,185,200,1.0,5.0,0.0,0.0,0.0,0.0,5.0,1.0,1.0,0,0,7,12,38,174,186,12/17/2020
2020-03-13,6,21,50,235,256,4.0,9.0,1.0,1.0,0.0,0.0,8.0,1.0,1.0,0,0,6,18,47,221,239,12/17/2020
2020-03-14,0,21,90,325,346,0.0,9.0,0.0,1.0,0.0,0.0,8.0,1.0,1.0,0,0,0,18,83,304,322,12/17/2020
2020-03-15,1,22,54,379,401,1.0,10.0,0.0,1.0,0.0,0.0,9.0,2.0,1.0,0,0,1,19,53,357,376,12/17/2020
2020-03-16,2,24,95,474,498,2.0,12.0,0.0,1.0,0.0,0.0,11.0,2.0,0.0,0,0,2,21,89,446,467,12/17/2020
2020-03-17,12,36,162,636,672,6.0,18.0,0.0,1.0,0.0,0.0,17.0,2.0,0.0,0,0,11,32,141,587,619,12/17/2020
2020-03-18,9,45,116,752,797,3.0,21.0,0.0,1.0,0.0,0.0,20.0,2.0,0.0,0,0,11,43,104,691,734,12/17/2020
2020-03-19,15,60,262,1014,1074,2.0,23.0,1.0,2.0,0.0,0.0,21.0,3.0,0.0,1,1,17,60,245,936,996,12/17/2020
2020-03-20,13,73,197,1211,1284,5.0,28.0,0.0,2.0,0.0,0.0,26.0,4.0,0.0,0,1,13,73,182,1118,1191,12/17/2020
2020-03-21,12,85,126,1337,1422,3.0,31.0,2.0,4.0,0.0,0.0,27.0,5.0,0.0,0,1,14,87,117,1235,1322,12/17/2020
2020-03-22,27,112,282,1619,1731,2.0,33.0,0.0,4.0,0.0,0.0,29.0,5.0,0.0,0,1,25,112,250,1485,1597,12/17/2020
2020-03-23,14,126,169,1788,1914,15.0,48.0,1.0,5.0,0.0,0.0,43.0,9.0,3.0,0,1,16,128,157,1642,1770,12/17/2020
2020-03-24,20,146,242,2030,2176,8.0,56.0,0.0,5.0,0.0,0.0,51.0,10.0,5.0,0,1,19,147,220,1862,2009,12/17/2020
2020-03-25,26,172,182,2212,2384,5.0,61.0,2.0,7.0,0.0,0.0,54.0,11.0,3.0,0,1,28,175,158,2020,2195,12/17/2020
2020-03-26,35,207,181,2393,2600,9.0,70.0,5.0,12.0,0.0,0.0,58.0,14.0,5.0,0,1,41,216,163,2183,2399,12/17/2020
2020-03-27,27,234,214,2607,2841,9.0,79.0,1.0,13.0,1.0,1.0,65.0,16.0,6.0,2,3,31,247,186,2369,2616,12/17/2020
2020-03-28,59,293,260,2867,3160,11.0,90.0,2.0,15.0,1.0,2.0,73.0,15.0,6.0,1,4,64,311,232,2601,2912,12/17/2020
2020-03-29,100,393,350,3217,3610,8.0,98.0,3.0,18.0,1.0,3.0,77.0,18.0,8.0,2,6,105,416,291,2892,3308,12/17/2020
2020-03-30,62,455,222,3439,3894,19.0,117.0,5.0,23.0,0.0,3.0,91.0,19.0,11.0,3,9,78,494,171,3063,3557,12/17/2020
2020-03-31,71,526,369,3808,4334,11.0,128.0,7.0,30.0,1.0,4.0,94.0,21.0,13.0,2,11,73,567,285,3348,3915,12/17/2020
2020-04-01,99,625,698,4506,5131,18.0,146.0,7.0,37.0,0.0,4.0,105.0,29.0,15.0,1,12,100,667,593,3941,4608,12/17/2020
2020-04-02,52,677,477,4983,5660,22.0,168.0,6.0,43.0,2.0,6.0,119.0,35.0,21.0,4,16,62,729,409,4350,5079,12/17/2020
2020-04-03,108,785,774,5757,6542,23.0,191.0,7.0,50.0,0.0,6.0,135.0,42.0,25.0,3,19,100,829,664,5014,5843,12/17/2020
2020-04-04,143,928,660,6417,7345,22.0,213.0,4.0,54.0,5.0,11.0,148.0,40.0,29.0,9,28,138,967,577,5591,6558,12/17/2020
2020-04-05,187,1115,1156,7573,8688,20.0,233.0,9.0,63.0,1.0,12.0,158.0,43.0,35.0,2,30,181,1148,979,6570,7718,12/17/2020
2020-04-06,218,1333,1706,9279,10612,26.0,259.0,7.0,70.0,0.0,12.0,177.0,47.0,39.0,7,37,207,1355,1452,8022,9377,12/17/2020
2020-04-07,284,1617,1629,10908,12525,20.0,279.0,4.0,74.0,2.0,14.0,191.0,49.0,41.0,5,42,260,1615,1388,9410,11025,12/17/2020
2020-04-08,290,1907,1720,12628,14535,19.0,298.0,8.0,82.0,5.0,19.0,197.0,49.0,37.0,10,52,271,1886,1457,10867,12753,12/17/2020
2020-04-09,283,2190,1516,14144,16334,32.0,330.0,8.0,90.0,4.0,23.0,217.0,53.0,40.0,7,59,277,2163,1267,12134,14297,12/17/2020
2020-04-10,419,2609,2574,16718,19327,29.0,359.0,17.0,107.0,5.0,28.0,224.0,59.0,41.0,11,70,400,2563,2220,14354,16917,12/17/2020
2020-04-11,298,2907,1905,18623,21530,29.0,388.0,11.0,118.0,2.0,30.0,240.0,61.0,48.0,12,82,280,2843,1620,15974,18817,12/17/2020
2020-04-12,314,3221,1670,20293,23514,35.0,423.0,13.0,131.0,5.0,35.0,257.0,59.0,49.0,9,91,286,3129,1303,17277,20406,12/17/2020
2020-04-13,161,3382,935,21228,24610,35.0,458.0,13.0,144.0,3.0,38.0,276.0,64.0,54.0,9,100,187,3316,786,18063,21379,12/17/2020
2020-04-14,290,3672,1787,23015,26687,27.0,485.0,18.0,162.0,5.0,43.0,280.0,72.0,53.0,8,108,261,3577,1417,19480,23057,12/17/2020
2020-04-15,350,4022,1799,24814,28836,31.0,516.0,20.0,182.0,3.0,46.0,288.0,72.0,54.0,17,125,306,3883,1415,20895,24778,12/17/2020
2020-04-16,447,4469,2494,27308,31777,36.0,552.0,25.0,207.0,6.0,52.0,293.0,72.0,53.0,14,139,387,4270,1905,22800,27070,12/17/2020
2020-04-17,304,4773,1821,29129,33902,32.0,584.0,20.0,227.0,7.0,59.0,298.0,66.0,45.0,21,160,290,4560,1322,24122,28682,12/17/2020
2020-04-18,321,5094,1725,30854,35948,26.0,610.0,18.0,245.0,4.0,63.0,302.0,63.0,49.0,15,175,284,4844,1234,25356,30200,12/17/2020
2020-04-19,381,5475,2047,32901,38376,23.0,633.0,26.0,271.0,1.0,64.0,298.0,65.0,55.0,11,186,337,5181,1634,26990,32171,12/17/2020
2020-04-20,394,5869,1907,34808,40677,46.0,679.0,29.0,300.0,2.0,66.0,313.0,75.0,56.0,10,196,376,5557,1467,28457,34014,12/17/2020
2020-04-21,444,6313,2110,36918,43231,45.0,724.0,32.0,332.0,5.0,71.0,321.0,72.0,56.0,18,214,383,5940,1599,30056,35996,12/17/2020
2020-04-22,418,6731,2390,39308,46039,41.0,765.0,32.0,364.0,5.0,76.0,325.0,73.0,58.0,18,232,379,6319,1766,31822,38141,12/17/2020
2020-04-23,479,7210,2469,41777,48987,32.0,797.0,28.0,392.0,5.0,81.0,324.0,76.0,62.0,15,247,412,6731,1720,33542,40273,12/17/2020
2020-04-24,491,7701,3284,45061,52762,35.0,832.0,26.0,418.0,4.0,85.0,329.0,85.0,63.0,15,262,407,7138,2360,35902,43040,12/17/2020
2020-04-25,393,8094,2206,47267,55361,34.0,866.0,17.0,435.0,5.0,90.0,341.0,85.0,62.0,14,276,299,7437,1594,37496,44933,12/17/2020
2020-04-26,316,8410,2309,49576,57986,33.0,899.0,15.0,450.0,3.0,93.0,356.0,86.0,59.0,14,290,274,7711,1718,39214,46925,12/17/2020
2020-04-27,249,8659,1620,51196,59855,29.0,928.0,21.0,471.0,4.0,97.0,360.0,86.0,61.0,10,300,206,7917,1071,40285,48202,12/17/2020
2020-04-28,410,9069,2263,53459,62528,44.0,972.0,24.0,495.0,3.0,100.0,377.0,88.0,59.0,22,322,331,8248,1541,41826,50074,12/17/2020
2020-04-29,476,9545,3343,56802,66347,36.0,1008.0,38.0,533.0,11.0,111.0,364.0,78.0,53.0,18,340,371,8619,2180,44006,52625,12/17/2020
2020-04-30,432,9977,2769,59571,69548,33.0,1041.0,38.0,571.0,6.0,117.0,353.0,83.0,57.0,24,364,351,8970,1722,45728,54698,12/17/2020
2020-05-01,454,10431,3086,62657,73088,52.0,1093.0,39.0,610.0,3.0,120.0,363.0,84.0,58.0,14,378,323,9293,1932,47660,56953,12/17/2020
2020-05-02,257,10688,1926,64583,75271,36.0,1129.0,38.0,648.0,5.0,125.0,356.0,93.0,63.0,24,402,193,9486,1176,48836,58322,12/17/2020
2020-05-03,283,10971,2160,66743,77714,31.0,1160.0,26.0,674.0,8.0,133.0,353.0,91.0,61.0,21,423,183,9669,1422,50258,59927,12/17/2020
2020-05-04,387,11358,2098,68841,80199,30.0,1190.0,31.0,705.0,6.0,139.0,346.0,89.0,58.0,18,441,290,9959,1453,51711,61670,12/17/2020
2020-05-05,433,11791,2873,71714,83505,29.0,1219.0,32.0,737.0,6.0,145.0,337.0,83.0,55.0,16,457,299,10258,1828,53539,63797,12/17/2020
2020-05-06,488,12279,2830,74544,86823,28.0,1247.0,44.0,781.0,9.0,154.0,312.0,80.0,55.0,21,478,340,10598,1787,55326,65924,12/17/2020
2020-05-07,425,12704,2969,77513,90217,36.0,1283.0,44.0,825.0,5.0,159.0,299.0,72.0,53.0,21,499,270,10868,1797,57123,67991,12/17/2020
2020-05-08,359,13063,2598,80111,93174,30.0,1313.0,29.0,854.0,5.0,164.0,295.0,72.0,54.0,22,521,230,11098,1551,58674,69772,12/17/2020
2020-05-09,467,13530,3346,83457,96987,22.0,1335.0,21.0,875.0,4.0,168.0,292.0,70.0,52.0,15,536,288,11386,2086,60760,72146,12/17/2020
2020-05-10,285,13815,2117,85574,99389,20.0,1355.0,23.0,898.0,6.0,174.0,283.0,71.0,50.0,14,550,190,11576,1401,62161,73737,12/17/2020
2020-05-11,257,14072,1857,87431,101503,31.0,1386.0,16.0,914.0,6.0,180.0,292.0,72.0,50.0,15,565,173,11749,1217,63378,75127,12/17/2020
2020-05-12,387,14459,2611,90042,104501,23.0,1409.0,18.0,932.0,4.0,184.0,293.0,70.0,49.0,22,587,224,11973,1525,64903,76876,12/17/2020
2020-05-13,351,14810,3630,93672,108482,23.0,1432.0,25.0,957.0,1.0,185.0,290.0,70.0,50.0,13,600,199,12172,1820,66723,78895,12/17/2020
2020-05-14,329,15139,3408,97080,112219,19.0,1451.0,27.0,984.0,3.0,188.0,279.0,65.0,46.0,15,615,232,12404,1850,68573,80977,12/17/2020
2020-05-15,381,15520,3458,100538,116058,24.0,1475.0,41.0,1025.0,5.0,193.0,257.0,63.0,46.0,14,629,232,12636,1695,70268,82904,12/17/2020
2020-05-16,449,15969,4156,104694,120663,25.0,1500.0,15.0,1040.0,5.0,198.0,262.0,62.0,47.0,15,644,247,12883,1812,72080,84963,12/17/2020
2020-05-17,240,16209,2768,107462,123671,17.0,1517.0,9.0,1049.0,5.0,203.0,265.0,60.0,46.0,10,654,126,13009,1429,73509,86518,12/17/2020
2020-05-18,250,16459,2001,109463,125922,19.0,1536.0,16.0,1065.0,5.0,208.0,263.0,58.0,41.0,18,672,135,13144,1297,74806,87950,12/17/2020
2020-05-19,415,16874,3168,112631,129505,23.0,1559.0,33.0,1098.0,5.0,213.0,248.0,57.0,39.0,11,683,215,13359,1813,76619,89978,12/17/2020
2020-05-20,326,17200,2771,115402,132602,19.0,1578.0,23.0,1121.0,7.0,220.0,237.0,53.0,34.0,22,705,183,13542,1432,78051,91593,12/17/2020
2020-05-21,374,17574,3757,119159,136733,25.0,1603.0,15.0,1136.0,3.0,223.0,244.0,54.0,30.0,20,725,168,13710,1835,79886,93596,12/17/2020
2020-05-22,351,17925,3161,122320,140245,20.0,1623.0,28.0,1164.0,5.0,228.0,231.0,53.0,30.0,11,736,206,13916,1498,81384,95300,12/17/2020
2020-05-23,253,18178,2742,125062,143240,19.0,1642.0,11.0,1175.0,3.0,231.0,236.0,53.0,33.0,13,749,109,14025,1204,82588,96613,12/17/2020
2020-05-24,163,18341,1370,126432,144773,13.0,1655.0,14.0,1189.0,2.0,233.0,233.0,54.0,36.0,8,757,83,14108,733,83321,97429,12/17/2020
2020-05-25,147,18488,1385,127817,146305,14.0,1669.0,14.0,1203.0,0.0,233.0,233.0,54.0,34.0,10,767,76,14184,685,84006,98190,12/17/2020
2020-05-26,285,18773,2620,130437,149210,24.0,1693.0,21.0,1224.0,5.0,238.0,231.0,49.0,33.0,15,782,158,14342,1553,85559,99901,12/17/2020
2020-05-27,276,19049,2057,132494,151543,20.0,1713.0,18.0,1242.0,3.0,241.0,230.0,51.0,33.0,10,792,132,14474,1082,86641,101115,12/17/2020
2020-05-28,348,19397,3359,135853,155250,17.0,1730.0,29.0,1271.0,4.0,245.0,214.0,47.0,32.0,8,800,130,14604,1043,87684,102288,12/17/2020
2020-05-29,410,19807,3915,139768,159575,19.0,1749.0,26.0,1297.0,7.0,252.0,200.0,43.0,31.0,12,812,174,14778,1466,89150,103928,12/17/2020
2020-05-30,225,20032,3915,143683,163715,16.0,1765.0,19.0,1316.0,4.0,256.0,193.0,41.0,29.0,12,824,109,14887,1632,90782,105669,12/17/2020
2020-05-31,155,20187,1690,145373,165560,11.0,1776.0,11.0,1327.0,1.0,257.0,192.0,44.0,26.0,3,827,78,14965,783,91565,106530,12/17/2020
2020-06-01,212,20399,2792,148165,168564,8.0,1784.0,14.0,1341.0,1.0,258.0,185.0,45.0,29.0,5,832,93,15058,1311,92876,107934,12/17/2020
2020-06-02,273,20672,3022,151187,171859,8.0,1792.0,9.0,1350.0,3.0,261.0,181.0,38.0,25.0,10,842,98,15156,1354,94230,109386,12/17/2020
2020-06-03,254,20926,3486,154673,175599,14.0,1806.0,18.0,1368.0,6.0,267.0,171.0,34.0,25.0,11,853,99,15255,1566,95796,111051,12/17/2020
2020-06-04,276,21202,4471,159144,180346,7.0,1813.0,26.0,1394.0,4.0,271.0,148.0,31.0,24.0,12,865,107,15362,1899,97695,113057,12/17/2020
2020-06-05,215,21417,3513,162657,184074,15.0,1828.0,13.0,1407.0,6.0,277.0,144.0,27.0,21.0,11,876,99,15461,1446,99141,114602,12/17/2020
2020-06-06,201,21618,2616,165273,186891,10.0,1838.0,7.0,1414.0,2.0,279.0,145.0,29.0,19.0,6,882,67,15528,1060,100201,115729,12/17/2020
2020-06-07,83,21701,1625,166898,188599,11.0,1849.0,7.0,1421.0,1.0,280.0,148.0,25.0,17.0,4,886,51,15579,760,100961,116540,12/17/2020
2020-06-08,119,21820,1849,168747,190567,15.0,1864.0,13.0,1434.0,2.0,282.0,148.0,27.0,18.0,4,890,45,15624,905,101866,117490,12/17/2020
2020-06-09,223,22043,2673,171420,193463,10.0,1874.0,19.0,1453.0,0.0,282.0,139.0,28.0,21.0,1,891,64,15688,1196,103062,118750,12/17/2020
2020-06-10,209,22252,2987,174407,196659,13.0,1887.0,12.0,1465.0,2.0,284.0,138.0,24.0,17.0,4,895,100,15788,1400,104462,120250,12/17/2020
2020-06-11,195,22447,3513,177920,200367,7.0,1894.0,15.0,1480.0,1.0,285.0,129.0,25.0,16.0,6,901,88,15876,1448,105910,121786,12/17/2020
2020-06-12,209,22656,4601,182521,205177,9.0,1903.0,16.0,1496.0,1.0,286.0,121.0,24.0,16.0,2,903,78,15954,1982,107892,123846,12/17/2020
2020-06-13,113,22769,3036,185557,208326,6.0,1909.0,5.0,1501.0,0.0,286.0,122.0,20.0,15.0,3,906,49,16003,1257,109149,125152,12/17/2020
2020-06-14,81,22850,2046,187603,210453,7.0,1916.0,8.0,1509.0,1.0,287.0,120.0,20.0,14.0,3,909,33,16036,924,110073,126109,12/17/2020
2020-06-15,188,23038,3108,190711,213749,14.0,1930.0,19.0,1528.0,0.0,287.0,115.0,20.0,16.0,5,914,75,16111,1701,111774,127885,12/17/2020
2020-06-16,110,23148,3017,193728,216876,11.0,1941.0,9.0,1537.0,1.0,288.0,116.0,22.0,16.0,8,922,50,16161,1464,113238,129399,12/17/2020
2020-06-17,127,23275,2835,196563,219838,15.0,1956.0,20.0,1557.0,4.0,292.0,107.0,18.0,14.0,6,928,51,16212,1255,114493,130705,12/17/2020
2020-06-18,149,23424,3049,199612,223036,9.0,1965.0,15.0,1572.0,1.0,293.0,100.0,19.0,16.0,7,935,70,16282,1250,115743,132025,12/17/2020
2020-06-19,141,23565,3769,203381,226946,12.0,1977.0,12.0,1584.0,1.0,294.0,99.0,20.0,17.0,3,938,59,16341,1302,117045,133386,12/17/2020
2020-06-20,84,23649,1891,205272,228921,9.0,1986.0,12.0,1596.0,0.0,294.0,96.0,20.0,18.0,4,942,36,16377,777,117822,134199,12/17/2020
2020-06-21,37,23686,1064,206336,230022,8.0,1994.0,5.0,1601.0,0.0,294.0,99.0,20.0,18.0,2,944,30,16407,654,118476,134883,12/17/2020
2020-06-22,138,23824,3730,210066,233890,12.0,2006.0,17.0,1618.0,0.0,294.0,94.0,19.0,18.0,2,946,65,16472,1629,120105,136577,12/17/2020
2020-06-23,163,23987,3830,213896,237883,3.0,2009.0,13.0,1631.0,3.0,297.0,81.0,18.0,18.0,7,953,81,16553,1706,121811,138364,12/17/2020
2020-06-24,120,24107,3502,217398,241505,9.0,2018.0,10.0,1641.0,1.0,298.0,79.0,18.0,18.0,5,958,45,16598,1597,123408,140006,12/17/2020
2020-06-25,103,24210,2883,220281,244491,6.0,2024.0,14.0,1655.0,1.0,299.0,70.0,17.0,17.0,1,959,51,16649,1428,124836,141485,12/17/2020
2020-06-26,94,24304,2488,222769,247073,2.0,2026.0,10.0,1665.0,0.0,299.0,62.0,18.0,18.0,1,960,60,16709,1267,126103,142812,12/17/2020
2020-06-27,84,24388,3216,225985,250373,5.0,2031.0,3.0,1668.0,1.0,300.0,63.0,17.0,17.0,5,965,37,16746,1158,127261,144007,12/17/2020
2020-06-28,39,24427,1469,227454,251881,4.0,2035.0,4.0,1672.0,4.0,304.0,59.0,15.0,14.0,6,971,17,16763,573,127834,144597,12/17/2020
2020-06-29,85,24512,3697,231151,255663,4.0,2039.0,5.0,1677.0,0.0,304.0,58.0,14.0,14.0,1,972,39,16802,1297,129131,145933,12/17/2020
2020-06-30,57,24569,1958,233109,257678,1.0,2040.0,5.0,1682.0,1.0,305.0,53.0,12.0,11.0,4,976,32,16834,955,130086,146920,12/17/2020
2020-07-01,144,24713,4098,237207,261920,8.0,2048.0,10.0,1692.0,0.0,305.0,51.0,11.0,11.0,1,977,79,16913,1849,131935,148848,12/17/2020
2020-07-02,103,24816,2803,240010,264826,5.0,2053.0,5.0,1697.0,1.0,306.0,50.0,10.0,10.0,3,980,59,16972,1034,132969,149941,12/17/2020
2020-07-03,50,24866,2079,242089,266955,9.0,2062.0,6.0,1703.0,0.0,306.0,53.0,9.0,9.0,3,983,24,16996,750,133719,150715,12/17/2020
2020-07-04,57,24923,2345,244434,269357,2.0,2064.0,4.0,1707.0,1.0,307.0,50.0,10.0,9.0,2,985,33,17029,964,134683,151712,12/17/2020
2020-07-05,49,24972,2932,247366,272338,1.0,2065.0,2.0,1709.0,1.0,308.0,48.0,8.0,8.0,2,987,26,17055,1360,136043,153098,12/17/2020
2020-07-06,101,25073,2814,250180,275253,6.0,2071.0,6.0,1715.0,0.0,308.0,48.0,9.0,9.0,4,991,57,17112,1497,137540,154652,12/17/2020
2020-07-07,81,25154,3457,253637,278791,5.0,2076.0,7.0,1722.0,0.0,308.0,46.0,8.0,8.0,2,993,47,17159,1481,139021,156180,12/17/2020
2020-07-08,105,25259,3409,257046,282305,4.0,2080.0,2.0,1724.0,0.0,308.0,48.0,9.0,8.0,0,993,64,17223,1349,140370,157593,12/17/2020
2020-07-09,94,25353,3714,260760,286113,9.0,2089.0,3.0,1727.0,0.0,308.0,54.0,9.0,8.0,0,993,50,17273,1551,141921,159194,12/17/2020
2020-07-10,132,25485,4437,265197,290682,6.0,2095.0,3.0,1730.0,2.0,310.0,55.0,7.0,7.0,3,996,80,17353,1987,143908,161261,12/17/2020
2020-07-11,63,25548,2938,268135,293683,6.0,2101.0,3.0,1733.0,1.0,311.0,57.0,6.0,6.0,3,999,36,17389,1262,145170,162559,12/17/2020
2020-07-12,47,25595,1838,269973,295568,1.0,2102.0,3.0,1736.0,1.0,312.0,54.0,6.0,5.0,3,1002,34,17423,908,146078,163501,12/17/2020
2020-07-13,84,25679,3209,273182,298861,8.0,2110.0,10.0,1746.0,0.0,312.0,52.0,6.0,5.0,1,1003,61,17484,1444,147522,165006,12/17/2020
2020-07-14,74,25753,3298,276480,302233,7.0,2117.0,4.0,1750.0,0.0,312.0,55.0,5.0,5.0,1,1004,44,17528,1331,148853,166381,12/17/2020
2020-07-15,130,25883,4181,280661,306544,5.0,2122.0,7.0,1757.0,0.0,312.0,53.0,5.0,4.0,0,1004,100,17628,1679,150532,168160,12/17/2020
2020-07-16,103,25986,3740,284401,310387,6.0,2128.0,9.0,1766.0,0.0,312.0,50.0,6.0,5.0,1,1005,76,17704,1537,152069,169773,12/17/2020
2020-07-17,156,26142,4239,288640,314782,14.0,2142.0,3.0,1769.0,1.0,313.0,60.0,5.0,5.0,2,1007,79,17783,1773,153842,171625,12/17/2020
2020-07-18,85,26227,3272,291912,318139,5.0,2147.0,9.0,1778.0,1.0,314.0,55.0,5.0,4.0,4,1011,70,17853,1341,155183,173036,12/17/2020
2020-07-19,82,26309,2696,294608,320917,7.0,2154.0,3.0,1781.0,0.0,314.0,59.0,6.0,4.0,2,1013,57,17910,1093,156276,174186,12/17/2020
2020-07-20,71,26380,2666,297274,323654,9.0,2163.0,7.0,1788.0,0.0,314.0,61.0,7.0,5.0,2,1015,68,17978,1396,157672,175650,12/17/2020
2020-07-21,130,26510,4304,301578,328088,9.0,2172.0,11.0,1799.0,0.0,314.0,59.0,9.0,6.0,1,1016,108,18086,1843,159515,177601,12/17/2020
2020-07-22,130,26640,3928,305506,332146,7.0,2179.0,8.0,1807.0,1.0,315.0,57.0,7.0,6.0,1,1017,86,18172,1598,161113,179285,12/17/2020
2020-07-23,141,26781,4415,309921,336702,8.0,2187.0,6.0,1813.0,0.0,315.0,59.0,8.0,7.0,0,1017,115,18287,1893,163006,181293,12/17/2020
2020-07-24,172,26953,5966,315887,342840,15.0,2202.0,12.0,1825.0,0.0,315.0,62.0,9.0,7.0,0,1017,119,18406,2222,165228,183634,12/17/2020
2020-07-25,134,27087,4398,320285,347372,7.0,2209.0,7.0,1832.0,0.0,315.0,62.0,10.0,8.0,3,1020,108,18514,2023,167251,185765,12/17/2020
2020-07-26,62,27149,3033,323318,350467,8.0,2217.0,9.0,1841.0,0.0,315.0,61.0,11.0,7.0,1,1021,54,18568,1287,168538,187106,12/17/2020
2020-07-27,188,27337,4191,327509,354846,12.0,2229.0,7.0,1848.0,0.0,315.0,66.0,13.0,8.0,1,1022,138,18706,2242,170780,189486,12/17/2020
2020-07-28,105,27442,3840,331349,358791,5.0,2234.0,5.0,1853.0,0.0,315.0,66.0,14.0,7.0,1,1023,95,18801,1574,172354,191155,12/17/2020
2020-07-29,190,27632,5139,336488,364120,9.0,2243.0,10.0,1863.0,0.0,315.0,65.0,15.0,7.0,0,1023,154,18955,2213,174567,193522,12/17/2020
2020-07-30,121,27753,4345,340833,368586,6.0,2249.0,2.0,1865.0,1.0,316.0,68.0,15.0,6.0,1,1024,96,19051,1561,176128,195179,12/17/2020
2020-07-31,131,27884,5512,346345,374229,7.0,2256.0,9.0,1874.0,0.0,316.0,66.0,15.0,7.0,1,1025,89,19140,1766,177894,197034,12/17/2020
2020-08-01,109,27993,4294,350639,378632,7.0,2263.0,2.0,1876.0,0.0,316.0,71.0,14.0,7.0,1,1026,89,19229,1491,179385,198614,12/17/2020
2020-08-02,84,28077,2804,353443,381520,12.0,2275.0,12.0,1888.0,2.0,318.0,69.0,14.0,8.0,2,1028,62,19291,1225,180610,199901,12/17/2020
2020-08-03,188,28265,5248,358691,386956,11.0,2286.0,10.0,1898.0,0.0,318.0,70.0,16.0,7.0,1,1029,150,19441,2117,182727,202168,12/17/2020
2020-08-04,125,28390,3691,362382,390772,8.0,2294.0,5.0,1903.0,1.0,319.0,72.0,12.0,5.0,2,1031,99,19540,1703,184430,203970,12/17/2020
2020-08-05,147,28537,5935,368317,396854,11.0,2305.0,9.0,1912.0,1.0,320.0,73.0,10.0,5.0,2,1033,119,19659,2365,186795,206454,12/17/2020
2020-08-06,169,28706,5546,373863,402569,7.0,2312.0,9.0,1921.0,0.0,320.0,71.0,9.0,4.0,0,1033,120,19779,2285,189080,208859,12/17/2020
2020-08-07,123,28829,4851,378714,407543,12.0,2324.0,9.0,1930.0,1.0,321.0,73.0,9.0,3.0,2,1035,87,19866,2051,191131,210997,12/17/2020
2020-08-08,123,28952,4112,382826,411778,19.0,2343.0,6.0,1936.0,1.0,322.0,85.0,8.0,3.0,1,1036,91,19957,1711,192842,212799,12/17/2020
2020-08-09,42,28994,1727,384553,413547,6.0,2349.0,8.0,1944.0,0.0,322.0,83.0,9.0,4.0,0,1036,35,19992,1018,193860,213852,12/17/2020
2020-08-10,149,29143,4587,389140,418283,8.0,2357.0,9.0,1953.0,0.0,322.0,82.0,9.0,4.0,1,1037,113,20105,1945,195805,215910,12/17/2020
2020-08-11,106,29249,4334,393474,422723,5.0,2362.0,13.0,1966.0,0.0,322.0,74.0,10.0,4.0,3,1040,92,20197,2186,197991,218188,12/17/2020
2020-08-12,121,29370,5188,398662,428032,8.0,2370.0,11.0,1977.0,0.0,322.0,71.0,9.0,3.0,1,1041,101,20298,2514,200505,220803,12/17/2020
2020-08-13,135,29505,4196,402858,432363,13.0,2383.0,12.0,1989.0,0.0,322.0,72.0,11.0,3.0,0,1041,95,20393,1830,202335,222728,12/17/2020
2020-08-14,145,29650,5498,408356,438006,13.0,2396.0,11.0,2000.0,0.0,322.0,74.0,11.0,4.0,3,1044,98,20491,1898,204233,224724,12/17/2020
2020-08-15,106,29756,4534,412890,442646,9.0,2405.0,11.0,2011.0,1.0,323.0,71.0,11.0,5.0,0,1044,88,20579,1623,205856,226435,12/17/2020
2020-08-16,83,29839,2477,415367,445206,6.0,2411.0,5.0,2016.0,4.0,327.0,68.0,8.0,4.0,6,1050,70,20649,920,206776,227425,12/17/2020
2020-08-17,106,29945,4575,419942,449887,8.0,2419.0,6.0,2022.0,0.0,327.0,70.0,8.0,5.0,2,1052,87,20736,2301,209077,229813,12/17/2020
2020-08-18,128,30073,4911,424853,454926,11.0,2430.0,8.0,2030.0,1.0,328.0,72.0,8.0,4.0,5,1057,94,20830,2659,211736,232566,12/17/2020
2020-08-19,113,30186,5077,429930,460116,8.0,2438.0,9.0,2039.0,1.0,329.0,70.0,9.0,5.0,0,1057,90,20920,2549,214285,235205,12/17/2020
2020-08-20,173,30359,7411,437341,467700,12.0,2450.0,6.0,2045.0,2.0,331.0,74.0,10.0,5.0,3,1060,139,21059,3398,217683,238742,12/17/2020
2020-08-21,152,30511,6577,443918,474429,8.0,2458.0,5.0,2050.0,1.0,332.0,76.0,9.0,4.0,2,1062,125,21184,2824,220507,241691,12/17/2020
2020-08-22,96,30607,5550,449468,480075,11.0,2469.0,12.0,2062.0,0.0,332.0,75.0,11.0,4.0,1,1063,84,21268,2504,223011,244279,12/17/2020
2020-08-23,72,30679,4375,453843,484522,11.0,2480.0,6.0,2068.0,0.0,332.0,80.0,12.0,2.0,1,1064,56,21324,2411,225422,246746,12/17/2020
2020-08-24,105,30784,5784,459627,490411,7.0,2487.0,10.0,2078.0,1.0,333.0,76.0,14.0,4.0,1,1065,77,21401,3053,228475,249876,12/17/2020
2020-08-25,108,30892,4764,464391,495283,10.0,2497.0,4.0,2082.0,1.0,334.0,81.0,12.0,4.0,1,1066,92,21493,2218,230693,252186,12/17/2020
2020-08-26,170,31062,9482,473873,504935,4.0,2501.0,8.0,2090.0,0.0,334.0,77.0,10.0,5.0,1,1067,127,21620,2985,233678,255298,12/17/2020
2020-08-27,91,31153,8565,482438,513591,6.0,2507.0,13.0,2103.0,1.0,335.0,69.0,7.0,5.0,2,1069,70,21690,3040,236718,258408,12/17/2020
2020-08-28,113,31266,7994,490432,521698,14.0,2521.0,4.0,2107.0,0.0,335.0,79.0,10.0,7.0,2,1071,87,21777,2338,239056,260833,12/17/2020
2020-08-29,65,31331,5374,495806,527137,6.0,2527.0,8.0,2115.0,1.0,336.0,76.0,11.0,6.0,2,1073,51,21828,1856,240912,262740,12/17/2020
2020-08-30,66,31397,4323,500129,531526,7.0,2534.0,4.0,2119.0,0.0,336.0,79.0,9.0,5.0,2,1075,48,21876,1932,242844,264720,12/17/2020
2020-08-31,105,31502,4863,504992,536494,12.0,2546.0,16.0,2135.0,0.0,336.0,75.0,8.0,4.0,1,1076,81,21957,2121,244965,266922,12/17/2020
2020-09-01,99,31601,7109,512101,543702,6.0,2552.0,9.0,2144.0,1.0,337.0,71.0,7.0,4.0,2,1078,66,22023,2303,247268,269291,12/17/2020
2020-09-02,125,31726,10529,522630,554356,9.0,2561.0,10.0,2154.0,1.0,338.0,69.0,8.0,4.0,2,1080,104,22127,2956,250224,272351,12/17/2020
2020-09-03,90,31816,11080,533710,565526,8.0,2569.0,8.0,2162.0,0.0,338.0,69.0,9.0,4.0,3,1083,73,22200,2488,252712,274912,12/17/2020
2020-09-04,103,31919,8963,542673,574592,11.0,2580.0,4.0,2166.0,0.0,338.0,76.0,9.0,4.0,1,1084,83,22283,2290,255002,277285,12/17/2020
2020-09-05,52,31971,6309,548982,580953,6.0,2586.0,9.0,2175.0,0.0,338.0,73.0,8.0,3.0,1,1085,42,22325,1548,256550,278875,12/17/2020
2020-09-06,88,32059,4325,553307,585366,4.0,2590.0,8.0,2183.0,1.0,339.0,68.0,6.0,3.0,1,1086,65,22390,1881,258431,280821,12/17/2020
2020-09-07,35,32094,3002,556309,588403,11.0,2601.0,3.0,2186.0,0.0,339.0,76.0,5.0,3.0,1,1087,26,22416,619,259050,281466,12/17/2020
2020-09-08,74,32168,6381,562690,594858,6.0,2607.0,12.0,2198.0,1.0,340.0,69.0,6.0,3.0,2,1089,66,22482,1533,260583,283065,12/17/2020
2020-09-09,118,32286,8650,571340,603626,10.0,2617.0,5.0,2203.0,1.0,341.0,73.0,9.0,3.0,1,1090,102,22584,2053,262636,285220,12/17/2020
2020-09-10,164,32450,11334,582674,615124,9.0,2626.0,8.0,2211.0,0.0,341.0,74.0,10.0,3.0,1,1091,111,22695,2180,264816,287511,12/17/2020
2020-09-11,120,32570,9454,592128,624698,11.0,2637.0,11.0,2222.0,0.0,341.0,74.0,10.0,5.0,0,1091,96,22791,1889,266705,289496,12/17/2020
2020-09-12,110,32680,6174,598302,630982,8.0,2645.0,5.0,2227.0,2.0,343.0,75.0,9.0,5.0,3,1094,97,22888,1460,268165,291053,12/17/2020
2020-09-13,58,32738,2717,601019,633757,4.0,2649.0,3.0,2230.0,0.0,343.0,76.0,10.0,5.0,0,1094,54,22942,825,268990,291932,12/17/2020
2020-09-14,104,32842,6446,607465,640307,6.0,2655.0,3.0,2233.0,2.0,345.0,77.0,10.0,5.0,2,1096,95,23037,1654,270644,293681,12/17/2020
2020-09-15,122,32964,8470,615935,648899,7.0,2662.0,2.0,2235.0,1.0,346.0,81.0,10.0,5.0,2,1098,124,23161,2118,272762,295923,12/17/2020
2020-09-16,137,33101,9716,625651,658752,7.0,2669.0,7.0,2242.0,2.0,348.0,79.0,9.0,6.0,5,1103,118,23279,1907,274669,297948,12/17/2020
2020-09-17,125,33226,9239,634890,668116,7.0,2676.0,15.0,2257.0,0.0,348.0,71.0,8.0,4.0,0,1103,154,23433,1877,276546,299979,12/17/2020
2020-09-18,132,33358,10045,644935,678293,7.0,2683.0,7.0,2264.0,1.0,349.0,70.0,11.0,6.0,2,1105,132,23565,1852,278398,301963,12/17/2020
2020-09-19,115,33473,8297,653232,686705,7.0,2690.0,3.0,2267.0,0.0,349.0,74.0,10.0,6.0,4,1109,112,23677,1642,280040,303717,12/17/2020
2020-09-20,60,33533,3676,656908,690441,7.0,2697.0,6.0,2273.0,2.0,351.0,73.0,9.0,8.0,4,1113,49,23726,1283,281323,305049,12/17/2020
2020-09-21,102,33635,7018,663926,697561,12.0,2709.0,3.0,2276.0,2.0,353.0,80.0,8.0,6.0,2,1115,94,23820,2335,283658,307478,12/17/2020
2020-09-22,154,33789,9287,673213,707002,12.0,2721.0,3.0,2279.0,1.0,354.0,88.0,7.0,5.0,1,1116,124,23944,2119,285777,309721,12/17/2020
2020-09-23,136,33925,10651,683864,717789,13.0,2734.0,7.0,2286.0,0.0,354.0,94.0,6.0,5.0,0,1116,127,24071,2132,287909,311980,12/17/2020
2020-09-24,120,34045,12480,696344,730389,8.0,2742.0,9.0,2295.0,1.0,355.0,92.0,7.0,5.0,1,1117,120,24191,3076,290985,315176,12/17/2020
2020-09-25,150,34195,10553,706897,741092,9.0,2751.0,10.0,2305.0,0.0,355.0,91.0,6.0,5.0,1,1118,143,24334,2922,293907,318241,12/17/2020
2020-09-26,147,34342,10560,717457,751799,12.0,2763.0,9.0,2314.0,0.0,355.0,94.0,6.0,5.0,1,1119,120,24454,2353,296260,320714,12/17/2020
2020-09-27,43,34385,2764,720221,754606,7.0,2770.0,5.0,2319.0,0.0,355.0,96.0,9.0,5.0,0,1119,34,24488,818,297078,321566,12/17/2020
2020-09-28,156,34541,7307,727528,762069,7.0,2777.0,7.0,2326.0,2.0,357.0,94.0,7.0,5.0,2,1121,138,24626,2186,299264,323890,12/17/2020
2020-09-29,203,34744,11046,738574,773318,12.0,2789.0,18.0,2344.0,1.0,358.0,87.0,6.0,6.0,1,1122,185,24811,2740,302004,326815,12/17/2020
2020-09-30,223,34967,12230,750804,785771,6.0,2795.0,6.0,2350.0,0.0,358.0,87.0,6.0,6.0,1,1123,189,25000,2495,304499,329499,12/17/2020
2020-10-01,185,35152,12503,763307,798459,17.0,2812.0,13.0,2363.0,1.0,359.0,90.0,6.0,4.0,2,1125,166,25166,2329,306828,331994,12/17/2020
2020-10-02,209,35361,12154,775461,810822,14.0,2826.0,13.0,2376.0,1.0,360.0,90.0,8.0,5.0,2,1127,181,25347,2422,309250,334597,12/17/2020
2020-10-03,157,35518,9313,784774,820292,9.0,2835.0,9.0,2385.0,2.0,362.0,88.0,9.0,4.0,2,1129,131,25478,1956,311206,336684,12/17/2020
2020-10-04,81,35599,2369,787143,822742,11.0,2846.0,9.0,2394.0,1.0,363.0,89.0,8.0,5.0,2,1131,76,25554,926,312132,337686,12/17/2020
2020-10-05,174,35773,8985,796128,831901,30.0,2876.0,10.0,2404.0,2.0,365.0,107.0,9.0,6.0,4,1135,160,25714,2950,315082,340796,12/17/2020
2020-10-06,189,35962,11186,807314,843276,11.0,2887.0,4.0,2408.0,0.0,365.0,114.0,11.0,7.0,0,1135,188,25902,2811,317893,343795,12/17/2020
2020-10-07,244,36206,12444,819758,855964,13.0,2900.0,14.0,2422.0,2.0,367.0,111.0,9.0,7.0,2,1137,245,26147,3434,321327,347474,12/17/2020
2020-10-08,282,36488,15233,834991,871479,17.0,2917.0,13.0,2435.0,2.0,369.0,113.0,7.0,5.0,4,1141,276,26423,4103,325430,351853,12/17/2020
2020-10-09,229,36717,13745,848736,885453,21.0,2938.0,12.0,2447.0,0.0,369.0,122.0,10.0,7.0,3,1144,200,26623,4174,329604,356227,12/17/2020
2020-10-10,231,36948,13832,862568,899516,19.0,2957.0,10.0,2457.0,1.0,370.0,130.0,13.0,7.0,2,1146,192,26815,3688,333292,360107,12/17/2020
2020-10-11,99,37047,3263,865831,902878,12.0,2969.0,9.0,2466.0,1.0,371.0,132.0,14.0,5.0,6,1152,89,26904,1132,334424,361328,12/17/2020
2020-10-12,169,37216,6440,872271,909487,19.0,2988.0,15.0,2481.0,2.0,373.0,134.0,14.0,5.0,4,1156,156,27060,1676,336100,363160,12/17/2020
2020-10-13,224,37440,8522,880793,918233,15.0,3003.0,13.0,2494.0,4.0,377.0,132.0,13.0,5.0,7,1163,212,27272,2259,338359,365631,12/17/2020
2020-10-14,335,37775,15042,895835,933610,17.0,3020.0,7.0,2501.0,0.0,377.0,142.0,15.0,5.0,2,1165,304,27576,3916,342275,369851,12/17/2020
2020-10-15,269,38044,14643,910478,948522,12.0,3032.0,16.0,2517.0,1.0,378.0,137.0,13.0,5.0,2,1167,253,27829,3469,345744,373573,12/17/2020
2020-10-16,288,38332,15011,925489,963821,13.0,3045.0,18.0,2535.0,1.0,379.0,131.0,13.0,4.0,2,1169,276,28105,3276,349020,377125,12/17/2020
2020-10-17,360,38692,14069,939558,978250,19.0,3064.0,11.0,2546.0,1.0,380.0,138.0,17.0,4.0,2,1171,309,28414,3158,352178,380592,12/17/2020
2020-10-18,155,38847,4039,943597,982444,18.0,3082.0,11.0,2557.0,0.0,380.0,145.0,17.0,6.0,2,1173,125,28539,1267,353445,381984,12/17/2020
2020-10-19,385,39232,8492,952089,991321,21.0,3103.0,22.0,2579.0,2.0,382.0,142.0,15.0,6.0,1,1174,320,28859,2485,355930,384789,12/17/2020
2020-10-20,439,39671,13245,965334,1005005,23.0,3126.0,17.0,2596.0,0.0,382.0,148.0,14.0,8.0,3,1177,383,29242,2916,358846,388088,12/17/2020
2020-10-21,544,40215,17464,982798,1023013,23.0,3149.0,8.0,2604.0,2.0,384.0,161.0,15.0,9.0,3,1180,472,29714,3382,362228,391942,12/17/2020
2020-10-22,538,40753,15864,998662,1039415,24.0,3173.0,20.0,2624.0,3.0,387.0,162.0,14.0,9.0,3,1183,489,30203,3085,365313,395516,12/17/2020
2020-10-23,514,41267,16637,1015299,1056566,22.0,3195.0,22.0,2646.0,1.0,388.0,161.0,15.0,9.0,3,1186,458,30661,2796,368109,398770,12/17/2020
2020-10-24,360,41627,10249,1025548,1067175,17.0,3212.0,11.0,2657.0,0.0,388.0,167.0,14.0,8.0,1,1187,338,30999,2185,370294,401293,12/17/2020
2020-10-25,233,41860,4760,1030308,1072168,16.0,3228.0,15.0,2672.0,1.0,389.0,167.0,15.0,8.0,2,1189,210,31209,1404,371698,402907,12/17/2020
2020-10-26,454,42314,9174,1039482,1081796,28.0,3256.0,15.0,2687.0,2.0,391.0,178.0,18.0,8.0,3,1192,402,31611,2887,374585,406196,12/17/2020
2020-10-27,516,42830,13995,1053477,1096307,29.0,3285.0,15.0,2702.0,2.0,393.0,190.0,18.0,9.0,4,1196,454,32065,2326,376911,408976,12/17/2020
2020-10-28,469,43299,15230,1068707,1112006,25.0,3310.0,26.0,2728.0,1.0,394.0,188.0,17.0,9.0,3,1199,412,32477,2611,379522,411999,12/17/2020
2020-10-29,609,43908,16260,1084967,1128875,20.0,3330.0,22.0,2750.0,3.0,397.0,183.0,19.0,11.0,4,1203,529,33006,3038,382560,415566,12/17/2020
2020-10-30,565,44473,14865,1099832,1144305,21.0,3351.0,21.0,2771.0,5.0,402.0,178.0,19.0,9.0,4,1207,470,33476,2857,385417,418893,12/17/2020
2020-10-31,599,45072,11819,1111651,1156723,32.0,3383.0,13.0,2784.0,1.0,403.0,196.0,23.0,10.0,3,1210,485,33961,2342,387759,421720,12/17/2020
2020-11-01,330,45402,5091,1116742,1162144,22.0,3405.0,15.0,2799.0,1.0,404.0,202.0,27.0,13.0,4,1214,277,34238,1231,388990,423228,12/17/2020
2020-11-02,522,45924,9935,1126677,1172601,38.0,3443.0,27.0,2826.0,3.0,407.0,210.0,25.0,13.0,5,1219,459,34697,2849,391839,426536,12/17/2020
2020-11-03,601,46525,13041,1139718,1186243,33.0,3476.0,25.0,2851.0,1.0,408.0,217.0,25.0,13.0,1,1220,530,35227,2441,394280,429507,12/17/2020
2020-11-04,688,47213,16101,1155819,1203032,34.0,3510.0,27.0,2878.0,2.0,410.0,222.0,26.0,12.0,4,1224,641,35868,2844,397124,432992,12/17/2020
2020-11-05,768,47981,16593,1172412,1220393,46.0,3556.0,35.0,2913.0,1.0,411.0,232.0,25.0,14.0,3,1227,684,36552,2782,399906,436458,12/17/2020
2020-11-06,769,48750,16026,1188438,1237188,43.0,3599.0,31.0,2944.0,1.0,412.0,243.0,29.0,17.0,5,1232,691,37243,2964,402870,440113,12/17/2020
2020-11-07,604,49354,13649,1202087,1251441,34.0,3633.0,25.0,2969.0,1.0,413.0,251.0,32.0,18.0,1,1233,578,37821,2403,405273,443094,12/17/2020
2020-11-08,337,49691,4166,1206253,1255944,33.0,3666.0,26.0,2995.0,1.0,414.0,257.0,31.0,19.0,4,1237,322,38143,1248,406521,444664,12/17/2020
2020-11-09,808,50499,9063,1215316,1265815,40.0,3706.0,33.0,3028.0,2.0,416.0,262.0,29.0,18.0,3,1240,766,38909,2270,408791,447700,12/17/2020
2020-11-10,1053,51552,12982,1228298,1279850,45.0,3751.0,37.0,3065.0,0.0,416.0,270.0,32.0,18.0,6,1246,982,39891,2816,411607,451498,12/17/2020
2020-11-11,1087,52639,19738,1248036,1300675,42.0,3793.0,24.0,3089.0,5.0,421.0,283.0,31.0,15.0,7,1253,1003,40894,2614,414221,455115,12/17/2020
2020-11-12,893,53532,13913,1261949,1315481,39.0,3832.0,31.0,3120.0,3.0,424.0,288.0,29.0,15.0,5,1258,813,41707,2156,416377,458084,12/17/2020
2020-11-13,1165,54697,16391,1278340,1333037,39.0,3871.0,31.0,3151.0,0.0,424.0,296.0,28.0,15.0,2,1260,1115,42822,3031,419408,462230,12/17/2020
2020-11-14,782,55479,13519,1291859,1347338,42.0,3913.0,26.0,3177.0,5.0,429.0,307.0,26.0,13.0,10,1270,738,43560,2417,421825,465385,12/17/2020
2020-11-15,578,56057,6173,1298032,1354089,46.0,3959.0,21.0,3198.0,5.0,434.0,327.0,29.0,11.0,7,1277,495,44055,1391,423216,467271,12/17/2020
2020-11-16,739,56796,9647,1307679,1364475,56.0,4015.0,39.0,3237.0,3.0,437.0,341.0,27.0,13.0,5,1282,674,44729,2599,425815,470544,12/17/2020
2020-11-17,1538,58334,18176,1325855,1384189,59.0,4074.0,45.0,3282.0,2.0,439.0,353.0,31.0,13.0,5,1287,1401,46130,4049,429864,475994,12/17/2020
2020-11-18,1136,59470,16044,1341899,1401369,38.0,4112.0,38.0,3320.0,5.0,444.0,348.0,30.0,15.0,7,1294,1020,47150,3146,433010,480160,12/17/2020
2020-11-19,1128,60598,13170,1355069,1415667,46.0,4158.0,42.0,3362.0,4.0,448.0,348.0,31.0,18.0,5,1299,1032,48182,3348,436358,484540,12/17/2020
2020-11-20,1457,62055,22226,1377295,1439350,49.0,4207.0,48.0,3410.0,3.0,451.0,346.0,34.0,14.0,6,1305,1293,49475,4253,440611,490086,12/17/2020
2020-11-21,854,62909,17370,1394665,1457574,43.0,4250.0,34.0,3444.0,5.0,456.0,350.0,36.0,14.0,7,1312,756,50231,3088,443699,493930,12/17/2020
2020-11-22,571,63480,7519,1402184,1465664,65.0,4315.0,28.0,3472.0,4.0,460.0,383.0,34.0,15.0,11,1323,486,50717,1766,445465,496182,12/17/2020
2020-11-23,994,64474,11030,1413214,1477688,75.0,4390.0,40.0,3512.0,0.0,460.0,418.0,41.0,18.0,10,1333,893,51610,3357,448822,500432,12/17/2020
2020-11-24,1050,65524,14579,1427793,1493317,47.0,4437.0,60.0,3572.0,6.0,466.0,399.0,43.0,22.0,10,1343,941,52551,2730,451552,504103,12/17/2020
2020-11-25,1266,66790,18790,1446583,1513373,59.0,4496.0,58.0,3630.0,4.0,470.0,396.0,44.0,26.0,7,1350,1178,53729,3504,455056,508785,12/17/2020
2020-11-26,547,67337,6482,1453065,1520402,51.0,4547.0,35.0,3665.0,4.0,474.0,408.0,47.0,25.0,12,1362,467,54196,1553,456609,510805,12/17/2020
2020-11-27,1044,68381,9724,1462789,1531170,56.0,4603.0,49.0,3714.0,7.0,481.0,408.0,49.0,22.0,6,1368,969,55165,2496,459105,514270,12/17/2020
2020-11-28,1182,69563,11960,1474749,1544312,64.0,4667.0,40.0,3754.0,0.0,481.0,432.0,49.0,22.0,3,1371,1097,56262,2773,461878,518140,12/17/2020
2020-11-29,822,70385,6935,1481684,1552069,62.0,4729.0,36.0,3790.0,3.0,484.0,455.0,50.0,24.0,8,1379,753,57015,2290,464168,521183,12/17/2020
2020-11-30,1283,71668,9925,1491609,1563277,67.0,4796.0,59.0,3849.0,2.0,486.0,461.0,53.0,30.0,6,1385,1161,58176,2778,466946,525122,12/17/2020
2020-12-01,1555,73223,13953,1505562,1578785,61.0,4857.0,55.0,3904.0,4.0,490.0,463.0,52.0,31.0,12,1397,1420,59596,3343,470289,529885,12/17/2020
2020-12-02,1561,74784,15564,1521126,1595910,57.0,4914.0,53.0,3957.0,7.0,497.0,460.0,53.0,30.0,14,1411,1425,61021,3228,473517,534538,12/17/2020
2020-12-03,1772,76556,14626,1535752,1612308,63.0,4977.0,77.0,4034.0,5.0,502.0,441.0,49.0,31.0,10,1421,1639,62660,3298,476815,539475,12/17/2020
2020-12-04,1648,78204,16507,1552259,1630463,70.0,5047.0,50.0,4084.0,7.0,509.0,454.0,46.0,30.0,11,1432,1522,64182,3759,480574,544756,12/17/2020
2020-12-05,1199,79403,12609,1564868,1644271,71.0,5118.0,42.0,4126.0,4.0,513.0,479.0,48.0,29.0,11,1443,1065,65247,2870,483444,548691,12/17/2020
2020-12-06,1125,80528,7842,1572710,1653238,63.0,5181.0,50.0,4176.0,10.0,523.0,482.0,49.0,25.0,14,1457,980,66227,2464,485908,552135,12/17/2020
2020-12-07,1392,81920,10629,1583339,1665259,74.0,5255.0,58.0,4234.0,6.0,529.0,492.0,46.0,25.0,19,1476,1252,67479,3291,489199,556678,12/17/2020
2020-12-08,1464,83384,15293,1598632,1682016,57.0,5312.0,57.0,4291.0,5.0,534.0,487.0,49.0,27.0,17,1493,1319,68798,3544,492743,561541,12/17/2020
2020-12-09,1499,84883,16351,1614983,1699866,55.0,5367.0,62.0,4353.0,9.0,543.0,471.0,47.0,29.0,12,1505,1341,70139,3220,495963,566102,12/17/2020
2020-12-10,1474,86357,17251,1632234,1718591,62.0,5429.0,58.0,4411.0,6.0,549.0,469.0,55.0,29.0,15,1520,1255,71394,4084,500047,571441,12/17/2020
2020-12-11,1486,87843,17357,1649591,1737434,72.0,5501.0,82.0,4493.0,7.0,556.0,452.0,59.0,32.0,14,1534,1293,72687,3612,503659,576346,12/17/2020
2020-12-12,1098,88941,13049,1662640,1751581,64.0,5565.0,53.0,4546.0,9.0,565.0,454.0,51.0,32.0,14,1548,919,73606,3111,506770,580376,12/17/2020
2020-12-13,674,89615,7142,1669782,1759397,72.0,5637.0,39.0,4585.0,13.0,578.0,474.0,53.0,29.0,22,1570,568,74174,2011,508781,582955,12/17/2020
2020-12-14,1306,90921,11176,1680958,1771879,74.0,5711.0,61.0,4646.0,9.0,587.0,478.0,62.0,30.0,11,1581,1136,75310,3394,512175,587485,12/17/2020
2020-12-15,1251,92172,14850,1695808,1787980,55.0,5766.0,49.0,4695.0,5.0,592.0,479.0,59.0,29.0,12,1593,1029,76339,3071,515246,591585,12/17/2020
2020-12-16,1117,93289,17107,1712915,1806204,,,,,,,,,,9,1602,951,77290,3408,518654,595944,12/17/2020
2020-02-27,0,0,0,0,0,1.0,1.0,0.0,0.0,0.0,0.0,1.0,0.0,0.0,0,0,0,0,0,0,0,12/19/2020
2020-02-28,0,0,0,0,0,0.0,1.0,0.0,0.0,0.0,0.0,1.0,1.0,0.0,0,0,0,0,0,0,0,12/19/2020
2020-02-29,0,0,0,0,0,0.0,1.0,0.0,0.0,0.0,0.0,1.0,1.0,0.0,0,0,0,0,0,0,0,12/19/2020
2020-03-01,2,2,2,2,4,0.0,1.0,0.0,0.0,0.0,0.0,1.0,1.0,1.0,0,0,2,2,2,2,4,12/19/2020
2020-03-02,0,2,1,3,5,1.0,2.0,0.0,0.0,0.0,0.0,2.0,2.0,2.0,0,0,0,2,0,2,4,12/19/2020
2020-03-03,0,2,2,5,7,0.0,2.0,0.0,0.0,0.0,0.0,2.0,2.0,2.0,0,0,0,2,1,3,5,12/19/2020
2020-03-04,0,2,12,17,19,1.0,3.0,0.0,0.0,0.0,0.0,3.0,2.0,2.0,0,0,0,2,10,13,15,12/19/2020
2020-03-05,0,2,4,21,23,0.0,3.0,0.0,0.0,0.0,0.0,3.0,2.0,2.0,0,0,1,3,4,17,20,12/19/2020
2020-03-06,1,3,12,33,36,0.0,3.0,0.0,0.0,0.0,0.0,3.0,2.0,2.0,0,0,0,3,11,28,31,12/19/2020
2020-03-07,0,3,19,52,55,0.0,3.0,0.0,0.0,0.0,0.0,3.0,2.0,1.0,0,0,0,3,19,47,50,12/19/2020
2020-03-08,0,3,18,70,73,0.0,3.0,0.0,0.0,0.0,0.0,3.0,2.0,1.0,0,0,0,3,18,65,68,12/19/2020
2020-03-09,1,4,15,85,89,0.0,3.0,0.0,0.0,0.0,0.0,3.0,2.0,1.0,0,0,1,4,14,79,83,12/19/2020
2020-03-10,2,6,25,110,116,0.0,3.0,0.0,0.0,0.0,0.0,3.0,2.0,1.0,0,0,1,5,23,102,107,12/19/2020
2020-03-11,0,6,34,144,150,1.0,4.0,0.0,0.0,0.0,0.0,4.0,1.0,1.0,0,0,0,5,34,136,141,12/19/2020
2020-03-12,9,15,41,185,200,1.0,5.0,0.0,0.0,0.0,0.0,5.0,1.0,1.0,0,0,7,12,38,174,186,12/19/2020
2020-03-13,6,21,50,235,256,4.0,9.0,1.0,1.0,0.0,0.0,8.0,1.0,1.0,0,0,6,18,47,221,239,12/19/2020
2020-03-14,0,21,90,325,346,0.0,9.0,0.0,1.0,0.0,0.0,8.0,1.0,1.0,0,0,0,18,83,304,322,12/19/2020
2020-03-15,1,22,54,379,401,1.0,10.0,0.0,1.0,0.0,0.0,9.0,2.0,1.0,0,0,1,19,53,357,376,12/19/2020
2020-03-16,2,24,95,474,498,2.0,12.0,0.0,1.0,0.0,0.0,11.0,2.0,0.0,0,0,2,21,89,446,467,12/19/2020
2020-03-17,12,36,162,636,672,6.0,18.0,0.0,1.0,0.0,0.0,17.0,2.0,0.0,0,0,11,32,141,587,619,12/19/2020
2020-03-18,9,45,116,752,797,3.0,21.0,0.0,1.0,0.0,0.0,20.0,2.0,0.0,0,0,11,43,104,691,734,12/19/2020
2020-03-19,15,60,262,1014,1074,2.0,23.0,1.0,2.0,0.0,0.0,21.0,3.0,0.0,1,1,17,60,245,936,996,12/19/2020
2020-03-20,13,73,197,1211,1284,5.0,28.0,0.0,2.0,0.0,0.0,26.0,4.0,0.0,0,1,13,73,182,1118,1191,12/19/2020
2020-03-21,12,85,126,1337,1422,3.0,31.0,2.0,4.0,0.0,0.0,27.0,5.0,0.0,0,1,14,87,117,1235,1322,12/19/2020
2020-03-22,27,112,282,1619,1731,2.0,33.0,0.0,4.0,0.0,0.0,29.0,5.0,0.0,0,1,25,112,250,1485,1597,12/19/2020
2020-03-23,14,126,169,1788,1914,15.0,48.0,1.0,5.0,0.0,0.0,43.0,9.0,3.0,0,1,16,128,156,1641,1769,12/19/2020
2020-03-24,20,146,242,2030,2176,8.0,56.0,0.0,5.0,0.0,0.0,51.0,10.0,5.0,0,1,19,147,219,1860,2007,12/19/2020
2020-03-25,26,172,182,2212,2384,5.0,61.0,2.0,7.0,0.0,0.0,54.0,11.0,3.0,0,1,28,175,158,2018,2193,12/19/2020
2020-03-26,35,207,181,2393,2600,9.0,70.0,5.0,12.0,0.0,0.0,58.0,14.0,5.0,0,1,41,216,163,2181,2397,12/19/2020
2020-03-27,27,234,214,2607,2841,9.0,79.0,1.0,13.0,1.0,1.0,65.0,16.0,6.0,2,3,31,247,186,2367,2614,12/19/2020
2020-03-28,59,293,260,2867,3160,11.0,90.0,2.0,15.0,1.0,2.0,73.0,15.0,6.0,1,4,64,311,232,2599,2910,12/19/2020
2020-03-29,100,393,350,3217,3610,8.0,98.0,3.0,18.0,1.0,3.0,77.0,18.0,8.0,2,6,105,416,290,2889,3305,12/19/2020
2020-03-30,62,455,222,3439,3894,19.0,117.0,5.0,23.0,0.0,3.0,91.0,19.0,11.0,3,9,78,494,171,3060,3554,12/19/2020
2020-03-31,71,526,369,3808,4334,11.0,128.0,7.0,30.0,1.0,4.0,94.0,21.0,13.0,2,11,73,567,284,3344,3911,12/19/2020
2020-04-01,99,625,698,4506,5131,18.0,146.0,7.0,37.0,0.0,4.0,105.0,29.0,15.0,1,12,100,667,592,3936,4603,12/19/2020
2020-04-02,52,677,477,4983,5660,22.0,168.0,6.0,43.0,2.0,6.0,119.0,35.0,21.0,4,16,62,729,409,4345,5074,12/19/2020
2020-04-03,108,785,774,5757,6542,23.0,191.0,7.0,50.0,0.0,6.0,135.0,42.0,25.0,3,19,100,829,662,5007,5836,12/19/2020
2020-04-04,143,928,660,6417,7345,22.0,213.0,4.0,54.0,5.0,11.0,148.0,40.0,29.0,9,28,138,967,577,5584,6551,12/19/2020
2020-04-05,187,1115,1156,7573,8688,20.0,233.0,9.0,63.0,1.0,12.0,158.0,43.0,35.0,2,30,181,1148,978,6562,7710,12/19/2020
2020-04-06,218,1333,1706,9279,10612,26.0,259.0,7.0,70.0,0.0,12.0,177.0,47.0,39.0,7,37,207,1355,1450,8012,9367,12/19/2020
2020-04-07,284,1617,1629,10908,12525,20.0,279.0,4.0,74.0,2.0,14.0,191.0,49.0,41.0,5,42,260,1615,1387,9399,11014,12/19/2020
2020-04-08,290,1907,1720,12628,14535,19.0,298.0,8.0,82.0,5.0,19.0,197.0,49.0,37.0,10,52,271,1886,1457,10856,12742,12/19/2020
2020-04-09,283,2190,1516,14144,16334,32.0,330.0,8.0,90.0,4.0,23.0,217.0,53.0,40.0,7,59,277,2163,1266,12122,14285,12/19/2020
2020-04-10,419,2609,2574,16718,19327,29.0,359.0,17.0,107.0,5.0,28.0,224.0,59.0,41.0,11,70,400,2563,2218,14340,16903,12/19/2020
2020-04-11,298,2907,1905,18623,21530,29.0,388.0,11.0,118.0,2.0,30.0,240.0,61.0,48.0,12,82,280,2843,1619,15959,18802,12/19/2020
2020-04-12,314,3221,1670,20293,23514,35.0,423.0,13.0,131.0,5.0,35.0,257.0,59.0,49.0,9,91,286,3129,1303,17262,20391,12/19/2020
2020-04-13,161,3382,935,21228,24610,35.0,458.0,13.0,144.0,3.0,38.0,276.0,64.0,54.0,9,100,187,3316,785,18047,21363,12/19/2020
2020-04-14,290,3672,1787,23015,26687,27.0,485.0,18.0,162.0,5.0,43.0,280.0,72.0,53.0,8,108,261,3577,1416,19463,23040,12/19/2020
2020-04-15,350,4022,1799,24814,28836,31.0,516.0,20.0,182.0,3.0,46.0,288.0,72.0,54.0,17,125,306,3883,1413,20876,24759,12/19/2020
2020-04-16,447,4469,2494,27308,31777,36.0,552.0,25.0,207.0,6.0,52.0,293.0,72.0,53.0,14,139,387,4270,1902,22778,27048,12/19/2020
2020-04-17,304,4773,1821,29129,33902,32.0,584.0,20.0,227.0,7.0,59.0,298.0,66.0,45.0,21,160,290,4560,1320,24098,28658,12/19/2020
2020-04-18,321,5094,1725,30854,35948,26.0,610.0,18.0,245.0,4.0,63.0,302.0,63.0,49.0,15,175,284,4844,1232,25330,30174,12/19/2020
2020-04-19,381,5475,2047,32901,38376,23.0,633.0,26.0,271.0,1.0,64.0,298.0,65.0,55.0,11,186,337,5181,1632,26962,32143,12/19/2020
2020-04-20,394,5869,1907,34808,40677,46.0,679.0,29.0,300.0,2.0,66.0,313.0,75.0,56.0,10,196,376,5557,1467,28429,33986,12/19/2020
2020-04-21,444,6313,2110,36918,43231,45.0,724.0,32.0,332.0,5.0,71.0,321.0,72.0,56.0,18,214,383,5940,1599,30028,35968,12/19/2020
2020-04-22,418,6731,2390,39308,46039,41.0,765.0,32.0,364.0,5.0,76.0,325.0,73.0,58.0,18,232,379,6319,1764,31792,38111,12/19/2020
2020-04-23,479,7210,2469,41777,48987,32.0,797.0,28.0,392.0,5.0,81.0,324.0,76.0,62.0,15,247,412,6731,1720,33512,40243,12/19/2020
2020-04-24,491,7701,3284,45061,52762,35.0,832.0,26.0,418.0,4.0,85.0,329.0,85.0,63.0,15,262,407,7138,2356,35868,43006,12/19/2020
2020-04-25,393,8094,2206,47267,55361,34.0,866.0,17.0,435.0,5.0,90.0,341.0,85.0,62.0,14,276,299,7437,1588,37456,44893,12/19/2020
2020-04-26,316,8410,2309,49576,57986,33.0,899.0,15.0,450.0,3.0,93.0,356.0,86.0,59.0,14,290,274,7711,1718,39174,46885,12/19/2020
2020-04-27,249,8659,1620,51196,59855,29.0,928.0,21.0,471.0,4.0,97.0,360.0,86.0,61.0,10,300,206,7917,1070,40244,48161,12/19/2020
2020-04-28,410,9069,2263,53459,62528,44.0,972.0,24.0,495.0,3.0,100.0,377.0,88.0,59.0,22,322,331,8248,1527,41771,50019,12/19/2020
2020-04-29,476,9545,3343,56802,66347,36.0,1008.0,38.0,533.0,11.0,111.0,364.0,78.0,53.0,18,340,371,8619,2180,43951,52570,12/19/2020
2020-04-30,432,9977,2769,59571,69548,33.0,1041.0,38.0,571.0,6.0,117.0,353.0,83.0,57.0,24,364,351,8970,1718,45669,54639,12/19/2020
2020-05-01,454,10431,3086,62657,73088,52.0,1093.0,38.0,609.0,3.0,120.0,364.0,84.0,58.0,14,378,323,9293,1928,47597,56890,12/19/2020
2020-05-02,257,10688,1926,64583,75271,36.0,1129.0,39.0,648.0,5.0,125.0,356.0,93.0,63.0,24,402,193,9486,1171,48768,58254,12/19/2020
2020-05-03,283,10971,2160,66743,77714,31.0,1160.0,26.0,674.0,8.0,133.0,353.0,91.0,61.0,21,423,183,9669,1413,50181,59850,12/19/2020
2020-05-04,387,11358,2098,68841,80199,30.0,1190.0,31.0,705.0,6.0,139.0,346.0,89.0,58.0,18,441,290,9959,1452,51633,61592,12/19/2020
2020-05-05,433,11791,2873,71714,83505,29.0,1219.0,32.0,737.0,6.0,145.0,337.0,83.0,55.0,16,457,299,10258,1827,53460,63718,12/19/2020
2020-05-06,488,12279,2830,74544,86823,28.0,1247.0,44.0,781.0,9.0,154.0,312.0,80.0,55.0,21,478,340,10598,1785,55245,65843,12/19/2020
2020-05-07,425,12704,2969,77513,90217,36.0,1283.0,44.0,825.0,5.0,159.0,299.0,72.0,53.0,21,499,270,10868,1794,57039,67907,12/19/2020
2020-05-08,359,13063,2598,80111,93174,30.0,1313.0,29.0,854.0,5.0,164.0,295.0,72.0,54.0,22,521,230,11098,1550,58589,69687,12/19/2020
2020-05-09,467,13530,3346,83457,96987,22.0,1335.0,21.0,875.0,4.0,168.0,292.0,70.0,52.0,15,536,288,11386,2085,60674,72060,12/19/2020
2020-05-10,285,13815,2117,85574,99389,20.0,1355.0,23.0,898.0,6.0,174.0,283.0,71.0,50.0,14,550,190,11576,1401,62075,73651,12/19/2020
2020-05-11,257,14072,1857,87431,101503,31.0,1386.0,16.0,914.0,6.0,180.0,292.0,72.0,50.0,15,565,173,11749,1216,63291,75040,12/19/2020
2020-05-12,387,14459,2611,90042,104501,23.0,1409.0,18.0,932.0,4.0,184.0,293.0,70.0,49.0,22,587,224,11973,1522,64813,76786,12/19/2020
2020-05-13,351,14810,3630,93672,108482,23.0,1432.0,25.0,957.0,1.0,185.0,290.0,70.0,50.0,13,600,199,12172,1819,66632,78804,12/19/2020
2020-05-14,329,15139,3408,97080,112219,19.0,1451.0,27.0,984.0,3.0,188.0,279.0,65.0,46.0,15,615,232,12404,1850,68482,80886,12/19/2020
2020-05-15,381,15520,3458,100538,116058,24.0,1475.0,41.0,1025.0,5.0,193.0,257.0,63.0,46.0,14,629,232,12636,1694,70176,82812,12/19/2020
2020-05-16,449,15969,4156,104694,120663,25.0,1500.0,15.0,1040.0,5.0,198.0,262.0,62.0,47.0,15,644,247,12883,1812,71988,84871,12/19/2020
2020-05-17,240,16209,2768,107462,123671,17.0,1517.0,9.0,1049.0,5.0,203.0,265.0,60.0,46.0,10,654,126,13009,1428,73416,86425,12/19/2020
2020-05-18,250,16459,2001,109463,125922,19.0,1536.0,16.0,1065.0,5.0,208.0,263.0,58.0,41.0,18,672,135,13144,1296,74712,87856,12/19/2020
2020-05-19,415,16874,3168,112631,129505,23.0,1559.0,33.0,1098.0,5.0,213.0,248.0,57.0,39.0,11,683,215,13359,1811,76523,89882,12/19/2020
2020-05-20,326,17200,2771,115402,132602,19.0,1578.0,23.0,1121.0,7.0,220.0,237.0,53.0,34.0,22,705,183,13542,1430,77953,91495,12/19/2020
2020-05-21,374,17574,3757,119159,136733,25.0,1603.0,15.0,1136.0,3.0,223.0,244.0,54.0,30.0,20,725,168,13710,1835,79788,93498,12/19/2020
2020-05-22,351,17925,3161,122320,140245,20.0,1623.0,28.0,1164.0,5.0,228.0,231.0,53.0,30.0,11,736,206,13916,1496,81284,95200,12/19/2020
2020-05-23,253,18178,2742,125062,143240,19.0,1642.0,11.0,1175.0,3.0,231.0,236.0,53.0,33.0,13,749,109,14025,1204,82488,96513,12/19/2020
2020-05-24,163,18341,1370,126432,144773,13.0,1655.0,14.0,1189.0,2.0,233.0,233.0,54.0,36.0,8,757,83,14108,733,83221,97329,12/19/2020
2020-05-25,147,18488,1385,127817,146305,14.0,1669.0,14.0,1203.0,0.0,233.0,233.0,54.0,34.0,10,767,76,14184,683,83904,98088,12/19/2020
2020-05-26,285,18773,2620,130437,149210,24.0,1693.0,21.0,1224.0,5.0,238.0,231.0,49.0,33.0,15,782,158,14342,1552,85456,99798,12/19/2020
2020-05-27,276,19049,2057,132494,151543,20.0,1713.0,18.0,1242.0,3.0,241.0,230.0,51.0,33.0,10,792,132,14474,1081,86537,101011,12/19/2020
2020-05-28,348,19397,3359,135853,155250,17.0,1730.0,29.0,1271.0,4.0,245.0,214.0,47.0,32.0,8,800,130,14604,1042,87579,102183,12/19/2020
2020-05-29,410,19807,3915,139768,159575,19.0,1749.0,26.0,1297.0,7.0,252.0,200.0,43.0,31.0,12,812,174,14778,1465,89044,103822,12/19/2020
2020-05-30,225,20032,3915,143683,163715,16.0,1765.0,19.0,1316.0,4.0,256.0,193.0,41.0,29.0,12,824,109,14887,1631,90675,105562,12/19/2020
2020-05-31,155,20187,1690,145373,165560,11.0,1776.0,11.0,1327.0,1.0,257.0,192.0,44.0,26.0,3,827,78,14965,783,91458,106423,12/19/2020
2020-06-01,212,20399,2792,148165,168564,8.0,1784.0,14.0,1341.0,1.0,258.0,185.0,45.0,29.0,5,832,93,15058,1310,92768,107826,12/19/2020
2020-06-02,273,20672,3022,151187,171859,8.0,1792.0,9.0,1350.0,3.0,261.0,181.0,38.0,25.0,10,842,98,15156,1351,94119,109275,12/19/2020
2020-06-03,254,20926,3486,154673,175599,14.0,1806.0,18.0,1368.0,6.0,267.0,171.0,34.0,25.0,11,853,99,15255,1566,95685,110940,12/19/2020
2020-06-04,276,21202,4471,159144,180346,7.0,1813.0,26.0,1394.0,4.0,271.0,148.0,31.0,24.0,12,865,107,15362,1897,97582,112944,12/19/2020
2020-06-05,215,21417,3513,162657,184074,15.0,1828.0,13.0,1407.0,6.0,277.0,144.0,27.0,21.0,11,876,99,15461,1443,99025,114486,12/19/2020
2020-06-06,201,21618,2616,165273,186891,10.0,1838.0,7.0,1414.0,2.0,279.0,145.0,29.0,19.0,6,882,67,15528,1059,100084,115612,12/19/2020
2020-06-07,83,21701,1625,166898,188599,11.0,1849.0,7.0,1421.0,1.0,280.0,148.0,25.0,17.0,4,886,51,15579,760,100844,116423,12/19/2020
2020-06-08,119,21820,1849,168747,190567,15.0,1864.0,13.0,1434.0,2.0,282.0,148.0,27.0,18.0,4,890,45,15624,904,101748,117372,12/19/2020
2020-06-09,223,22043,2673,171420,193463,10.0,1874.0,19.0,1453.0,0.0,282.0,139.0,28.0,21.0,1,891,64,15688,1194,102942,118630,12/19/2020
2020-06-10,209,22252,2987,174407,196659,13.0,1887.0,12.0,1465.0,2.0,284.0,138.0,24.0,17.0,4,895,100,15788,1400,104342,120130,12/19/2020
2020-06-11,195,22447,3513,177920,200367,7.0,1894.0,15.0,1480.0,1.0,285.0,129.0,25.0,16.0,6,901,88,15876,1448,105790,121666,12/19/2020
2020-06-12,209,22656,4601,182521,205177,9.0,1903.0,16.0,1496.0,1.0,286.0,121.0,24.0,16.0,2,903,78,15954,1982,107772,123726,12/19/2020
2020-06-13,113,22769,3036,185557,208326,6.0,1909.0,5.0,1501.0,0.0,286.0,122.0,20.0,15.0,3,906,49,16003,1256,109028,125031,12/19/2020
2020-06-14,81,22850,2046,187603,210453,7.0,1916.0,8.0,1509.0,1.0,287.0,120.0,20.0,14.0,3,909,33,16036,924,109952,125988,12/19/2020
2020-06-15,188,23038,3108,190711,213749,14.0,1930.0,19.0,1528.0,0.0,287.0,115.0,20.0,16.0,5,914,75,16111,1701,111653,127764,12/19/2020
2020-06-16,110,23148,3017,193728,216876,11.0,1941.0,9.0,1537.0,1.0,288.0,116.0,22.0,16.0,8,922,50,16161,1464,113117,129278,12/19/2020
2020-06-17,127,23275,2835,196563,219838,15.0,1956.0,20.0,1557.0,4.0,292.0,107.0,18.0,14.0,6,928,51,16212,1255,114372,130584,12/19/2020
2020-06-18,149,23424,3049,199612,223036,9.0,1965.0,15.0,1572.0,1.0,293.0,100.0,19.0,16.0,7,935,70,16282,1250,115622,131904,12/19/2020
2020-06-19,141,23565,3769,203381,226946,12.0,1977.0,12.0,1584.0,1.0,294.0,99.0,20.0,17.0,3,938,59,16341,1302,116924,133265,12/19/2020
2020-06-20,84,23649,1891,205272,228921,9.0,1986.0,12.0,1596.0,0.0,294.0,96.0,20.0,18.0,4,942,36,16377,777,117701,134078,12/19/2020
2020-06-21,37,23686,1064,206336,230022,8.0,1994.0,5.0,1601.0,0.0,294.0,99.0,20.0,18.0,2,944,30,16407,654,118355,134762,12/19/2020
2020-06-22,138,23824,3730,210066,233890,12.0,2006.0,17.0,1618.0,0.0,294.0,94.0,19.0,18.0,2,946,65,16472,1629,119984,136456,12/19/2020
2020-06-23,163,23987,3830,213896,237883,3.0,2009.0,13.0,1631.0,3.0,297.0,81.0,18.0,18.0,7,953,81,16553,1706,121690,138243,12/19/2020
2020-06-24,120,24107,3502,217398,241505,9.0,2018.0,10.0,1641.0,1.0,298.0,79.0,18.0,18.0,5,958,45,16598,1597,123287,139885,12/19/2020
2020-06-25,103,24210,2883,220281,244491,6.0,2024.0,14.0,1655.0,1.0,299.0,70.0,17.0,17.0,1,959,51,16649,1427,124714,141363,12/19/2020
2020-06-26,94,24304,2488,222769,247073,2.0,2026.0,10.0,1665.0,0.0,299.0,62.0,18.0,18.0,1,960,60,16709,1266,125980,142689,12/19/2020
2020-06-27,84,24388,3216,225985,250373,5.0,2031.0,3.0,1668.0,1.0,300.0,63.0,17.0,17.0,5,965,37,16746,1158,127138,143884,12/19/2020
2020-06-28,39,24427,1469,227454,251881,4.0,2035.0,4.0,1672.0,4.0,304.0,59.0,15.0,14.0,6,971,17,16763,573,127711,144474,12/19/2020
2020-06-29,85,24512,3697,231151,255663,4.0,2039.0,5.0,1677.0,0.0,304.0,58.0,14.0,14.0,1,972,39,16802,1297,129008,145810,12/19/2020
2020-06-30,58,24570,1958,233109,257679,1.0,2040.0,5.0,1682.0,1.0,305.0,53.0,12.0,11.0,4,976,33,16835,952,129960,146795,12/19/2020
2020-07-01,144,24714,4098,237207,261921,8.0,2048.0,10.0,1692.0,0.0,305.0,51.0,11.0,11.0,1,977,79,16914,1848,131808,148722,12/19/2020
2020-07-02,103,24817,2803,240010,264827,5.0,2053.0,5.0,1697.0,1.0,306.0,50.0,10.0,10.0,3,980,59,16973,1034,132842,149815,12/19/2020
2020-07-03,50,24867,2079,242089,266956,9.0,2062.0,6.0,1703.0,0.0,306.0,53.0,9.0,9.0,3,983,24,16997,750,133592,150589,12/19/2020
2020-07-04,57,24924,2345,244434,269358,2.0,2064.0,4.0,1707.0,1.0,307.0,50.0,10.0,9.0,2,985,33,17030,964,134556,151586,12/19/2020
2020-07-05,49,24973,2932,247366,272339,1.0,2065.0,2.0,1709.0,1.0,308.0,48.0,8.0,8.0,2,987,26,17056,1360,135916,152972,12/19/2020
2020-07-06,101,25074,2814,250180,275254,6.0,2071.0,6.0,1715.0,0.0,308.0,48.0,9.0,9.0,4,991,57,17113,1494,137410,154523,12/19/2020
2020-07-07,81,25155,3457,253637,278792,5.0,2076.0,7.0,1722.0,0.0,308.0,46.0,8.0,8.0,2,993,47,17160,1481,138891,156051,12/19/2020
2020-07-08,105,25260,3409,257046,282306,4.0,2080.0,2.0,1724.0,0.0,308.0,48.0,9.0,8.0,0,993,64,17224,1348,140239,157463,12/19/2020
2020-07-09,94,25354,3714,260760,286114,9.0,2089.0,3.0,1727.0,0.0,308.0,54.0,9.0,8.0,0,993,50,17274,1550,141789,159063,12/19/2020
2020-07-10,132,25486,4437,265197,290683,6.0,2095.0,3.0,1730.0,2.0,310.0,55.0,7.0,7.0,3,996,80,17354,1986,143775,161129,12/19/2020
2020-07-11,63,25549,2938,268135,293684,6.0,2101.0,3.0,1733.0,1.0,311.0,57.0,6.0,6.0,3,999,36,17390,1260,145035,162425,12/19/2020
2020-07-12,47,25596,1838,269973,295569,1.0,2102.0,3.0,1736.0,1.0,312.0,54.0,6.0,5.0,3,1002,34,17424,907,145942,163366,12/19/2020
2020-07-13,84,25680,3209,273182,298862,8.0,2110.0,10.0,1746.0,0.0,312.0,52.0,6.0,5.0,1,1003,61,17485,1443,147385,164870,12/19/2020
2020-07-14,74,25754,3298,276480,302234,7.0,2117.0,4.0,1750.0,0.0,312.0,55.0,5.0,5.0,1,1004,44,17529,1330,148715,166244,12/19/2020
2020-07-15,130,25884,4181,280661,306545,5.0,2122.0,7.0,1757.0,0.0,312.0,53.0,5.0,4.0,0,1004,100,17629,1678,150393,168022,12/19/2020
2020-07-16,103,25987,3740,284401,310388,6.0,2128.0,9.0,1766.0,0.0,312.0,50.0,6.0,5.0,1,1005,76,17705,1536,151929,169634,12/19/2020
2020-07-17,156,26143,4239,288640,314783,14.0,2142.0,3.0,1769.0,1.0,313.0,60.0,5.0,5.0,2,1007,79,17784,1772,153701,171485,12/19/2020
2020-07-18,85,26228,3272,291912,318140,5.0,2147.0,9.0,1778.0,1.0,314.0,55.0,5.0,4.0,4,1011,70,17854,1341,155042,172896,12/19/2020
2020-07-19,82,26310,2696,294608,320918,7.0,2154.0,3.0,1781.0,0.0,314.0,59.0,6.0,4.0,2,1013,57,17911,1093,156135,174046,12/19/2020
2020-07-20,71,26381,2666,297274,323655,9.0,2163.0,7.0,1788.0,0.0,314.0,61.0,7.0,5.0,2,1015,68,17979,1396,157531,175510,12/19/2020
2020-07-21,130,26511,4304,301578,328089,9.0,2172.0,11.0,1799.0,0.0,314.0,59.0,9.0,6.0,1,1016,108,18087,1842,159373,177460,12/19/2020
2020-07-22,130,26641,3928,305506,332147,7.0,2179.0,8.0,1807.0,1.0,315.0,57.0,7.0,6.0,1,1017,86,18173,1598,160971,179144,12/19/2020
2020-07-23,141,26782,4415,309921,336703,8.0,2187.0,6.0,1813.0,0.0,315.0,59.0,8.0,7.0,0,1017,115,18288,1893,162864,181152,12/19/2020
2020-07-24,172,26954,5966,315887,342841,15.0,2202.0,12.0,1825.0,0.0,315.0,62.0,9.0,7.0,0,1017,119,18407,2221,165085,183492,12/19/2020
2020-07-25,134,27088,4398,320285,347373,7.0,2209.0,7.0,1832.0,0.0,315.0,62.0,10.0,8.0,3,1020,108,18515,2020,167105,185620,12/19/2020
2020-07-26,62,27150,3033,323318,350468,8.0,2217.0,9.0,1841.0,0.0,315.0,61.0,11.0,7.0,1,1021,54,18569,1285,168390,186959,12/19/2020
2020-07-27,188,27338,4191,327509,354847,12.0,2229.0,7.0,1848.0,0.0,315.0,66.0,13.0,8.0,1,1022,138,18707,2242,170632,189339,12/19/2020
2020-07-28,105,27443,3840,331349,358792,5.0,2234.0,5.0,1853.0,0.0,315.0,66.0,14.0,7.0,1,1023,95,18802,1573,172205,191007,12/19/2020
2020-07-29,190,27633,5139,336488,364121,9.0,2243.0,10.0,1863.0,0.0,315.0,65.0,15.0,7.0,0,1023,154,18956,2212,174417,193373,12/19/2020
2020-07-30,121,27754,4345,340833,368587,6.0,2249.0,2.0,1865.0,1.0,316.0,68.0,15.0,6.0,1,1024,96,19052,1560,175977,195029,12/19/2020
2020-07-31,131,27885,5512,346345,374230,7.0,2256.0,9.0,1874.0,0.0,316.0,66.0,15.0,7.0,1,1025,89,19141,1766,177743,196884,12/19/2020
2020-08-01,109,27994,4294,350639,378633,7.0,2263.0,2.0,1876.0,0.0,316.0,71.0,14.0,7.0,1,1026,89,19230,1490,179233,198463,12/19/2020
2020-08-02,84,28078,2804,353443,381521,12.0,2275.0,12.0,1888.0,2.0,318.0,69.0,14.0,8.0,2,1028,62,19292,1224,180457,199749,12/19/2020
2020-08-03,188,28266,5248,358691,386957,11.0,2286.0,10.0,1898.0,0.0,318.0,70.0,16.0,7.0,1,1029,150,19442,2116,182573,202015,12/19/2020
2020-08-04,125,28391,3691,362382,390773,8.0,2294.0,5.0,1903.0,1.0,319.0,72.0,12.0,5.0,2,1031,99,19541,1702,184275,203816,12/19/2020
2020-08-05,147,28538,5935,368317,396855,11.0,2305.0,9.0,1912.0,1.0,320.0,73.0,10.0,5.0,2,1033,119,19660,2362,186637,206297,12/19/2020
2020-08-06,169,28707,5546,373863,402570,7.0,2312.0,9.0,1921.0,0.0,320.0,71.0,9.0,4.0,0,1033,120,19780,2284,188921,208701,12/19/2020
2020-08-07,123,28830,4851,378714,407544,12.0,2324.0,9.0,1930.0,1.0,321.0,73.0,9.0,3.0,2,1035,87,19867,2051,190972,210839,12/19/2020
2020-08-08,123,28953,4112,382826,411779,19.0,2343.0,6.0,1936.0,1.0,322.0,85.0,8.0,3.0,1,1036,91,19958,1711,192683,212641,12/19/2020
2020-08-09,42,28995,1727,384553,413548,6.0,2349.0,8.0,1944.0,0.0,322.0,83.0,9.0,4.0,0,1036,35,19993,1018,193701,213694,12/19/2020
2020-08-10,149,29144,4587,389140,418284,8.0,2357.0,9.0,1953.0,0.0,322.0,82.0,9.0,4.0,1,1037,113,20106,1945,195646,215752,12/19/2020
2020-08-11,106,29250,4334,393474,422724,5.0,2362.0,13.0,1966.0,0.0,322.0,74.0,10.0,4.0,3,1040,92,20198,2185,197831,218029,12/19/2020
2020-08-12,121,29371,5188,398662,428033,8.0,2370.0,11.0,1977.0,0.0,322.0,71.0,9.0,3.0,1,1041,101,20299,2514,200345,220644,12/19/2020
2020-08-13,135,29506,4196,402858,432364,13.0,2383.0,12.0,1989.0,0.0,322.0,72.0,11.0,3.0,0,1041,95,20394,1830,202175,222569,12/19/2020
2020-08-14,145,29651,5498,408356,438007,13.0,2396.0,11.0,2000.0,0.0,322.0,74.0,11.0,4.0,3,1044,98,20492,1897,204072,224564,12/19/2020
2020-08-15,106,29757,4534,412890,442647,9.0,2405.0,11.0,2011.0,1.0,323.0,71.0,11.0,5.0,0,1044,88,20580,1623,205695,226275,12/19/2020
2020-08-16,83,29840,2477,415367,445207,6.0,2411.0,5.0,2016.0,4.0,327.0,68.0,8.0,4.0,6,1050,70,20650,920,206615,227265,12/19/2020
2020-08-17,106,29946,4575,419942,449888,8.0,2419.0,6.0,2022.0,0.0,327.0,70.0,8.0,5.0,2,1052,87,20737,2301,208916,229653,12/19/2020
2020-08-18,128,30074,4911,424853,454927,11.0,2430.0,8.0,2030.0,1.0,328.0,72.0,8.0,4.0,5,1057,94,20831,2658,211574,232405,12/19/2020
2020-08-19,113,30187,5077,429930,460117,8.0,2438.0,9.0,2039.0,1.0,329.0,70.0,9.0,5.0,0,1057,90,20921,2548,214122,235043,12/19/2020
2020-08-20,173,30360,7411,437341,467701,12.0,2450.0,6.0,2045.0,2.0,331.0,74.0,10.0,5.0,3,1060,139,21060,3398,217520,238580,12/19/2020
2020-08-21,152,30512,6577,443918,474430,8.0,2458.0,5.0,2050.0,1.0,332.0,76.0,9.0,4.0,2,1062,125,21185,2822,220342,241527,12/19/2020
2020-08-22,96,30608,5550,449468,480076,11.0,2469.0,12.0,2062.0,0.0,332.0,75.0,11.0,4.0,1,1063,84,21269,2502,222844,244113,12/19/2020
2020-08-23,72,30680,4375,453843,484523,11.0,2480.0,6.0,2068.0,0.0,332.0,80.0,12.0,2.0,1,1064,56,21325,2411,225255,246580,12/19/2020
2020-08-24,105,30785,5784,459627,490412,7.0,2487.0,10.0,2078.0,1.0,333.0,76.0,14.0,4.0,1,1065,77,21402,3051,228306,249708,12/19/2020
2020-08-25,108,30893,4764,464391,495284,10.0,2497.0,4.0,2082.0,1.0,334.0,81.0,12.0,4.0,1,1066,92,21494,2216,230522,252016,12/19/2020
2020-08-26,170,31063,9482,473873,504936,4.0,2501.0,8.0,2090.0,0.0,334.0,77.0,10.0,5.0,1,1067,127,21621,2985,233507,255128,12/19/2020
2020-08-27,91,31154,8565,482438,513592,6.0,2507.0,13.0,2103.0,1.0,335.0,69.0,7.0,5.0,2,1069,70,21691,3040,236547,258238,12/19/2020
2020-08-28,113,31267,7994,490432,521699,14.0,2521.0,4.0,2107.0,0.0,335.0,79.0,10.0,7.0,2,1071,87,21778,2338,238885,260663,12/19/2020
2020-08-29,65,31332,5374,495806,527138,6.0,2527.0,8.0,2115.0,1.0,336.0,76.0,11.0,6.0,2,1073,51,21829,1855,240740,262569,12/19/2020
2020-08-30,66,31398,4323,500129,531527,7.0,2534.0,4.0,2119.0,0.0,336.0,79.0,9.0,5.0,2,1075,48,21877,1932,242672,264549,12/19/2020
2020-08-31,105,31503,4863,504992,536495,12.0,2546.0,16.0,2135.0,0.0,336.0,75.0,8.0,4.0,1,1076,81,21958,2118,244790,266748,12/19/2020
2020-09-01,99,31602,7109,512101,543703,6.0,2552.0,9.0,2144.0,1.0,337.0,71.0,7.0,4.0,2,1078,66,22024,2302,247092,269116,12/19/2020
2020-09-02,125,31727,10529,522630,554357,9.0,2561.0,10.0,2154.0,1.0,338.0,69.0,8.0,4.0,2,1080,104,22128,2956,250048,272176,12/19/2020
2020-09-03,90,31817,11080,533710,565527,8.0,2569.0,8.0,2162.0,0.0,338.0,69.0,9.0,4.0,3,1083,73,22201,2488,252536,274737,12/19/2020
2020-09-04,103,31920,8963,542673,574593,11.0,2580.0,4.0,2166.0,0.0,338.0,76.0,9.0,4.0,1,1084,83,22284,2290,254826,277110,12/19/2020
2020-09-05,52,31972,6309,548982,580954,6.0,2586.0,9.0,2175.0,0.0,338.0,73.0,8.0,3.0,1,1085,42,22326,1547,256373,278699,12/19/2020
2020-09-06,88,32060,4325,553307,585367,4.0,2590.0,8.0,2183.0,1.0,339.0,68.0,6.0,3.0,1,1086,65,22391,1879,258252,280643,12/19/2020
2020-09-07,35,32095,3002,556309,588404,11.0,2601.0,3.0,2186.0,0.0,339.0,76.0,5.0,3.0,1,1087,26,22417,619,258871,281288,12/19/2020
2020-09-08,74,32169,6381,562690,594859,6.0,2607.0,12.0,2198.0,1.0,340.0,69.0,6.0,3.0,2,1089,66,22483,1533,260404,282887,12/19/2020
2020-09-09,118,32287,8650,571340,603627,10.0,2617.0,5.0,2203.0,1.0,341.0,73.0,9.0,3.0,1,1090,102,22585,2050,262454,285039,12/19/2020
2020-09-10,164,32451,11334,582674,615125,9.0,2626.0,8.0,2211.0,0.0,341.0,74.0,10.0,3.0,1,1091,111,22696,2177,264631,287327,12/19/2020
2020-09-11,120,32571,9454,592128,624699,11.0,2637.0,11.0,2222.0,0.0,341.0,74.0,10.0,5.0,0,1091,96,22792,1889,266520,289312,12/19/2020
2020-09-12,110,32681,6174,598302,630983,8.0,2645.0,5.0,2227.0,2.0,343.0,75.0,9.0,5.0,3,1094,97,22889,1460,267980,290869,12/19/2020
2020-09-13,58,32739,2717,601019,633758,4.0,2649.0,3.0,2230.0,0.0,343.0,76.0,10.0,5.0,0,1094,54,22943,825,268805,291748,12/19/2020
2020-09-14,104,32843,6446,607465,640308,6.0,2655.0,3.0,2233.0,2.0,345.0,77.0,10.0,5.0,2,1096,95,23038,1653,270458,293496,12/19/2020
2020-09-15,122,32965,8470,615935,648900,7.0,2662.0,2.0,2235.0,1.0,346.0,81.0,10.0,5.0,2,1098,124,23162,2118,272576,295738,12/19/2020
2020-09-16,137,33102,9716,625651,658753,7.0,2669.0,7.0,2242.0,2.0,348.0,79.0,9.0,6.0,5,1103,118,23280,1907,274483,297763,12/19/2020
2020-09-17,125,33227,9239,634890,668117,7.0,2676.0,15.0,2257.0,0.0,348.0,71.0,8.0,4.0,0,1103,154,23434,1876,276359,299793,12/19/2020
2020-09-18,132,33359,10045,644935,678294,7.0,2683.0,7.0,2264.0,1.0,349.0,70.0,11.0,6.0,2,1105,132,23566,1852,278211,301777,12/19/2020
2020-09-19,115,33474,8297,653232,686706,7.0,2690.0,3.0,2267.0,0.0,349.0,74.0,10.0,6.0,4,1109,112,23678,1641,279852,303530,12/19/2020
2020-09-20,60,33534,3676,656908,690442,7.0,2697.0,6.0,2273.0,2.0,351.0,73.0,9.0,8.0,4,1113,49,23727,1283,281135,304862,12/19/2020
2020-09-21,102,33636,7018,663926,697562,12.0,2709.0,3.0,2276.0,2.0,353.0,80.0,8.0,6.0,2,1115,94,23821,2335,283470,307291,12/19/2020
2020-09-22,154,33790,9287,673213,707003,12.0,2721.0,3.0,2279.0,1.0,354.0,88.0,7.0,5.0,1,1116,124,23945,2119,285589,309534,12/19/2020
2020-09-23,136,33926,10651,683864,717790,13.0,2734.0,7.0,2286.0,0.0,354.0,94.0,6.0,5.0,0,1116,127,24072,2132,287721,311793,12/19/2020
2020-09-24,120,34046,12480,696344,730390,8.0,2742.0,9.0,2295.0,1.0,355.0,92.0,7.0,5.0,1,1117,120,24192,3074,290795,314987,12/19/2020
2020-09-25,150,34196,10553,706897,741093,9.0,2751.0,10.0,2305.0,0.0,355.0,91.0,6.0,5.0,1,1118,143,24335,2920,293715,318050,12/19/2020
2020-09-26,147,34343,10560,717457,751800,12.0,2763.0,9.0,2314.0,0.0,355.0,94.0,6.0,5.0,1,1119,120,24455,2352,296067,320522,12/19/2020
2020-09-27,43,34386,2764,720221,754607,7.0,2770.0,5.0,2319.0,0.0,355.0,96.0,9.0,5.0,0,1119,34,24489,818,296885,321374,12/19/2020
2020-09-28,156,34542,7307,727528,762070,7.0,2777.0,7.0,2326.0,2.0,357.0,94.0,7.0,5.0,2,1121,138,24627,2185,299070,323697,12/19/2020
2020-09-29,203,34745,11046,738574,773319,12.0,2789.0,18.0,2344.0,1.0,358.0,87.0,6.0,6.0,1,1122,185,24812,2739,301809,326621,12/19/2020
2020-09-30,223,34968,12230,750804,785772,6.0,2795.0,6.0,2350.0,0.0,358.0,87.0,6.0,6.0,1,1123,189,25001,2494,304303,329304,12/19/2020
2020-10-01,185,35153,12503,763307,798460,17.0,2812.0,13.0,2363.0,1.0,359.0,90.0,6.0,4.0,2,1125,166,25167,2327,306630,331797,12/19/2020
2020-10-02,209,35362,12154,775461,810823,14.0,2826.0,13.0,2376.0,1.0,360.0,90.0,8.0,5.0,2,1127,181,25348,2422,309052,334400,12/19/2020
2020-10-03,157,35519,9313,784774,820293,9.0,2835.0,9.0,2385.0,2.0,362.0,88.0,9.0,4.0,2,1129,131,25479,1955,311007,336486,12/19/2020
2020-10-04,81,35600,2369,787143,822743,11.0,2846.0,9.0,2394.0,1.0,363.0,89.0,8.0,5.0,2,1131,76,25555,924,311931,337486,12/19/2020
2020-10-05,174,35774,8985,796128,831902,30.0,2876.0,10.0,2404.0,2.0,365.0,107.0,9.0,6.0,4,1135,160,25715,2948,314879,340594,12/19/2020
2020-10-06,189,35963,11186,807314,843277,11.0,2887.0,4.0,2408.0,0.0,365.0,114.0,11.0,7.0,0,1135,188,25903,2811,317690,343593,12/19/2020
2020-10-07,244,36207,12444,819758,855965,13.0,2900.0,14.0,2422.0,2.0,367.0,111.0,9.0,7.0,2,1137,245,26148,3433,321123,347271,12/19/2020
2020-10-08,282,36489,15233,834991,871480,17.0,2917.0,13.0,2435.0,2.0,369.0,113.0,7.0,5.0,4,1141,276,26424,4099,325222,351646,12/19/2020
2020-10-09,229,36718,13745,848736,885454,21.0,2938.0,12.0,2447.0,0.0,369.0,122.0,10.0,7.0,3,1144,201,26625,4172,329394,356019,12/19/2020
2020-10-10,231,36949,13832,862568,899517,19.0,2957.0,10.0,2457.0,1.0,370.0,130.0,13.0,7.0,2,1146,191,26816,3686,333080,359896,12/19/2020
2020-10-11,99,37048,3263,865831,902879,12.0,2969.0,9.0,2466.0,1.0,371.0,132.0,14.0,5.0,6,1152,89,26905,1131,334211,361116,12/19/2020
2020-10-12,169,37217,6440,872271,909488,19.0,2988.0,15.0,2481.0,2.0,373.0,134.0,14.0,5.0,4,1156,156,27061,1673,335884,362945,12/19/2020
2020-10-13,224,37441,8522,880793,918234,15.0,3003.0,13.0,2494.0,4.0,377.0,132.0,13.0,5.0,7,1163,212,27273,2259,338143,365416,12/19/2020
2020-10-14,335,37776,15042,895835,933611,17.0,3020.0,7.0,2501.0,0.0,377.0,142.0,15.0,5.0,2,1165,304,27577,3916,342059,369636,12/19/2020
2020-10-15,269,38045,14643,910478,948523,12.0,3032.0,16.0,2517.0,1.0,378.0,137.0,13.0,5.0,2,1167,252,27829,3468,345527,373356,12/19/2020
2020-10-16,288,38333,15011,925489,963822,13.0,3045.0,18.0,2535.0,1.0,379.0,131.0,13.0,4.0,2,1169,277,28106,3274,348801,376907,12/19/2020
2020-10-17,360,38693,14069,939558,978251,19.0,3064.0,11.0,2546.0,1.0,380.0,138.0,17.0,4.0,2,1171,309,28415,3155,351956,380371,12/19/2020
2020-10-18,155,38848,4039,943597,982445,18.0,3082.0,11.0,2557.0,0.0,380.0,145.0,17.0,6.0,2,1173,125,28540,1267,353223,381763,12/19/2020
2020-10-19,385,39233,8492,952089,991322,21.0,3103.0,22.0,2579.0,2.0,382.0,142.0,15.0,6.0,1,1174,320,28860,2485,355708,384568,12/19/2020
2020-10-20,439,39672,13245,965334,1005006,23.0,3126.0,17.0,2596.0,0.0,382.0,148.0,14.0,8.0,3,1177,383,29243,2914,358622,387865,12/19/2020
2020-10-21,544,40216,17464,982798,1023014,23.0,3149.0,8.0,2604.0,2.0,384.0,161.0,15.0,9.0,3,1180,471,29714,3382,362004,391718,12/19/2020
2020-10-22,538,40754,15864,998662,1039416,24.0,3173.0,20.0,2624.0,3.0,387.0,162.0,14.0,9.0,3,1183,489,30203,3083,365087,395290,12/19/2020
2020-10-23,514,41268,16637,1015299,1056567,22.0,3195.0,22.0,2646.0,1.0,388.0,161.0,15.0,9.0,3,1186,458,30661,2796,367883,398544,12/19/2020
2020-10-24,360,41628,10249,1025548,1067176,17.0,3212.0,11.0,2657.0,0.0,388.0,167.0,14.0,8.0,1,1187,338,30999,2185,370068,401067,12/19/2020
2020-10-25,233,41861,4760,1030308,1072169,16.0,3228.0,15.0,2672.0,1.0,389.0,167.0,15.0,8.0,2,1189,210,31209,1404,371472,402681,12/19/2020
2020-10-26,454,42315,9174,1039482,1081797,28.0,3256.0,15.0,2687.0,2.0,391.0,178.0,18.0,8.0,3,1192,402,31611,2886,374358,405969,12/19/2020
2020-10-27,516,42831,13995,1053477,1096308,29.0,3285.0,15.0,2702.0,2.0,393.0,190.0,18.0,9.0,4,1196,454,32065,2326,376684,408749,12/19/2020
2020-10-28,469,43300,15230,1068707,1112007,25.0,3310.0,26.0,2728.0,1.0,394.0,188.0,17.0,9.0,3,1199,412,32477,2610,379294,411771,12/19/2020
2020-10-29,609,43909,16260,1084967,1128876,20.0,3330.0,22.0,2750.0,3.0,397.0,183.0,19.0,11.0,4,1203,529,33006,3037,382331,415337,12/19/2020
2020-10-30,565,44474,14865,1099832,1144306,21.0,3351.0,21.0,2771.0,5.0,402.0,178.0,19.0,9.0,4,1207,470,33476,2856,385187,418663,12/19/2020
2020-10-31,599,45073,11819,1111651,1156724,32.0,3383.0,13.0,2784.0,1.0,403.0,196.0,23.0,10.0,3,1210,486,33962,2341,387528,421490,12/19/2020
2020-11-01,330,45403,5091,1116742,1162145,22.0,3405.0,15.0,2799.0,1.0,404.0,202.0,27.0,13.0,4,1214,277,34239,1230,388758,422997,12/19/2020
2020-11-02,522,45925,9935,1126677,1172602,38.0,3443.0,27.0,2826.0,3.0,407.0,210.0,25.0,13.0,5,1219,459,34698,2848,391606,426304,12/19/2020
2020-11-03,601,46526,13041,1139718,1186244,33.0,3476.0,25.0,2851.0,1.0,408.0,217.0,25.0,13.0,1,1220,530,35228,2440,394046,429274,12/19/2020
2020-11-04,688,47214,16101,1155819,1203033,34.0,3510.0,27.0,2878.0,2.0,410.0,222.0,26.0,12.0,4,1224,642,35870,2841,396887,432757,12/19/2020
2020-11-05,768,47982,16593,1172412,1220394,46.0,3556.0,35.0,2913.0,1.0,411.0,232.0,25.0,14.0,3,1227,683,36553,2781,399668,436221,12/19/2020
2020-11-06,769,48751,16026,1188438,1237189,43.0,3599.0,31.0,2944.0,1.0,412.0,243.0,29.0,17.0,5,1232,691,37244,2963,402631,439875,12/19/2020
2020-11-07,604,49355,13649,1202087,1251442,34.0,3633.0,25.0,2969.0,1.0,413.0,251.0,32.0,18.0,1,1233,578,37822,2403,405034,442856,12/19/2020
2020-11-08,337,49692,4166,1206253,1255945,33.0,3666.0,26.0,2995.0,1.0,414.0,257.0,31.0,19.0,4,1237,322,38144,1248,406282,444426,12/19/2020
2020-11-09,808,50500,9063,1215316,1265816,40.0,3706.0,33.0,3028.0,2.0,416.0,262.0,29.0,18.0,3,1240,766,38910,2269,408551,447461,12/19/2020
2020-11-10,1053,51553,12982,1228298,1279851,45.0,3751.0,37.0,3065.0,0.0,416.0,270.0,32.0,18.0,6,1246,982,39892,2815,411366,451258,12/19/2020
2020-11-11,1087,52640,19738,1248036,1300676,42.0,3793.0,24.0,3089.0,5.0,421.0,283.0,31.0,15.0,7,1253,1003,40895,2614,413980,454875,12/19/2020
2020-11-12,893,53533,13913,1261949,1315482,39.0,3832.0,31.0,3120.0,3.0,424.0,288.0,29.0,15.0,5,1258,814,41709,2154,416134,457843,12/19/2020
2020-11-13,1165,54698,16391,1278340,1333038,39.0,3871.0,31.0,3151.0,0.0,424.0,296.0,28.0,15.0,2,1260,1115,42824,3031,419165,461989,12/19/2020
2020-11-14,782,55480,13519,1291859,1347339,42.0,3913.0,26.0,3177.0,5.0,429.0,307.0,26.0,13.0,10,1270,738,43562,2416,421581,465143,12/19/2020
2020-11-15,578,56058,6173,1298032,1354090,46.0,3959.0,21.0,3198.0,5.0,434.0,327.0,29.0,11.0,7,1277,495,44057,1391,422972,467029,12/19/2020
2020-11-16,739,56797,9647,1307679,1364476,56.0,4015.0,39.0,3237.0,3.0,437.0,341.0,27.0,13.0,5,1282,674,44731,2599,425571,470302,12/19/2020
2020-11-17,1538,58335,18176,1325855,1384190,59.0,4074.0,45.0,3282.0,2.0,439.0,353.0,31.0,13.0,5,1287,1402,46133,4047,429618,475751,12/19/2020
2020-11-18,1136,59471,16044,1341899,1401370,38.0,4112.0,38.0,3320.0,5.0,444.0,348.0,30.0,15.0,7,1294,1020,47153,3144,432762,479915,12/19/2020
2020-11-19,1128,60599,13170,1355069,1415668,46.0,4158.0,42.0,3362.0,4.0,448.0,348.0,31.0,18.0,5,1299,1032,48185,3348,436110,484295,12/19/2020
2020-11-20,1457,62056,22226,1377295,1439351,49.0,4207.0,48.0,3410.0,3.0,451.0,346.0,34.0,14.0,6,1305,1293,49478,4248,440358,489836,12/19/2020
2020-11-21,854,62910,17370,1394665,1457575,43.0,4250.0,34.0,3444.0,5.0,456.0,350.0,36.0,14.0,7,1312,756,50234,3087,443445,493679,12/19/2020
2020-11-22,571,63481,7519,1402184,1465665,65.0,4315.0,28.0,3472.0,4.0,460.0,383.0,34.0,15.0,11,1323,486,50720,1766,445211,495931,12/19/2020
2020-11-23,994,64475,11030,1413214,1477689,75.0,4390.0,41.0,3513.0,0.0,460.0,417.0,41.0,18.0,10,1333,893,51613,3356,448567,500180,12/19/2020
2020-11-24,1049,65524,14579,1427793,1493317,47.0,4437.0,59.0,3572.0,6.0,466.0,399.0,43.0,22.0,10,1343,940,52553,2729,451296,503849,12/19/2020
2020-11-25,1266,66790,18790,1446583,1513373,59.0,4496.0,58.0,3630.0,4.0,470.0,396.0,44.0,26.0,7,1350,1178,53731,3502,454798,508529,12/19/2020
2020-11-26,547,67337,6482,1453065,1520402,51.0,4547.0,35.0,3665.0,4.0,474.0,408.0,47.0,25.0,12,1362,467,54198,1552,456350,510548,12/19/2020
2020-11-27,1044,68381,9724,1462789,1531170,56.0,4603.0,49.0,3714.0,7.0,481.0,408.0,49.0,22.0,6,1368,969,55167,2494,458844,514011,12/19/2020
2020-11-28,1182,69563,11960,1474749,1544312,64.0,4667.0,40.0,3754.0,0.0,481.0,432.0,49.0,22.0,3,1371,1097,56264,2773,461617,517881,12/19/2020
2020-11-29,822,70385,6935,1481684,1552069,62.0,4729.0,36.0,3790.0,3.0,484.0,455.0,50.0,24.0,8,1379,753,57017,2287,463904,520921,12/19/2020
2020-11-30,1283,71668,9925,1491609,1563277,66.0,4795.0,59.0,3849.0,2.0,486.0,460.0,53.0,30.0,6,1385,1161,58178,2777,466681,524859,12/19/2020
2020-12-01,1555,73223,13953,1505562,1578785,62.0,4857.0,55.0,3904.0,4.0,490.0,463.0,52.0,31.0,12,1397,1420,59598,3341,470022,529620,12/19/2020
2020-12-02,1561,74784,15564,1521126,1595910,57.0,4914.0,53.0,3957.0,7.0,497.0,460.0,53.0,30.0,14,1411,1425,61023,3227,473249,534272,12/19/2020
2020-12-03,1772,76556,14626,1535752,1612308,63.0,4977.0,77.0,4034.0,5.0,502.0,441.0,49.0,31.0,10,1421,1639,62662,3296,476545,539207,12/19/2020
2020-12-04,1648,78204,16506,1552258,1630462,70.0,5047.0,50.0,4084.0,7.0,509.0,454.0,46.0,29.0,11,1432,1522,64184,3755,480300,544484,12/19/2020
2020-12-05,1199,79403,12609,1564867,1644270,71.0,5118.0,42.0,4126.0,4.0,513.0,479.0,48.0,28.0,11,1443,1066,65250,2867,483167,548417,12/19/2020
2020-12-06,1125,80528,7842,1572709,1653237,63.0,5181.0,50.0,4176.0,10.0,523.0,482.0,49.0,24.0,14,1457,980,66230,2462,485629,551859,12/19/2020
2020-12-07,1392,81920,10629,1583338,1665258,74.0,5255.0,58.0,4234.0,6.0,529.0,492.0,46.0,24.0,19,1476,1252,67482,3288,488917,556399,12/19/2020
2020-12-08,1464,83384,15293,1598631,1682015,57.0,5312.0,57.0,4291.0,5.0,534.0,487.0,49.0,26.0,17,1493,1318,68800,3542,492459,561259,12/19/2020
2020-12-09,1499,84883,16352,1614983,1699866,55.0,5367.0,62.0,4353.0,9.0,543.0,471.0,47.0,28.0,12,1505,1341,70141,3215,495674,565815,12/19/2020
2020-12-10,1474,86357,17253,1632236,1718593,62.0,5429.0,58.0,4411.0,6.0,549.0,469.0,55.0,28.0,17,1522,1254,71395,4082,499756,571151,12/19/2020
2020-12-11,1488,87845,17360,1649596,1737441,72.0,5501.0,82.0,4493.0,7.0,556.0,452.0,59.0,31.0,15,1537,1297,72692,3606,503362,576054,12/19/2020
2020-12-12,1099,88944,13050,1662646,1751590,64.0,5565.0,53.0,4546.0,9.0,565.0,454.0,51.0,31.0,15,1552,917,73609,3110,506472,580081,12/19/2020
2020-12-13,673,89617,7143,1669789,1759406,72.0,5637.0,39.0,4585.0,13.0,578.0,474.0,53.0,28.0,22,1574,560,74169,2011,508483,582652,12/19/2020
2020-12-14,1305,90922,11179,1680968,1771890,77.0,5714.0,61.0,4646.0,9.0,587.0,481.0,62.0,29.0,14,1588,1135,75304,3394,511877,587181,12/19/2020
2020-12-15,1253,92175,15030,1695998,1788173,63.0,5777.0,51.0,4697.0,5.0,592.0,488.0,58.0,27.0,13,1601,1062,76366,3074,514951,591317,12/19/2020
2020-12-16,1256,93431,18936,1714934,1808365,45.0,5822.0,64.0,4761.0,10.0,602.0,459.0,56.0,29.0,13,1614,1051,77417,3686,518637,596054,12/19/2020
2020-12-17,465,93896,8530,1723464,1817360,,,,,,,,,,11,1625,395,77812,1174,519811,597623,12/19/2020
2020-02-27,0,0,0,0,0,1.0,1.0,0.0,0.0,0.0,0.0,1.0,0.0,0.0,0,0,0,0,0,0,0,12/21/2020
2020-02-28,0,0,0,0,0,0.0,1.0,0.0,0.0,0.0,0.0,1.0,1.0,0.0,0,0,0,0,0,0,0,12/21/2020
2020-02-29,0,0,0,0,0,0.0,1.0,0.0,0.0,0.0,0.0,1.0,1.0,0.0,0,0,0,0,0,0,0,12/21/2020
2020-03-01,2,2,2,2,4,0.0,1.0,0.0,0.0,0.0,0.0,1.0,1.0,1.0,0,0,2,2,2,2,4,12/21/2020
2020-03-02,0,2,1,3,5,1.0,2.0,0.0,0.0,0.0,0.0,2.0,2.0,2.0,0,0,0,2,0,2,4,12/21/2020
2020-03-03,0,2,2,5,7,0.0,2.0,0.0,0.0,0.0,0.0,2.0,2.0,2.0,0,0,0,2,1,3,5,12/21/2020
2020-03-04,0,2,12,17,19,1.0,3.0,0.0,0.0,0.0,0.0,3.0,2.0,2.0,0,0,0,2,10,13,15,12/21/2020
2020-03-05,0,2,4,21,23,0.0,3.0,0.0,0.0,0.0,0.0,3.0,2.0,2.0,0,0,1,3,4,17,20,12/21/2020
2020-03-06,1,3,12,33,36,0.0,3.0,0.0,0.0,0.0,0.0,3.0,2.0,2.0,0,0,0,3,11,28,31,12/21/2020
2020-03-07,0,3,19,52,55,0.0,3.0,0.0,0.0,0.0,0.0,3.0,2.0,1.0,0,0,0,3,19,47,50,12/21/2020
2020-03-08,0,3,18,70,73,0.0,3.0,0.0,0.0,0.0,0.0,3.0,2.0,1.0,0,0,0,3,18,65,68,12/21/2020
2020-03-09,1,4,15,85,89,0.0,3.0,0.0,0.0,0.0,0.0,3.0,2.0,1.0,0,0,1,4,14,79,83,12/21/2020
2020-03-10,2,6,25,110,116,0.0,3.0,0.0,0.0,0.0,0.0,3.0,2.0,1.0,0,0,1,5,23,102,107,12/21/2020
2020-03-11,0,6,34,144,150,1.0,4.0,0.0,0.0,0.0,0.0,4.0,1.0,1.0,0,0,0,5,34,136,141,12/21/2020
2020-03-12,9,15,41,185,200,1.0,5.0,0.0,0.0,0.0,0.0,5.0,1.0,1.0,0,0,7,12,38,174,186,12/21/2020
2020-03-13,6,21,50,235,256,4.0,9.0,1.0,1.0,0.0,0.0,8.0,1.0,1.0,0,0,6,18,47,221,239,12/21/2020
2020-03-14,0,21,90,325,346,0.0,9.0,0.0,1.0,0.0,0.0,8.0,1.0,1.0,0,0,0,18,83,304,322,12/21/2020
2020-03-15,1,22,54,379,401,1.0,10.0,0.0,1.0,0.0,0.0,9.0,2.0,1.0,0,0,1,19,53,357,376,12/21/2020
2020-03-16,2,24,95,474,498,2.0,12.0,0.0,1.0,0.0,0.0,11.0,2.0,0.0,0,0,2,21,88,445,466,12/21/2020
2020-03-17,12,36,162,636,672,6.0,18.0,0.0,1.0,0.0,0.0,17.0,2.0,0.0,0,0,11,32,141,586,618,12/21/2020
2020-03-18,9,45,116,752,797,3.0,21.0,0.0,1.0,0.0,0.0,20.0,2.0,0.0,0,0,11,43,104,690,733,12/21/2020
2020-03-19,15,60,262,1014,1074,2.0,23.0,1.0,2.0,0.0,0.0,21.0,3.0,0.0,1,1,17,60,243,933,993,12/21/2020
2020-03-20,13,73,197,1211,1284,5.0,28.0,0.0,2.0,0.0,0.0,26.0,4.0,0.0,0,1,13,73,182,1115,1188,12/21/2020
2020-03-21,12,85,126,1337,1422,3.0,31.0,2.0,4.0,0.0,0.0,27.0,5.0,0.0,0,1,14,87,117,1232,1319,12/21/2020
2020-03-22,27,112,282,1619,1731,2.0,33.0,0.0,4.0,0.0,0.0,29.0,5.0,0.0,0,1,25,112,250,1482,1594,12/21/2020
2020-03-23,14,126,169,1788,1914,15.0,48.0,1.0,5.0,0.0,0.0,43.0,9.0,3.0,0,1,16,128,156,1638,1766,12/21/2020
2020-03-24,20,146,242,2030,2176,8.0,56.0,0.0,5.0,0.0,0.0,51.0,10.0,5.0,0,1,19,147,218,1856,2003,12/21/2020
2020-03-25,26,172,182,2212,2384,5.0,61.0,2.0,7.0,0.0,0.0,54.0,11.0,3.0,0,1,28,175,158,2014,2189,12/21/2020
2020-03-26,35,207,181,2393,2600,9.0,70.0,5.0,12.0,0.0,0.0,58.0,14.0,5.0,0,1,41,216,162,2176,2392,12/21/2020
2020-03-27,27,234,214,2607,2841,9.0,79.0,1.0,13.0,1.0,1.0,65.0,16.0,6.0,2,3,31,247,185,2361,2608,12/21/2020
2020-03-28,59,293,260,2867,3160,11.0,90.0,2.0,15.0,1.0,2.0,73.0,15.0,6.0,1,4,64,311,231,2592,2903,12/21/2020
2020-03-29,100,393,350,3217,3610,8.0,98.0,3.0,18.0,1.0,3.0,77.0,18.0,8.0,2,6,105,416,288,2880,3296,12/21/2020
2020-03-30,62,455,222,3439,3894,19.0,117.0,5.0,23.0,0.0,3.0,91.0,19.0,11.0,3,9,78,494,171,3051,3545,12/21/2020
2020-03-31,71,526,369,3808,4334,11.0,128.0,7.0,30.0,1.0,4.0,94.0,21.0,13.0,2,11,73,567,282,3333,3900,12/21/2020
2020-04-01,99,625,698,4506,5131,18.0,146.0,7.0,37.0,0.0,4.0,105.0,29.0,15.0,1,12,100,667,588,3921,4588,12/21/2020
2020-04-02,52,677,477,4983,5660,22.0,168.0,6.0,43.0,2.0,6.0,119.0,35.0,21.0,4,16,62,729,408,4329,5058,12/21/2020
2020-04-03,108,785,774,5757,6542,23.0,191.0,7.0,50.0,0.0,6.0,135.0,42.0,25.0,3,19,100,829,661,4990,5819,12/21/2020
2020-04-04,143,928,660,6417,7345,22.0,213.0,4.0,54.0,5.0,11.0,148.0,40.0,29.0,9,28,138,967,576,5566,6533,12/21/2020
2020-04-05,187,1115,1156,7573,8688,20.0,233.0,9.0,63.0,1.0,12.0,158.0,43.0,35.0,2,30,181,1148,976,6542,7690,12/21/2020
2020-04-06,218,1333,1706,9279,10612,26.0,259.0,7.0,70.0,0.0,12.0,177.0,47.0,39.0,7,37,207,1355,1448,7990,9345,12/21/2020
2020-04-07,284,1617,1629,10908,12525,20.0,279.0,4.0,74.0,2.0,14.0,191.0,49.0,41.0,5,42,260,1615,1384,9374,10989,12/21/2020
2020-04-08,290,1907,1720,12628,14535,19.0,298.0,8.0,82.0,5.0,19.0,197.0,49.0,37.0,10,52,271,1886,1453,10827,12713,12/21/2020
2020-04-09,283,2190,1516,14144,16334,32.0,330.0,8.0,90.0,4.0,23.0,217.0,53.0,40.0,7,59,277,2163,1263,12090,14253,12/21/2020
2020-04-10,419,2609,2574,16718,19327,29.0,359.0,17.0,107.0,5.0,28.0,224.0,59.0,41.0,11,70,400,2563,2210,14300,16863,12/21/2020
2020-04-11,298,2907,1905,18623,21530,29.0,388.0,11.0,118.0,2.0,30.0,240.0,61.0,48.0,12,82,280,2843,1613,15913,18756,12/21/2020
2020-04-12,315,3222,1670,20293,23515,35.0,423.0,13.0,131.0,5.0,35.0,257.0,59.0,49.0,9,91,286,3129,1300,17213,20342,12/21/2020
2020-04-13,161,3383,935,21228,24611,35.0,458.0,13.0,144.0,3.0,38.0,276.0,64.0,54.0,9,100,187,3316,781,17994,21310,12/21/2020
2020-04-14,290,3673,1787,23015,26688,27.0,485.0,18.0,162.0,5.0,43.0,280.0,72.0,53.0,8,108,261,3577,1411,19405,22982,12/21/2020
2020-04-15,350,4023,1799,24814,28837,31.0,516.0,20.0,182.0,3.0,46.0,288.0,72.0,54.0,17,125,306,3883,1407,20812,24695,12/21/2020
2020-04-16,447,4470,2494,27308,31778,36.0,552.0,25.0,207.0,6.0,52.0,293.0,72.0,53.0,14,139,387,4270,1894,22706,26976,12/21/2020
2020-04-17,304,4774,1821,29129,33903,32.0,584.0,20.0,227.0,7.0,59.0,298.0,66.0,45.0,21,160,290,4560,1315,24021,28581,12/21/2020
2020-04-18,321,5095,1725,30854,35949,26.0,610.0,18.0,245.0,4.0,63.0,302.0,63.0,49.0,15,175,284,4844,1227,25248,30092,12/21/2020
2020-04-19,381,5476,2047,32901,38377,23.0,633.0,26.0,271.0,1.0,64.0,298.0,65.0,55.0,11,186,337,5181,1628,26876,32057,12/21/2020
2020-04-20,394,5870,1907,34808,40678,46.0,679.0,29.0,300.0,2.0,66.0,313.0,75.0,56.0,10,196,376,5557,1459,28335,33892,12/21/2020
2020-04-21,444,6314,2110,36918,43232,45.0,724.0,32.0,332.0,5.0,71.0,321.0,72.0,56.0,18,214,382,5939,1594,29929,35868,12/21/2020
2020-04-22,418,6732,2390,39308,46040,41.0,765.0,32.0,364.0,5.0,76.0,325.0,73.0,58.0,18,232,380,6319,1757,31686,38005,12/21/2020
2020-04-23,479,7211,2469,41777,48988,32.0,797.0,28.0,392.0,5.0,81.0,324.0,76.0,62.0,15,247,412,6731,1716,33402,40133,12/21/2020
2020-04-24,491,7702,3284,45061,52763,35.0,832.0,26.0,418.0,4.0,85.0,329.0,85.0,63.0,15,262,407,7138,2340,35742,42880,12/21/2020
2020-04-25,393,8095,2206,47267,55362,34.0,866.0,17.0,435.0,5.0,90.0,341.0,85.0,62.0,14,276,299,7437,1578,37320,44757,12/21/2020
2020-04-26,316,8411,2309,49576,57987,33.0,899.0,15.0,450.0,3.0,93.0,356.0,86.0,59.0,14,290,274,7711,1715,39035,46746,12/21/2020
2020-04-27,249,8660,1620,51196,59856,29.0,928.0,21.0,471.0,4.0,97.0,360.0,86.0,61.0,10,300,206,7917,1067,40102,48019,12/21/2020
2020-04-28,410,9070,2263,53459,62529,44.0,972.0,24.0,495.0,3.0,100.0,377.0,88.0,59.0,22,322,330,8247,1513,41615,49862,12/21/2020
2020-04-29,476,9546,3343,56802,66348,36.0,1008.0,38.0,533.0,11.0,111.0,364.0,78.0,53.0,18,340,371,8618,2170,43785,52403,12/21/2020
2020-04-30,432,9978,2769,59571,69549,33.0,1041.0,38.0,571.0,6.0,117.0,353.0,83.0,57.0,24,364,351,8969,1711,45496,54465,12/21/2020
2020-05-01,454,10432,3086,62657,73089,52.0,1093.0,39.0,610.0,3.0,120.0,363.0,84.0,58.0,14,378,323,9292,1919,47415,56707,12/21/2020
2020-05-02,257,10689,1926,64583,75272,36.0,1129.0,38.0,648.0,5.0,125.0,356.0,93.0,63.0,24,402,193,9485,1164,48579,58064,12/21/2020
2020-05-03,283,10972,2160,66743,77715,31.0,1160.0,26.0,674.0,8.0,133.0,353.0,91.0,61.0,21,423,183,9668,1404,49983,59651,12/21/2020
2020-05-04,387,11359,2098,68841,80200,30.0,1190.0,31.0,705.0,6.0,139.0,346.0,89.0,58.0,18,441,290,9958,1448,51431,61389,12/21/2020
2020-05-05,433,11792,2873,71714,83506,29.0,1219.0,32.0,737.0,6.0,145.0,337.0,83.0,55.0,16,457,299,10257,1819,53250,63507,12/21/2020
2020-05-06,488,12280,2830,74544,86824,28.0,1247.0,44.0,781.0,9.0,154.0,312.0,80.0,55.0,21,478,340,10597,1770,55020,65617,12/21/2020
2020-05-07,425,12705,2969,77513,90218,36.0,1283.0,44.0,825.0,5.0,159.0,299.0,72.0,53.0,21,499,270,10867,1786,56806,67673,12/21/2020
2020-05-08,359,13064,2598,80111,93175,30.0,1313.0,29.0,854.0,5.0,164.0,295.0,72.0,54.0,22,521,230,11097,1543,58349,69446,12/21/2020
2020-05-09,467,13531,3346,83457,96988,22.0,1335.0,21.0,875.0,4.0,168.0,292.0,70.0,52.0,15,536,288,11385,2079,60428,71813,12/21/2020
2020-05-10,285,13816,2117,85574,99390,20.0,1355.0,23.0,898.0,6.0,174.0,283.0,71.0,50.0,14,550,190,11575,1390,61818,73393,12/21/2020
2020-05-11,257,14073,1857,87431,101504,31.0,1386.0,16.0,914.0,6.0,180.0,292.0,72.0,50.0,15,565,173,11748,1215,63033,74781,12/21/2020
2020-05-12,387,14460,2611,90042,104502,23.0,1409.0,18.0,932.0,4.0,184.0,293.0,70.0,49.0,22,587,224,11972,1516,64549,76521,12/21/2020
2020-05-13,351,14811,3630,93672,108483,23.0,1432.0,25.0,957.0,1.0,185.0,290.0,70.0,50.0,13,600,198,12170,1814,66363,78533,12/21/2020
2020-05-14,329,15140,3408,97080,112220,19.0,1451.0,27.0,984.0,3.0,188.0,279.0,65.0,46.0,15,615,233,12403,1844,68207,80610,12/21/2020
2020-05-15,381,15521,3458,100538,116059,24.0,1475.0,41.0,1025.0,5.0,193.0,257.0,63.0,46.0,14,629,232,12635,1691,69898,82533,12/21/2020
2020-05-16,449,15970,4156,104694,120664,25.0,1500.0,15.0,1040.0,5.0,198.0,262.0,62.0,47.0,15,644,247,12882,1808,71706,84588,12/21/2020
2020-05-17,240,16210,2768,107462,123672,17.0,1517.0,9.0,1049.0,5.0,203.0,265.0,60.0,46.0,10,654,126,13008,1424,73130,86138,12/21/2020
2020-05-18,250,16460,2001,109463,125923,19.0,1536.0,16.0,1065.0,5.0,208.0,263.0,58.0,41.0,18,672,135,13143,1286,74416,87559,12/21/2020
2020-05-19,415,16875,3168,112631,129506,23.0,1559.0,33.0,1098.0,5.0,213.0,248.0,57.0,39.0,11,683,215,13358,1806,76222,89580,12/21/2020
2020-05-20,326,17201,2771,115402,132603,19.0,1578.0,23.0,1121.0,7.0,220.0,237.0,53.0,34.0,22,705,183,13541,1425,77647,91188,12/21/2020
2020-05-21,374,17575,3757,119159,136734,25.0,1603.0,15.0,1136.0,3.0,223.0,244.0,54.0,30.0,20,725,168,13709,1828,79475,93184,12/21/2020
2020-05-22,351,17926,3161,122320,140246,20.0,1623.0,28.0,1164.0,5.0,228.0,231.0,53.0,30.0,11,736,206,13915,1493,80968,94883,12/21/2020
2020-05-23,253,18179,2742,125062,143241,19.0,1642.0,11.0,1175.0,3.0,231.0,236.0,53.0,33.0,13,749,109,14024,1200,82168,96192,12/21/2020
2020-05-24,163,18342,1370,126432,144774,13.0,1655.0,14.0,1189.0,2.0,233.0,233.0,54.0,36.0,8,757,83,14107,733,82901,97008,12/21/2020
2020-05-25,147,18489,1385,127817,146306,14.0,1669.0,14.0,1203.0,0.0,233.0,233.0,54.0,34.0,10,767,76,14183,680,83581,97764,12/21/2020
2020-05-26,285,18774,2620,130437,149211,24.0,1693.0,21.0,1224.0,5.0,238.0,231.0,49.0,33.0,15,782,158,14341,1547,85128,99469,12/21/2020
2020-05-27,276,19050,2057,132494,151544,20.0,1713.0,18.0,1242.0,3.0,241.0,230.0,51.0,33.0,10,792,132,14473,1081,86209,100682,12/21/2020
2020-05-28,348,19398,3359,135853,155251,17.0,1730.0,29.0,1271.0,4.0,245.0,214.0,47.0,32.0,8,800,130,14603,1035,87244,101847,12/21/2020
2020-05-29,410,19808,3915,139768,159576,19.0,1749.0,26.0,1297.0,7.0,252.0,200.0,43.0,31.0,12,812,174,14777,1458,88702,103479,12/21/2020
2020-05-30,225,20033,3915,143683,163716,16.0,1765.0,19.0,1316.0,4.0,256.0,193.0,41.0,29.0,12,824,109,14886,1629,90331,105217,12/21/2020
2020-05-31,155,20188,1690,145373,165561,11.0,1776.0,11.0,1327.0,1.0,257.0,192.0,44.0,26.0,3,827,78,14964,781,91112,106076,12/21/2020
2020-06-01,212,20400,2792,148165,168565,8.0,1784.0,14.0,1341.0,1.0,258.0,185.0,45.0,29.0,5,832,93,15057,1305,92417,107474,12/21/2020
2020-06-02,273,20673,3021,151186,171859,8.0,1792.0,9.0,1350.0,3.0,261.0,181.0,38.0,25.0,10,842,98,15155,1344,93761,108916,12/21/2020
2020-06-03,254,20927,3486,154672,175599,14.0,1806.0,18.0,1368.0,6.0,267.0,171.0,34.0,25.0,11,853,99,15254,1561,95322,110576,12/21/2020
2020-06-04,276,21203,4471,159143,180346,7.0,1813.0,26.0,1394.0,4.0,271.0,148.0,31.0,24.0,12,865,107,15361,1891,97213,112574,12/21/2020
2020-06-05,215,21418,3513,162656,184074,15.0,1828.0,13.0,1407.0,6.0,277.0,144.0,27.0,21.0,11,876,99,15460,1432,98645,114105,12/21/2020
2020-06-06,201,21619,2616,165272,186891,10.0,1838.0,7.0,1414.0,2.0,279.0,145.0,29.0,19.0,6,882,67,15527,1054,99699,115226,12/21/2020
2020-06-07,83,21702,1625,166897,188599,11.0,1849.0,7.0,1421.0,1.0,280.0,148.0,25.0,17.0,4,886,51,15578,757,100456,116034,12/21/2020
2020-06-08,119,21821,1849,168746,190567,15.0,1864.0,13.0,1434.0,2.0,282.0,148.0,27.0,18.0,4,890,45,15623,902,101358,116981,12/21/2020
2020-06-09,223,22044,2673,171419,193463,10.0,1874.0,19.0,1453.0,0.0,282.0,139.0,28.0,21.0,1,891,64,15687,1193,102551,118238,12/21/2020
2020-06-10,209,22253,2987,174406,196659,13.0,1887.0,12.0,1465.0,2.0,284.0,138.0,24.0,17.0,4,895,100,15787,1399,103950,119737,12/21/2020
2020-06-11,195,22448,3513,177919,200367,7.0,1894.0,15.0,1480.0,1.0,285.0,129.0,25.0,16.0,6,901,88,15875,1444,105394,121269,12/21/2020
2020-06-12,209,22657,4601,182520,205177,9.0,1903.0,16.0,1496.0,1.0,286.0,121.0,24.0,16.0,2,903,78,15953,1979,107373,123326,12/21/2020
2020-06-13,113,22770,3036,185556,208326,6.0,1909.0,5.0,1501.0,0.0,286.0,122.0,20.0,15.0,3,906,49,16002,1252,108625,124627,12/21/2020
2020-06-14,81,22851,2046,187602,210453,7.0,1916.0,8.0,1509.0,1.0,287.0,120.0,20.0,14.0,3,909,33,16035,922,109547,125582,12/21/2020
2020-06-15,188,23039,3108,190710,213749,14.0,1930.0,19.0,1528.0,0.0,287.0,115.0,20.0,16.0,5,914,75,16110,1698,111245,127355,12/21/2020
2020-06-16,110,23149,3017,193727,216876,11.0,1941.0,9.0,1537.0,1.0,288.0,116.0,22.0,16.0,8,922,50,16160,1461,112706,128866,12/21/2020
2020-06-17,127,23276,2835,196562,219838,15.0,1956.0,20.0,1557.0,4.0,292.0,107.0,18.0,14.0,6,928,51,16211,1251,113957,130168,12/21/2020
2020-06-18,149,23425,3049,199611,223036,9.0,1965.0,15.0,1572.0,1.0,293.0,100.0,19.0,16.0,7,935,70,16281,1246,115203,131484,12/21/2020
2020-06-19,141,23566,3769,203380,226946,12.0,1977.0,12.0,1584.0,1.0,294.0,99.0,20.0,17.0,3,938,59,16340,1300,116503,132843,12/21/2020
2020-06-20,84,23650,1891,205271,228921,9.0,1986.0,12.0,1596.0,0.0,294.0,96.0,20.0,18.0,4,942,36,16376,774,117277,133653,12/21/2020
2020-06-21,37,23687,1064,206335,230022,8.0,1994.0,5.0,1601.0,0.0,294.0,99.0,20.0,18.0,2,944,30,16406,653,117930,134336,12/21/2020
2020-06-22,138,23825,3730,210065,233890,12.0,2006.0,17.0,1618.0,0.0,294.0,94.0,19.0,18.0,2,946,65,16471,1625,119555,136026,12/21/2020
2020-06-23,163,23988,3830,213895,237883,3.0,2009.0,13.0,1631.0,3.0,297.0,81.0,18.0,18.0,7,953,81,16552,1699,121254,137806,12/21/2020
2020-06-24,120,24108,3502,217397,241505,9.0,2018.0,10.0,1641.0,1.0,298.0,79.0,18.0,18.0,5,958,45,16597,1592,122846,139443,12/21/2020
2020-06-25,103,24211,2883,220280,244491,6.0,2024.0,14.0,1655.0,1.0,299.0,70.0,17.0,17.0,1,959,51,16648,1424,124270,140918,12/21/2020
2020-06-26,94,24305,2488,222768,247073,2.0,2026.0,10.0,1665.0,0.0,299.0,62.0,18.0,18.0,1,960,60,16708,1265,125535,142243,12/21/2020
2020-06-27,84,24389,3216,225984,250373,5.0,2031.0,3.0,1668.0,1.0,300.0,63.0,17.0,17.0,5,965,37,16745,1156,126691,143436,12/21/2020
2020-06-28,39,24428,1469,227453,251881,4.0,2035.0,4.0,1672.0,4.0,304.0,59.0,15.0,14.0,6,971,17,16762,571,127262,144024,12/21/2020
2020-06-29,85,24513,3697,231150,255663,4.0,2039.0,5.0,1677.0,0.0,304.0,58.0,14.0,14.0,1,972,39,16801,1293,128555,145356,12/21/2020
2020-06-30,58,24571,1958,233108,257679,1.0,2040.0,5.0,1682.0,1.0,305.0,53.0,12.0,11.0,4,976,33,16834,951,129506,146340,12/21/2020
2020-07-01,144,24715,4098,237206,261921,8.0,2048.0,10.0,1692.0,0.0,305.0,51.0,11.0,11.0,1,977,79,16913,1844,131350,148263,12/21/2020
2020-07-02,103,24818,2803,240009,264827,5.0,2053.0,5.0,1697.0,1.0,306.0,50.0,10.0,10.0,3,980,59,16972,1034,132384,149356,12/21/2020
2020-07-03,50,24868,2079,242088,266956,9.0,2062.0,6.0,1703.0,0.0,306.0,53.0,9.0,9.0,3,983,24,16996,747,133131,150127,12/21/2020
2020-07-04,57,24925,2345,244433,269358,2.0,2064.0,4.0,1707.0,1.0,307.0,50.0,10.0,9.0,2,985,33,17029,963,134094,151123,12/21/2020
2020-07-05,49,24974,2932,247365,272339,1.0,2065.0,2.0,1709.0,1.0,308.0,48.0,8.0,8.0,2,987,26,17055,1352,135446,152501,12/21/2020
2020-07-06,101,25075,2814,250179,275254,6.0,2071.0,6.0,1715.0,0.0,308.0,48.0,9.0,9.0,4,991,57,17112,1490,136936,154048,12/21/2020
2020-07-07,81,25156,3457,253636,278792,5.0,2076.0,7.0,1722.0,0.0,308.0,46.0,8.0,8.0,2,993,47,17159,1475,138411,155570,12/21/2020
2020-07-08,105,25261,3409,257045,282306,4.0,2080.0,2.0,1724.0,0.0,308.0,48.0,9.0,8.0,0,993,64,17223,1344,139755,156978,12/21/2020
2020-07-09,94,25355,3714,260759,286114,9.0,2089.0,3.0,1727.0,0.0,308.0,54.0,9.0,8.0,0,993,50,17273,1545,141300,158573,12/21/2020
2020-07-10,132,25487,4437,265196,290683,6.0,2095.0,3.0,1730.0,2.0,310.0,55.0,7.0,7.0,3,996,80,17353,1979,143279,160632,12/21/2020
2020-07-11,63,25550,2938,268134,293684,6.0,2101.0,3.0,1733.0,1.0,311.0,57.0,6.0,6.0,3,999,36,17389,1255,144534,161923,12/21/2020
2020-07-12,47,25597,1838,269972,295569,1.0,2102.0,3.0,1736.0,1.0,312.0,54.0,6.0,5.0,3,1002,34,17423,905,145439,162862,12/21/2020
2020-07-13,84,25681,3209,273181,298862,8.0,2110.0,10.0,1746.0,0.0,312.0,52.0,6.0,5.0,1,1003,61,17484,1440,146879,164363,12/21/2020
2020-07-14,74,25755,3298,276479,302234,7.0,2117.0,4.0,1750.0,0.0,312.0,55.0,5.0,5.0,1,1004,44,17528,1327,148206,165734,12/21/2020
2020-07-15,130,25885,4181,280660,306545,5.0,2122.0,7.0,1757.0,0.0,312.0,53.0,5.0,4.0,0,1004,100,17628,1677,149883,167511,12/21/2020
2020-07-16,103,25988,3740,284400,310388,6.0,2128.0,9.0,1766.0,0.0,312.0,50.0,6.0,5.0,1,1005,76,17704,1532,151415,169119,12/21/2020
2020-07-17,156,26144,4239,288639,314783,14.0,2142.0,3.0,1769.0,1.0,313.0,60.0,5.0,5.0,2,1007,79,17783,1769,153184,170967,12/21/2020
2020-07-18,85,26229,3272,291911,318140,5.0,2147.0,9.0,1778.0,1.0,314.0,55.0,5.0,4.0,4,1011,70,17853,1335,154519,172372,12/21/2020
2020-07-19,82,26311,2696,294607,320918,7.0,2154.0,3.0,1781.0,0.0,314.0,59.0,6.0,4.0,2,1013,57,17910,1092,155611,173521,12/21/2020
2020-07-20,71,26382,2666,297273,323655,9.0,2163.0,7.0,1788.0,0.0,314.0,61.0,7.0,5.0,2,1015,68,17978,1390,157001,174979,12/21/2020
2020-07-21,130,26512,4304,301577,328089,9.0,2172.0,11.0,1799.0,0.0,314.0,59.0,9.0,6.0,1,1016,108,18086,1840,158841,176927,12/21/2020
2020-07-22,130,26642,3928,305505,332147,7.0,2179.0,8.0,1807.0,1.0,315.0,57.0,7.0,6.0,1,1017,86,18172,1594,160435,178607,12/21/2020
2020-07-23,141,26783,4415,309920,336703,8.0,2187.0,6.0,1813.0,0.0,315.0,59.0,8.0,7.0,0,1017,115,18287,1889,162324,180611,12/21/2020
2020-07-24,172,26955,5966,315886,342841,15.0,2202.0,12.0,1825.0,0.0,315.0,62.0,9.0,7.0,0,1017,119,18406,2218,164542,182948,12/21/2020
2020-07-25,134,27089,4398,320284,347373,7.0,2209.0,7.0,1832.0,0.0,315.0,62.0,10.0,8.0,3,1020,108,18514,2016,166558,185072,12/21/2020
2020-07-26,62,27151,3033,323317,350468,8.0,2217.0,9.0,1841.0,0.0,315.0,61.0,11.0,7.0,1,1021,54,18568,1280,167838,186406,12/21/2020
2020-07-27,188,27339,4191,327508,354847,12.0,2229.0,7.0,1848.0,0.0,315.0,66.0,13.0,8.0,1,1022,138,18706,2237,170075,188781,12/21/2020
2020-07-28,105,27444,3840,331348,358792,5.0,2234.0,5.0,1853.0,0.0,315.0,66.0,14.0,7.0,1,1023,95,18801,1568,171643,190444,12/21/2020
2020-07-29,190,27634,5139,336487,364121,9.0,2243.0,10.0,1863.0,0.0,315.0,65.0,15.0,7.0,0,1023,154,18955,2203,173846,192801,12/21/2020
2020-07-30,121,27755,4345,340832,368587,6.0,2249.0,2.0,1865.0,1.0,316.0,68.0,15.0,6.0,1,1024,96,19051,1558,175404,194455,12/21/2020
2020-07-31,131,27886,5512,346344,374230,7.0,2256.0,9.0,1874.0,0.0,316.0,66.0,15.0,7.0,1,1025,89,19140,1762,177166,196306,12/21/2020
2020-08-01,109,27995,4294,350638,378633,7.0,2263.0,2.0,1876.0,0.0,316.0,71.0,14.0,7.0,1,1026,89,19229,1487,178653,197882,12/21/2020
2020-08-02,84,28079,2804,353442,381521,12.0,2275.0,12.0,1888.0,2.0,318.0,69.0,14.0,8.0,2,1028,62,19291,1222,179875,199166,12/21/2020
2020-08-03,188,28267,5248,358690,386957,11.0,2286.0,10.0,1898.0,0.0,318.0,70.0,16.0,7.0,1,1029,150,19441,2106,181981,201422,12/21/2020
2020-08-04,125,28392,3691,362381,390773,8.0,2294.0,5.0,1903.0,1.0,319.0,72.0,12.0,5.0,2,1031,99,19540,1698,183679,203219,12/21/2020
2020-08-05,147,28539,5934,368315,396854,11.0,2305.0,9.0,1912.0,1.0,320.0,73.0,10.0,5.0,2,1033,119,19659,2357,186036,205695,12/21/2020
2020-08-06,169,28708,5546,373861,402569,7.0,2312.0,9.0,1921.0,0.0,320.0,71.0,9.0,4.0,0,1033,120,19779,2277,188313,208092,12/21/2020
2020-08-07,123,28831,4851,378712,407543,12.0,2324.0,9.0,1930.0,1.0,321.0,73.0,9.0,3.0,2,1035,87,19866,2045,190358,210224,12/21/2020
2020-08-08,123,28954,4112,382824,411778,19.0,2343.0,6.0,1936.0,1.0,322.0,85.0,8.0,3.0,1,1036,91,19957,1709,192067,212024,12/21/2020
2020-08-09,42,28996,1727,384551,413547,6.0,2349.0,8.0,1944.0,0.0,322.0,83.0,9.0,4.0,0,1036,35,19992,1016,193083,213075,12/21/2020
2020-08-10,149,29145,4587,389138,418283,8.0,2357.0,9.0,1953.0,0.0,322.0,82.0,9.0,4.0,1,1037,113,20105,1943,195026,215131,12/21/2020
2020-08-11,106,29251,4334,393472,422723,5.0,2362.0,13.0,1966.0,0.0,322.0,74.0,10.0,4.0,3,1040,92,20197,2183,197209,217406,12/21/2020
2020-08-12,121,29372,5188,398660,428032,8.0,2370.0,11.0,1977.0,0.0,322.0,71.0,9.0,3.0,1,1041,101,20298,2512,199721,220019,12/21/2020
2020-08-13,135,29507,4196,402856,432363,13.0,2383.0,12.0,1989.0,0.0,322.0,72.0,11.0,3.0,0,1041,95,20393,1824,201545,221938,12/21/2020
2020-08-14,145,29652,5498,408354,438006,13.0,2396.0,11.0,2000.0,0.0,322.0,74.0,11.0,4.0,3,1044,98,20491,1891,203436,223927,12/21/2020
2020-08-15,106,29758,4534,412888,442646,9.0,2405.0,11.0,2011.0,1.0,323.0,71.0,11.0,5.0,0,1044,88,20579,1620,205056,225635,12/21/2020
2020-08-16,83,29841,2477,415365,445206,6.0,2411.0,5.0,2016.0,4.0,327.0,68.0,8.0,4.0,6,1050,70,20649,916,205972,226621,12/21/2020
2020-08-17,106,29947,4575,419940,449887,8.0,2419.0,6.0,2022.0,0.0,327.0,70.0,8.0,5.0,2,1052,87,20736,2295,208267,229003,12/21/2020
2020-08-18,128,30075,4911,424851,454926,11.0,2430.0,8.0,2030.0,1.0,328.0,72.0,8.0,4.0,5,1057,94,20830,2653,210920,231750,12/21/2020
2020-08-19,113,30188,5076,429927,460115,8.0,2438.0,9.0,2039.0,1.0,329.0,70.0,9.0,5.0,0,1057,90,20920,2543,213463,234383,12/21/2020
2020-08-20,173,30361,7411,437338,467699,12.0,2450.0,6.0,2045.0,2.0,331.0,74.0,10.0,5.0,3,1060,139,21059,3392,216855,237914,12/21/2020
2020-08-21,152,30513,6577,443915,474428,8.0,2458.0,5.0,2050.0,1.0,332.0,76.0,9.0,4.0,2,1062,125,21184,2818,219673,240857,12/21/2020
2020-08-22,96,30609,5550,449465,480074,11.0,2469.0,12.0,2062.0,0.0,332.0,75.0,11.0,4.0,1,1063,84,21268,2499,222172,243440,12/21/2020
2020-08-23,72,30681,4375,453840,484521,11.0,2480.0,6.0,2068.0,0.0,332.0,80.0,12.0,2.0,1,1064,56,21324,2408,224580,245904,12/21/2020
2020-08-24,105,30786,5784,459624,490410,7.0,2487.0,10.0,2078.0,1.0,333.0,76.0,14.0,4.0,1,1065,77,21401,3045,227625,249026,12/21/2020
2020-08-25,108,30894,4764,464388,495282,10.0,2497.0,4.0,2082.0,1.0,334.0,81.0,12.0,4.0,1,1066,92,21493,2213,229838,251331,12/21/2020
2020-08-26,170,31064,9482,473870,504934,4.0,2501.0,8.0,2090.0,0.0,334.0,77.0,10.0,5.0,1,1067,127,21620,2974,232812,254432,12/21/2020
2020-08-27,91,31155,8565,482435,513590,6.0,2507.0,13.0,2103.0,1.0,335.0,69.0,7.0,5.0,2,1069,70,21690,3035,235847,257537,12/21/2020
2020-08-28,113,31268,7994,490429,521697,14.0,2521.0,4.0,2107.0,0.0,335.0,79.0,10.0,7.0,2,1071,87,21777,2338,238185,259962,12/21/2020
2020-08-29,65,31333,5374,495803,527136,6.0,2527.0,8.0,2115.0,1.0,336.0,76.0,11.0,6.0,2,1073,51,21828,1850,240035,261863,12/21/2020
2020-08-30,66,31399,4323,500126,531525,7.0,2534.0,4.0,2119.0,0.0,336.0,79.0,9.0,5.0,2,1075,48,21876,1930,241965,263841,12/21/2020
2020-08-31,105,31504,4863,504989,536493,12.0,2546.0,16.0,2135.0,0.0,336.0,75.0,8.0,4.0,1,1076,81,21957,2115,244080,266037,12/21/2020
2020-09-01,99,31603,7109,512098,543701,6.0,2552.0,9.0,2144.0,1.0,337.0,71.0,7.0,4.0,2,1078,66,22023,2298,246378,268401,12/21/2020
2020-09-02,125,31728,10529,522627,554355,9.0,2561.0,10.0,2154.0,1.0,338.0,69.0,8.0,4.0,2,1080,104,22127,2953,249331,271458,12/21/2020
2020-09-03,90,31818,11080,533707,565525,8.0,2569.0,8.0,2162.0,0.0,338.0,69.0,9.0,4.0,3,1083,73,22200,2482,251813,274013,12/21/2020
2020-09-04,103,31921,8963,542670,574591,11.0,2580.0,4.0,2166.0,0.0,338.0,76.0,9.0,4.0,1,1084,83,22283,2284,254097,276380,12/21/2020
2020-09-05,52,31973,6306,548976,580949,6.0,2586.0,9.0,2175.0,0.0,338.0,73.0,8.0,3.0,1,1085,42,22325,1542,255639,277964,12/21/2020
2020-09-06,88,32061,4325,553301,585362,4.0,2590.0,8.0,2183.0,1.0,339.0,68.0,6.0,3.0,1,1086,65,22390,1873,257512,279902,12/21/2020
2020-09-07,35,32096,3002,556303,588399,11.0,2601.0,3.0,2186.0,0.0,339.0,76.0,5.0,3.0,1,1087,26,22416,619,258131,280547,12/21/2020
2020-09-08,74,32170,6381,562684,594854,6.0,2607.0,12.0,2198.0,1.0,340.0,69.0,6.0,3.0,2,1089,66,22482,1531,259662,282144,12/21/2020
2020-09-09,118,32288,8650,571334,603622,10.0,2617.0,5.0,2203.0,1.0,341.0,73.0,9.0,3.0,1,1090,102,22584,2046,261708,284292,12/21/2020
2020-09-10,164,32452,11334,582668,615120,9.0,2626.0,8.0,2211.0,0.0,341.0,74.0,10.0,3.0,1,1091,111,22695,2172,263880,286575,12/21/2020
2020-09-11,120,32572,9454,592122,624694,11.0,2637.0,11.0,2222.0,0.0,341.0,74.0,10.0,5.0,0,1091,95,22790,1883,265763,288553,12/21/2020
2020-09-12,110,32682,6158,598280,630962,8.0,2645.0,5.0,2227.0,2.0,343.0,75.0,9.0,5.0,3,1094,97,22887,1435,267198,290085,12/21/2020
2020-09-13,58,32740,2717,600997,633737,4.0,2649.0,3.0,2230.0,0.0,343.0,76.0,10.0,5.0,0,1094,54,22941,822,268020,290961,12/21/2020
2020-09-14,104,32844,6434,607431,640275,6.0,2655.0,3.0,2233.0,2.0,345.0,77.0,10.0,5.0,2,1096,95,23036,1641,269661,292697,12/21/2020
2020-09-15,122,32966,8457,615888,648854,7.0,2662.0,2.0,2235.0,1.0,346.0,81.0,10.0,5.0,2,1098,124,23160,2102,271763,294923,12/21/2020
2020-09-16,137,33103,9706,625594,658697,7.0,2669.0,7.0,2242.0,2.0,348.0,79.0,9.0,6.0,5,1103,118,23278,1896,273659,296937,12/21/2020
2020-09-17,125,33228,9228,634822,668050,7.0,2676.0,15.0,2257.0,0.0,348.0,71.0,8.0,4.0,0,1103,154,23432,1859,275518,298950,12/21/2020
2020-09-18,132,33360,10028,644850,678210,7.0,2683.0,7.0,2264.0,1.0,349.0,70.0,11.0,6.0,2,1105,132,23564,1846,277364,300928,12/21/2020
2020-09-19,115,33475,8292,653142,686617,7.0,2690.0,3.0,2267.0,0.0,349.0,74.0,10.0,6.0,4,1109,112,23676,1637,279001,302677,12/21/2020
2020-09-20,60,33535,3676,656818,690353,7.0,2697.0,6.0,2273.0,2.0,351.0,73.0,9.0,8.0,4,1113,49,23725,1280,280281,304006,12/21/2020
2020-09-21,102,33637,7006,663824,697461,12.0,2709.0,3.0,2276.0,2.0,353.0,80.0,8.0,6.0,2,1115,94,23819,2329,282610,306429,12/21/2020
2020-09-22,154,33791,9273,673097,706888,12.0,2721.0,3.0,2279.0,1.0,354.0,88.0,7.0,5.0,1,1116,124,23943,2111,284721,308664,12/21/2020
2020-09-23,136,33927,10639,683736,717663,13.0,2734.0,7.0,2286.0,0.0,354.0,94.0,6.0,5.0,0,1116,127,24070,2125,286846,310916,12/21/2020
2020-09-24,120,34047,12469,696205,730252,8.0,2742.0,9.0,2295.0,1.0,355.0,92.0,7.0,5.0,1,1117,120,24190,3069,289915,314105,12/21/2020
2020-09-25,150,34197,10546,706751,740948,9.0,2751.0,10.0,2305.0,0.0,355.0,91.0,6.0,5.0,1,1118,143,24333,2912,292827,317160,12/21/2020
2020-09-26,147,34344,10556,717307,751651,12.0,2763.0,9.0,2314.0,0.0,355.0,94.0,6.0,5.0,1,1119,120,24453,2345,295172,319625,12/21/2020
2020-09-27,43,34387,2764,720071,754458,7.0,2770.0,5.0,2319.0,0.0,355.0,96.0,9.0,5.0,0,1119,34,24487,815,295987,320474,12/21/2020
2020-09-28,156,34543,7294,727365,761908,7.0,2777.0,7.0,2326.0,2.0,357.0,94.0,7.0,5.0,2,1121,138,24625,2181,298168,322793,12/21/2020
2020-09-29,203,34746,11033,738398,773144,12.0,2789.0,18.0,2344.0,1.0,358.0,87.0,6.0,6.0,1,1122,185,24810,2732,300900,325710,12/21/2020
2020-09-30,223,34969,12219,750617,785586,6.0,2795.0,6.0,2350.0,0.0,358.0,87.0,6.0,6.0,1,1123,189,24999,2485,303385,328384,12/21/2020
2020-10-01,184,35153,12492,763109,798262,17.0,2812.0,13.0,2363.0,1.0,359.0,90.0,6.0,4.0,2,1125,166,25165,2320,305705,330870,12/21/2020
2020-10-02,209,35362,12148,775257,810619,14.0,2826.0,13.0,2376.0,1.0,360.0,90.0,8.0,5.0,2,1127,181,25346,2409,308114,333460,12/21/2020
2020-10-03,157,35519,9304,784561,820080,9.0,2835.0,9.0,2385.0,2.0,362.0,88.0,9.0,4.0,2,1129,131,25477,1947,310061,335538,12/21/2020
2020-10-04,81,35600,2369,786930,822530,11.0,2846.0,9.0,2394.0,1.0,363.0,89.0,8.0,5.0,2,1131,76,25553,922,310983,336536,12/21/2020
2020-10-05,174,35774,8963,795893,831667,30.0,2876.0,10.0,2404.0,2.0,365.0,107.0,9.0,6.0,4,1135,160,25713,2939,313922,339635,12/21/2020
2020-10-06,189,35963,11186,807079,843042,11.0,2887.0,4.0,2408.0,0.0,365.0,114.0,11.0,7.0,0,1135,188,25901,2806,316728,342629,12/21/2020
2020-10-07,244,36207,12426,819505,855712,13.0,2900.0,14.0,2422.0,2.0,367.0,111.0,9.0,7.0,2,1137,245,26146,3423,320151,346297,12/21/2020
2020-10-08,282,36489,15221,834726,871215,17.0,2917.0,13.0,2435.0,2.0,369.0,113.0,7.0,5.0,4,1141,276,26422,4088,324239,350661,12/21/2020
2020-10-09,229,36718,13728,848454,885172,21.0,2938.0,12.0,2447.0,0.0,369.0,122.0,10.0,7.0,3,1144,201,26623,4155,328394,355017,12/21/2020
2020-10-10,231,36949,13827,862281,899230,19.0,2957.0,10.0,2457.0,1.0,370.0,130.0,13.0,7.0,2,1146,191,26814,3679,332073,358887,12/21/2020
2020-10-11,99,37048,3263,865544,902592,12.0,2969.0,9.0,2466.0,1.0,371.0,132.0,14.0,5.0,6,1152,89,26903,1130,333203,360106,12/21/2020
2020-10-12,169,37217,6418,871962,909179,19.0,2988.0,15.0,2481.0,2.0,373.0,134.0,14.0,5.0,4,1156,156,27059,1667,334870,361929,12/21/2020
2020-10-13,224,37441,8517,880479,917920,15.0,3003.0,13.0,2494.0,4.0,377.0,132.0,13.0,5.0,7,1163,212,27271,2249,337119,364390,12/21/2020
2020-10-14,335,37776,15032,895511,933287,17.0,3020.0,7.0,2501.0,0.0,377.0,142.0,15.0,5.0,2,1165,304,27575,3911,341030,368605,12/21/2020
2020-10-15,269,38045,14625,910136,948181,12.0,3032.0,16.0,2517.0,1.0,378.0,137.0,13.0,5.0,2,1167,252,27827,3462,344492,372319,12/21/2020
2020-10-16,288,38333,15008,925144,963477,13.0,3045.0,18.0,2535.0,1.0,379.0,131.0,13.0,4.0,2,1169,277,28104,3258,347750,375854,12/21/2020
2020-10-17,360,38693,14058,939202,977895,19.0,3064.0,11.0,2546.0,1.0,380.0,138.0,17.0,4.0,2,1171,309,28413,3144,350894,379307,12/21/2020
2020-10-18,155,38848,4039,943241,982089,18.0,3082.0,11.0,2557.0,0.0,380.0,145.0,17.0,6.0,2,1173,125,28538,1263,352157,380695,12/21/2020
2020-10-19,385,39233,8492,951733,990966,21.0,3103.0,22.0,2579.0,2.0,382.0,142.0,15.0,6.0,1,1174,320,28858,2476,354633,383491,12/21/2020
2020-10-20,439,39672,13245,964978,1004650,23.0,3126.0,17.0,2596.0,0.0,382.0,148.0,14.0,8.0,3,1177,383,29241,2909,357542,386783,12/21/2020
2020-10-21,544,40216,17464,982442,1022658,23.0,3149.0,8.0,2604.0,2.0,384.0,161.0,15.0,9.0,3,1180,471,29712,3377,360919,390631,12/21/2020
2020-10-22,538,40754,15864,998306,1039060,24.0,3173.0,20.0,2624.0,3.0,387.0,162.0,14.0,9.0,3,1183,488,30200,3073,363992,394192,12/21/2020
2020-10-23,514,41268,16637,1014943,1056211,22.0,3195.0,22.0,2646.0,1.0,388.0,161.0,15.0,9.0,3,1186,458,30658,2791,366783,397441,12/21/2020
2020-10-24,360,41628,10249,1025192,1066820,17.0,3212.0,11.0,2657.0,0.0,388.0,167.0,14.0,8.0,1,1187,338,30996,2179,368962,399958,12/21/2020
2020-10-25,233,41861,4760,1029952,1071813,16.0,3228.0,15.0,2672.0,1.0,389.0,167.0,15.0,8.0,2,1189,210,31206,1401,370363,401569,12/21/2020
2020-10-26,454,42315,9174,1039126,1081441,28.0,3256.0,15.0,2687.0,2.0,391.0,178.0,18.0,8.0,3,1192,402,31608,2880,373243,404851,12/21/2020
2020-10-27,516,42831,13995,1053121,1095952,29.0,3285.0,15.0,2702.0,2.0,393.0,190.0,18.0,9.0,4,1196,454,32062,2319,375562,407624,12/21/2020
2020-10-28,469,43300,15226,1068347,1111647,25.0,3310.0,26.0,2728.0,1.0,394.0,188.0,17.0,9.0,3,1199,411,32473,2600,378162,410635,12/21/2020
2020-10-29,609,43909,16260,1084607,1128516,20.0,3330.0,22.0,2750.0,3.0,397.0,183.0,19.0,11.0,4,1203,527,33000,3033,381195,414195,12/21/2020
2020-10-30,564,44473,14865,1099472,1143945,21.0,3351.0,21.0,2771.0,5.0,402.0,178.0,19.0,9.0,4,1207,470,33470,2849,384044,417514,12/21/2020
2020-10-31,599,45072,11819,1111291,1156363,32.0,3383.0,13.0,2784.0,1.0,403.0,196.0,23.0,10.0,3,1210,486,33956,2338,386382,420338,12/21/2020
2020-11-01,330,45402,5091,1116382,1161784,22.0,3405.0,15.0,2799.0,1.0,404.0,202.0,27.0,13.0,4,1214,276,34232,1226,387608,421840,12/21/2020
2020-11-02,522,45924,9935,1126317,1172241,38.0,3443.0,27.0,2826.0,3.0,407.0,210.0,25.0,13.0,5,1219,459,34691,2846,390454,425145,12/21/2020
2020-11-03,601,46525,13040,1139357,1185882,33.0,3476.0,25.0,2851.0,1.0,408.0,217.0,25.0,13.0,1,1220,530,35221,2436,392890,428111,12/21/2020
2020-11-04,688,47213,16101,1155458,1202671,34.0,3510.0,27.0,2878.0,2.0,410.0,222.0,26.0,12.0,4,1224,642,35863,2836,395726,431589,12/21/2020
2020-11-05,768,47981,16593,1172051,1220032,46.0,3556.0,35.0,2913.0,1.0,411.0,232.0,25.0,14.0,3,1227,683,36546,2772,398498,435044,12/21/2020
2020-11-06,769,48750,16026,1188077,1236827,43.0,3599.0,31.0,2944.0,1.0,412.0,243.0,29.0,17.0,5,1232,691,37237,2952,401450,438687,12/21/2020
2020-11-07,604,49354,13649,1201726,1251080,34.0,3633.0,25.0,2969.0,1.0,413.0,251.0,32.0,18.0,1,1233,578,37815,2400,403850,441665,12/21/2020
2020-11-08,337,49691,4166,1205892,1255583,33.0,3666.0,26.0,2995.0,1.0,414.0,257.0,31.0,19.0,4,1237,322,38137,1245,405095,443232,12/21/2020
2020-11-09,808,50499,9063,1214955,1265454,40.0,3706.0,33.0,3028.0,2.0,416.0,262.0,29.0,18.0,3,1240,765,38902,2261,407356,446258,12/21/2020
2020-11-10,1053,51552,12982,1227937,1279489,45.0,3751.0,37.0,3065.0,0.0,416.0,270.0,32.0,18.0,6,1246,982,39884,2810,410166,450050,12/21/2020
2020-11-11,1087,52639,19738,1247675,1300314,42.0,3793.0,24.0,3089.0,5.0,421.0,283.0,31.0,15.0,7,1253,1002,40886,2611,412777,453663,12/21/2020
2020-11-12,893,53532,13913,1261588,1315120,39.0,3832.0,31.0,3120.0,3.0,424.0,288.0,29.0,15.0,5,1258,814,41700,2151,414928,456628,12/21/2020
2020-11-13,1165,54697,16391,1277979,1332676,39.0,3871.0,31.0,3151.0,0.0,424.0,296.0,28.0,15.0,2,1260,1115,42815,3016,417944,460759,12/21/2020
2020-11-14,782,55479,13519,1291498,1346977,42.0,3913.0,26.0,3177.0,5.0,429.0,307.0,26.0,13.0,10,1270,738,43553,2412,420356,463909,12/21/2020
2020-11-15,578,56057,6173,1297671,1353728,46.0,3959.0,21.0,3198.0,5.0,434.0,327.0,29.0,11.0,7,1277,495,44048,1388,421744,465792,12/21/2020
2020-11-16,739,56796,9647,1307318,1364114,56.0,4015.0,39.0,3237.0,3.0,437.0,341.0,27.0,13.0,5,1282,674,44722,2590,424334,469056,12/21/2020
2020-11-17,1538,58334,18176,1325494,1383828,59.0,4074.0,45.0,3282.0,2.0,439.0,353.0,31.0,13.0,5,1287,1402,46124,4040,428374,474498,12/21/2020
2020-11-18,1136,59470,16042,1341536,1401006,38.0,4112.0,38.0,3320.0,5.0,444.0,348.0,30.0,15.0,7,1294,1020,47144,3137,431511,478655,12/21/2020
2020-11-19,1128,60598,13171,1354707,1415305,47.0,4159.0,42.0,3362.0,4.0,448.0,349.0,31.0,18.0,5,1299,1032,48176,3342,434853,483029,12/21/2020
2020-11-20,1457,62055,22226,1376933,1438988,49.0,4208.0,48.0,3410.0,3.0,451.0,347.0,34.0,14.0,6,1305,1293,49469,4231,439084,488553,12/21/2020
2020-11-21,854,62909,17369,1394302,1457211,43.0,4251.0,34.0,3444.0,5.0,456.0,351.0,36.0,14.0,7,1312,755,50224,3078,442162,492386,12/21/2020
2020-11-22,571,63480,7519,1401821,1465301,65.0,4316.0,28.0,3472.0,4.0,460.0,384.0,34.0,15.0,11,1323,486,50710,1764,443926,494636,12/21/2020
2020-11-23,994,64474,11030,1412851,1477325,75.0,4391.0,40.0,3512.0,0.0,460.0,419.0,41.0,18.0,10,1333,893,51603,3345,447271,498874,12/21/2020
2020-11-24,1049,65523,14579,1427430,1492953,47.0,4438.0,60.0,3572.0,6.0,466.0,400.0,43.0,22.0,10,1343,940,52543,2722,449993,502536,12/21/2020
2020-11-25,1265,66788,18787,1446217,1513005,59.0,4497.0,59.0,3631.0,4.0,470.0,396.0,44.0,26.0,7,1350,1179,53722,3386,453379,507101,12/21/2020
2020-11-26,547,67335,6483,1452700,1520035,51.0,4548.0,35.0,3666.0,4.0,474.0,408.0,47.0,25.0,12,1362,467,54189,1503,454882,509071,12/21/2020
2020-11-27,1043,68378,9724,1462424,1530802,56.0,4604.0,50.0,3716.0,7.0,481.0,407.0,48.0,22.0,7,1369,968,55157,2488,457370,512527,12/21/2020
2020-11-28,1182,69560,11960,1474384,1543944,64.0,4668.0,39.0,3755.0,0.0,481.0,432.0,49.0,22.0,3,1372,1097,56254,2767,460137,516391,12/21/2020
2020-11-29,822,70382,6936,1481320,1551702,62.0,4730.0,36.0,3791.0,3.0,484.0,455.0,50.0,24.0,8,1380,755,57009,2283,462420,519429,12/21/2020
2020-11-30,1283,71665,9925,1491245,1562910,67.0,4797.0,60.0,3851.0,2.0,486.0,460.0,53.0,30.0,6,1386,1162,58171,2769,465189,523360,12/21/2020
2020-12-01,1555,73220,13956,1505201,1578421,61.0,4858.0,55.0,3906.0,4.0,490.0,462.0,52.0,31.0,12,1398,1419,59590,3331,468520,528110,12/21/2020
2020-12-02,1561,74781,15563,1520764,1595545,57.0,4915.0,53.0,3959.0,7.0,497.0,459.0,53.0,30.0,14,1412,1432,61022,3222,471742,532764,12/21/2020
2020-12-03,1772,76553,14626,1535390,1611943,64.0,4979.0,76.0,4035.0,5.0,502.0,442.0,49.0,31.0,10,1422,1640,62662,3285,475027,537689,12/21/2020
2020-12-04,1648,78201,16505,1551895,1630096,70.0,5049.0,50.0,4085.0,7.0,509.0,455.0,46.0,29.0,11,1433,1520,64182,3739,478766,542948,12/21/2020
2020-12-05,1199,79400,12609,1564504,1643904,71.0,5120.0,42.0,4127.0,4.0,513.0,480.0,48.0,29.0,11,1444,1066,65248,2861,481627,546875,12/21/2020
2020-12-06,1125,80525,7843,1572347,1652872,65.0,5185.0,50.0,4177.0,10.0,523.0,485.0,49.0,25.0,14,1458,980,66228,2454,484081,550309,12/21/2020
2020-12-07,1396,81921,10640,1582987,1664908,74.0,5259.0,58.0,4235.0,6.0,529.0,495.0,47.0,25.0,19,1477,1253,67481,3287,487368,554849,12/21/2020
2020-12-08,1464,83385,15314,1598301,1681686,57.0,5316.0,57.0,4292.0,5.0,534.0,490.0,50.0,27.0,17,1494,1315,68796,3543,490911,559707,12/21/2020
2020-12-09,1499,84884,16351,1614652,1699536,56.0,5372.0,63.0,4355.0,9.0,543.0,474.0,47.0,29.0,12,1506,1342,70138,3203,494114,564252,12/21/2020
2020-12-10,1474,86358,17264,1631916,1718274,64.0,5436.0,58.0,4413.0,6.0,549.0,474.0,55.0,28.0,18,1524,1257,71395,4066,498180,569575,12/21/2020
2020-12-11,1489,87847,17368,1649284,1737131,72.0,5508.0,82.0,4495.0,7.0,556.0,457.0,60.0,31.0,16,1540,1293,72688,3591,501771,574459,12/21/2020
2020-12-12,1104,88951,13054,1662338,1751289,65.0,5573.0,54.0,4549.0,9.0,565.0,459.0,52.0,31.0,16,1556,919,73607,3095,504866,578473,12/21/2020
2020-12-13,672,89623,7145,1669483,1759106,74.0,5647.0,40.0,4589.0,13.0,578.0,480.0,54.0,29.0,25,1581,556,74163,2003,506869,581032,12/21/2020
2020-12-14,1314,90937,11196,1680679,1771616,82.0,5729.0,61.0,4650.0,9.0,587.0,492.0,65.0,31.0,14,1595,1141,75304,3385,510254,585558,12/21/2020
2020-12-15,1265,92202,15053,1695732,1787934,67.0,5796.0,53.0,4703.0,5.0,592.0,501.0,60.0,30.0,13,1608,1064,76368,3076,513330,589698,12/21/2020
2020-12-16,1273,93475,19057,1714789,1808264,53.0,5849.0,69.0,4772.0,10.0,602.0,475.0,59.0,32.0,15,1623,1084,77452,3705,517035,594487,12/21/2020
2020-12-17,481,93956,8791,1723580,1817536,46.0,5895.0,57.0,4829.0,8.0,610.0,456.0,59.0,33.0,12,1635,427,77879,1260,518295,596174,12/21/2020
2020-12-18,1086,95042,13288,1736868,1831910,48.0,5943.0,62.0,4891.0,11.0,621.0,431.0,59.0,34.0,9,1644,904,78783,2688,520983,599766,12/21/2020
2020-12-19,1307,96349,16307,1753175,1849524,43.0,5986.0,36.0,4927.0,9.0,630.0,429.0,57.0,36.0,15,1659,1029,79812,3109,524092,603904,12/21/2020
2020-12-20,528,96877,6665,1759840,1856717,,,,,,,,,,11,1670,419,80231,1649,525741,605972,12/21/2020
2020-02-27,0,0,0,0,0,1.0,1.0,0.0,0.0,0.0,0.0,1.0,0.0,0.0,0,0,0,0,0,0,0,12/22/2020
2020-02-28,0,0,0,0,0,0.0,1.0,0.0,0.0,0.0,0.0,1.0,1.0,0.0,0,0,0,0,0,0,0,12/22/2020
2020-02-29,0,0,0,0,0,0.0,1.0,0.0,0.0,0.0,0.0,1.0,1.0,0.0,0,0,0,0,0,0,0,12/22/2020
2020-03-01,2,2,2,2,4,0.0,1.0,0.0,0.0,0.0,0.0,1.0,1.0,1.0,0,0,2,2,2,2,4,12/22/2020
2020-03-02,0,2,1,3,5,1.0,2.0,0.0,0.0,0.0,0.0,2.0,2.0,2.0,0,0,0,2,0,2,4,12/22/2020
2020-03-03,0,2,2,5,7,0.0,2.0,0.0,0.0,0.0,0.0,2.0,2.0,2.0,0,0,0,2,1,3,5,12/22/2020
2020-03-04,0,2,12,17,19,1.0,3.0,0.0,0.0,0.0,0.0,3.0,2.0,2.0,0,0,0,2,10,13,15,12/22/2020
2020-03-05,0,2,4,21,23,0.0,3.0,0.0,0.0,0.0,0.0,3.0,2.0,2.0,0,0,1,3,4,17,20,12/22/2020
2020-03-06,1,3,12,33,36,0.0,3.0,0.0,0.0,0.0,0.0,3.0,2.0,2.0,0,0,0,3,11,28,31,12/22/2020
2020-03-07,0,3,19,52,55,0.0,3.0,0.0,0.0,0.0,0.0,3.0,2.0,1.0,0,0,0,3,19,47,50,12/22/2020
2020-03-08,0,3,18,70,73,0.0,3.0,0.0,0.0,0.0,0.0,3.0,2.0,1.0,0,0,0,3,18,65,68,12/22/2020
2020-03-09,1,4,15,85,89,0.0,3.0,0.0,0.0,0.0,0.0,3.0,2.0,1.0,0,0,1,4,14,79,83,12/22/2020
2020-03-10,2,6,25,110,116,0.0,3.0,0.0,0.0,0.0,0.0,3.0,2.0,1.0,0,0,1,5,23,102,107,12/22/2020
2020-03-11,0,6,34,144,150,1.0,4.0,0.0,0.0,0.0,0.0,4.0,1.0,1.0,0,0,0,5,34,136,141,12/22/2020
2020-03-12,9,15,41,185,200,1.0,5.0,0.0,0.0,0.0,0.0,5.0,1.0,1.0,0,0,7,12,38,174,186,12/22/2020
2020-03-13,6,21,50,235,256,4.0,9.0,1.0,1.0,0.0,0.0,8.0,1.0,1.0,0,0,6,18,47,221,239,12/22/2020
2020-03-14,0,21,90,325,346,0.0,9.0,0.0,1.0,0.0,0.0,8.0,1.0,1.0,0,0,0,18,83,304,322,12/22/2020
2020-03-15,1,22,54,379,401,1.0,10.0,0.0,1.0,0.0,0.0,9.0,2.0,1.0,0,0,1,19,53,357,376,12/22/2020
2020-03-16,2,24,95,474,498,2.0,12.0,0.0,1.0,0.0,0.0,11.0,2.0,0.0,0,0,2,21,88,445,466,12/22/2020
2020-03-17,12,36,162,636,672,6.0,18.0,0.0,1.0,0.0,0.0,17.0,2.0,0.0,0,0,11,32,141,586,618,12/22/2020
2020-03-18,9,45,116,752,797,3.0,21.0,0.0,1.0,0.0,0.0,20.0,2.0,0.0,0,0,11,43,104,690,733,12/22/2020
2020-03-19,15,60,262,1014,1074,2.0,23.0,1.0,2.0,0.0,0.0,21.0,3.0,0.0,1,1,17,60,243,933,993,12/22/2020
2020-03-20,13,73,197,1211,1284,5.0,28.0,0.0,2.0,0.0,0.0,26.0,4.0,0.0,0,1,13,73,181,1114,1187,12/22/2020
2020-03-21,12,85,126,1337,1422,3.0,31.0,2.0,4.0,0.0,0.0,27.0,5.0,0.0,0,1,14,87,117,1231,1318,12/22/2020
2020-03-22,27,112,282,1619,1731,2.0,33.0,0.0,4.0,0.0,0.0,29.0,5.0,0.0,0,1,25,112,250,1481,1593,12/22/2020
2020-03-23,14,126,169,1788,1914,15.0,48.0,1.0,5.0,0.0,0.0,43.0,9.0,3.0,0,1,16,128,156,1637,1765,12/22/2020
2020-03-24,20,146,242,2030,2176,8.0,56.0,0.0,5.0,0.0,0.0,51.0,10.0,5.0,0,1,19,147,217,1854,2001,12/22/2020
2020-03-25,26,172,182,2212,2384,5.0,61.0,2.0,7.0,0.0,0.0,54.0,11.0,3.0,0,1,28,175,158,2012,2187,12/22/2020
2020-03-26,35,207,181,2393,2600,9.0,70.0,5.0,12.0,0.0,0.0,58.0,14.0,5.0,0,1,41,216,162,2174,2390,12/22/2020
2020-03-27,27,234,214,2607,2841,9.0,79.0,1.0,13.0,1.0,1.0,65.0,16.0,6.0,2,3,31,247,184,2358,2605,12/22/2020
2020-03-28,59,293,260,2867,3160,11.0,90.0,2.0,15.0,1.0,2.0,73.0,15.0,6.0,1,4,64,311,231,2589,2900,12/22/2020
2020-03-29,100,393,350,3217,3610,8.0,98.0,3.0,18.0,1.0,3.0,77.0,18.0,8.0,2,6,105,416,287,2876,3292,12/22/2020
2020-03-30,62,455,222,3439,3894,19.0,117.0,5.0,23.0,0.0,3.0,91.0,19.0,11.0,3,9,78,494,171,3047,3541,12/22/2020
2020-03-31,71,526,369,3808,4334,11.0,128.0,7.0,30.0,1.0,4.0,94.0,21.0,13.0,2,11,73,567,282,3329,3896,12/22/2020
2020-04-01,99,625,698,4506,5131,18.0,146.0,7.0,37.0,0.0,4.0,105.0,29.0,15.0,1,12,100,667,588,3917,4584,12/22/2020
2020-04-02,52,677,477,4983,5660,22.0,168.0,6.0,43.0,2.0,6.0,119.0,35.0,21.0,4,16,62,729,408,4325,5054,12/22/2020
2020-04-03,108,785,774,5757,6542,23.0,191.0,7.0,50.0,0.0,6.0,135.0,42.0,25.0,3,19,100,829,659,4984,5813,12/22/2020
2020-04-04,143,928,660,6417,7345,22.0,213.0,4.0,54.0,5.0,11.0,148.0,40.0,29.0,9,28,138,967,576,5560,6527,12/22/2020
2020-04-05,187,1115,1156,7573,8688,20.0,233.0,9.0,63.0,1.0,12.0,158.0,43.0,35.0,2,30,181,1148,976,6536,7684,12/22/2020
2020-04-06,218,1333,1706,9279,10612,26.0,259.0,7.0,70.0,0.0,12.0,177.0,47.0,39.0,7,37,207,1355,1448,7984,9339,12/22/2020
2020-04-07,284,1617,1629,10908,12525,20.0,279.0,4.0,74.0,2.0,14.0,191.0,49.0,41.0,5,42,260,1615,1381,9365,10980,12/22/2020
2020-04-08,290,1907,1720,12628,14535,19.0,298.0,8.0,82.0,5.0,19.0,197.0,49.0,37.0,10,52,271,1886,1452,10817,12703,12/22/2020
2020-04-09,283,2190,1516,14144,16334,32.0,330.0,8.0,90.0,4.0,23.0,217.0,53.0,40.0,7,59,277,2163,1262,12079,14242,12/22/2020
2020-04-10,419,2609,2574,16718,19327,29.0,359.0,17.0,107.0,5.0,28.0,224.0,59.0,41.0,11,70,400,2563,2208,14287,16850,12/22/2020
2020-04-11,298,2907,1905,18623,21530,29.0,388.0,11.0,118.0,2.0,30.0,240.0,61.0,48.0,12,82,280,2843,1612,15899,18742,12/22/2020
2020-04-12,315,3222,1670,20293,23515,35.0,423.0,13.0,131.0,5.0,35.0,257.0,59.0,49.0,9,91,286,3129,1300,17199,20328,12/22/2020
2020-04-13,161,3383,935,21228,24611,35.0,458.0,13.0,144.0,3.0,38.0,276.0,64.0,54.0,9,100,187,3316,780,17979,21295,12/22/2020
2020-04-14,290,3673,1787,23015,26688,27.0,485.0,18.0,162.0,5.0,43.0,280.0,72.0,53.0,8,108,261,3577,1409,19388,22965,12/22/2020
2020-04-15,350,4023,1799,24814,28837,31.0,516.0,20.0,182.0,3.0,46.0,288.0,72.0,54.0,17,125,306,3883,1405,20793,24676,12/22/2020
2020-04-16,447,4470,2494,27308,31778,36.0,552.0,25.0,207.0,6.0,52.0,293.0,72.0,53.0,14,139,387,4270,1891,22684,26954,12/22/2020
2020-04-17,304,4774,1821,29129,33903,32.0,584.0,20.0,227.0,7.0,59.0,298.0,66.0,45.0,21,160,290,4560,1314,23998,28558,12/22/2020
2020-04-18,321,5095,1725,30854,35949,26.0,610.0,18.0,245.0,4.0,63.0,302.0,63.0,49.0,15,175,284,4844,1225,25223,30067,12/22/2020
2020-04-19,381,5476,2047,32901,38377,23.0,633.0,26.0,271.0,1.0,64.0,298.0,65.0,55.0,11,186,337,5181,1626,26849,32030,12/22/2020
2020-04-20,394,5870,1907,34808,40678,46.0,679.0,29.0,300.0,2.0,66.0,313.0,75.0,56.0,10,196,376,5557,1457,28306,33863,12/22/2020
2020-04-21,444,6314,2110,36918,43232,45.0,724.0,32.0,332.0,5.0,71.0,321.0,72.0,56.0,18,214,382,5939,1594,29900,35839,12/22/2020
2020-04-22,418,6732,2390,39308,46040,41.0,765.0,32.0,364.0,5.0,76.0,325.0,73.0,58.0,18,232,380,6319,1756,31656,37975,12/22/2020
2020-04-23,479,7211,2469,41777,48988,32.0,797.0,28.0,392.0,5.0,81.0,324.0,76.0,62.0,15,247,412,6731,1712,33368,40099,12/22/2020
2020-04-24,491,7702,3284,45061,52763,35.0,832.0,26.0,418.0,4.0,85.0,329.0,85.0,63.0,15,262,407,7138,2338,35706,42844,12/22/2020
2020-04-25,393,8095,2206,47267,55362,34.0,866.0,17.0,435.0,5.0,90.0,341.0,85.0,62.0,14,276,299,7437,1571,37277,44714,12/22/2020
2020-04-26,316,8411,2309,49576,57987,33.0,899.0,15.0,450.0,3.0,93.0,356.0,86.0,59.0,14,290,274,7711,1714,38991,46702,12/22/2020
2020-04-27,249,8660,1620,51196,59856,29.0,928.0,21.0,471.0,4.0,97.0,360.0,86.0,61.0,10,300,206,7917,1065,40056,47973,12/22/2020
2020-04-28,410,9070,2263,53459,62529,44.0,972.0,24.0,495.0,3.0,100.0,377.0,88.0,59.0,22,322,330,8247,1503,41559,49806,12/22/2020
2020-04-29,476,9546,3343,56802,66348,36.0,1008.0,38.0,533.0,11.0,111.0,364.0,78.0,53.0,18,340,371,8618,2166,43725,52343,12/22/2020
2020-04-30,432,9978,2769,59571,69549,33.0,1041.0,38.0,571.0,6.0,117.0,353.0,83.0,57.0,24,364,351,8969,1710,45435,54404,12/22/2020
2020-05-01,454,10432,3086,62657,73089,52.0,1093.0,39.0,610.0,3.0,120.0,363.0,84.0,58.0,14,378,323,9292,1918,47353,56645,12/22/2020
2020-05-02,257,10689,1926,64583,75272,36.0,1129.0,38.0,648.0,5.0,125.0,356.0,93.0,63.0,24,402,193,9485,1161,48514,57999,12/22/2020
2020-05-03,283,10972,2160,66743,77715,31.0,1160.0,27.0,675.0,8.0,133.0,352.0,91.0,61.0,21,423,183,9668,1403,49917,59585,12/22/2020
2020-05-04,387,11359,2098,68841,80200,30.0,1190.0,31.0,706.0,5.0,138.0,346.0,89.0,58.0,18,441,290,9958,1447,51364,61322,12/22/2020
2020-05-05,433,11792,2873,71714,83506,29.0,1219.0,32.0,738.0,6.0,144.0,337.0,83.0,55.0,16,457,299,10257,1817,53181,63438,12/22/2020
2020-05-06,488,12280,2830,74544,86824,28.0,1247.0,44.0,782.0,9.0,153.0,312.0,80.0,55.0,21,478,340,10597,1769,54950,65547,12/22/2020
2020-05-07,425,12705,2969,77513,90218,36.0,1283.0,44.0,826.0,5.0,158.0,299.0,72.0,53.0,21,499,270,10867,1785,56735,67602,12/22/2020
2020-05-08,359,13064,2598,80111,93175,30.0,1313.0,29.0,855.0,5.0,163.0,295.0,72.0,54.0,22,521,230,11097,1542,58277,69374,12/22/2020
2020-05-09,467,13531,3346,83457,96988,22.0,1335.0,21.0,876.0,4.0,167.0,292.0,70.0,52.0,15,536,288,11385,2077,60354,71739,12/22/2020
2020-05-10,285,13816,2117,85574,99390,20.0,1355.0,23.0,899.0,6.0,173.0,283.0,71.0,50.0,14,550,190,11575,1390,61744,73319,12/22/2020
2020-05-11,257,14073,1857,87431,101504,31.0,1386.0,16.0,915.0,6.0,179.0,292.0,72.0,50.0,15,565,173,11748,1215,62959,74707,12/22/2020
2020-05-12,387,14460,2611,90042,104502,23.0,1409.0,18.0,933.0,4.0,183.0,293.0,70.0,49.0,22,587,224,11972,1511,64470,76442,12/22/2020
2020-05-13,351,14811,3630,93672,108483,23.0,1432.0,25.0,958.0,1.0,184.0,290.0,70.0,50.0,13,600,198,12170,1810,66280,78450,12/22/2020
2020-05-14,329,15140,3408,97080,112220,19.0,1451.0,27.0,985.0,3.0,187.0,279.0,65.0,46.0,15,615,233,12403,1842,68122,80525,12/22/2020
2020-05-15,381,15521,3458,100538,116059,24.0,1475.0,41.0,1026.0,5.0,192.0,257.0,63.0,46.0,14,629,232,12635,1691,69813,82448,12/22/2020
2020-05-16,449,15970,4156,104694,120664,25.0,1500.0,15.0,1041.0,5.0,197.0,262.0,62.0,47.0,15,644,247,12882,1806,71619,84501,12/22/2020
2020-05-17,240,16210,2768,107462,123672,17.0,1517.0,9.0,1050.0,5.0,202.0,265.0,60.0,46.0,10,654,126,13008,1423,73042,86050,12/22/2020
2020-05-18,250,16460,2001,109463,125923,19.0,1536.0,16.0,1066.0,5.0,207.0,263.0,58.0,41.0,18,672,135,13143,1284,74326,87469,12/22/2020
2020-05-19,415,16875,3168,112631,129506,23.0,1559.0,33.0,1099.0,5.0,212.0,248.0,57.0,39.0,11,683,215,13358,1803,76129,89487,12/22/2020
2020-05-20,326,17201,2771,115402,132603,19.0,1578.0,23.0,1122.0,7.0,219.0,237.0,53.0,34.0,22,705,183,13541,1424,77553,91094,12/22/2020
2020-05-21,374,17575,3757,119159,136734,25.0,1603.0,15.0,1137.0,3.0,222.0,244.0,54.0,30.0,20,725,168,13709,1826,79379,93088,12/22/2020
2020-05-22,351,17926,3161,122320,140246,20.0,1623.0,28.0,1165.0,5.0,227.0,231.0,53.0,30.0,11,736,206,13915,1492,80871,94786,12/22/2020
2020-05-23,253,18179,2742,125062,143241,19.0,1642.0,11.0,1176.0,3.0,230.0,236.0,53.0,33.0,13,749,109,14024,1199,82070,96094,12/22/2020
2020-05-24,163,18342,1370,126432,144774,13.0,1655.0,14.0,1190.0,2.0,232.0,233.0,54.0,36.0,8,757,83,14107,733,82803,96910,12/22/2020
2020-05-25,147,18489,1385,127817,146306,14.0,1669.0,14.0,1204.0,0.0,232.0,233.0,54.0,34.0,10,767,76,14183,680,83483,97666,12/22/2020
2020-05-26,285,18774,2620,130437,149211,24.0,1693.0,21.0,1225.0,5.0,237.0,231.0,49.0,33.0,15,782,158,14341,1544,85027,99368,12/22/2020
2020-05-27,276,19050,2057,132494,151544,20.0,1713.0,18.0,1243.0,3.0,240.0,230.0,51.0,33.0,10,792,132,14473,1081,86108,100581,12/22/2020
2020-05-28,348,19398,3359,135853,155251,17.0,1730.0,29.0,1272.0,4.0,244.0,214.0,47.0,32.0,8,800,130,14603,1035,87143,101746,12/22/2020
2020-05-29,410,19808,3915,139768,159576,19.0,1749.0,26.0,1298.0,7.0,251.0,200.0,43.0,31.0,12,812,174,14777,1457,88600,103377,12/22/2020
2020-05-30,225,20033,3915,143683,163716,16.0,1765.0,19.0,1317.0,4.0,255.0,193.0,41.0,29.0,12,824,109,14886,1627,90227,105113,12/22/2020
2020-05-31,155,20188,1690,145373,165561,11.0,1776.0,11.0,1328.0,1.0,256.0,192.0,44.0,26.0,3,827,78,14964,780,91007,105971,12/22/2020
2020-06-01,212,20400,2792,148165,168565,8.0,1784.0,14.0,1342.0,1.0,257.0,185.0,45.0,29.0,5,832,93,15057,1305,92312,107369,12/22/2020
2020-06-02,273,20673,3021,151186,171859,8.0,1792.0,9.0,1351.0,3.0,260.0,181.0,38.0,25.0,10,842,98,15155,1343,93655,108810,12/22/2020
2020-06-03,254,20927,3486,154672,175599,14.0,1806.0,18.0,1369.0,6.0,266.0,171.0,34.0,25.0,11,853,99,15254,1560,95215,110469,12/22/2020
2020-06-04,276,21203,4471,159143,180346,7.0,1813.0,26.0,1395.0,4.0,270.0,148.0,31.0,24.0,12,865,107,15361,1887,97102,112463,12/22/2020
2020-06-05,215,21418,3513,162656,184074,15.0,1828.0,13.0,1408.0,6.0,276.0,144.0,27.0,21.0,11,876,99,15460,1430,98532,113992,12/22/2020
2020-06-06,201,21619,2616,165272,186891,10.0,1838.0,7.0,1415.0,2.0,278.0,145.0,29.0,19.0,6,882,67,15527,1054,99586,115113,12/22/2020
2020-06-07,83,21702,1625,166897,188599,11.0,1849.0,7.0,1422.0,1.0,279.0,148.0,25.0,17.0,4,886,51,15578,756,100342,115920,12/22/2020
2020-06-08,119,21821,1849,168746,190567,15.0,1864.0,13.0,1435.0,2.0,281.0,148.0,27.0,18.0,4,890,45,15623,902,101244,116867,12/22/2020
2020-06-09,223,22044,2673,171419,193463,10.0,1874.0,19.0,1454.0,0.0,281.0,139.0,28.0,21.0,1,891,64,15687,1193,102437,118124,12/22/2020
2020-06-10,209,22253,2987,174406,196659,13.0,1887.0,12.0,1466.0,2.0,283.0,138.0,24.0,17.0,4,895,100,15787,1398,103835,119622,12/22/2020
2020-06-11,195,22448,3513,177919,200367,7.0,1894.0,15.0,1481.0,1.0,284.0,129.0,25.0,16.0,6,901,88,15875,1444,105279,121154,12/22/2020
2020-06-12,209,22657,4601,182520,205177,9.0,1903.0,16.0,1497.0,1.0,285.0,121.0,24.0,16.0,2,903,78,15953,1978,107257,123210,12/22/2020
2020-06-13,113,22770,3036,185556,208326,6.0,1909.0,5.0,1502.0,0.0,285.0,122.0,20.0,15.0,3,906,49,16002,1252,108509,124511,12/22/2020
2020-06-14,81,22851,2046,187602,210453,7.0,1916.0,8.0,1510.0,1.0,286.0,120.0,20.0,14.0,3,909,33,16035,922,109431,125466,12/22/2020
2020-06-15,188,23039,3108,190710,213749,14.0,1930.0,19.0,1529.0,0.0,286.0,115.0,20.0,16.0,5,914,75,16110,1698,111129,127239,12/22/2020
2020-06-16,110,23149,3017,193727,216876,11.0,1941.0,9.0,1538.0,1.0,287.0,116.0,22.0,16.0,8,922,50,16160,1460,112589,128749,12/22/2020
2020-06-17,127,23276,2835,196562,219838,15.0,1956.0,20.0,1558.0,4.0,291.0,107.0,18.0,14.0,6,928,51,16211,1251,113840,130051,12/22/2020
2020-06-18,149,23425,3049,199611,223036,9.0,1965.0,15.0,1573.0,1.0,292.0,100.0,19.0,16.0,7,935,70,16281,1246,115086,131367,12/22/2020
2020-06-19,141,23566,3769,203380,226946,12.0,1977.0,12.0,1585.0,1.0,293.0,99.0,20.0,17.0,3,938,59,16340,1300,116386,132726,12/22/2020
2020-06-20,84,23650,1891,205271,228921,9.0,1986.0,12.0,1597.0,0.0,293.0,96.0,20.0,18.0,4,942,36,16376,772,117158,133534,12/22/2020
2020-06-21,37,23687,1064,206335,230022,8.0,1994.0,5.0,1602.0,0.0,293.0,99.0,20.0,18.0,2,944,30,16406,652,117810,134216,12/22/2020
2020-06-22,138,23825,3730,210065,233890,12.0,2006.0,17.0,1619.0,0.0,293.0,94.0,19.0,18.0,2,946,65,16471,1622,119432,135903,12/22/2020
2020-06-23,163,23988,3830,213895,237883,3.0,2009.0,13.0,1632.0,3.0,296.0,81.0,18.0,18.0,7,953,81,16552,1699,121131,137683,12/22/2020
2020-06-24,120,24108,3502,217397,241505,9.0,2018.0,10.0,1642.0,1.0,297.0,79.0,18.0,18.0,5,958,45,16597,1590,122721,139318,12/22/2020
2020-06-25,103,24211,2883,220280,244491,6.0,2024.0,14.0,1656.0,1.0,298.0,70.0,17.0,17.0,1,959,51,16648,1423,124144,140792,12/22/2020
2020-06-26,94,24305,2488,222768,247073,2.0,2026.0,10.0,1666.0,0.0,298.0,62.0,18.0,18.0,1,960,60,16708,1265,125409,142117,12/22/2020
2020-06-27,84,24389,3216,225984,250373,5.0,2031.0,3.0,1669.0,1.0,299.0,63.0,17.0,17.0,5,965,37,16745,1155,126564,143309,12/22/2020
2020-06-28,39,24428,1469,227453,251881,4.0,2035.0,4.0,1673.0,4.0,303.0,59.0,15.0,14.0,6,971,17,16762,570,127134,143896,12/22/2020
2020-06-29,85,24513,3697,231150,255663,4.0,2039.0,5.0,1678.0,0.0,303.0,58.0,14.0,14.0,1,972,39,16801,1292,128426,145227,12/22/2020
2020-06-30,58,24571,1958,233108,257679,1.0,2040.0,5.0,1683.0,1.0,304.0,53.0,12.0,11.0,4,976,33,16834,951,129377,146211,12/22/2020
2020-07-01,144,24715,4098,237206,261921,8.0,2048.0,10.0,1693.0,0.0,304.0,51.0,11.0,11.0,1,977,79,16913,1843,131220,148133,12/22/2020
2020-07-02,103,24818,2803,240009,264827,5.0,2053.0,5.0,1698.0,1.0,305.0,50.0,10.0,10.0,3,980,59,16972,1034,132254,149226,12/22/2020
2020-07-03,50,24868,2079,242088,266956,9.0,2062.0,6.0,1704.0,0.0,305.0,53.0,9.0,9.0,3,983,24,16996,747,133001,149997,12/22/2020
2020-07-04,57,24925,2345,244433,269358,2.0,2064.0,4.0,1708.0,1.0,306.0,50.0,10.0,9.0,2,985,33,17029,963,133964,150993,12/22/2020
2020-07-05,49,24974,2932,247365,272339,1.0,2065.0,2.0,1710.0,1.0,307.0,48.0,8.0,8.0,2,987,26,17055,1351,135315,152370,12/22/2020
2020-07-06,101,25075,2814,250179,275254,6.0,2071.0,6.0,1716.0,0.0,307.0,48.0,9.0,9.0,4,991,57,17112,1489,136804,153916,12/22/2020
2020-07-07,81,25156,3457,253636,278792,5.0,2076.0,7.0,1723.0,0.0,307.0,46.0,8.0,8.0,2,993,47,17159,1474,138278,155437,12/22/2020
2020-07-08,105,25261,3409,257045,282306,4.0,2080.0,2.0,1725.0,0.0,307.0,48.0,9.0,8.0,0,993,64,17223,1341,139619,156842,12/22/2020
2020-07-09,94,25355,3714,260759,286114,9.0,2089.0,3.0,1728.0,0.0,307.0,54.0,9.0,8.0,0,993,50,17273,1544,141163,158436,12/22/2020
2020-07-10,132,25487,4437,265196,290683,6.0,2095.0,3.0,1731.0,2.0,309.0,55.0,7.0,7.0,3,996,80,17353,1979,143142,160495,12/22/2020
2020-07-11,63,25550,2938,268134,293684,6.0,2101.0,3.0,1734.0,1.0,310.0,57.0,6.0,6.0,3,999,36,17389,1254,144396,161785,12/22/2020
2020-07-12,47,25597,1838,269972,295569,1.0,2102.0,3.0,1737.0,1.0,311.0,54.0,6.0,5.0,3,1002,34,17423,902,145298,162721,12/22/2020
2020-07-13,84,25681,3209,273181,298862,8.0,2110.0,10.0,1747.0,0.0,311.0,52.0,6.0,5.0,1,1003,61,17484,1440,146738,164222,12/22/2020
2020-07-14,74,25755,3298,276479,302234,7.0,2117.0,4.0,1751.0,0.0,311.0,55.0,5.0,5.0,1,1004,44,17528,1325,148063,165591,12/22/2020
2020-07-15,130,25885,4181,280660,306545,5.0,2122.0,7.0,1758.0,0.0,311.0,53.0,5.0,4.0,0,1004,100,17628,1674,149737,167365,12/22/2020
2020-07-16,103,25988,3740,284400,310388,6.0,2128.0,9.0,1767.0,0.0,311.0,50.0,6.0,5.0,1,1005,76,17704,1531,151268,168972,12/22/2020
2020-07-17,156,26144,4239,288639,314783,14.0,2142.0,3.0,1770.0,1.0,312.0,60.0,5.0,5.0,2,1007,79,17783,1768,153036,170819,12/22/2020
2020-07-18,85,26229,3272,291911,318140,5.0,2147.0,9.0,1779.0,1.0,313.0,55.0,5.0,4.0,4,1011,70,17853,1335,154371,172224,12/22/2020
2020-07-19,82,26311,2696,294607,320918,7.0,2154.0,3.0,1782.0,0.0,313.0,59.0,6.0,4.0,2,1013,57,17910,1092,155463,173373,12/22/2020
2020-07-20,71,26382,2666,297273,323655,9.0,2163.0,7.0,1789.0,0.0,313.0,61.0,7.0,5.0,2,1015,68,17978,1390,156853,174831,12/22/2020
2020-07-21,130,26512,4304,301577,328089,9.0,2172.0,11.0,1800.0,0.0,313.0,59.0,9.0,6.0,1,1016,108,18086,1839,158692,176778,12/22/2020
2020-07-22,130,26642,3928,305505,332147,7.0,2179.0,8.0,1808.0,1.0,314.0,57.0,7.0,6.0,1,1017,86,18172,1594,160286,178458,12/22/2020
2020-07-23,141,26783,4415,309920,336703,8.0,2187.0,6.0,1814.0,0.0,314.0,59.0,8.0,7.0,0,1017,115,18287,1887,162173,180460,12/22/2020
2020-07-24,172,26955,5966,315886,342841,15.0,2202.0,12.0,1826.0,0.0,314.0,62.0,9.0,7.0,0,1017,119,18406,2215,164388,182794,12/22/2020
2020-07-25,134,27089,4398,320284,347373,7.0,2209.0,7.0,1833.0,0.0,314.0,62.0,10.0,8.0,3,1020,108,18514,2015,166403,184917,12/22/2020
2020-07-26,62,27151,3033,323317,350468,8.0,2217.0,9.0,1842.0,0.0,314.0,61.0,11.0,7.0,1,1021,54,18568,1279,167682,186250,12/22/2020
2020-07-27,188,27339,4191,327508,354847,12.0,2229.0,7.0,1849.0,0.0,314.0,66.0,13.0,8.0,1,1022,138,18706,2237,169919,188625,12/22/2020
2020-07-28,105,27444,3840,331348,358792,5.0,2234.0,5.0,1854.0,0.0,314.0,66.0,14.0,7.0,1,1023,95,18801,1566,171485,190286,12/22/2020
2020-07-29,190,27634,5139,336487,364121,9.0,2243.0,10.0,1864.0,0.0,314.0,65.0,15.0,7.0,0,1023,154,18955,2203,173688,192643,12/22/2020
2020-07-30,121,27755,4345,340832,368587,6.0,2249.0,2.0,1866.0,1.0,315.0,68.0,15.0,6.0,1,1024,96,19051,1556,175244,194295,12/22/2020
2020-07-31,131,27886,5512,346344,374230,7.0,2256.0,9.0,1875.0,0.0,315.0,66.0,15.0,7.0,1,1025,89,19140,1761,177005,196145,12/22/2020
2020-08-01,109,27995,4294,350638,378633,7.0,2263.0,2.0,1877.0,0.0,315.0,71.0,14.0,7.0,1,1026,89,19229,1484,178489,197718,12/22/2020
2020-08-02,84,28079,2804,353442,381521,12.0,2275.0,12.0,1889.0,2.0,317.0,69.0,14.0,8.0,2,1028,62,19291,1222,179711,199002,12/22/2020
2020-08-03,188,28267,5248,358690,386957,11.0,2286.0,10.0,1899.0,0.0,317.0,70.0,16.0,7.0,1,1029,150,19441,2104,181815,201256,12/22/2020
2020-08-04,125,28392,3691,362381,390773,8.0,2294.0,5.0,1904.0,1.0,318.0,72.0,12.0,5.0,2,1031,99,19540,1698,183513,203053,12/22/2020
2020-08-05,147,28539,5934,368315,396854,11.0,2305.0,9.0,1913.0,1.0,319.0,73.0,10.0,5.0,2,1033,119,19659,2354,185867,205526,12/22/2020
2020-08-06,169,28708,5546,373861,402569,7.0,2312.0,9.0,1922.0,0.0,319.0,71.0,9.0,4.0,0,1033,120,19779,2273,188140,207919,12/22/2020
2020-08-07,123,28831,4851,378712,407543,12.0,2324.0,9.0,1931.0,1.0,320.0,73.0,9.0,3.0,2,1035,87,19866,2043,190183,210049,12/22/2020
2020-08-08,123,28954,4112,382824,411778,19.0,2343.0,6.0,1937.0,1.0,321.0,85.0,8.0,3.0,1,1036,91,19957,1708,191891,211848,12/22/2020
2020-08-09,42,28996,1727,384551,413547,6.0,2349.0,8.0,1945.0,0.0,321.0,83.0,9.0,4.0,0,1036,35,19992,1015,192906,212898,12/22/2020
2020-08-10,149,29145,4587,389138,418283,8.0,2357.0,9.0,1954.0,0.0,321.0,82.0,9.0,4.0,1,1037,113,20105,1942,194848,214953,12/22/2020
2020-08-11,106,29251,4334,393472,422723,5.0,2362.0,13.0,1967.0,0.0,321.0,74.0,10.0,4.0,3,1040,92,20197,2180,197028,217225,12/22/2020
2020-08-12,121,29372,5188,398660,428032,8.0,2370.0,11.0,1978.0,0.0,321.0,71.0,9.0,3.0,1,1041,101,20298,2509,199537,219835,12/22/2020
2020-08-13,135,29507,4196,402856,432363,13.0,2383.0,12.0,1990.0,0.0,321.0,72.0,11.0,3.0,0,1041,95,20393,1823,201360,221753,12/22/2020
2020-08-14,145,29652,5498,408354,438006,13.0,2396.0,11.0,2001.0,0.0,321.0,74.0,11.0,4.0,3,1044,98,20491,1889,203249,223740,12/22/2020
2020-08-15,106,29758,4534,412888,442646,9.0,2405.0,11.0,2012.0,1.0,322.0,71.0,11.0,5.0,0,1044,88,20579,1620,204869,225448,12/22/2020
2020-08-16,83,29841,2477,415365,445206,6.0,2411.0,5.0,2017.0,4.0,326.0,68.0,8.0,4.0,6,1050,70,20649,916,205785,226434,12/22/2020
2020-08-17,106,29947,4575,419940,449887,8.0,2419.0,6.0,2023.0,0.0,326.0,70.0,8.0,5.0,2,1052,87,20736,2292,208077,228813,12/22/2020
2020-08-18,128,30075,4911,424851,454926,11.0,2430.0,8.0,2031.0,1.0,327.0,72.0,8.0,4.0,5,1057,94,20830,2650,210727,231557,12/22/2020
2020-08-19,113,30188,5076,429927,460115,8.0,2438.0,9.0,2040.0,1.0,328.0,70.0,9.0,5.0,0,1057,90,20920,2542,213269,234189,12/22/2020
2020-08-20,173,30361,7411,437338,467699,12.0,2450.0,6.0,2046.0,2.0,330.0,74.0,10.0,5.0,3,1060,139,21059,3392,216661,237720,12/22/2020
2020-08-21,152,30513,6577,443915,474428,8.0,2458.0,5.0,2051.0,1.0,331.0,76.0,9.0,4.0,2,1062,125,21184,2816,219477,240661,12/22/2020
2020-08-22,96,30609,5550,449465,480074,11.0,2469.0,12.0,2063.0,0.0,331.0,75.0,11.0,4.0,1,1063,84,21268,2498,221975,243243,12/22/2020
2020-08-23,72,30681,4375,453840,484521,11.0,2480.0,6.0,2069.0,0.0,331.0,80.0,12.0,2.0,1,1064,56,21324,2408,224383,245707,12/22/2020
2020-08-24,105,30786,5784,459624,490410,7.0,2487.0,10.0,2079.0,1.0,332.0,76.0,14.0,4.0,1,1065,77,21401,3045,227428,248829,12/22/2020
2020-08-25,108,30894,4764,464388,495282,10.0,2497.0,4.0,2083.0,1.0,333.0,81.0,12.0,4.0,1,1066,92,21493,2211,229639,251132,12/22/2020
2020-08-26,170,31064,9482,473870,504934,4.0,2501.0,8.0,2091.0,0.0,333.0,77.0,10.0,5.0,1,1067,127,21620,2972,232611,254231,12/22/2020
2020-08-27,91,31155,8565,482435,513590,6.0,2507.0,13.0,2104.0,1.0,334.0,69.0,7.0,5.0,2,1069,70,21690,3033,235644,257334,12/22/2020
2020-08-28,113,31268,7994,490429,521697,14.0,2521.0,4.0,2108.0,0.0,334.0,79.0,10.0,7.0,2,1071,87,21777,2332,237976,259753,12/22/2020
2020-08-29,65,31333,5374,495803,527136,6.0,2527.0,8.0,2116.0,1.0,335.0,76.0,11.0,6.0,2,1073,51,21828,1850,239826,261654,12/22/2020
2020-08-30,66,31399,4323,500126,531525,7.0,2534.0,4.0,2120.0,0.0,335.0,79.0,9.0,5.0,2,1075,48,21876,1930,241756,263632,12/22/2020
2020-08-31,105,31504,4863,504989,536493,12.0,2546.0,16.0,2136.0,0.0,335.0,75.0,8.0,4.0,1,1076,81,21957,2115,243871,265828,12/22/2020
2020-09-01,99,31603,7109,512098,543701,6.0,2552.0,9.0,2145.0,1.0,336.0,71.0,7.0,4.0,2,1078,66,22023,2296,246167,268190,12/22/2020
2020-09-02,125,31728,10529,522627,554355,9.0,2561.0,10.0,2155.0,1.0,337.0,69.0,8.0,4.0,2,1080,104,22127,2953,249120,271247,12/22/2020
2020-09-03,90,31818,11080,533707,565525,8.0,2569.0,8.0,2163.0,0.0,337.0,69.0,9.0,4.0,3,1083,73,22200,2479,251599,273799,12/22/2020
2020-09-04,103,31921,8963,542670,574591,11.0,2580.0,4.0,2167.0,0.0,337.0,76.0,9.0,4.0,1,1084,83,22283,2282,253881,276164,12/22/2020
2020-09-05,52,31973,6306,548976,580949,6.0,2586.0,9.0,2176.0,0.0,337.0,73.0,8.0,3.0,1,1085,42,22325,1541,255422,277747,12/22/2020
2020-09-06,88,32061,4325,553301,585362,4.0,2590.0,8.0,2184.0,1.0,338.0,68.0,6.0,3.0,1,1086,65,22390,1871,257293,279683,12/22/2020
2020-09-07,35,32096,3002,556303,588399,11.0,2601.0,3.0,2187.0,0.0,338.0,76.0,5.0,3.0,1,1087,26,22416,619,257912,280328,12/22/2020
2020-09-08,74,32170,6381,562684,594854,6.0,2607.0,12.0,2199.0,1.0,339.0,69.0,6.0,3.0,2,1089,66,22482,1530,259442,281924,12/22/2020
2020-09-09,118,32288,8650,571334,603622,10.0,2617.0,5.0,2204.0,1.0,340.0,73.0,9.0,3.0,1,1090,102,22584,2043,261485,284069,12/22/2020
2020-09-10,164,32452,11334,582668,615120,9.0,2626.0,8.0,2212.0,0.0,340.0,74.0,10.0,3.0,1,1091,111,22695,2171,263656,286351,12/22/2020
2020-09-11,120,32572,9454,592122,624694,11.0,2637.0,11.0,2223.0,0.0,340.0,74.0,10.0,5.0,0,1091,95,22790,1881,265537,288327,12/22/2020
2020-09-12,110,32682,6158,598280,630962,8.0,2645.0,5.0,2228.0,2.0,342.0,75.0,9.0,5.0,3,1094,97,22887,1433,266970,289857,12/22/2020
2020-09-13,58,32740,2717,600997,633737,4.0,2649.0,3.0,2231.0,0.0,342.0,76.0,10.0,5.0,0,1094,54,22941,822,267792,290733,12/22/2020
2020-09-14,104,32844,6434,607431,640275,6.0,2655.0,3.0,2234.0,2.0,344.0,77.0,10.0,5.0,2,1096,95,23036,1639,269431,292467,12/22/2020
2020-09-15,122,32966,8457,615888,648854,7.0,2662.0,2.0,2236.0,1.0,345.0,81.0,10.0,5.0,2,1098,124,23160,2098,271529,294689,12/22/2020
2020-09-16,137,33103,9706,625594,658697,7.0,2669.0,7.0,2243.0,2.0,347.0,79.0,9.0,6.0,5,1103,118,23278,1896,273425,296703,12/22/2020
2020-09-17,125,33228,9228,634822,668050,7.0,2676.0,15.0,2258.0,0.0,347.0,71.0,8.0,4.0,0,1103,154,23432,1857,275282,298714,12/22/2020
2020-09-18,132,33360,10028,644850,678210,7.0,2683.0,7.0,2265.0,1.0,348.0,70.0,11.0,6.0,2,1105,132,23564,1845,277127,300691,12/22/2020
2020-09-19,115,33475,8292,653142,686617,7.0,2690.0,3.0,2268.0,0.0,348.0,74.0,10.0,6.0,4,1109,112,23676,1634,278761,302437,12/22/2020
2020-09-20,60,33535,3676,656818,690353,7.0,2697.0,6.0,2274.0,2.0,350.0,73.0,9.0,8.0,4,1113,49,23725,1280,280041,303766,12/22/2020
2020-09-21,102,33637,7006,663824,697461,12.0,2709.0,3.0,2277.0,2.0,352.0,80.0,8.0,6.0,2,1115,94,23819,2329,282370,306189,12/22/2020
2020-09-22,154,33791,9273,673097,706888,12.0,2721.0,3.0,2280.0,1.0,353.0,88.0,7.0,5.0,1,1116,124,23943,2109,284479,308422,12/22/2020
2020-09-23,136,33927,10639,683736,717663,13.0,2734.0,7.0,2287.0,0.0,353.0,94.0,6.0,5.0,0,1116,127,24070,2124,286603,310673,12/22/2020
2020-09-24,120,34047,12469,696205,730252,8.0,2742.0,9.0,2296.0,1.0,354.0,92.0,7.0,5.0,1,1117,120,24190,3069,289672,313862,12/22/2020
2020-09-25,150,34197,10546,706751,740948,9.0,2751.0,10.0,2306.0,0.0,354.0,91.0,6.0,5.0,1,1118,143,24333,2911,292583,316916,12/22/2020
2020-09-26,147,34344,10556,717307,751651,12.0,2763.0,9.0,2315.0,0.0,354.0,94.0,6.0,5.0,1,1119,120,24453,2342,294925,319378,12/22/2020
2020-09-27,43,34387,2764,720071,754458,7.0,2770.0,5.0,2320.0,0.0,354.0,96.0,9.0,5.0,0,1119,34,24487,814,295739,320226,12/22/2020
2020-09-28,156,34543,7294,727365,761908,7.0,2777.0,7.0,2327.0,2.0,356.0,94.0,7.0,5.0,2,1121,138,24625,2181,297920,322545,12/22/2020
2020-09-29,203,34746,11033,738398,773144,12.0,2789.0,18.0,2345.0,1.0,357.0,87.0,6.0,6.0,1,1122,185,24810,2730,300650,325460,12/22/2020
2020-09-30,223,34969,12219,750617,785586,6.0,2795.0,6.0,2351.0,0.0,357.0,87.0,6.0,6.0,1,1123,189,24999,2484,303134,328133,12/22/2020
2020-10-01,184,35153,12492,763109,798262,17.0,2812.0,13.0,2364.0,1.0,358.0,90.0,6.0,4.0,2,1125,166,25165,2318,305452,330617,12/22/2020
2020-10-02,209,35362,12148,775257,810619,14.0,2826.0,13.0,2377.0,1.0,359.0,90.0,8.0,5.0,2,1127,181,25346,2409,307861,333207,12/22/2020
2020-10-03,157,35519,9304,784561,820080,9.0,2835.0,9.0,2386.0,2.0,361.0,88.0,9.0,4.0,2,1129,131,25477,1947,309808,335285,12/22/2020
2020-10-04,81,35600,2369,786930,822530,11.0,2846.0,9.0,2395.0,1.0,362.0,89.0,8.0,5.0,2,1131,76,25553,922,310730,336283,12/22/2020
2020-10-05,174,35774,8963,795893,831667,30.0,2876.0,10.0,2405.0,2.0,364.0,107.0,9.0,6.0,4,1135,160,25713,2939,313669,339382,12/22/2020
2020-10-06,189,35963,11186,807079,843042,11.0,2887.0,4.0,2409.0,0.0,364.0,114.0,11.0,7.0,0,1135,188,25901,2805,316474,342375,12/22/2020
2020-10-07,244,36207,12426,819505,855712,13.0,2900.0,14.0,2423.0,2.0,366.0,111.0,9.0,7.0,2,1137,245,26146,3422,319896,346042,12/22/2020
2020-10-08,282,36489,15221,834726,871215,17.0,2917.0,13.0,2436.0,2.0,368.0,113.0,7.0,5.0,4,1141,276,26422,4082,323978,350400,12/22/2020
2020-10-09,229,36718,13728,848454,885172,21.0,2938.0,12.0,2448.0,0.0,368.0,122.0,10.0,7.0,3,1144,201,26623,4151,328129,354752,12/22/2020
2020-10-10,231,36949,13827,862281,899230,19.0,2957.0,10.0,2458.0,1.0,369.0,130.0,13.0,7.0,2,1146,191,26814,3678,331807,358621,12/22/2020
2020-10-11,99,37048,3263,865544,902592,12.0,2969.0,9.0,2467.0,1.0,370.0,132.0,14.0,5.0,6,1152,89,26903,1130,332937,359840,12/22/2020
2020-10-12,169,37217,6418,871962,909179,19.0,2988.0,15.0,2482.0,2.0,372.0,134.0,14.0,5.0,4,1156,156,27059,1665,334602,361661,12/22/2020
2020-10-13,225,37442,8517,880479,917921,15.0,3003.0,13.0,2495.0,4.0,376.0,132.0,13.0,5.0,7,1163,212,27271,2244,336846,364117,12/22/2020
2020-10-14,336,37778,15032,895511,933289,17.0,3020.0,7.0,2502.0,0.0,376.0,142.0,15.0,5.0,2,1165,304,27575,3909,340755,368330,12/22/2020
2020-10-15,269,38047,14625,910136,948183,12.0,3032.0,16.0,2518.0,1.0,377.0,137.0,13.0,5.0,2,1167,252,27827,3461,344216,372043,12/22/2020
2020-10-16,288,38335,15008,925144,963479,13.0,3045.0,18.0,2536.0,1.0,378.0,131.0,13.0,4.0,2,1169,277,28104,3257,347473,375577,12/22/2020
2020-10-17,360,38695,14058,939202,977897,19.0,3064.0,11.0,2547.0,1.0,379.0,138.0,17.0,4.0,2,1171,308,28412,3141,350614,379026,12/22/2020
2020-10-18,155,38850,4039,943241,982091,18.0,3082.0,11.0,2558.0,0.0,379.0,145.0,17.0,6.0,2,1173,125,28537,1262,351876,380413,12/22/2020
2020-10-19,385,39235,8492,951733,990968,21.0,3103.0,22.0,2580.0,2.0,381.0,142.0,15.0,6.0,1,1174,320,28857,2473,354349,383206,12/22/2020
2020-10-20,439,39674,13245,964978,1004652,23.0,3126.0,17.0,2597.0,0.0,381.0,148.0,14.0,8.0,3,1177,383,29240,2907,357256,386496,12/22/2020
2020-10-21,544,40218,17464,982442,1022660,23.0,3149.0,8.0,2605.0,2.0,383.0,161.0,15.0,9.0,3,1180,471,29711,3374,360630,390341,12/22/2020
2020-10-22,538,40756,15864,998306,1039062,24.0,3173.0,20.0,2625.0,3.0,386.0,162.0,14.0,9.0,3,1183,488,30199,3068,363698,393897,12/22/2020
2020-10-23,514,41270,16637,1014943,1056213,22.0,3195.0,22.0,2647.0,1.0,387.0,161.0,15.0,9.0,3,1186,458,30657,2789,366487,397144,12/22/2020
2020-10-24,360,41630,10249,1025192,1066822,17.0,3212.0,11.0,2658.0,0.0,387.0,167.0,14.0,8.0,1,1187,338,30995,2176,368663,399658,12/22/2020
2020-10-25,233,41863,4760,1029952,1071815,16.0,3228.0,15.0,2673.0,1.0,388.0,167.0,15.0,8.0,2,1189,210,31205,1400,370063,401268,12/22/2020
2020-10-26,454,42317,9174,1039126,1081443,28.0,3256.0,15.0,2688.0,2.0,390.0,178.0,18.0,8.0,3,1192,402,31607,2879,372942,404549,12/22/2020
2020-10-27,516,42833,13995,1053121,1095954,29.0,3285.0,15.0,2703.0,2.0,392.0,190.0,18.0,9.0,4,1196,454,32061,2318,375260,407321,12/22/2020
2020-10-28,469,43302,15226,1068347,1111649,25.0,3310.0,26.0,2729.0,1.0,393.0,188.0,17.0,9.0,3,1199,411,32472,2595,377855,410327,12/22/2020
2020-10-29,609,43911,16260,1084607,1128518,20.0,3330.0,22.0,2751.0,3.0,396.0,183.0,19.0,11.0,4,1203,527,32999,3031,380886,413885,12/22/2020
2020-10-30,564,44475,14865,1099472,1143947,21.0,3351.0,21.0,2772.0,5.0,401.0,178.0,19.0,9.0,4,1207,470,33469,2845,383731,417200,12/22/2020
2020-10-31,599,45074,11819,1111291,1156365,32.0,3383.0,13.0,2785.0,1.0,402.0,196.0,23.0,10.0,3,1210,486,33955,2337,386068,420023,12/22/2020
2020-11-01,330,45404,5091,1116382,1161786,22.0,3405.0,15.0,2800.0,1.0,403.0,202.0,27.0,13.0,4,1214,276,34231,1225,387293,421524,12/22/2020
2020-11-02,522,45926,9935,1126317,1172243,38.0,3443.0,27.0,2827.0,3.0,406.0,210.0,25.0,13.0,5,1219,458,34689,2845,390138,424827,12/22/2020
2020-11-03,601,46527,13040,1139357,1185884,33.0,3476.0,25.0,2852.0,1.0,407.0,217.0,25.0,13.0,1,1220,530,35219,2435,392573,427792,12/22/2020
2020-11-04,688,47215,16101,1155458,1202673,34.0,3510.0,27.0,2879.0,2.0,409.0,222.0,26.0,12.0,4,1224,641,35860,2832,395405,431265,12/22/2020
2020-11-05,768,47983,16593,1172051,1220034,46.0,3556.0,35.0,2914.0,1.0,410.0,232.0,25.0,14.0,3,1227,684,36544,2770,398175,434719,12/22/2020
2020-11-06,769,48752,16026,1188077,1236829,43.0,3599.0,31.0,2945.0,1.0,411.0,243.0,29.0,17.0,5,1232,690,37234,2949,401124,438358,12/22/2020
2020-11-07,604,49356,13649,1201726,1251082,34.0,3633.0,25.0,2970.0,1.0,412.0,251.0,32.0,18.0,1,1233,578,37812,2399,403523,441335,12/22/2020
2020-11-08,337,49693,4166,1205892,1255585,33.0,3666.0,26.0,2996.0,1.0,413.0,257.0,31.0,19.0,4,1237,323,38135,1245,404768,442903,12/22/2020
2020-11-09,808,50501,9063,1214955,1265456,40.0,3706.0,33.0,3029.0,2.0,415.0,262.0,29.0,18.0,3,1240,765,38900,2259,407027,445927,12/22/2020
2020-11-10,1053,51554,12982,1227937,1279491,45.0,3751.0,37.0,3066.0,0.0,415.0,270.0,32.0,18.0,6,1246,982,39882,2808,409835,449717,12/22/2020
2020-11-11,1087,52641,19738,1247675,1300316,42.0,3793.0,24.0,3090.0,5.0,420.0,283.0,31.0,15.0,7,1253,1002,40884,2610,412445,453329,12/22/2020
2020-11-12,893,53534,13913,1261588,1315122,39.0,3832.0,31.0,3121.0,3.0,423.0,288.0,29.0,15.0,5,1258,814,41698,2148,414593,456291,12/22/2020
2020-11-13,1165,54699,16391,1277979,1332678,39.0,3871.0,31.0,3152.0,0.0,423.0,296.0,28.0,15.0,2,1260,1115,42813,3014,417607,460420,12/22/2020
2020-11-14,782,55481,13519,1291498,1346979,42.0,3913.0,26.0,3178.0,5.0,428.0,307.0,26.0,13.0,10,1270,738,43551,2408,420015,463566,12/22/2020
2020-11-15,578,56059,6173,1297671,1353730,46.0,3959.0,21.0,3199.0,5.0,433.0,327.0,29.0,11.0,7,1277,495,44046,1387,421402,465448,12/22/2020
2020-11-16,739,56798,9647,1307318,1364116,56.0,4015.0,39.0,3238.0,3.0,436.0,341.0,27.0,13.0,5,1282,674,44720,2588,423990,468710,12/22/2020
2020-11-17,1538,58336,18176,1325494,1383830,59.0,4074.0,45.0,3283.0,2.0,438.0,353.0,31.0,13.0,5,1287,1402,46122,4037,428027,474149,12/22/2020
2020-11-18,1136,59472,16042,1341536,1401008,39.0,4113.0,38.0,3321.0,5.0,443.0,349.0,30.0,15.0,7,1294,1020,47142,3132,431159,478301,12/22/2020
2020-11-19,1128,60600,13171,1354707,1415307,47.0,4160.0,42.0,3363.0,4.0,447.0,350.0,31.0,18.0,5,1299,1032,48174,3339,434498,482672,12/22/2020
2020-11-20,1457,62057,22226,1376933,1438990,49.0,4209.0,48.0,3411.0,3.0,450.0,348.0,34.0,14.0,6,1305,1293,49467,4227,438725,488192,12/22/2020
2020-11-21,854,62911,17369,1394302,1457213,43.0,4252.0,34.0,3445.0,5.0,455.0,352.0,36.0,14.0,7,1312,755,50222,3074,441799,492021,12/22/2020
2020-11-22,571,63482,7519,1401821,1465303,65.0,4317.0,28.0,3473.0,4.0,459.0,385.0,34.0,15.0,11,1323,486,50708,1764,443563,494271,12/22/2020
2020-11-23,994,64476,11030,1412851,1477327,75.0,4392.0,40.0,3513.0,0.0,459.0,420.0,41.0,18.0,10,1333,893,51601,3337,446900,498501,12/22/2020
2020-11-24,1049,65525,14579,1427430,1492955,47.0,4439.0,60.0,3573.0,6.0,465.0,401.0,43.0,22.0,10,1343,939,52540,2717,449617,502157,12/22/2020
2020-11-25,1265,66790,18787,1446217,1513007,59.0,4498.0,59.0,3632.0,4.0,469.0,397.0,44.0,26.0,7,1350,1179,53719,3383,453000,506719,12/22/2020
2020-11-26,547,67337,6483,1452700,1520037,51.0,4549.0,35.0,3667.0,4.0,473.0,409.0,47.0,25.0,12,1362,467,54186,1502,454502,508688,12/22/2020
2020-11-27,1043,68380,9724,1462424,1530804,56.0,4605.0,51.0,3718.0,7.0,480.0,407.0,48.0,22.0,7,1369,968,55154,2484,456986,512140,12/22/2020
2020-11-28,1182,69562,11960,1474384,1543946,64.0,4669.0,39.0,3757.0,0.0,480.0,432.0,49.0,22.0,3,1372,1097,56251,2762,459748,515999,12/22/2020
2020-11-29,822,70384,6936,1481320,1551704,62.0,4731.0,35.0,3792.0,3.0,483.0,456.0,50.0,24.0,8,1380,755,57006,2281,462029,519035,12/22/2020
2020-11-30,1283,71667,9925,1491245,1562912,67.0,4798.0,60.0,3852.0,2.0,485.0,461.0,53.0,30.0,6,1386,1162,58168,2767,464796,522964,12/22/2020
2020-12-01,1555,73222,13956,1505201,1578423,61.0,4859.0,55.0,3907.0,4.0,489.0,463.0,52.0,31.0,12,1398,1419,59587,3326,468122,527709,12/22/2020
2020-12-02,1561,74783,15563,1520764,1595547,57.0,4916.0,53.0,3960.0,7.0,496.0,460.0,53.0,30.0,14,1412,1432,61019,3218,471340,532359,12/22/2020
2020-12-03,1772,76555,14626,1535390,1611945,64.0,4980.0,76.0,4036.0,5.0,501.0,443.0,49.0,31.0,10,1422,1640,62659,3280,474620,537279,12/22/2020
2020-12-04,1648,78203,16505,1551895,1630098,70.0,5050.0,50.0,4086.0,7.0,508.0,456.0,46.0,29.0,11,1433,1520,64179,3738,478358,542537,12/22/2020
2020-12-05,1199,79402,12609,1564504,1643906,71.0,5121.0,42.0,4128.0,4.0,512.0,481.0,48.0,29.0,11,1444,1066,65245,2860,481218,546463,12/22/2020
2020-12-06,1125,80527,7843,1572347,1652874,65.0,5186.0,50.0,4178.0,10.0,522.0,486.0,49.0,25.0,14,1458,979,66224,2453,483671,549895,12/22/2020
2020-12-07,1396,81923,10640,1582987,1664910,74.0,5260.0,59.0,4237.0,6.0,528.0,495.0,47.0,25.0,19,1477,1254,67478,3283,486954,554432,12/22/2020
2020-12-08,1464,83387,15315,1598302,1681689,57.0,5317.0,57.0,4294.0,5.0,533.0,490.0,50.0,27.0,17,1494,1315,68793,3539,490493,559286,12/22/2020
2020-12-09,1499,84886,16351,1614653,1699539,57.0,5374.0,63.0,4357.0,9.0,542.0,475.0,47.0,29.0,12,1506,1342,70135,3196,493689,563824,12/22/2020
2020-12-10,1474,86360,17264,1631917,1718277,64.0,5438.0,58.0,4415.0,7.0,549.0,474.0,54.0,28.0,18,1524,1257,71392,4062,497751,569143,12/22/2020
2020-12-11,1489,87849,17370,1649287,1737136,72.0,5510.0,82.0,4497.0,7.0,556.0,457.0,59.0,31.0,16,1540,1293,72685,3589,501340,574025,12/22/2020
2020-12-12,1106,88955,13054,1662341,1751296,65.0,5575.0,54.0,4551.0,9.0,565.0,459.0,51.0,31.0,16,1556,920,73605,3093,504433,578038,12/22/2020
2020-12-13,672,89627,7145,1669486,1759113,74.0,5649.0,41.0,4592.0,14.0,579.0,478.0,52.0,28.0,25,1581,556,74161,2001,506434,580595,12/22/2020
2020-12-14,1314,90941,11196,1680682,1771623,82.0,5731.0,62.0,4654.0,9.0,588.0,489.0,63.0,30.0,14,1595,1141,75302,3377,509811,585113,12/22/2020
2020-12-15,1268,92209,15076,1695758,1787967,69.0,5800.0,55.0,4709.0,5.0,593.0,498.0,58.0,29.0,13,1608,1066,76368,3079,512890,589258,12/22/2020
2020-12-16,1273,93482,19066,1714824,1808306,53.0,5853.0,70.0,4779.0,10.0,603.0,471.0,57.0,31.0,15,1623,1086,77454,3701,516591,594045,12/22/2020
2020-12-17,483,93965,8818,1723642,1817607,46.0,5899.0,59.0,4838.0,8.0,611.0,450.0,56.0,31.0,13,1636,429,77883,1274,517865,595748,12/22/2020
2020-12-18,1089,95054,13360,1737002,1832056,51.0,5950.0,64.0,4902.0,11.0,622.0,426.0,56.0,32.0,9,1645,916,78799,2715,520580,599379,12/22/2020
2020-12-19,1311,96365,16325,1753327,1849692,55.0,6005.0,39.0,4941.0,9.0,631.0,433.0,55.0,35.0,15,1660,1081,79880,3124,523704,603584,12/22/2020
2020-12-20,533,96898,6758,1760085,1856983,54.0,6059.0,39.0,4980.0,8.0,639.0,440.0,54.0,38.0,11,1671,427,80307,1679,525383,605690,12/22/2020
2020-12-21,1061,97959,11384,1771469,1869428,,,,,,,,,,7,1678,880,81187,3358,528741,609928,12/22/2020
2020-02-27,0,0,0,0,0,1.0,1.0,0.0,0.0,0.0,0.0,1.0,0.0,0.0,0,0,0,0,0,0,0,12/23/2020
2020-02-28,0,0,0,0,0,0.0,1.0,0.0,0.0,0.0,0.0,1.0,1.0,0.0,0,0,0,0,0,0,0,12/23/2020
2020-02-29,0,0,0,0,0,0.0,1.0,0.0,0.0,0.0,0.0,1.0,1.0,0.0,0,0,0,0,0,0,0,12/23/2020
2020-03-01,2,2,2,2,4,0.0,1.0,0.0,0.0,0.0,0.0,1.0,1.0,1.0,0,0,2,2,2,2,4,12/23/2020
2020-03-02,0,2,1,3,5,1.0,2.0,0.0,0.0,0.0,0.0,2.0,2.0,2.0,0,0,0,2,0,2,4,12/23/2020
2020-03-03,0,2,2,5,7,0.0,2.0,0.0,0.0,0.0,0.0,2.0,2.0,2.0,0,0,0,2,1,3,5,12/23/2020
2020-03-04,0,2,12,17,19,1.0,3.0,0.0,0.0,0.0,0.0,3.0,2.0,2.0,0,0,0,2,10,13,15,12/23/2020
2020-03-05,0,2,4,21,23,0.0,3.0,0.0,0.0,0.0,0.0,3.0,2.0,2.0,0,0,1,3,4,17,20,12/23/2020
2020-03-06,1,3,12,33,36,0.0,3.0,0.0,0.0,0.0,0.0,3.0,2.0,2.0,0,0,0,3,11,28,31,12/23/2020
2020-03-07,0,3,19,52,55,0.0,3.0,0.0,0.0,0.0,0.0,3.0,2.0,1.0,0,0,0,3,19,47,50,12/23/2020
2020-03-08,0,3,18,70,73,0.0,3.0,0.0,0.0,0.0,0.0,3.0,2.0,1.0,0,0,0,3,18,65,68,12/23/2020
2020-03-09,1,4,15,85,89,0.0,3.0,0.0,0.0,0.0,0.0,3.0,2.0,1.0,0,0,1,4,14,79,83,12/23/2020
2020-03-10,2,6,25,110,116,0.0,3.0,0.0,0.0,0.0,0.0,3.0,2.0,1.0,0,0,1,5,23,102,107,12/23/2020
2020-03-11,0,6,34,144,150,1.0,4.0,0.0,0.0,0.0,0.0,4.0,1.0,1.0,0,0,0,5,34,136,141,12/23/2020
2020-03-12,9,15,41,185,200,1.0,5.0,0.0,0.0,0.0,0.0,5.0,1.0,1.0,0,0,7,12,38,174,186,12/23/2020
2020-03-13,6,21,50,235,256,4.0,9.0,1.0,1.0,0.0,0.0,8.0,1.0,1.0,0,0,6,18,47,221,239,12/23/2020
2020-03-14,0,21,90,325,346,0.0,9.0,0.0,1.0,0.0,0.0,8.0,1.0,1.0,0,0,0,18,83,304,322,12/23/2020
2020-03-15,1,22,54,379,401,1.0,10.0,0.0,1.0,0.0,0.0,9.0,2.0,1.0,0,0,1,19,53,357,376,12/23/2020
2020-03-16,2,24,95,474,498,2.0,12.0,0.0,1.0,0.0,0.0,11.0,2.0,0.0,0,0,2,21,88,445,466,12/23/2020
2020-03-17,12,36,162,636,672,6.0,18.0,0.0,1.0,0.0,0.0,17.0,2.0,0.0,0,0,11,32,141,586,618,12/23/2020
2020-03-18,9,45,116,752,797,3.0,21.0,0.0,1.0,0.0,0.0,20.0,2.0,0.0,0,0,11,43,104,690,733,12/23/2020
2020-03-19,15,60,262,1014,1074,2.0,23.0,1.0,2.0,0.0,0.0,21.0,3.0,0.0,1,1,17,60,243,933,993,12/23/2020
2020-03-20,13,73,197,1211,1284,5.0,28.0,0.0,2.0,0.0,0.0,26.0,4.0,0.0,0,1,13,73,181,1114,1187,12/23/2020
2020-03-21,12,85,126,1337,1422,3.0,31.0,2.0,4.0,0.0,0.0,27.0,5.0,0.0,0,1,14,87,117,1231,1318,12/23/2020
2020-03-22,27,112,282,1619,1731,2.0,33.0,0.0,4.0,0.0,0.0,29.0,5.0,0.0,0,1,25,112,250,1481,1593,12/23/2020
2020-03-23,14,126,169,1788,1914,15.0,48.0,1.0,5.0,0.0,0.0,43.0,9.0,3.0,0,1,16,128,156,1637,1765,12/23/2020
2020-03-24,20,146,242,2030,2176,8.0,56.0,0.0,5.0,0.0,0.0,51.0,10.0,5.0,0,1,19,147,217,1854,2001,12/23/2020
2020-03-25,26,172,182,2212,2384,5.0,61.0,2.0,7.0,0.0,0.0,54.0,11.0,3.0,0,1,28,175,158,2012,2187,12/23/2020
2020-03-26,35,207,181,2393,2600,9.0,70.0,5.0,12.0,0.0,0.0,58.0,14.0,5.0,0,1,41,216,162,2174,2390,12/23/2020
2020-03-27,27,234,214,2607,2841,9.0,79.0,1.0,13.0,1.0,1.0,65.0,16.0,6.0,2,3,31,247,184,2358,2605,12/23/2020
2020-03-28,59,293,260,2867,3160,11.0,90.0,2.0,15.0,1.0,2.0,73.0,15.0,6.0,1,4,64,311,230,2588,2899,12/23/2020
2020-03-29,100,393,350,3217,3610,8.0,98.0,3.0,18.0,1.0,3.0,77.0,18.0,8.0,2,6,105,416,287,2875,3291,12/23/2020
2020-03-30,62,455,222,3439,3894,19.0,117.0,5.0,23.0,0.0,3.0,91.0,19.0,11.0,3,9,78,494,171,3046,3540,12/23/2020
2020-03-31,71,526,369,3808,4334,11.0,128.0,7.0,30.0,1.0,4.0,94.0,21.0,13.0,2,11,73,567,281,3327,3894,12/23/2020
2020-04-01,99,625,698,4506,5131,18.0,146.0,7.0,37.0,0.0,4.0,105.0,29.0,15.0,1,12,100,667,588,3915,4582,12/23/2020
2020-04-02,52,677,477,4983,5660,22.0,168.0,6.0,43.0,2.0,6.0,119.0,35.0,21.0,4,16,62,729,408,4323,5052,12/23/2020
2020-04-03,108,785,774,5757,6542,23.0,191.0,7.0,50.0,0.0,6.0,135.0,42.0,25.0,3,19,100,829,659,4982,5811,12/23/2020
2020-04-04,143,928,660,6417,7345,22.0,213.0,4.0,54.0,5.0,11.0,148.0,40.0,29.0,9,28,138,967,576,5558,6525,12/23/2020
2020-04-05,187,1115,1156,7573,8688,20.0,233.0,9.0,63.0,1.0,12.0,158.0,43.0,35.0,2,30,181,1148,974,6532,7680,12/23/2020
2020-04-06,218,1333,1706,9279,10612,26.0,259.0,7.0,70.0,0.0,12.0,177.0,47.0,39.0,7,37,207,1355,1447,7979,9334,12/23/2020
2020-04-07,284,1617,1629,10908,12525,20.0,279.0,4.0,74.0,2.0,14.0,191.0,49.0,41.0,5,42,260,1615,1378,9357,10972,12/23/2020
2020-04-08,290,1907,1720,12628,14535,19.0,298.0,8.0,82.0,5.0,19.0,197.0,49.0,37.0,10,52,271,1886,1449,10806,12692,12/23/2020
2020-04-09,283,2190,1516,14144,16334,32.0,330.0,8.0,90.0,4.0,23.0,217.0,53.0,40.0,7,59,277,2163,1260,12066,14229,12/23/2020
2020-04-10,419,2609,2574,16718,19327,29.0,359.0,17.0,107.0,5.0,28.0,224.0,59.0,41.0,11,70,400,2563,2206,14272,16835,12/23/2020
2020-04-11,298,2907,1905,18623,21530,29.0,388.0,11.0,118.0,2.0,30.0,240.0,61.0,48.0,12,82,280,2843,1606,15878,18721,12/23/2020
2020-04-12,315,3222,1670,20293,23515,35.0,423.0,13.0,131.0,5.0,35.0,257.0,59.0,49.0,9,91,286,3129,1296,17174,20303,12/23/2020
2020-04-13,161,3383,935,21228,24611,35.0,458.0,13.0,144.0,3.0,38.0,276.0,64.0,54.0,9,100,187,3316,779,17953,21269,12/23/2020
2020-04-14,290,3673,1787,23015,26688,27.0,485.0,18.0,162.0,5.0,43.0,280.0,72.0,53.0,8,108,261,3577,1406,19359,22936,12/23/2020
2020-04-15,350,4023,1799,24814,28837,31.0,516.0,20.0,182.0,3.0,46.0,288.0,72.0,54.0,17,125,306,3883,1404,20763,24646,12/23/2020
2020-04-16,447,4470,2494,27308,31778,36.0,552.0,25.0,207.0,6.0,52.0,293.0,72.0,53.0,14,139,387,4270,1890,22653,26923,12/23/2020
2020-04-17,304,4774,1822,29130,33904,32.0,584.0,20.0,227.0,7.0,59.0,298.0,66.0,45.0,21,160,290,4560,1313,23966,28526,12/23/2020
2020-04-18,321,5095,1725,30855,35950,26.0,610.0,18.0,245.0,4.0,63.0,302.0,63.0,49.0,15,175,284,4844,1225,25191,30035,12/23/2020
2020-04-19,381,5476,2046,32901,38377,23.0,633.0,26.0,271.0,1.0,64.0,298.0,65.0,55.0,11,186,337,5181,1620,26811,31992,12/23/2020
2020-04-20,394,5870,1907,34808,40678,46.0,679.0,29.0,300.0,2.0,66.0,313.0,75.0,56.0,10,196,376,5557,1452,28263,33820,12/23/2020
2020-04-21,444,6314,2110,36918,43232,45.0,724.0,32.0,332.0,5.0,71.0,321.0,72.0,56.0,18,214,382,5939,1588,29851,35790,12/23/2020
2020-04-22,418,6732,2390,39308,46040,41.0,765.0,32.0,364.0,5.0,76.0,325.0,73.0,58.0,18,232,380,6319,1754,31605,37924,12/23/2020
2020-04-23,479,7211,2469,41777,48988,32.0,797.0,28.0,392.0,5.0,81.0,324.0,76.0,62.0,15,247,412,6731,1710,33315,40046,12/23/2020
2020-04-24,491,7702,3284,45061,52763,35.0,832.0,26.0,418.0,4.0,85.0,329.0,85.0,63.0,15,262,407,7138,2330,35645,42783,12/23/2020
2020-04-25,393,8095,2206,47267,55362,34.0,866.0,17.0,435.0,5.0,90.0,341.0,85.0,62.0,14,276,299,7437,1568,37213,44650,12/23/2020
2020-04-26,316,8411,2309,49576,57987,33.0,899.0,15.0,450.0,3.0,93.0,356.0,86.0,59.0,14,290,274,7711,1712,38925,46636,12/23/2020
2020-04-27,249,8660,1620,51196,59856,29.0,928.0,21.0,471.0,4.0,97.0,360.0,86.0,61.0,10,300,206,7917,1063,39988,47905,12/23/2020
2020-04-28,410,9070,2263,53459,62529,44.0,972.0,24.0,495.0,3.0,100.0,377.0,88.0,59.0,22,322,330,8247,1498,41486,49733,12/23/2020
2020-04-29,476,9546,3343,56802,66348,36.0,1008.0,38.0,533.0,11.0,111.0,364.0,78.0,53.0,18,340,371,8618,2161,43647,52265,12/23/2020
2020-04-30,432,9978,2769,59571,69549,33.0,1041.0,38.0,571.0,6.0,117.0,353.0,83.0,57.0,24,364,351,8969,1698,45345,54314,12/23/2020
2020-05-01,454,10432,3086,62657,73089,52.0,1093.0,38.0,609.0,3.0,120.0,364.0,84.0,58.0,14,378,323,9292,1913,47258,56550,12/23/2020
2020-05-02,257,10689,1926,64583,75272,36.0,1129.0,39.0,648.0,5.0,125.0,356.0,93.0,63.0,24,402,193,9485,1157,48415,57900,12/23/2020
2020-05-03,283,10972,2160,66743,77715,31.0,1160.0,27.0,675.0,8.0,133.0,352.0,91.0,61.0,21,423,183,9668,1402,49817,59485,12/23/2020
2020-05-04,387,11359,2098,68841,80200,30.0,1190.0,31.0,706.0,5.0,138.0,346.0,89.0,58.0,18,441,290,9958,1444,51261,61219,12/23/2020
2020-05-05,433,11792,2873,71714,83506,29.0,1219.0,32.0,738.0,6.0,144.0,337.0,83.0,55.0,16,457,299,10257,1815,53076,63333,12/23/2020
2020-05-06,488,12280,2830,74544,86824,28.0,1247.0,44.0,782.0,9.0,153.0,312.0,80.0,55.0,21,478,340,10597,1764,54840,65437,12/23/2020
2020-05-07,425,12705,2969,77513,90218,36.0,1283.0,44.0,826.0,5.0,158.0,299.0,72.0,53.0,21,499,270,10867,1784,56624,67491,12/23/2020
2020-05-08,359,13064,2598,80111,93175,30.0,1313.0,29.0,855.0,5.0,163.0,295.0,72.0,54.0,22,521,230,11097,1538,58162,69259,12/23/2020
2020-05-09,467,13531,3346,83457,96988,22.0,1335.0,21.0,876.0,4.0,167.0,292.0,70.0,52.0,15,536,288,11385,2070,60232,71617,12/23/2020
2020-05-10,285,13816,2117,85574,99390,20.0,1355.0,23.0,899.0,6.0,173.0,283.0,71.0,50.0,14,550,190,11575,1389,61621,73196,12/23/2020
2020-05-11,257,14073,1857,87431,101504,31.0,1386.0,16.0,915.0,6.0,179.0,292.0,72.0,50.0,15,565,173,11748,1213,62834,74582,12/23/2020
2020-05-12,387,14460,2611,90042,104502,23.0,1409.0,18.0,933.0,4.0,183.0,293.0,70.0,49.0,22,587,224,11972,1511,64345,76317,12/23/2020
2020-05-13,351,14811,3630,93672,108483,23.0,1432.0,25.0,958.0,1.0,184.0,290.0,70.0,50.0,13,600,198,12170,1808,66153,78323,12/23/2020
2020-05-14,329,15140,3408,97080,112220,19.0,1451.0,27.0,985.0,3.0,187.0,279.0,65.0,46.0,15,615,233,12403,1841,67994,80397,12/23/2020
2020-05-15,381,15521,3458,100538,116059,24.0,1475.0,41.0,1026.0,5.0,192.0,257.0,63.0,46.0,14,629,232,12635,1688,69682,82317,12/23/2020
2020-05-16,449,15970,4156,104694,120664,25.0,1500.0,15.0,1041.0,5.0,197.0,262.0,62.0,47.0,15,644,247,12882,1801,71483,84365,12/23/2020
2020-05-17,240,16210,2768,107462,123672,17.0,1517.0,9.0,1050.0,5.0,202.0,265.0,60.0,46.0,10,654,126,13008,1423,72906,85914,12/23/2020
2020-05-18,250,16460,2001,109463,125923,19.0,1536.0,16.0,1066.0,5.0,207.0,263.0,58.0,41.0,18,672,135,13143,1284,74190,87333,12/23/2020
2020-05-19,415,16875,3168,112631,129506,23.0,1559.0,33.0,1099.0,5.0,212.0,248.0,57.0,39.0,11,683,215,13358,1801,75991,89349,12/23/2020
2020-05-20,326,17201,2771,115402,132603,19.0,1578.0,23.0,1122.0,7.0,219.0,237.0,53.0,34.0,22,705,183,13541,1424,77415,90956,12/23/2020
2020-05-21,374,17575,3757,119159,136734,25.0,1603.0,15.0,1137.0,3.0,222.0,244.0,54.0,30.0,20,725,168,13709,1823,79238,92947,12/23/2020
2020-05-22,351,17926,3161,122320,140246,20.0,1623.0,28.0,1165.0,5.0,227.0,231.0,53.0,30.0,11,736,206,13915,1490,80728,94643,12/23/2020
2020-05-23,253,18179,2742,125062,143241,19.0,1642.0,11.0,1176.0,3.0,230.0,236.0,53.0,33.0,13,749,109,14024,1199,81927,95951,12/23/2020
2020-05-24,163,18342,1370,126432,144774,13.0,1655.0,14.0,1190.0,2.0,232.0,233.0,54.0,36.0,8,757,83,14107,733,82660,96767,12/23/2020
2020-05-25,147,18489,1385,127817,146306,14.0,1669.0,14.0,1204.0,0.0,232.0,233.0,54.0,34.0,10,767,76,14183,680,83340,97523,12/23/2020
2020-05-26,285,18774,2620,130437,149211,24.0,1693.0,21.0,1225.0,5.0,237.0,231.0,49.0,33.0,15,782,158,14341,1542,84882,99223,12/23/2020
2020-05-27,276,19050,2057,132494,151544,20.0,1713.0,18.0,1243.0,3.0,240.0,230.0,51.0,33.0,10,792,132,14473,1081,85963,100436,12/23/2020
2020-05-28,348,19398,3359,135853,155251,17.0,1730.0,29.0,1272.0,4.0,244.0,214.0,47.0,32.0,8,800,130,14603,1033,86996,101599,12/23/2020
2020-05-29,410,19808,3915,139768,159576,19.0,1749.0,26.0,1298.0,7.0,251.0,200.0,43.0,31.0,12,812,174,14777,1455,88451,103228,12/23/2020
2020-05-30,225,20033,3915,143683,163716,16.0,1765.0,19.0,1317.0,4.0,255.0,193.0,41.0,29.0,12,824,109,14886,1623,90074,104960,12/23/2020
2020-05-31,155,20188,1690,145373,165561,11.0,1776.0,11.0,1328.0,1.0,256.0,192.0,44.0,26.0,3,827,78,14964,780,90854,105818,12/23/2020
2020-06-01,212,20400,2792,148165,168565,8.0,1784.0,14.0,1342.0,1.0,257.0,185.0,45.0,29.0,5,832,93,15057,1304,92158,107215,12/23/2020
2020-06-02,273,20673,3021,151186,171859,8.0,1792.0,9.0,1351.0,3.0,260.0,181.0,38.0,25.0,10,842,98,15155,1340,93498,108653,12/23/2020
2020-06-03,254,20927,3486,154672,175599,14.0,1806.0,18.0,1369.0,6.0,266.0,171.0,34.0,25.0,11,853,99,15254,1557,95055,110309,12/23/2020
2020-06-04,276,21203,4471,159143,180346,7.0,1813.0,26.0,1395.0,4.0,270.0,148.0,31.0,24.0,12,865,107,15361,1883,96938,112299,12/23/2020
2020-06-05,215,21418,3513,162656,184074,15.0,1828.0,13.0,1408.0,6.0,276.0,144.0,27.0,21.0,11,876,99,15460,1423,98361,113821,12/23/2020
2020-06-06,201,21619,2616,165272,186891,10.0,1838.0,7.0,1415.0,2.0,278.0,145.0,29.0,19.0,6,882,67,15527,1052,99413,114940,12/23/2020
2020-06-07,83,21702,1625,166897,188599,11.0,1849.0,7.0,1422.0,1.0,279.0,148.0,25.0,17.0,4,886,51,15578,756,100169,115747,12/23/2020
2020-06-08,119,21821,1849,168746,190567,15.0,1864.0,13.0,1435.0,2.0,281.0,148.0,27.0,18.0,4,890,45,15623,902,101071,116694,12/23/2020
2020-06-09,223,22044,2673,171419,193463,10.0,1874.0,19.0,1454.0,0.0,281.0,139.0,28.0,21.0,1,891,64,15687,1193,102264,117951,12/23/2020
2020-06-10,209,22253,2987,174406,196659,13.0,1887.0,12.0,1466.0,2.0,283.0,138.0,24.0,17.0,4,895,100,15787,1398,103662,119449,12/23/2020
2020-06-11,195,22448,3515,177921,200369,7.0,1894.0,15.0,1481.0,1.0,284.0,129.0,25.0,16.0,6,901,88,15875,1445,105107,120982,12/23/2020
2020-06-12,209,22657,4601,182522,205179,9.0,1903.0,16.0,1497.0,1.0,285.0,121.0,24.0,16.0,2,903,78,15953,1973,107080,123033,12/23/2020
2020-06-13,113,22770,3036,185558,208328,6.0,1909.0,5.0,1502.0,0.0,285.0,122.0,20.0,15.0,3,906,49,16002,1251,108331,124333,12/23/2020
2020-06-14,81,22851,2046,187604,210455,7.0,1916.0,8.0,1510.0,1.0,286.0,120.0,20.0,14.0,3,909,33,16035,922,109253,125288,12/23/2020
2020-06-15,188,23039,3107,190711,213750,14.0,1930.0,19.0,1529.0,0.0,286.0,115.0,20.0,16.0,5,914,75,16110,1694,110947,127057,12/23/2020
2020-06-16,110,23149,3017,193728,216877,11.0,1941.0,9.0,1538.0,1.0,287.0,116.0,22.0,16.0,8,922,50,16160,1458,112405,128565,12/23/2020
2020-06-17,127,23276,2835,196563,219839,15.0,1956.0,20.0,1558.0,4.0,291.0,107.0,18.0,14.0,6,928,51,16211,1249,113654,129865,12/23/2020
2020-06-18,149,23425,3049,199612,223037,9.0,1965.0,15.0,1573.0,1.0,292.0,100.0,19.0,16.0,7,935,70,16281,1245,114899,131180,12/23/2020
2020-06-19,141,23566,3769,203381,226947,12.0,1977.0,12.0,1585.0,1.0,293.0,99.0,20.0,17.0,3,938,59,16340,1296,116195,132535,12/23/2020
2020-06-20,84,23650,1891,205272,228922,9.0,1986.0,12.0,1597.0,0.0,293.0,96.0,20.0,18.0,4,942,36,16376,771,116966,133342,12/23/2020
2020-06-21,37,23687,1064,206336,230023,8.0,1994.0,5.0,1602.0,0.0,293.0,99.0,20.0,18.0,2,944,30,16406,651,117617,134023,12/23/2020
2020-06-22,138,23825,3730,210066,233891,12.0,2006.0,17.0,1619.0,0.0,293.0,94.0,19.0,18.0,2,946,65,16471,1621,119238,135709,12/23/2020
2020-06-23,163,23988,3830,213896,237884,3.0,2009.0,13.0,1632.0,3.0,296.0,81.0,18.0,18.0,7,953,81,16552,1697,120935,137487,12/23/2020
2020-06-24,120,24108,3502,217398,241506,9.0,2018.0,10.0,1642.0,1.0,297.0,79.0,18.0,18.0,5,958,45,16597,1590,122525,139122,12/23/2020
2020-06-25,103,24211,2883,220281,244492,6.0,2024.0,14.0,1656.0,1.0,298.0,70.0,17.0,17.0,1,959,51,16648,1422,123947,140595,12/23/2020
2020-06-26,94,24305,2488,222769,247074,2.0,2026.0,10.0,1666.0,0.0,298.0,62.0,18.0,18.0,1,960,60,16708,1264,125211,141919,12/23/2020
2020-06-27,84,24389,3216,225985,250374,5.0,2031.0,3.0,1669.0,1.0,299.0,63.0,17.0,17.0,5,965,37,16745,1155,126366,143111,12/23/2020
2020-06-28,39,24428,1469,227454,251882,4.0,2035.0,4.0,1673.0,4.0,303.0,59.0,15.0,14.0,6,971,17,16762,570,126936,143698,12/23/2020
2020-06-29,85,24513,3697,231151,255664,4.0,2039.0,5.0,1678.0,0.0,303.0,58.0,14.0,14.0,1,972,39,16801,1290,128226,145027,12/23/2020
2020-06-30,58,24571,1958,233109,257680,1.0,2040.0,5.0,1683.0,1.0,304.0,53.0,12.0,11.0,4,976,33,16834,950,129176,146010,12/23/2020
2020-07-01,144,24715,4098,237207,261922,8.0,2048.0,10.0,1693.0,0.0,304.0,51.0,11.0,11.0,1,977,79,16913,1842,131018,147931,12/23/2020
2020-07-02,103,24818,2803,240010,264828,5.0,2053.0,5.0,1698.0,1.0,305.0,50.0,10.0,10.0,3,980,59,16972,1031,132049,149021,12/23/2020
2020-07-03,50,24868,2079,242089,266957,9.0,2062.0,6.0,1704.0,0.0,305.0,53.0,9.0,9.0,3,983,24,16996,746,132795,149791,12/23/2020
2020-07-04,57,24925,2345,244434,269359,2.0,2064.0,4.0,1708.0,1.0,306.0,50.0,10.0,9.0,2,985,33,17029,963,133758,150787,12/23/2020
2020-07-05,49,24974,2932,247366,272340,1.0,2065.0,2.0,1710.0,1.0,307.0,48.0,8.0,8.0,2,987,26,17055,1349,135107,152162,12/23/2020
2020-07-06,101,25075,2814,250180,275255,6.0,2071.0,6.0,1716.0,0.0,307.0,48.0,9.0,9.0,4,991,57,17112,1486,136593,153705,12/23/2020
2020-07-07,81,25156,3457,253637,278793,5.0,2076.0,7.0,1723.0,0.0,307.0,46.0,8.0,8.0,2,993,47,17159,1473,138066,155225,12/23/2020
2020-07-08,105,25261,3409,257046,282307,4.0,2080.0,2.0,1725.0,0.0,307.0,48.0,9.0,8.0,0,993,64,17223,1341,139407,156630,12/23/2020
2020-07-09,94,25355,3714,260760,286115,9.0,2089.0,3.0,1728.0,0.0,307.0,54.0,9.0,8.0,0,993,50,17273,1542,140949,158222,12/23/2020
2020-07-10,132,25487,4437,265197,290684,6.0,2095.0,3.0,1731.0,2.0,309.0,55.0,7.0,7.0,3,996,80,17353,1974,142923,160276,12/23/2020
2020-07-11,63,25550,2938,268135,293685,6.0,2101.0,3.0,1734.0,1.0,310.0,57.0,6.0,6.0,3,999,36,17389,1251,144174,161563,12/23/2020
2020-07-12,47,25597,1838,269973,295570,1.0,2102.0,3.0,1737.0,1.0,311.0,54.0,6.0,5.0,3,1002,34,17423,902,145076,162499,12/23/2020
2020-07-13,84,25681,3209,273182,298863,8.0,2110.0,10.0,1747.0,0.0,311.0,52.0,6.0,5.0,1,1003,61,17484,1439,146515,163999,12/23/2020
2020-07-14,74,25755,3298,276480,302235,7.0,2117.0,4.0,1751.0,0.0,311.0,55.0,5.0,5.0,1,1004,44,17528,1325,147840,165368,12/23/2020
2020-07-15,130,25885,4181,280661,306546,5.0,2122.0,7.0,1758.0,0.0,311.0,53.0,5.0,4.0,0,1004,100,17628,1672,149512,167140,12/23/2020
2020-07-16,103,25988,3740,284401,310389,6.0,2128.0,9.0,1767.0,0.0,311.0,50.0,6.0,5.0,1,1005,76,17704,1531,151043,168747,12/23/2020
2020-07-17,156,26144,4239,288640,314784,14.0,2142.0,3.0,1770.0,1.0,312.0,60.0,5.0,5.0,2,1007,79,17783,1767,152810,170593,12/23/2020
2020-07-18,85,26229,3272,291912,318141,5.0,2147.0,9.0,1779.0,1.0,313.0,55.0,5.0,4.0,4,1011,70,17853,1334,154144,171997,12/23/2020
2020-07-19,82,26311,2696,294608,320919,7.0,2154.0,3.0,1782.0,0.0,313.0,59.0,6.0,4.0,2,1013,57,17910,1091,155235,173145,12/23/2020
2020-07-20,71,26382,2666,297274,323656,9.0,2163.0,7.0,1789.0,0.0,313.0,61.0,7.0,5.0,2,1015,68,17978,1390,156625,174603,12/23/2020
2020-07-21,130,26512,4304,301578,328090,9.0,2172.0,11.0,1800.0,0.0,313.0,59.0,9.0,6.0,1,1016,108,18086,1836,158461,176547,12/23/2020
2020-07-22,130,26642,3928,305506,332148,7.0,2179.0,8.0,1808.0,1.0,314.0,57.0,7.0,6.0,1,1017,86,18172,1594,160055,178227,12/23/2020
2020-07-23,141,26783,4415,309921,336704,8.0,2187.0,6.0,1814.0,0.0,314.0,59.0,8.0,7.0,0,1017,115,18287,1886,161941,180228,12/23/2020
2020-07-24,172,26955,5966,315887,342842,15.0,2202.0,12.0,1826.0,0.0,314.0,62.0,9.0,7.0,0,1017,119,18406,2214,164155,182561,12/23/2020
2020-07-25,134,27089,4398,320285,347374,7.0,2209.0,7.0,1833.0,0.0,314.0,62.0,10.0,8.0,3,1020,108,18514,2013,166168,184682,12/23/2020
2020-07-26,62,27151,3033,323318,350469,8.0,2217.0,9.0,1842.0,0.0,314.0,61.0,11.0,7.0,1,1021,54,18568,1278,167446,186014,12/23/2020
2020-07-27,188,27339,4191,327509,354848,12.0,2229.0,7.0,1849.0,0.0,314.0,66.0,13.0,8.0,1,1022,138,18706,2235,169681,188387,12/23/2020
2020-07-28,105,27444,3840,331349,358793,5.0,2234.0,5.0,1854.0,0.0,314.0,66.0,14.0,7.0,1,1023,95,18801,1566,171247,190048,12/23/2020
2020-07-29,190,27634,5139,336488,364122,9.0,2243.0,10.0,1864.0,0.0,314.0,65.0,15.0,7.0,0,1023,154,18955,2201,173448,192403,12/23/2020
2020-07-30,121,27755,4345,340833,368588,6.0,2249.0,2.0,1866.0,1.0,315.0,68.0,15.0,6.0,1,1024,96,19051,1553,175001,194052,12/23/2020
2020-07-31,131,27886,5512,346345,374231,7.0,2256.0,9.0,1875.0,0.0,315.0,66.0,15.0,7.0,1,1025,89,19140,1757,176758,195898,12/23/2020
2020-08-01,109,27995,4295,350640,378635,7.0,2263.0,2.0,1877.0,0.0,315.0,71.0,14.0,7.0,1,1026,89,19229,1484,178242,197471,12/23/2020
2020-08-02,84,28079,2804,353444,381523,12.0,2275.0,12.0,1889.0,2.0,317.0,69.0,14.0,8.0,2,1028,62,19291,1222,179464,198755,12/23/2020
2020-08-03,188,28267,5248,358692,386959,11.0,2286.0,10.0,1899.0,0.0,317.0,70.0,16.0,7.0,1,1029,150,19441,2099,181563,201004,12/23/2020
2020-08-04,125,28392,3691,362383,390775,8.0,2294.0,5.0,1904.0,1.0,318.0,72.0,12.0,5.0,2,1031,99,19540,1694,183257,202797,12/23/2020
2020-08-05,147,28539,5933,368316,396855,11.0,2305.0,9.0,1913.0,1.0,319.0,73.0,10.0,5.0,2,1033,119,19659,2352,185609,205268,12/23/2020
2020-08-06,169,28708,5546,373862,402570,7.0,2312.0,9.0,1922.0,0.0,319.0,71.0,9.0,4.0,0,1033,120,19779,2268,187877,207656,12/23/2020
2020-08-07,123,28831,4851,378713,407544,12.0,2324.0,9.0,1931.0,1.0,320.0,73.0,9.0,3.0,2,1035,87,19866,2039,189916,209782,12/23/2020
2020-08-08,123,28954,4112,382825,411779,19.0,2343.0,6.0,1937.0,1.0,321.0,85.0,8.0,3.0,1,1036,91,19957,1707,191623,211580,12/23/2020
2020-08-09,42,28996,1727,384552,413548,6.0,2349.0,8.0,1945.0,0.0,321.0,83.0,9.0,4.0,0,1036,35,19992,1015,192638,212630,12/23/2020
2020-08-10,149,29145,4587,389139,418284,8.0,2357.0,9.0,1954.0,0.0,321.0,82.0,9.0,4.0,1,1037,113,20105,1941,194579,214684,12/23/2020
2020-08-11,106,29251,4334,393473,422724,5.0,2362.0,13.0,1967.0,0.0,321.0,74.0,10.0,4.0,3,1040,92,20197,2177,196756,216953,12/23/2020
2020-08-12,121,29372,5189,398662,428034,8.0,2370.0,11.0,1978.0,0.0,321.0,71.0,9.0,3.0,1,1041,101,20298,2507,199263,219561,12/23/2020
2020-08-13,135,29507,4196,402858,432365,13.0,2383.0,12.0,1990.0,0.0,321.0,72.0,11.0,3.0,0,1041,95,20393,1822,201085,221478,12/23/2020
2020-08-14,145,29652,5499,408357,438009,13.0,2396.0,11.0,2001.0,0.0,321.0,74.0,11.0,4.0,3,1044,98,20491,1887,202972,223463,12/23/2020
2020-08-15,106,29758,4534,412891,442649,9.0,2405.0,11.0,2012.0,1.0,322.0,71.0,11.0,5.0,0,1044,88,20579,1620,204592,225171,12/23/2020
2020-08-16,83,29841,2477,415368,445209,6.0,2411.0,5.0,2017.0,4.0,326.0,68.0,8.0,4.0,6,1050,70,20649,916,205508,226157,12/23/2020
2020-08-17,106,29947,4575,419943,449890,8.0,2419.0,6.0,2023.0,0.0,326.0,70.0,8.0,5.0,2,1052,87,20736,2291,207799,228535,12/23/2020
2020-08-18,128,30075,4912,424855,454930,11.0,2430.0,8.0,2031.0,1.0,327.0,72.0,8.0,4.0,5,1057,94,20830,2651,210450,231280,12/23/2020
2020-08-19,113,30188,5077,429932,460120,8.0,2438.0,9.0,2040.0,1.0,328.0,70.0,9.0,5.0,0,1057,90,20920,2540,212990,233910,12/23/2020
2020-08-20,173,30361,7410,437342,467703,12.0,2450.0,6.0,2046.0,2.0,330.0,74.0,10.0,5.0,3,1060,139,21059,3388,216378,237437,12/23/2020
2020-08-21,152,30513,6577,443919,474432,8.0,2458.0,5.0,2051.0,1.0,331.0,76.0,9.0,4.0,2,1062,125,21184,2812,219190,240374,12/23/2020
2020-08-22,96,30609,5550,449469,480078,11.0,2469.0,12.0,2063.0,0.0,331.0,75.0,11.0,4.0,1,1063,84,21268,2497,221687,242955,12/23/2020
2020-08-23,72,30681,4375,453844,484525,11.0,2480.0,6.0,2069.0,0.0,331.0,80.0,12.0,2.0,1,1064,56,21324,2406,224093,245417,12/23/2020
2020-08-24,105,30786,5784,459628,490414,7.0,2487.0,10.0,2079.0,1.0,332.0,76.0,14.0,4.0,1,1065,77,21401,3041,227134,248535,12/23/2020
2020-08-25,108,30894,4764,464392,495286,10.0,2497.0,4.0,2083.0,1.0,333.0,81.0,12.0,4.0,1,1066,92,21493,2211,229345,250838,12/23/2020
2020-08-26,170,31064,9482,473874,504938,4.0,2501.0,8.0,2091.0,0.0,333.0,77.0,10.0,5.0,1,1067,127,21620,2971,232316,253936,12/23/2020
2020-08-27,91,31155,8565,482439,513594,6.0,2507.0,13.0,2104.0,1.0,334.0,69.0,7.0,5.0,2,1069,70,21690,3030,235346,257036,12/23/2020
2020-08-28,113,31268,7994,490433,521701,14.0,2521.0,4.0,2108.0,0.0,334.0,79.0,10.0,7.0,2,1071,87,21777,2330,237676,259453,12/23/2020
2020-08-29,65,31333,5374,495807,527140,6.0,2527.0,8.0,2116.0,1.0,335.0,76.0,11.0,6.0,2,1073,51,21828,1847,239523,261351,12/23/2020
2020-08-30,66,31399,4323,500130,531529,7.0,2534.0,4.0,2120.0,0.0,335.0,79.0,9.0,5.0,2,1075,48,21876,1925,241448,263324,12/23/2020
2020-08-31,105,31504,4863,504993,536497,12.0,2546.0,16.0,2136.0,0.0,335.0,75.0,8.0,4.0,1,1076,81,21957,2114,243562,265519,12/23/2020
2020-09-01,99,31603,7109,512102,543705,6.0,2552.0,9.0,2145.0,1.0,336.0,71.0,7.0,4.0,2,1078,66,22023,2296,245858,267881,12/23/2020
2020-09-02,125,31728,10529,522631,554359,9.0,2561.0,10.0,2155.0,1.0,337.0,69.0,8.0,4.0,2,1080,104,22127,2950,248808,270935,12/23/2020
2020-09-03,90,31818,11080,533711,565529,8.0,2569.0,8.0,2163.0,0.0,337.0,69.0,9.0,4.0,3,1083,73,22200,2478,251286,273486,12/23/2020
2020-09-04,103,31921,8963,542674,574595,11.0,2580.0,4.0,2167.0,0.0,337.0,76.0,9.0,4.0,1,1084,83,22283,2281,253567,275850,12/23/2020
2020-09-05,52,31973,6306,548980,580953,6.0,2586.0,9.0,2176.0,0.0,337.0,73.0,8.0,3.0,1,1085,42,22325,1539,255106,277431,12/23/2020
2020-09-06,88,32061,4325,553305,585366,4.0,2590.0,8.0,2184.0,1.0,338.0,68.0,6.0,3.0,1,1086,65,22390,1871,256977,279367,12/23/2020
2020-09-07,35,32096,3002,556307,588403,11.0,2601.0,3.0,2187.0,0.0,338.0,76.0,5.0,3.0,1,1087,26,22416,619,257596,280012,12/23/2020
2020-09-08,74,32170,6381,562688,594858,6.0,2607.0,12.0,2199.0,1.0,339.0,69.0,6.0,3.0,2,1089,66,22482,1529,259125,281607,12/23/2020
2020-09-09,118,32288,8650,571338,603626,10.0,2617.0,5.0,2204.0,1.0,340.0,73.0,9.0,3.0,1,1090,102,22584,2041,261166,283750,12/23/2020
2020-09-10,164,32452,11334,582672,615124,9.0,2626.0,8.0,2212.0,0.0,340.0,74.0,10.0,3.0,1,1091,111,22695,2169,263335,286030,12/23/2020
2020-09-11,120,32572,9454,592126,624698,11.0,2637.0,11.0,2223.0,0.0,340.0,74.0,10.0,5.0,0,1091,95,22790,1880,265215,288005,12/23/2020
2020-09-12,110,32682,6158,598284,630966,8.0,2645.0,5.0,2228.0,2.0,342.0,75.0,9.0,5.0,3,1094,97,22887,1431,266646,289533,12/23/2020
2020-09-13,58,32740,2717,601001,633741,4.0,2649.0,3.0,2231.0,0.0,342.0,76.0,10.0,5.0,0,1094,54,22941,820,267466,290407,12/23/2020
2020-09-14,104,32844,6434,607435,640279,6.0,2655.0,3.0,2234.0,2.0,344.0,77.0,10.0,5.0,2,1096,95,23036,1637,269103,292139,12/23/2020
2020-09-15,122,32966,8457,615892,648858,7.0,2662.0,2.0,2236.0,1.0,345.0,81.0,10.0,5.0,2,1098,124,23160,2097,271200,294360,12/23/2020
2020-09-16,137,33103,9706,625598,658701,7.0,2669.0,7.0,2243.0,2.0,347.0,79.0,9.0,6.0,5,1103,118,23278,1894,273094,296372,12/23/2020
2020-09-17,125,33228,9228,634826,668054,7.0,2676.0,15.0,2258.0,0.0,347.0,71.0,8.0,4.0,0,1103,154,23432,1856,274950,298382,12/23/2020
2020-09-18,132,33360,10028,644854,678214,7.0,2683.0,7.0,2265.0,1.0,348.0,70.0,11.0,6.0,2,1105,132,23564,1842,276792,300356,12/23/2020
2020-09-19,115,33475,8292,653146,686621,7.0,2690.0,3.0,2268.0,0.0,348.0,74.0,10.0,6.0,4,1109,112,23676,1634,278426,302102,12/23/2020
2020-09-20,60,33535,3676,656822,690357,7.0,2697.0,6.0,2274.0,2.0,350.0,73.0,9.0,8.0,4,1113,49,23725,1279,279705,303430,12/23/2020
2020-09-21,102,33637,7007,663829,697466,12.0,2709.0,3.0,2277.0,2.0,352.0,80.0,8.0,6.0,2,1115,94,23819,2329,282034,305853,12/23/2020
2020-09-22,154,33791,9274,673103,706894,12.0,2721.0,3.0,2280.0,1.0,353.0,88.0,7.0,5.0,1,1116,124,23943,2108,284142,308085,12/23/2020
2020-09-23,136,33927,10638,683741,717668,13.0,2734.0,7.0,2287.0,0.0,353.0,94.0,6.0,5.0,0,1116,127,24070,2122,286264,310334,12/23/2020
2020-09-24,120,34047,12468,696209,730256,8.0,2742.0,9.0,2296.0,1.0,354.0,92.0,7.0,5.0,1,1117,120,24190,3069,289333,313523,12/23/2020
2020-09-25,150,34197,10546,706755,740952,9.0,2751.0,10.0,2306.0,0.0,354.0,91.0,6.0,5.0,1,1118,143,24333,2908,292241,316574,12/23/2020
2020-09-26,147,34344,10556,717311,751655,12.0,2763.0,9.0,2315.0,0.0,354.0,94.0,6.0,5.0,1,1119,120,24453,2341,294582,319035,12/23/2020
2020-09-27,43,34387,2764,720075,754462,7.0,2770.0,5.0,2320.0,0.0,354.0,96.0,9.0,5.0,0,1119,34,24487,814,295396,319883,12/23/2020
2020-09-28,156,34543,7294,727369,761912,7.0,2777.0,7.0,2327.0,2.0,356.0,94.0,7.0,5.0,2,1121,138,24625,2180,297576,322201,12/23/2020
2020-09-29,203,34746,11033,738402,773148,12.0,2789.0,18.0,2345.0,1.0,357.0,87.0,6.0,6.0,1,1122,185,24810,2728,300304,325114,12/23/2020
2020-09-30,223,34969,12219,750621,785590,6.0,2795.0,6.0,2351.0,0.0,357.0,87.0,6.0,6.0,1,1123,189,24999,2484,302788,327787,12/23/2020
2020-10-01,184,35153,12492,763113,798266,17.0,2812.0,13.0,2364.0,1.0,358.0,90.0,6.0,4.0,2,1125,166,25165,2314,305102,330267,12/23/2020
2020-10-02,209,35362,12149,775262,810624,14.0,2826.0,13.0,2377.0,1.0,359.0,90.0,8.0,5.0,2,1127,181,25346,2405,307507,332853,12/23/2020
2020-10-03,157,35519,9304,784566,820085,9.0,2835.0,9.0,2386.0,2.0,361.0,88.0,9.0,4.0,2,1129,131,25477,1945,309452,334929,12/23/2020
2020-10-04,81,35600,2369,786935,822535,11.0,2846.0,9.0,2395.0,1.0,362.0,89.0,8.0,5.0,2,1131,76,25553,921,310373,335926,12/23/2020
2020-10-05,174,35774,8963,795898,831672,30.0,2876.0,10.0,2405.0,2.0,364.0,107.0,9.0,6.0,4,1135,160,25713,2938,313311,339024,12/23/2020
2020-10-06,189,35963,11186,807084,843047,11.0,2887.0,4.0,2409.0,0.0,364.0,114.0,11.0,7.0,0,1135,188,25901,2802,316113,342014,12/23/2020
2020-10-07,244,36207,12426,819510,855717,13.0,2900.0,14.0,2423.0,2.0,366.0,111.0,9.0,7.0,2,1137,245,26146,3418,319531,345677,12/23/2020
2020-10-08,282,36489,15222,834732,871221,17.0,2917.0,13.0,2436.0,2.0,368.0,113.0,7.0,5.0,4,1141,276,26422,4081,323612,350034,12/23/2020
2020-10-09,229,36718,13727,848459,885177,21.0,2938.0,12.0,2448.0,0.0,368.0,122.0,10.0,7.0,3,1144,201,26623,4148,327760,354383,12/23/2020
2020-10-10,231,36949,13827,862286,899235,19.0,2957.0,10.0,2458.0,1.0,369.0,130.0,13.0,7.0,2,1146,191,26814,3677,331437,358251,12/23/2020
2020-10-11,99,37048,3263,865549,902597,12.0,2969.0,9.0,2467.0,1.0,370.0,132.0,14.0,5.0,6,1152,89,26903,1127,332564,359467,12/23/2020
2020-10-12,169,37217,6418,871967,909184,19.0,2988.0,15.0,2482.0,2.0,372.0,134.0,14.0,5.0,4,1156,156,27059,1663,334227,361286,12/23/2020
2020-10-13,225,37442,8517,880484,917926,15.0,3003.0,13.0,2495.0,4.0,376.0,132.0,13.0,5.0,7,1163,212,27271,2241,336468,363739,12/23/2020
2020-10-14,336,37778,15032,895516,933294,17.0,3020.0,7.0,2502.0,0.0,376.0,142.0,15.0,5.0,2,1165,304,27575,3907,340375,367950,12/23/2020
2020-10-15,269,38047,14625,910141,948188,12.0,3032.0,16.0,2518.0,1.0,377.0,137.0,13.0,5.0,2,1167,252,27827,3458,343833,371660,12/23/2020
2020-10-16,288,38335,15008,925149,963484,13.0,3045.0,18.0,2536.0,1.0,378.0,131.0,13.0,4.0,2,1169,277,28104,3257,347090,375194,12/23/2020
2020-10-17,360,38695,14059,939208,977903,19.0,3064.0,11.0,2547.0,1.0,379.0,138.0,17.0,4.0,2,1171,308,28412,3138,350228,378640,12/23/2020
2020-10-18,155,38850,4039,943247,982097,18.0,3082.0,11.0,2558.0,0.0,379.0,145.0,17.0,6.0,2,1173,125,28537,1262,351490,380027,12/23/2020
2020-10-19,385,39235,8491,951738,990973,21.0,3103.0,22.0,2580.0,2.0,381.0,142.0,15.0,6.0,1,1174,320,28857,2468,353958,382815,12/23/2020
2020-10-20,439,39674,13245,964983,1004657,23.0,3126.0,17.0,2597.0,0.0,381.0,148.0,14.0,8.0,3,1177,383,29240,2906,356864,386104,12/23/2020
2020-10-21,544,40218,17464,982447,1022665,23.0,3149.0,8.0,2605.0,2.0,383.0,161.0,15.0,9.0,3,1180,471,29711,3372,360236,389947,12/23/2020
2020-10-22,538,40756,15866,998313,1039069,24.0,3173.0,20.0,2625.0,3.0,386.0,162.0,14.0,9.0,3,1183,488,30199,3067,363303,393502,12/23/2020
2020-10-23,514,41270,16635,1014948,1056218,22.0,3195.0,22.0,2647.0,1.0,387.0,161.0,15.0,9.0,3,1186,458,30657,2783,366086,396743,12/23/2020
2020-10-24,360,41630,10250,1025198,1066828,17.0,3212.0,11.0,2658.0,0.0,387.0,167.0,14.0,8.0,1,1187,338,30995,2174,368260,399255,12/23/2020
2020-10-25,233,41863,4760,1029958,1071821,16.0,3228.0,15.0,2673.0,1.0,388.0,167.0,15.0,8.0,2,1189,210,31205,1400,369660,400865,12/23/2020
2020-10-26,454,42317,9174,1039132,1081449,28.0,3256.0,15.0,2688.0,2.0,390.0,178.0,18.0,8.0,3,1192,402,31607,2869,372529,404136,12/23/2020
2020-10-27,516,42833,13995,1053127,1095960,29.0,3285.0,15.0,2703.0,2.0,392.0,190.0,18.0,9.0,4,1196,454,32061,2314,374843,406904,12/23/2020
2020-10-28,469,43302,15226,1068353,1111655,25.0,3310.0,26.0,2729.0,1.0,393.0,188.0,17.0,9.0,3,1199,411,32472,2593,377436,409908,12/23/2020
2020-10-29,609,43911,16260,1084613,1128524,20.0,3330.0,22.0,2751.0,3.0,396.0,183.0,19.0,11.0,4,1203,527,32999,3028,380464,413463,12/23/2020
2020-10-30,564,44475,14865,1099478,1143953,21.0,3351.0,21.0,2772.0,5.0,401.0,178.0,19.0,9.0,4,1207,470,33469,2844,383308,416777,12/23/2020
2020-10-31,599,45074,11819,1111297,1156371,32.0,3383.0,13.0,2785.0,1.0,402.0,196.0,23.0,10.0,3,1210,486,33955,2335,385643,419598,12/23/2020
2020-11-01,330,45404,5091,1116388,1161792,22.0,3405.0,15.0,2800.0,1.0,403.0,202.0,27.0,13.0,4,1214,276,34231,1225,386868,421099,12/23/2020
2020-11-02,522,45926,9935,1126323,1172249,38.0,3443.0,27.0,2827.0,3.0,406.0,210.0,25.0,13.0,5,1219,458,34689,2844,389712,424401,12/23/2020
2020-11-03,601,46527,13040,1139363,1185890,33.0,3476.0,25.0,2852.0,1.0,407.0,217.0,25.0,13.0,1,1220,530,35219,2434,392146,427365,12/23/2020
2020-11-04,688,47215,16101,1155464,1202679,34.0,3510.0,27.0,2879.0,2.0,409.0,222.0,26.0,12.0,4,1224,641,35860,2831,394977,430837,12/23/2020
2020-11-05,768,47983,16593,1172057,1220040,46.0,3556.0,35.0,2914.0,1.0,410.0,232.0,25.0,14.0,3,1227,684,36544,2768,397745,434289,12/23/2020
2020-11-06,769,48752,16026,1188083,1236835,43.0,3599.0,31.0,2945.0,1.0,411.0,243.0,29.0,17.0,5,1232,690,37234,2945,400690,437924,12/23/2020
2020-11-07,604,49356,13649,1201732,1251088,34.0,3633.0,25.0,2970.0,1.0,412.0,251.0,32.0,18.0,1,1233,578,37812,2395,403085,440897,12/23/2020
2020-11-08,337,49693,4166,1205898,1255591,33.0,3666.0,26.0,2996.0,1.0,413.0,257.0,31.0,19.0,4,1237,323,38135,1241,404326,442461,12/23/2020
2020-11-09,808,50501,9063,1214961,1265462,40.0,3706.0,33.0,3029.0,2.0,415.0,262.0,29.0,18.0,3,1240,765,38900,2257,406583,445483,12/23/2020
2020-11-10,1053,51554,12982,1227943,1279497,45.0,3751.0,37.0,3066.0,0.0,415.0,270.0,32.0,18.0,6,1246,982,39882,2805,409388,449270,12/23/2020
2020-11-11,1087,52641,19738,1247681,1300322,42.0,3793.0,24.0,3090.0,5.0,420.0,283.0,31.0,15.0,7,1253,1002,40884,2603,411991,452875,12/23/2020
2020-11-12,893,53534,13913,1261594,1315128,39.0,3832.0,31.0,3121.0,3.0,423.0,288.0,29.0,15.0,5,1258,814,41698,2145,414136,455834,12/23/2020
2020-11-13,1165,54699,16391,1277985,1332684,39.0,3871.0,31.0,3152.0,0.0,423.0,296.0,28.0,15.0,2,1260,1115,42813,3009,417145,459958,12/23/2020
2020-11-14,782,55481,13519,1291504,1346985,42.0,3913.0,26.0,3178.0,5.0,428.0,307.0,26.0,13.0,10,1270,738,43551,2404,419549,463100,12/23/2020
2020-11-15,578,56059,6173,1297677,1353736,46.0,3959.0,21.0,3199.0,5.0,433.0,327.0,29.0,11.0,7,1277,495,44046,1386,420935,464981,12/23/2020
2020-11-16,739,56798,9647,1307324,1364122,56.0,4015.0,39.0,3238.0,3.0,436.0,341.0,27.0,13.0,5,1282,674,44720,2585,423520,468240,12/23/2020
2020-11-17,1538,58336,18176,1325500,1383836,59.0,4074.0,45.0,3283.0,2.0,438.0,353.0,31.0,13.0,5,1287,1402,46122,4035,427555,473677,12/23/2020
2020-11-18,1136,59472,16042,1341542,1401014,39.0,4113.0,38.0,3321.0,5.0,443.0,349.0,30.0,15.0,7,1294,1020,47142,3125,430680,477822,12/23/2020
2020-11-19,1128,60600,13171,1354713,1415313,47.0,4160.0,42.0,3363.0,4.0,447.0,350.0,31.0,18.0,5,1299,1032,48174,3338,434018,482192,12/23/2020
2020-11-20,1457,62057,22226,1376939,1438996,49.0,4209.0,48.0,3411.0,3.0,450.0,348.0,34.0,14.0,6,1305,1293,49467,4226,438244,487711,12/23/2020
2020-11-21,854,62911,17369,1394308,1457219,43.0,4252.0,34.0,3445.0,5.0,455.0,352.0,36.0,14.0,7,1312,755,50222,3067,441311,491533,12/23/2020
2020-11-22,571,63482,7519,1401827,1465309,65.0,4317.0,28.0,3473.0,4.0,459.0,385.0,34.0,15.0,11,1323,486,50708,1764,443075,493783,12/23/2020
2020-11-23,994,64476,11031,1412858,1477334,75.0,4392.0,41.0,3514.0,0.0,459.0,419.0,41.0,18.0,10,1333,893,51601,3336,446411,498012,12/23/2020
2020-11-24,1049,65525,14579,1427437,1492962,47.0,4439.0,59.0,3573.0,6.0,465.0,401.0,43.0,22.0,10,1343,939,52540,2714,449125,501665,12/23/2020
2020-11-25,1265,66790,18787,1446224,1513014,59.0,4498.0,59.0,3632.0,4.0,469.0,397.0,44.0,26.0,7,1350,1179,53719,3383,452508,506227,12/23/2020
2020-11-26,547,67337,6483,1452707,1520044,51.0,4549.0,35.0,3667.0,4.0,473.0,409.0,47.0,25.0,12,1362,467,54186,1502,454010,508196,12/23/2020
2020-11-27,1043,68380,9724,1462431,1530811,56.0,4605.0,51.0,3718.0,7.0,480.0,407.0,48.0,22.0,7,1369,968,55154,2481,456491,511645,12/23/2020
2020-11-28,1182,69562,11960,1474391,1543953,64.0,4669.0,39.0,3757.0,0.0,480.0,432.0,49.0,22.0,3,1372,1097,56251,2759,459250,515501,12/23/2020
2020-11-29,822,70384,6936,1481327,1551711,62.0,4731.0,35.0,3792.0,3.0,483.0,456.0,50.0,24.0,8,1380,755,57006,2278,461528,518534,12/23/2020
2020-11-30,1283,71667,9925,1491252,1562919,67.0,4798.0,60.0,3852.0,2.0,485.0,461.0,53.0,30.0,6,1386,1162,58168,2766,464294,522462,12/23/2020
2020-12-01,1555,73222,13956,1505208,1578430,61.0,4859.0,55.0,3907.0,4.0,489.0,463.0,52.0,31.0,12,1398,1419,59587,3323,467617,527204,12/23/2020
2020-12-02,1561,74783,15563,1520771,1595554,57.0,4916.0,53.0,3960.0,7.0,496.0,460.0,53.0,30.0,14,1412,1432,61019,3210,470827,531846,12/23/2020
2020-12-03,1772,76555,14626,1535397,1611952,64.0,4980.0,76.0,4036.0,5.0,501.0,443.0,49.0,31.0,10,1422,1640,62659,3277,474104,536763,12/23/2020
2020-12-04,1648,78203,16506,1551903,1630106,70.0,5050.0,50.0,4086.0,7.0,508.0,456.0,46.0,29.0,11,1433,1520,64179,3735,477839,542018,12/23/2020
2020-12-05,1199,79402,12609,1564512,1643914,71.0,5121.0,42.0,4128.0,4.0,512.0,481.0,48.0,29.0,11,1444,1066,65245,2859,480698,545943,12/23/2020
2020-12-06,1125,80527,7844,1572356,1652883,66.0,5187.0,50.0,4178.0,10.0,522.0,487.0,49.0,25.0,14,1458,979,66224,2450,483148,549372,12/23/2020
2020-12-07,1396,81923,10641,1582997,1664920,74.0,5261.0,59.0,4237.0,6.0,528.0,496.0,47.0,25.0,20,1478,1254,67478,3281,486429,553907,12/23/2020
2020-12-08,1464,83387,15314,1598311,1681698,59.0,5320.0,57.0,4294.0,5.0,533.0,493.0,51.0,28.0,17,1495,1315,68793,3533,489962,558755,12/23/2020
2020-12-09,1499,84886,16353,1614664,1699550,58.0,5378.0,63.0,4357.0,9.0,542.0,479.0,48.0,30.0,12,1507,1342,70135,3195,493157,563292,12/23/2020
2020-12-10,1474,86360,17265,1631929,1718289,65.0,5443.0,58.0,4415.0,7.0,549.0,479.0,55.0,29.0,18,1525,1257,71392,4061,497218,568610,12/23/2020
2020-12-11,1489,87849,17371,1649300,1737149,72.0,5515.0,83.0,4498.0,7.0,556.0,461.0,60.0,32.0,16,1541,1293,72685,3587,500805,573490,12/23/2020
2020-12-12,1122,88971,13056,1662356,1751327,65.0,5580.0,54.0,4552.0,9.0,565.0,463.0,53.0,31.0,16,1557,920,73605,3090,503895,577500,12/23/2020
2020-12-13,672,89643,7144,1669500,1759143,74.0,5654.0,41.0,4593.0,14.0,579.0,482.0,54.0,28.0,25,1582,556,74161,1997,505892,580053,12/23/2020
2020-12-14,1314,90957,11197,1680697,1771654,82.0,5736.0,63.0,4656.0,10.0,589.0,491.0,64.0,30.0,14,1596,1141,75302,3373,509265,584567,12/23/2020
2020-12-15,1268,92225,15076,1695773,1787998,70.0,5806.0,57.0,4713.0,5.0,594.0,499.0,59.0,29.0,13,1609,1066,76368,3070,512335,588703,12/23/2020
2020-12-16,1275,93500,19067,1714840,1808340,54.0,5860.0,70.0,4783.0,11.0,605.0,472.0,58.0,31.0,15,1624,1086,77454,3694,516029,593483,12/23/2020
2020-12-17,483,93983,8819,1723659,1817642,46.0,5906.0,59.0,4842.0,8.0,613.0,451.0,57.0,31.0,14,1638,429,77883,1271,517300,595183,12/23/2020
2020-12-18,1108,95091,13470,1737129,1832220,51.0,5957.0,67.0,4909.0,11.0,624.0,424.0,57.0,32.0,13,1651,916,78799,2757,520057,598856,12/23/2020
2020-12-19,1315,96406,16327,1753456,1849862,55.0,6012.0,39.0,4948.0,9.0,633.0,431.0,56.0,35.0,18,1669,1081,79880,3114,523171,603051,12/23/2020
2020-12-20,532,96938,6776,1760232,1857170,57.0,6069.0,40.0,4988.0,8.0,641.0,440.0,56.0,38.0,12,1681,427,80307,1685,524856,605163,12/23/2020
2020-12-21,1089,98027,11919,1772151,1870178,62.0,6131.0,53.0,5041.0,7.0,648.0,442.0,49.0,35.0,9,1690,880,81187,3559,528415,609602,12/23/2020
2020-12-22,1036,99063,16243,1788394,1887457,,,,,,,,,,14,1704,879,82066,3358,531773,613839,12/23/2020
